k	name	unqRat	unqCnt	notUnqCnt	totCnt
2	"2-out1459"	.01724	2	114	116
2	"2-out17515"	.01465	4	269	273
2	"2-out17869"	.00803	2	247	249
2	"2-out17870"	.00657	2	302	304
2	"2-out18110"	.00904	2	219	221
2	"2-out18115"	.00985	2	201	203
2	"2-out18250"	.01052	2	188	190
3	"3-out1459"	.02586	3	113	116
3	"3-out17515"	.02197	6	267	273
3	"3-out17869"	.01204	3	246	249
3	"3-out17870"	.00986	3	301	304
3	"3-out18110"	.01357	3	218	221
3	"3-out18115"	.01477	3	200	203
3	"3-out18250"	.01578	3	187	190
4	"4-out654"	.00282	2	707	709
4	"4-out1459"	.03448	4	112	116
4	"4-out16895"	.01587	2	124	126
4	"4-out17515"	.02930	8	265	273
4	"4-out17869"	.01606	4	245	249
4	"4-out17870"	.01315	4	300	304
4	"4-out18110"	.01809	4	217	221
4	"4-out18115"	.01970	4	199	203
4	"4-out18250"	.02105	4	186	190
4	"4-out19227"	.00198	2	1007	1009
4	"4-out19687"	.00165	2	1205	1207
5	"5-out1"	.01411	6	419	425
5	"5-out2"	.00924	6	643	649
5	"5-out3"	.00867	3	343	346
5	"5-out6"	.00591	2	336	338
5	"5-out7"	.01038	8	762	770
5	"5-out8"	.01587	10	620	630
5	"5-out10"	.00102	2	1953	1955
5	"5-out11"	.01123	9	792	801
5	"5-out12"	.00060	2	3296	3298
5	"5-out16"	.00215	2	927	929
5	"5-out19"	.00644	6	925	931
5	"5-out20"	.00214	2	930	932
5	"5-out22"	.00581	2	342	344
5	"5-out24"	.00604	3	493	496
5	"5-out25"	.00636	5	780	785
5	"5-out27"	.00927	7	748	755
5	"5-out28"	.00206	2	967	969
5	"5-out29"	.00542	2	367	369
5	"5-out31"	.00341	4	1168	1172
5	"5-out33"	.01736	5	283	288
5	"5-out34"	.02034	7	337	344
5	"5-out35"	.00438	2	454	456
5	"5-out36"	.00225	2	884	886
5	"5-out37"	.00234	2	852	854
5	"5-out46"	.02844	25	854	879
5	"5-out48"	.00634	5	783	788
5	"5-out49"	.00751	2	264	266
5	"5-out51"	.00810	3	367	370
5	"5-out52"	.00634	2	313	315
5	"5-out53"	.00325	2	613	615
5	"5-out56"	.00628	4	632	636
5	"5-out57"	.00241	2	827	829
5	"5-out58"	.00414	2	480	482
5	"5-out59"	.00495	4	803	807
5	"5-out60"	.00535	4	743	747
5	"5-out62"	.01458	7	473	480
5	"5-out63"	.00338	3	884	887
5	"5-out64"	.00563	14	2471	2485
5	"5-out65"	.00336	4	1183	1187
5	"5-out66"	.00237	2	840	842
5	"5-out67"	.00224	2	887	889
5	"5-out69"	.00495	4	803	807
5	"5-out71"	.00963	4	411	415
5	"5-out73"	.01176	4	336	340
5	"5-out75"	.00672	4	591	595
5	"5-out76"	.00795	6	748	754
5	"5-out77"	.00197	2	1013	1015
5	"5-out78"	.00498	4	798	802
5	"5-out79"	.00150	3	1994	1997
5	"5-out80"	.00765	10	1296	1306
5	"5-out83"	.00137	2	1450	1452
5	"5-out84"	.02941	18	594	612
5	"5-out86"	.00276	4	1442	1446
5	"5-out87"	.00539	5	921	926
5	"5-out91"	.01891	8	415	423
5	"5-out92"	.00222	2	895	897
5	"5-out93"	.00458	2	434	436
5	"5-out95"	.01474	5	334	339
5	"5-out96"	.00441	2	451	453
5	"5-out97"	.00591	2	336	338
5	"5-out98"	.00533	9	1677	1686
5	"5-out99"	.02295	7	298	305
5	"5-out100"	.00936	5	529	534
5	"5-out102"	.00508	2	391	393
5	"5-out106"	.00337	4	1182	1186
5	"5-out108"	.03930	9	220	229
5	"5-out109"	.03030	7	224	231
5	"5-out110"	.01201	9	740	749
5	"5-out115"	.01621	6	364	370
5	"5-out117"	.00325	2	612	614
5	"5-out118"	.02254	22	954	976
5	"5-out119"	.00374	2	532	534
5	"5-out120"	.01680	4	234	238
5	"5-out121"	.00975	10	1015	1025
5	"5-out124"	.01298	5	380	385
5	"5-out126"	.00473	2	420	422
5	"5-out127"	.00645	2	308	310
5	"5-out128"	.00232	3	1285	1288
5	"5-out129"	.00214	2	930	932
5	"5-out134"	.00322	3	928	931
5	"5-out135"	.00435	2	457	459
5	"5-out136"	.00429	4	928	932
5	"5-out139"	.02702	7	252	259
5	"5-out141"	.00462	2	430	432
5	"5-out142"	.00136	7	5135	5142
5	"5-out146"	.01869	2	105	107
5	"5-out147"	.00215	4	1856	1860
5	"5-out154"	.00282	2	707	709
5	"5-out156"	.00525	6	1135	1141
5	"5-out157"	.01244	6	476	482
5	"5-out158"	.01333	6	444	450
5	"5-out159"	.00148	4	2692	2696
5	"5-out160"	.00573	2	347	349
5	"5-out162"	.02845	7	239	246
5	"5-out165"	.00554	5	896	901
5	"5-out167"	.00353	2	564	566
5	"5-out169"	.00679	5	731	736
5	"5-out172"	.00631	6	944	950
5	"5-out176"	.00408	4	975	979
5	"5-out181"	.00971	9	917	926
5	"5-out184"	.00337	2	591	593
5	"5-out186"	.01342	2	147	149
5	"5-out187"	.01401	3	211	214
5	"5-out191"	.00346	5	1440	1445
5	"5-out192"	.00373	5	1332	1337
5	"5-out193"	.01251	25	1972	1997
5	"5-out199"	.00172	4	2311	2315
5	"5-out201"	.03448	5	140	145
5	"5-out205"	.00538	6	1108	1114
5	"5-out208"	.00852	3	349	352
5	"5-out211"	.00467	2	426	428
5	"5-out212"	.02705	28	1007	1035
5	"5-out213"	.00398	2	500	502
5	"5-out214"	.00845	4	469	473
5	"5-out222"	.00432	2	460	462
5	"5-out223"	.03434	17	478	495
5	"5-out224"	.00840	2	236	238
5	"5-out226"	.00533	2	373	375
5	"5-out227"	.02074	5	236	241
5	"5-out228"	.00500	3	596	599
5	"5-out230"	.00495	9	1808	1817
5	"5-out231"	.01869	6	315	321
5	"5-out233"	.03691	11	287	298
5	"5-out234"	.01886	6	312	318
5	"5-out235"	.02857	9	306	315
5	"5-out236"	.01916	6	307	313
5	"5-out237"	.00958	3	310	313
5	"5-out238"	.00925	3	321	324
5	"5-out239"	.01242	4	318	322
5	"5-out240"	.01253	4	315	319
5	"5-out241"	.00651	2	305	307
5	"5-out244"	.02348	7	291	298
5	"5-out247"	.00949	3	313	316
5	"5-out249"	.00617	2	322	324
5	"5-out251"	.01290	4	306	310
5	"5-out252"	.01277	4	309	313
5	"5-out253"	.01282	4	308	312
5	"5-out255"	.01282	4	308	312
5	"5-out258"	.00641	2	310	312
5	"5-out259"	.02949	10	329	339
5	"5-out260"	.00657	2	302	304
5	"5-out261"	.00326	2	610	612
5	"5-out264"	.03021	11	353	364
5	"5-out265"	.02747	10	354	364
5	"5-out268"	.01265	9	702	711
5	"5-out269"	.01741	12	677	689
5	"5-out272"	.02481	10	393	403
5	"5-out276"	.02345	14	583	597
5	"5-out277"	.00682	6	873	879
5	"5-out278"	.00456	3	654	657
5	"5-out281"	.01039	14	1333	1347
5	"5-out282"	.01343	18	1322	1340
5	"5-out287"	.00686	5	723	728
5	"5-out288"	.00174	2	1146	1148
5	"5-out289"	.00215	2	927	929
5	"5-out290"	.00216	2	921	923
5	"5-out291"	.00430	4	926	930
5	"5-out292"	.00207	2	961	963
5	"5-out293"	.00213	2	934	936
5	"5-out294"	.00323	4	1233	1237
5	"5-out295"	.00213	2	935	937
5	"5-out298"	.00803	5	617	622
5	"5-out300"	.01123	2	176	178
5	"5-out303"	.01098	3	270	273
5	"5-out306"	.00214	2	931	933
5	"5-out309"	.00373	2	534	536
5	"5-out313"	.00179	2	1110	1112
5	"5-out314"	.00844	7	822	829
5	"5-out315"	.00451	4	881	885
5	"5-out320"	.00396	2	503	505
5	"5-out321"	.00829	2	239	241
5	"5-out322"	.00491	2	405	407
5	"5-out324"	.00335	2	594	596
5	"5-out325"	.01262	5	391	396
5	"5-out329"	.01804	7	381	388
5	"5-out332"	.00702	6	848	854
5	"5-out333"	.01481	2	133	135
5	"5-out334"	.00410	3	728	731
5	"5-out337"	.00251	2	793	795
5	"5-out338"	.00881	7	787	794
5	"5-out339"	.00251	2	793	795
5	"5-out340"	.01069	10	925	935
5	"5-out341"	.00210	2	949	951
5	"5-out342"	.00681	5	729	734
5	"5-out343"	.00411	12	2904	2916
5	"5-out345"	.00421	4	946	950
5	"5-out346"	.00429	4	928	932
5	"5-out347"	.00213	2	934	936
5	"5-out348"	.02409	10	405	415
5	"5-out349"	.00289	2	690	692
5	"5-out350"	.00608	13	2124	2137
5	"5-out352"	.00689	2	288	290
5	"5-out353"	.01114	4	355	359
5	"5-out354"	.00230	2	866	868
5	"5-out355"	.00328	2	607	609
5	"5-out356"	.00373	2	533	535
5	"5-out361"	.01395	12	848	860
5	"5-out364"	.00568	2	350	352
5	"5-out365"	.00681	3	437	440
5	"5-out367"	.00378	2	527	529
5	"5-out369"	.01060	3	280	283
5	"5-out370"	.01066	5	464	469
5	"5-out372"	.00070	2	2837	2839
5	"5-out373"	.01847	16	850	866
5	"5-out374"	.00626	9	1428	1437
5	"5-out375"	.02825	18	619	637
5	"5-out376"	.00094	2	2113	2115
5	"5-out377"	.00854	2	232	234
5	"5-out381"	.01226	4	322	326
5	"5-out385"	.00668	2	297	299
5	"5-out386"	.00716	2	277	279
5	"5-out387"	.01181	3	251	254
5	"5-out391"	.06849	5	68	73
5	"5-out393"	.00584	2	340	342
5	"5-out395"	.03021	11	353	364
5	"5-out399"	.00414	6	1441	1447
5	"5-out405"	.00182	2	1091	1093
5	"5-out406"	.00278	2	717	719
5	"5-out409"	.00463	3	644	647
5	"5-out410"	.00371	6	1609	1615
5	"5-out415"	.01709	2	115	117
5	"5-out416"	.00109	2	1819	1821
5	"5-out419"	.01351	2	146	148
5	"5-out420"	.00330	4	1207	1211
5	"5-out421"	.01285	5	384	389
5	"5-out424"	.00765	5	648	653
5	"5-out426"	.00536	2	371	373
5	"5-out428"	.01983	7	346	353
5	"5-out430"	.00169	6	3524	3530
5	"5-out431"	.00825	16	1923	1939
5	"5-out432"	.00670	13	1926	1939
5	"5-out433"	.00185	3	1613	1616
5	"5-out435"	.00078	2	2546	2548
5	"5-out438"	.00275	2	723	725
5	"5-out442"	.01221	12	970	982
5	"5-out443"	.00283	2	704	706
5	"5-out444"	.01253	8	630	638
5	"5-out445"	.00950	4	417	421
5	"5-out446"	.00809	7	858	865
5	"5-out451"	.00284	19	6650	6669
5	"5-out453"	.00748	6	796	802
5	"5-out454"	.00465	6	1282	1288
5	"5-out455"	.00995	4	398	402
5	"5-out456"	.01081	4	366	370
5	"5-out457"	.01436	5	343	348
5	"5-out459"	.01602	5	307	312
5	"5-out460"	.02884	9	303	312
5	"5-out463"	.03790	13	330	343
5	"5-out465"	.00961	3	309	312
5	"5-out466"	.01111	4	356	360
5	"5-out472"	.00643	2	309	311
5	"5-out473"	.01400	5	352	357
5	"5-out474"	.01923	6	306	312
5	"5-out476"	.00641	2	310	312
5	"5-out478"	.00649	2	306	308
5	"5-out480"	.01261	4	313	317
5	"5-out482"	.00949	3	313	316
5	"5-out483"	.00632	2	314	316
5	"5-out484"	.00641	2	310	312
5	"5-out485"	.00579	2	343	345
5	"5-out488"	.00641	2	310	312
5	"5-out489"	.00576	2	345	347
5	"5-out493"	.00542	2	367	369
5	"5-out494"	.01436	5	343	348
5	"5-out495"	.00649	2	306	308
5	"5-out496"	.00649	2	306	308
5	"5-out497"	.00937	3	317	320
5	"5-out498"	.01886	6	312	318
5	"5-out499"	.00574	2	346	348
5	"5-out500"	.00668	2	297	299
5	"5-out502"	.01840	6	320	326
5	"5-out503"	.01290	4	306	310
5	"5-out504"	.00647	2	307	309
5	"5-out505"	.00645	2	308	310
5	"5-out506"	.01273	4	310	314
5	"5-out508"	.00641	2	310	312
5	"5-out509"	.02229	7	307	314
5	"5-out511"	.04487	14	298	312
5	"5-out513"	.00632	2	314	316
5	"5-out515"	.00643	2	309	311
5	"5-out520"	.00958	3	310	313
5	"5-out521"	.01910	6	308	314
5	"5-out522"	.01910	6	308	314
5	"5-out524"	.00623	2	319	321
5	"5-out525"	.00623	2	319	321
5	"5-out526"	.00651	2	305	307
5	"5-out527"	.02250	7	304	311
5	"5-out528"	.00983	3	302	305
5	"5-out529"	.00643	2	309	311
5	"5-out535"	.01282	4	308	312
5	"5-out536"	.00647	2	307	309
5	"5-out537"	.00864	3	344	347
5	"5-out539"	.00641	2	310	312
5	"5-out540"	.00630	2	315	317
5	"5-out544"	.01923	6	306	312
5	"5-out545"	.03215	10	301	311
5	"5-out546"	.00961	3	309	312
5	"5-out547"	.00645	2	308	310
5	"5-out548"	.01607	5	306	311
5	"5-out550"	.00597	2	333	335
5	"5-out554"	.01081	4	366	370
5	"5-out558"	.00943	6	630	636
5	"5-out560"	.00895	8	885	893
5	"5-out561"	.00431	2	462	464
5	"5-out563"	.00376	7	1851	1858
5	"5-out565"	.00139	2	1435	1437
5	"5-out566"	.00596	14	2332	2346
5	"5-out567"	.01086	2	182	184
5	"5-out569"	.00541	6	1102	1108
5	"5-out570"	.00378	7	1841	1848
5	"5-out573"	.01517	9	584	593
5	"5-out579"	.01652	4	238	242
5	"5-out580"	.03021	11	353	364
5	"5-out581"	.00693	4	573	577
5	"5-out583"	.01294	4	305	309
5	"5-out584"	.02893	9	302	311
5	"5-out585"	.02373	8	329	337
5	"5-out587"	.00845	3	352	355
5	"5-out592"	.03225	10	300	310
5	"5-out593"	.03225	10	300	310
5	"5-out594"	.01602	5	307	312
5	"5-out596"	.00625	2	318	320
5	"5-out601"	.00964	3	308	311
5	"5-out603"	.01315	4	300	304
5	"5-out605"	.03846	12	300	312
5	"5-out608"	.00617	2	322	324
5	"5-out609"	.00647	2	307	309
5	"5-out610"	.00636	2	312	314
5	"5-out614"	.00609	2	326	328
5	"5-out615"	.02215	7	309	316
5	"5-out616"	.01557	5	316	321
5	"5-out618"	.00611	2	325	327
5	"5-out620"	.01607	5	306	311
5	"5-out627"	.01602	5	307	312
5	"5-out633"	.00634	2	313	315
5	"5-out634"	.00641	2	310	312
5	"5-out636"	.00647	2	307	309
5	"5-out637"	.00647	2	307	309
5	"5-out638"	.01273	4	310	314
5	"5-out639"	.00611	2	325	327
5	"5-out643"	.00232	2	859	861
5	"5-out645"	.08823	9	93	102
5	"5-out649"	.00576	2	345	347
5	"5-out650"	.00500	6	1192	1198
5	"5-out652"	.00546	3	546	549
5	"5-out654"	.01128	8	701	709
5	"5-out655"	.00557	2	357	359
5	"5-out657"	.00865	2	229	231
5	"5-out658"	.00691	7	1005	1012
5	"5-out659"	.00223	2	892	894
5	"5-out660"	.00571	2	348	350
5	"5-out663"	.00629	8	1262	1270
5	"5-out665"	.00891	9	1001	1010
5	"5-out666"	.00738	4	538	542
5	"5-out668"	.00328	18	5460	5478
5	"5-out671"	.01047	152	14355	14507
5	"5-out672"	.00089	4	4489	4493
5	"5-out674"	.00429	36	8348	8384
5	"5-out675"	.00318	4	1251	1255
5	"5-out676"	.00883	5	561	566
5	"5-out677"	.00564	10	1763	1773
5	"5-out678"	.00347	18	5161	5179
5	"5-out679"	.02812	61	2108	2169
5	"5-out680"	.01644	93	5561	5654
5	"5-out690"	.01117	2	177	179
5	"5-out691"	.01418	2	139	141
5	"5-out692"	.00579	2	343	345
5	"5-out693"	.05154	5	92	97
5	"5-out695"	.00477	4	833	837
5	"5-out696"	.02205	12	532	544
5	"5-out698"	.01386	8	569	577
5	"5-out699"	.00837	6	710	716
5	"5-out700"	.01328	4	297	301
5	"5-out703"	.01265	4	312	316
5	"5-out704"	.01215	4	325	329
5	"5-out705"	.01929	6	305	311
5	"5-out707"	.01315	2	150	152
5	"5-out708"	.00239	2	832	834
5	"5-out712"	.01041	2	190	192
5	"5-out714"	.01376	3	215	218
5	"5-out719"	.00600	2	331	333
5	"5-out720"	.00647	5	767	772
5	"5-out721"	.00268	2	743	745
5	"5-out724"	.00670	13	1925	1938
5	"5-out725"	.00205	4	1942	1946
5	"5-out726"	.00194	4	2054	2058
5	"5-out727"	.00291	6	2055	2061
5	"5-out729"	.00598	2	332	334
5	"5-out730"	.02994	5	162	167
5	"5-out732"	.25000	4	12	16
5	"5-out734"	.00257	4	1547	1551
5	"5-out736"	.00258	4	1541	1545
5	"5-out737"	.01863	6	316	322
5	"5-out738"	.01242	4	318	322
5	"5-out742"	.01277	4	309	313
5	"5-out745"	.00606	2	328	330
5	"5-out746"	.00636	2	312	314
5	"5-out748"	.02153	7	318	325
5	"5-out749"	.00645	2	308	310
5	"5-out750"	.01916	6	307	313
5	"5-out751"	.00638	2	311	313
5	"5-out752"	.01577	5	312	317
5	"5-out755"	.00961	3	309	312
5	"5-out756"	.01923	6	306	312
5	"5-out757"	.01286	4	307	311
5	"5-out758"	.00641	2	310	312
5	"5-out761"	.00943	3	315	318
5	"5-out762"	.00952	3	312	315
5	"5-out763"	.00641	2	310	312
5	"5-out764"	.01269	4	311	315
5	"5-out765"	.00634	2	313	315
5	"5-out768"	.04126	13	302	315
5	"5-out769"	.00952	3	312	315
5	"5-out770"	.00647	2	307	309
5	"5-out772"	.01294	4	305	309
5	"5-out773"	.01265	4	312	316
5	"5-out775"	.00651	2	305	307
5	"5-out776"	.00628	2	316	318
5	"5-out780"	.01923	6	306	312
5	"5-out783"	.00634	2	313	315
5	"5-out785"	.00645	2	308	310
5	"5-out787"	.01302	4	303	307
5	"5-out788"	.01628	5	302	307
5	"5-out789"	.01916	6	307	313
5	"5-out790"	.01294	4	305	309
5	"5-out792"	.01916	6	307	313
5	"5-out794"	.01623	5	303	308
5	"5-out796"	.01948	6	302	308
5	"5-out799"	.01269	4	311	315
5	"5-out800"	.01290	4	306	310
5	"5-out801"	.00634	2	313	315
5	"5-out802"	.00621	2	320	322
5	"5-out803"	.00557	2	357	359
5	"5-out804"	.00961	3	309	312
5	"5-out805"	.01910	6	308	314
5	"5-out807"	.00630	2	315	317
5	"5-out810"	.00615	2	323	325
5	"5-out813"	.00625	2	318	320
5	"5-out814"	.01234	4	320	324
5	"5-out815"	.00613	2	324	326
5	"5-out818"	.00636	2	312	314
5	"5-out819"	.00578	2	344	346
5	"5-out820"	.01286	4	307	311
5	"5-out822"	.01282	4	308	312
5	"5-out828"	.01520	4	259	263
5	"5-out829"	.00645	2	308	310
5	"5-out830"	.00655	2	303	305
5	"5-out833"	.00664	2	299	301
5	"5-out835"	.00930	2	213	215
5	"5-out838"	.00362	2	549	551
5	"5-out840"	.00660	2	301	303
5	"5-out841"	.00331	2	602	604
5	"5-out842"	.00571	2	348	350
5	"5-out843"	.00393	2	506	508
5	"5-out844"	.00108	2	1847	1849
5	"5-out847"	.00966	6	615	621
5	"5-out848"	.00454	3	657	660
5	"5-out849"	.00881	4	450	454
5	"5-out851"	.01425	6	415	421
5	"5-out852"	.00515	2	386	388
5	"5-out853"	.00146	2	1367	1369
5	"5-out855"	.00858	4	462	466
5	"5-out856"	.00436	4	912	916
5	"5-out859"	.01023	34	3289	3323
5	"5-out860"	.01293	16	1221	1237
5	"5-out861"	.00399	23	5739	5762
5	"5-out862"	.00574	14	2425	2439
5	"5-out867"	.00572	3	521	524
5	"5-out868"	.00520	5	955	960
5	"5-out871"	.01230	4	321	325
5	"5-out872"	.00921	2	215	217
5	"5-out874"	.02020	2	97	99
5	"5-out875"	.00475	4	837	841
5	"5-out876"	.01468	9	604	613
5	"5-out878"	.01550	8	508	516
5	"5-out881"	.02348	7	291	298
5	"5-out884"	.00958	3	310	313
5	"5-out887"	.00613	2	324	326
5	"5-out888"	.00929	11	1172	1183
5	"5-out890"	.01666	7	413	420
5	"5-out892"	.00995	4	398	402
5	"5-out895"	.00738	2	269	271
5	"5-out896"	.01238	4	319	323
5	"5-out898"	.00475	2	419	421
5	"5-out899"	.00454	2	438	440
5	"5-out903"	.03252	4	119	123
5	"5-out904"	.02072	4	189	193
5	"5-out910"	.00209	4	1901	1905
5	"5-out912"	.00463	3	644	647
5	"5-out915"	.00295	2	675	677
5	"5-out917"	.00553	9	1618	1627
5	"5-out918"	.00226	3	1320	1323
5	"5-out921"	.00877	2	226	228
5	"5-out924"	.00456	9	1963	1972
5	"5-out925"	.02187	24	1073	1097
5	"5-out926"	.00618	12	1927	1939
5	"5-out928"	.00189	4	2112	2116
5	"5-out929"	.00296	5	1680	1685
5	"5-out931"	.00327	2	608	610
5	"5-out933"	.01003	3	296	299
5	"5-out934"	.01515	4	260	264
5	"5-out935"	.00396	2	502	504
5	"5-out936"	.01029	6	577	583
5	"5-out938"	.01408	3	210	213
5	"5-out941"	.00925	2	214	216
5	"5-out946"	.00418	2	476	478
5	"5-out947"	.00508	2	391	393
5	"5-out949"	.01320	4	299	303
5	"5-out950"	.01282	4	308	312
5	"5-out951"	.02250	7	304	311
5	"5-out958"	.01734	6	340	346
5	"5-out959"	.01600	2	123	125
5	"5-out965"	.00135	2	1477	1479
5	"5-out967"	.01552	5	317	322
5	"5-out968"	.03333	11	319	330
5	"5-out971"	.00747	7	929	936
5	"5-out974"	.01470	3	201	204
5	"5-out977"	.00500	2	398	400
5	"5-out978"	.00146	3	2051	2054
5	"5-out980"	.00204	3	1462	1465
5	"5-out983"	.00851	2	233	235
5	"5-out990"	.01629	8	483	491
5	"5-out992"	.00715	4	555	559
5	"5-out994"	.00396	2	502	504
5	"5-out996"	.00325	2	612	614
5	"5-out998"	.01526	2	129	131
5	"5-out999"	.03216	23	692	715
5	"5-out1000"	.00749	2	265	267
5	"5-out1002"	.02214	6	265	271
5	"5-out1004"	.00383	2	520	522
5	"5-out1007"	.00512	2	388	390
5	"5-out1013"	.00264	2	753	755
5	"5-out1021"	.00573	6	1040	1046
5	"5-out1022"	.02525	10	386	396
5	"5-out1023"	.02142	18	822	840
5	"5-out1025"	.01111	7	623	630
5	"5-out1027"	.01973	3	149	152
5	"5-out1028"	.00903	12	1316	1328
5	"5-out1029"	.00869	10	1140	1150
5	"5-out1030"	.01690	6	349	355
5	"5-out1035"	.00606	5	819	824
5	"5-out1036"	.00856	4	463	467
5	"5-out1037"	.00181	2	1102	1104
5	"5-out1046"	.00252	2	789	791
5	"5-out1047"	.01123	5	440	445
5	"5-out1050"	.02702	4	144	148
5	"5-out1052"	.00803	2	247	249
5	"5-out1053"	.01304	6	454	460
5	"5-out1054"	.00441	3	676	679
5	"5-out1056"	.06340	22	325	347
5	"5-out1060"	.00350	2	568	570
5	"5-out1061"	.01088	8	727	735
5	"5-out1063"	.00480	2	414	416
5	"5-out1064"	.00394	2	505	507
5	"5-out1066"	.06278	14	209	223
5	"5-out1067"	.00201	2	993	995
5	"5-out1069"	.03496	5	138	143
5	"5-out1070"	.03478	4	111	115
5	"5-out1072"	.00727	4	546	550
5	"5-out1074"	.00696	12	1710	1722
5	"5-out1079"	.00520	8	1529	1537
5	"5-out1080"	.00697	6	854	860
5	"5-out1081"	.00387	2	514	516
5	"5-out1082"	.01503	2	131	133
5	"5-out1085"	.03252	4	119	123
5	"5-out1091"	.07432	11	137	148
5	"5-out1092"	.00786	9	1135	1144
5	"5-out1098"	.12413	18	127	145
5	"5-out1099"	.00273	2	730	732
5	"5-out1100"	.01136	2	174	176
5	"5-out1101"	.00622	4	639	643
5	"5-out1102"	.00527	5	942	947
5	"5-out1104"	.00533	7	1306	1313
5	"5-out1106"	.00626	6	951	957
5	"5-out1112"	.00751	2	264	266
5	"5-out1113"	.00716	2	277	279
5	"5-out1117"	.01250	6	474	480
5	"5-out1119"	.00588	2	338	340
5	"5-out1124"	.00821	3	362	365
5	"5-out1125"	.01111	4	356	360
5	"5-out1126"	.01212	6	489	495
5	"5-out1127"	.00552	2	360	362
5	"5-out1128"	.00795	9	1123	1132
5	"5-out1129"	.00233	2	854	856
5	"5-out1130"	.01150	18	1546	1564
5	"5-out1131"	.00401	7	1735	1742
5	"5-out1135"	.03674	23	603	626
5	"5-out1136"	.02770	11	386	397
5	"5-out1138"	.01431	8	551	559
5	"5-out1140"	.00306	2	651	653
5	"5-out1141"	.00386	8	2062	2070
5	"5-out1142"	.00381	2	522	524
5	"5-out1143"	.00615	2	323	325
5	"5-out1146"	.01290	4	306	310
5	"5-out1149"	.02525	10	386	396
5	"5-out1150"	.00579	2	343	345
5	"5-out1151"	.00613	2	324	326
5	"5-out1152"	.00617	2	322	324
5	"5-out1153"	.01302	4	303	307
5	"5-out1154"	.00371	2	537	539
5	"5-out1157"	.00628	2	316	318
5	"5-out1159"	.00970	3	306	309
5	"5-out1160"	.00455	2	437	439
5	"5-out1161"	.00461	8	1724	1732
5	"5-out1163"	.01869	4	210	214
5	"5-out1164"	.01868	17	893	910
5	"5-out1165"	.00609	10	1631	1641
5	"5-out1166"	.00754	10	1315	1325
5	"5-out1167"	.00515	7	1352	1359
5	"5-out1169"	.02803	6	208	214
5	"5-out1170"	.01898	3	155	158
5	"5-out1171"	.01562	4	252	256
5	"5-out1173"	.00727	2	273	275
5	"5-out1176"	.00439	5	1132	1137
5	"5-out1177"	.01108	5	446	451
5	"5-out1179"	.00376	30	7938	7968
5	"5-out1180"	.00316	6	1890	1896
5	"5-out1181"	.00419	2	475	477
5	"5-out1183"	.01052	6	564	570
5	"5-out1185"	.00873	2	227	229
5	"5-out1186"	.03174	2	61	63
5	"5-out1187"	.00757	2	262	264
5	"5-out1188"	.02941	2	66	68
5	"5-out1191"	.00636	2	312	314
5	"5-out1194"	.00175	2	1140	1142
5	"5-out1196"	.00341	3	876	879
5	"5-out1198"	.00293	2	680	682
5	"5-out1201"	.02684	12	435	447
5	"5-out1203"	.02181	6	269	275
5	"5-out1204"	.02542	6	230	236
5	"5-out1205"	.03937	5	122	127
5	"5-out1208"	.00961	3	309	312
5	"5-out1211"	.02277	20	858	878
5	"5-out1212"	.02277	20	858	878
5	"5-out1213"	.02481	20	786	806
5	"5-out1214"	.02277	20	858	878
5	"5-out1215"	.01719	13	743	756
5	"5-out1216"	.02159	16	725	741
5	"5-out1221"	.00487	2	408	410
5	"5-out1222"	.00581	2	342	344
5	"5-out1223"	.01130	9	787	796
5	"5-out1225"	.00476	4	835	839
5	"5-out1226"	.00216	2	923	925
5	"5-out1228"	.00271	4	1471	1475
5	"5-out1229"	.00431	6	1385	1391
5	"5-out1230"	.00557	8	1428	1436
5	"5-out1231"	.00114	2	1747	1749
5	"5-out1232"	.02515	8	310	318
5	"5-out1235"	.05714	4	66	70
5	"5-out1239"	.01648	6	358	364
5	"5-out1240"	.00468	2	425	427
5	"5-out1243"	.02662	9	329	338
5	"5-out1245"	.00622	5	798	803
5	"5-out1246"	.00975	2	203	205
5	"5-out1248"	.00706	8	1124	1132
5	"5-out1249"	.00668	2	297	299
5	"5-out1250"	.01466	5	336	341
5	"5-out1252"	.00960	12	1237	1249
5	"5-out1253"	.01619	12	729	741
5	"5-out1257"	.00756	7	918	925
5	"5-out1259"	.00386	11	2834	2845
5	"5-out1260"	.00725	5	684	689
5	"5-out1262"	.00395	5	1260	1265
5	"5-out1263"	.00596	3	500	503
5	"5-out1265"	.00380	2	524	526
5	"5-out1267"	.00862	2	230	232
5	"5-out1268"	.01224	3	242	245
5	"5-out1270"	.01525	11	710	721
5	"5-out1271"	.01023	3	290	293
5	"5-out1272"	.00414	2	480	482
5	"5-out1273"	.02061	10	475	485
5	"5-out1274"	.00357	2	557	559
5	"5-out1275"	.01169	2	169	171
5	"5-out1276"	.01162	2	170	172
5	"5-out1277"	.00472	2	421	423
5	"5-out1279"	.00543	3	549	552
5	"5-out1280"	.01762	11	613	624
5	"5-out1281"	.01079	5	458	463
5	"5-out1283"	.01456	3	203	206
5	"5-out1284"	.03278	2	59	61
5	"5-out1285"	.07432	11	137	148
5	"5-out1288"	.01194	4	331	335
5	"5-out1289"	.00322	4	1235	1239
5	"5-out1293"	.03652	8	211	219
5	"5-out1294"	.00519	2	383	385
5	"5-out1295"	.00221	2	902	904
5	"5-out1299"	.00390	4	1020	1024
5	"5-out1301"	.00193	2	1034	1036
5	"5-out1302"	.00731	4	543	547
5	"5-out1305"	.00627	7	1108	1115
5	"5-out1306"	.00575	6	1037	1043
5	"5-out1307"	.02982	15	488	503
5	"5-out1308"	.00478	7	1457	1464
5	"5-out1309"	.00336	5	1479	1484
5	"5-out1310"	.00486	6	1227	1233
5	"5-out1311"	.00598	8	1328	1336
5	"5-out1312"	.01066	10	928	938
5	"5-out1313"	.04819	4	79	83
5	"5-out1314"	.00651	2	305	307
5	"5-out1315"	.00716	2	277	279
5	"5-out1316"	.02280	7	300	307
5	"5-out1317"	.00793	2	250	252
5	"5-out1322"	.00267	2	745	747
5	"5-out1323"	.01388	4	284	288
5	"5-out1324"	.01000	2	198	200
5	"5-out1325"	.00291	5	1712	1717
5	"5-out1330"	.00948	18	1880	1898
5	"5-out1333"	.03858	12	299	311
5	"5-out1334"	.00845	4	469	473
5	"5-out1335"	.01898	6	310	316
5	"5-out1338"	.00970	3	306	309
5	"5-out1339"	.00655	2	303	305
5	"5-out1340"	.01818	6	324	330
5	"5-out1341"	.01910	6	308	314
5	"5-out1342"	.03559	11	298	309
5	"5-out1343"	.01463	15	1010	1025
5	"5-out1344"	.00625	2	318	320
5	"5-out1345"	.01486	7	464	471
5	"5-out1348"	.01265	4	312	316
5	"5-out1349"	.00952	3	312	315
5	"5-out1350"	.00581	2	342	344
5	"5-out1351"	.00641	2	310	312
5	"5-out1361"	.01282	4	308	312
5	"5-out1362"	.00619	2	321	323
5	"5-out1365"	.01261	4	313	317
5	"5-out1366"	.01851	6	318	324
5	"5-out1367"	.00571	2	348	350
5	"5-out1368"	.01286	4	307	311
5	"5-out1369"	.00636	2	312	314
5	"5-out1370"	.00636	2	312	314
5	"5-out1371"	.00911	3	326	329
5	"5-out1372"	.01567	5	314	319
5	"5-out1373"	.00946	3	314	317
5	"5-out1374"	.00625	2	318	320
5	"5-out1375"	.01246	4	317	321
5	"5-out1377"	.01246	4	317	321
5	"5-out1378"	.01863	9	474	483
5	"5-out1379"	.01047	6	567	573
5	"5-out1380"	.01045	16	1515	1531
5	"5-out1383"	.02116	4	185	189
5	"5-out1384"	.01694	12	696	708
5	"5-out1388"	.00514	3	580	583
5	"5-out1389"	.02031	9	434	443
5	"5-out1391"	.01764	3	167	170
5	"5-out1392"	.01764	3	167	170
5	"5-out1393"	.00806	2	246	248
5	"5-out1404"	.00531	4	749	753
5	"5-out1405"	.02120	6	277	283
5	"5-out1406"	.00522	2	381	383
5	"5-out1409"	.01587	7	434	441
5	"5-out1411"	.01476	4	267	271
5	"5-out1412"	.00925	2	214	216
5	"5-out1413"	.00477	2	417	419
5	"5-out1419"	.00501	2	397	399
5	"5-out1420"	.00313	2	635	637
5	"5-out1422"	.00472	2	421	423
5	"5-out1427"	.02760	9	317	326
5	"5-out1429"	.00183	2	1085	1087
5	"5-out1430"	.01002	4	395	399
5	"5-out1432"	.00300	2	663	665
5	"5-out1433"	.00609	4	652	656
5	"5-out1434"	.00937	7	740	747
5	"5-out1435"	.00728	3	409	412
5	"5-out1437"	.00535	10	1858	1868
5	"5-out1438"	.00898	3	331	334
5	"5-out1439"	.00235	6	2543	2549
5	"5-out1440"	.04387	24	523	547
5	"5-out1441"	.00694	4	572	576
5	"5-out1443"	.00778	4	510	514
5	"5-out1444"	.00196	3	1524	1527
5	"5-out1445"	.00755	10	1313	1323
5	"5-out1446"	.01702	4	231	235
5	"5-out1450"	.00214	2	932	934
5	"5-out1451"	.00552	2	360	362
5	"5-out1452"	.00519	3	574	577
5	"5-out1453"	.01365	4	289	293
5	"5-out1454"	.02158	3	136	139
5	"5-out1455"	.00938	2	211	213
5	"5-out1459"	.06034	7	109	116
5	"5-out1462"	.01015	2	195	197
5	"5-out1463"	.00465	4	856	860
5	"5-out1466"	.02127	12	552	564
5	"5-out1467"	.00392	3	762	765
5	"5-out1468"	.00607	2	327	329
5	"5-out1469"	.01769	2	111	113
5	"5-out1470"	.01092	8	724	732
5	"5-out1471"	.01052	14	1316	1330
5	"5-out1474"	.03643	9	238	247
5	"5-out1475"	.04453	11	236	247
5	"5-out1479"	.00317	2	628	630
5	"5-out1484"	.00476	2	418	420
5	"5-out1485"	.00541	5	918	923
5	"5-out1486"	.00300	2	664	666
5	"5-out1488"	.00980	2	202	204
5	"5-out1490"	.01747	13	731	744
5	"5-out1491"	.00197	2	1013	1015
5	"5-out1493"	.00900	11	1211	1222
5	"5-out1494"	.00500	4	796	800
5	"5-out1496"	.01392	6	425	431
5	"5-out1497"	.00378	2	527	529
5	"5-out1500"	.00738	2	269	271
5	"5-out1501"	.00499	10	1993	2003
5	"5-out1502"	.01534	6	385	391
5	"5-out1505"	.01866	7	368	375
5	"5-out1506"	.00693	8	1145	1153
5	"5-out1507"	.01581	18	1120	1138
5	"5-out1509"	.00312	4	1274	1278
5	"5-out1510"	.00389	2	512	514
5	"5-out1512"	.02020	6	291	297
5	"5-out1513"	.02380	7	287	294
5	"5-out1514"	.01238	13	1037	1050
5	"5-out1515"	.01581	18	1120	1138
5	"5-out1516"	.01588	18	1115	1133
5	"5-out1517"	.02117	9	416	425
5	"5-out1518"	.01449	6	408	414
5	"5-out1519"	.01388	6	426	432
5	"5-out1520"	.01398	6	423	429
5	"5-out1521"	.00428	2	465	467
5	"5-out1524"	.02247	2	87	89
5	"5-out1525"	.01379	4	286	290
5	"5-out1527"	.00778	2	255	257
5	"5-out1529"	.00497	3	600	603
5	"5-out1530"	.00447	2	445	447
5	"5-out1534"	.00383	5	1299	1304
5	"5-out1538"	.00882	3	337	340
5	"5-out1541"	.02762	5	176	181
5	"5-out1542"	.01219	2	162	164
5	"5-out1543"	.05921	9	143	152
5	"5-out1544"	.00673	2	295	297
5	"5-out1547"	.01010	2	196	198
5	"5-out1548"	.00150	2	1328	1330
5	"5-out1549"	.00419	8	1901	1909
5	"5-out1550"	.00450	2	442	444
5	"5-out1551"	.00460	2	432	434
5	"5-out1553"	.00493	14	2825	2839
5	"5-out1555"	.00222	2	898	900
5	"5-out1560"	.00865	2	229	231
5	"5-out1562"	.00412	2	483	485
5	"5-out1565"	.00539	2	369	371
5	"5-out1566"	.00732	2	271	273
5	"5-out1567"	.00487	2	408	410
5	"5-out1568"	.00497	3	600	603
5	"5-out1570"	.02083	17	799	816
5	"5-out1573"	.01581	4	249	253
5	"5-out1578"	.00278	2	716	718
5	"5-out1582"	.01571	8	501	509
5	"5-out1586"	.00769	4	516	520
5	"5-out1587"	.00934	4	424	428
5	"5-out1590"	.03323	11	320	331
5	"5-out1594"	.01253	8	630	638
5	"5-out1596"	.01754	2	112	114
5	"5-out1598"	.03703	3	78	81
5	"5-out1600"	.00819	2	242	244
5	"5-out1602"	.00313	2	636	638
5	"5-out1603"	.00615	6	969	975
5	"5-out1604"	.00465	3	642	645
5	"5-out1606"	.00406	4	980	984
5	"5-out1610"	.00478	10	2080	2090
5	"5-out1612"	.01932	4	203	207
5	"5-out1614"	.02714	6	215	221
5	"5-out1616"	.01321	6	448	454
5	"5-out1617"	.00233	2	855	857
5	"5-out1619"	.01136	3	261	264
5	"5-out1623"	.01805	8	435	443
5	"5-out1624"	.00262	2	761	763
5	"5-out1625"	.00147	2	1357	1359
5	"5-out1626"	.00352	2	566	568
5	"5-out1628"	.01476	4	267	271
5	"5-out1630"	.00078	2	2553	2555
5	"5-out1631"	.02857	10	340	350
5	"5-out1632"	.02168	8	361	369
5	"5-out1633"	.02857	10	340	350
5	"5-out1634"	.02710	10	359	369
5	"5-out1635"	.02710	10	359	369
5	"5-out1637"	.01400	7	493	500
5	"5-out1641"	.01234	6	480	486
5	"5-out1642"	.01152	5	429	434
5	"5-out1643"	.00881	4	450	454
5	"5-out1646"	.01036	2	191	193
5	"5-out1650"	.00341	5	1459	1464
5	"5-out1651"	.00518	2	384	386
5	"5-out1652"	.00278	7	2507	2514
5	"5-out1653"	.01047	2	189	191
5	"5-out1655"	.01839	8	427	435
5	"5-out1656"	.02439	6	240	246
5	"5-out1659"	.00826	5	600	605
5	"5-out1662"	.00725	11	1505	1516
5	"5-out1663"	.00526	2	378	380
5	"5-out1665"	.00518	4	768	772
5	"5-out1666"	.00284	2	702	704
5	"5-out1667"	.01059	5	467	472
5	"5-out1668"	.00878	7	790	797
5	"5-out1674"	.00573	4	693	697
5	"5-out1676"	.00458	2	434	436
5	"5-out1677"	.00900	11	1211	1222
5	"5-out1678"	.02857	10	340	350
5	"5-out1682"	.00787	3	378	381
5	"5-out1684"	.01886	7	364	371
5	"5-out1688"	.03669	4	105	109
5	"5-out1689"	.00222	6	2688	2694
5	"5-out1691"	.00493	4	806	810
5	"5-out1692"	.00803	2	247	249
5	"5-out1693"	.00952	2	208	210
5	"5-out1697"	.01181	3	251	254
5	"5-out1700"	.00403	2	494	496
5	"5-out1702"	.00545	9	1642	1651
5	"5-out1703"	.00213	10	4674	4684
5	"5-out1704"	.02857	10	340	350
5	"5-out1706"	.01293	3	229	232
5	"5-out1708"	.04000	3	72	75
5	"5-out1709"	.00348	5	1429	1434
5	"5-out1710"	.01304	6	454	460
5	"5-out1711"	.00615	2	323	325
5	"5-out1713"	.03738	4	103	107
5	"5-out1714"	.01360	2	145	147
5	"5-out1715"	.01211	7	571	578
5	"5-out1716"	.02830	9	309	318
5	"5-out1717"	.00766	4	518	522
5	"5-out1718"	.00350	5	1421	1426
5	"5-out1719"	.02831	16	549	565
5	"5-out1722"	.01138	5	434	439
5	"5-out1723"	.00533	2	373	375
5	"5-out1727"	.00425	2	468	470
5	"5-out1729"	.00345	2	577	579
5	"5-out1732"	.00890	6	668	674
5	"5-out1734"	.00160	4	2484	2488
5	"5-out1735"	.00125	3	2382	2385
5	"5-out1738"	.00775	2	256	258
5	"5-out1739"	.01465	9	605	614
5	"5-out1740"	.00903	19	2083	2102
5	"5-out1741"	.00367	3	813	816
5	"5-out1747"	.03196	7	212	219
5	"5-out1748"	.01066	4	371	375
5	"5-out1749"	.00568	2	350	352
5	"5-out1751"	.01139	4	347	351
5	"5-out1752"	.01104	9	806	815
5	"5-out1756"	.02436	21	841	862
5	"5-out1758"	.00282	2	707	709
5	"5-out1762"	.00796	4	498	502
5	"5-out1764"	.00238	2	838	840
5	"5-out1765"	.00353	3	845	848
5	"5-out1767"	.01468	11	738	749
5	"5-out1772"	.00258	6	2315	2321
5	"5-out1773"	.01107	3	268	271
5	"5-out1774"	.00214	2	931	933
5	"5-out1775"	.00615	2	323	325
5	"5-out1777"	.01119	13	1148	1161
5	"5-out1781"	.04030	16	381	397
5	"5-out1782"	.01179	4	335	339
5	"5-out1783"	.03260	9	267	276
5	"5-out1784"	.00135	4	2942	2946
5	"5-out1785"	.00813	3	366	369
5	"5-out1786"	.00907	6	655	661
5	"5-out1796"	.00917	4	432	436
5	"5-out1800"	.00410	3	728	731
5	"5-out1801"	.01028	12	1155	1167
5	"5-out1805"	.00289	5	1725	1730
5	"5-out1809"	.00347	4	1147	1151
5	"5-out1810"	.00429	5	1159	1164
5	"5-out1811"	.00468	3	637	640
5	"5-out1813"	.00763	2	260	262
5	"5-out1815"	.01340	5	368	373
5	"5-out1816"	.00472	2	421	423
5	"5-out1817"	.01217	20	1623	1643
5	"5-out1820"	.00868	11	1256	1267
5	"5-out1821"	.01556	4	253	257
5	"5-out1822"	.00581	4	684	688
5	"5-out1823"	.00572	4	695	699
5	"5-out1826"	.00248	2	804	806
5	"5-out1829"	.00173	2	1154	1156
5	"5-out1832"	.00399	2	499	501
5	"5-out1836"	.00519	2	383	385
5	"5-out1837"	.00626	2	317	319
5	"5-out1838"	.04733	8	161	169
5	"5-out1839"	.01029	6	577	583
5	"5-out1840"	.02777	5	175	180
5	"5-out1841"	.03658	6	158	164
5	"5-out1843"	.02281	6	257	263
5	"5-out1848"	.00274	4	1453	1457
5	"5-out1850"	.01329	5	371	376
5	"5-out1853"	.00617	17	2735	2752
5	"5-out1855"	.04285	3	67	70
5	"5-out1856"	.00789	6	754	760
5	"5-out1858"	.06034	7	109	116
5	"5-out1859"	.07142	7	91	98
5	"5-out1860"	.00396	2	502	504
5	"5-out1861"	.00364	4	1094	1098
5	"5-out1863"	.00557	3	535	538
5	"5-out1866"	.01152	8	686	694
5	"5-out1870"	.01886	5	260	265
5	"5-out1877"	.00564	2	352	354
5	"5-out1878"	.00398	2	500	502
5	"5-out1879"	.01715	14	802	816
5	"5-out1881"	.01760	5	279	284
5	"5-out1882"	.01048	3	283	286
5	"5-out1883"	.00412	4	966	970
5	"5-out1884"	.01190	4	332	336
5	"5-out1887"	.01941	8	404	412
5	"5-out1888"	.01251	9	710	719
5	"5-out1890"	.00284	2	700	702
5	"5-out1891"	.00290	4	1371	1375
5	"5-out1892"	.00835	11	1306	1317
5	"5-out1893"	.01534	12	770	782
5	"5-out1894"	.02100	10	466	476
5	"5-out1895"	.01736	5	283	288
5	"5-out1905"	.00219	2	909	911
5	"5-out1906"	.00647	3	460	463
5	"5-out1908"	.00761	4	521	525
5	"5-out1911"	.01212	2	163	165
5	"5-out1912"	.00475	5	1047	1052
5	"5-out1915"	.01123	2	176	178
5	"5-out1917"	.02572	8	303	311
5	"5-out1918"	.00740	2	268	270
5	"5-out1920"	.00575	3	518	521
5	"5-out1923"	.00191	2	1042	1044
5	"5-out1924"	.00200	2	997	999
5	"5-out1926"	.00813	8	976	984
5	"5-out1927"	.00459	2	433	435
5	"5-out1934"	.00944	11	1154	1165
5	"5-out1936"	.00366	2	543	545
5	"5-out1937"	.00512	3	582	585
5	"5-out1938"	.00420	4	947	951
5	"5-out1940"	.00883	4	449	453
5	"5-out1941"	.00230	2	866	868
5	"5-out1942"	.00593	6	1005	1011
5	"5-out1943"	.02494	12	469	481
5	"5-out1944"	.00408	2	487	489
5	"5-out1945"	.00410	6	1454	1460
5	"5-out1946"	.03111	22	685	707
5	"5-out1947"	.05426	7	122	129
5	"5-out1948"	.00713	12	1671	1683
5	"5-out1949"	.00714	4	556	560
5	"5-out1950"	.03843	49	1226	1275
5	"5-out1953"	.00446	4	892	896
5	"5-out1954"	.00490	3	609	612
5	"5-out1955"	.00399	2	499	501
5	"5-out1956"	.00500	2	398	400
5	"5-out1958"	.02702	10	360	370
5	"5-out1961"	.01291	7	535	542
5	"5-out1963"	.00719	5	690	695
5	"5-out1967"	.00365	2	545	547
5	"5-out1968"	.00619	12	1925	1937
5	"5-out1970"	.00905	7	766	773
5	"5-out1972"	.00224	2	888	890
5	"5-out1975"	.00741	5	669	674
5	"5-out1977"	.01689	16	931	947
5	"5-out1978"	.00596	3	500	503
5	"5-out1979"	.00625	5	795	800
5	"5-out1981"	.00840	2	236	238
5	"5-out1982"	.03005	11	355	366
5	"5-out1983"	.00359	2	555	557
5	"5-out1985"	.00985	4	402	406
5	"5-out1986"	.00501	2	397	399
5	"5-out1989"	.00529	4	752	756
5	"5-out1991"	.00415	8	1919	1927
5	"5-out1994"	.00632	2	314	316
5	"5-out1998"	.01764	22	1225	1247
5	"5-out2001"	.00800	2	248	250
5	"5-out2002"	.00419	4	950	954
5	"5-out2003"	.00197	2	1009	1011
5	"5-out2005"	.01147	6	517	523
5	"5-out2008"	.00432	5	1151	1156
5	"5-out2009"	.00275	2	725	727
5	"5-out2011"	.00865	4	458	462
5	"5-out2012"	.00356	10	2793	2803
5	"5-out2016"	.00224	2	890	892
5	"5-out2017"	.01210	12	979	991
5	"5-out2024"	.01204	5	410	415
5	"5-out2026"	.00507	4	784	788
5	"5-out2027"	.00228	2	875	877
5	"5-out2037"	.03552	20	543	563
5	"5-out2039"	.01194	4	331	335
5	"5-out2042"	.00510	2	390	392
5	"5-out2046"	.00564	4	704	708
5	"5-out2052"	.01769	2	111	113
5	"5-out2053"	.00121	2	1645	1647
5	"5-out2054"	.00628	2	316	318
5	"5-out2059"	.02547	8	306	314
5	"5-out2062"	.02267	10	431	441
5	"5-out2065"	.00882	3	337	340
5	"5-out2066"	.00335	2	595	597
5	"5-out2067"	.00389	6	1535	1541
5	"5-out2068"	.00313	4	1270	1274
5	"5-out2071"	.02941	2	66	68
5	"5-out2072"	.00853	5	581	586
5	"5-out2074"	.00581	2	342	344
5	"5-out2075"	.02542	6	230	236
5	"5-out2080"	.01226	2	161	163
5	"5-out2082"	.01136	2	174	176
5	"5-out2093"	.01319	5	374	379
5	"5-out2094"	.01196	5	413	418
5	"5-out2095"	.01639	6	360	366
5	"5-out2097"	.02173	4	180	184
5	"5-out2099"	.00820	9	1088	1097
5	"5-out2100"	.00590	7	1178	1185
5	"5-out2102"	.01006	9	885	894
5	"5-out2106"	.00343	5	1450	1455
5	"5-out2109"	.00710	3	419	422
5	"5-out2111"	.00275	2	723	725
5	"5-out2112"	.00715	5	694	699
5	"5-out2114"	.01228	5	402	407
5	"5-out2116"	.00877	4	452	456
5	"5-out2121"	.00444	2	448	450
5	"5-out2123"	.01550	39	2476	2515
5	"5-out2124"	.01506	8	523	531
5	"5-out2126"	.00428	2	465	467
5	"5-out2127"	.01408	2	140	142
5	"5-out2128"	.01100	7	629	636
5	"5-out2130"	.01603	8	491	499
5	"5-out2132"	.02539	8	307	315
5	"5-out2134"	.01607	5	306	311
5	"5-out2136"	.00446	2	446	448
5	"5-out2140"	.00628	2	316	318
5	"5-out2141"	.01523	8	517	525
5	"5-out2142"	.00080	2	2489	2491
5	"5-out2146"	.00881	6	675	681
5	"5-out2147"	.00684	2	290	292
5	"5-out2148"	.01206	7	573	580
5	"5-out2149"	.00655	2	303	305
5	"5-out2150"	.02545	7	268	275
5	"5-out2151"	.00306	2	651	653
5	"5-out2155"	.01587	4	248	252
5	"5-out2156"	.02158	3	136	139
5	"5-out2158"	.00675	2	294	296
5	"5-out2159"	.01223	4	323	327
5	"5-out2161"	.01030	7	672	679
5	"5-out2163"	.01061	4	373	377
5	"5-out2166"	.00619	2	321	323
5	"5-out2167"	.00436	6	1368	1374
5	"5-out2169"	.00330	2	604	606
5	"5-out2170"	.00498	2	399	401
5	"5-out2171"	.01492	5	330	335
5	"5-out2173"	.00377	4	1055	1059
5	"5-out2175"	.00264	2	755	757
5	"5-out2177"	.00945	4	419	423
5	"5-out2178"	.01639	6	360	366
5	"5-out2179"	.00501	2	397	399
5	"5-out2180"	.00321	2	621	623
5	"5-out2184"	.00352	2	565	567
5	"5-out2187"	.00302	6	1977	1983
5	"5-out2188"	.00265	2	752	754
5	"5-out2192"	.00502	7	1387	1394
5	"5-out2193"	.00864	3	344	347
5	"5-out2195"	.01152	4	343	347
5	"5-out2196"	.00696	2	285	287
5	"5-out2197"	.00874	6	680	686
5	"5-out2199"	.00178	2	1117	1119
5	"5-out2200"	.00387	4	1028	1032
5	"5-out2205"	.03676	5	131	136
5	"5-out2208"	.01300	15	1138	1153
5	"5-out2209"	.00214	5	2327	2332
5	"5-out2210"	.00068	2	2923	2925
5	"5-out2211"	.00628	3	474	477
5	"5-out2214"	.00355	3	840	843
5	"5-out2215"	.01063	6	558	564
5	"5-out2216"	.00415	2	479	481
5	"5-out2217"	.00525	3	568	571
5	"5-out2218"	.00675	3	441	444
5	"5-out2219"	.01265	15	1170	1185
5	"5-out2222"	.01342	2	147	149
5	"5-out2227"	.01206	8	655	663
5	"5-out2230"	.00224	2	887	889
5	"5-out2231"	.00450	4	883	887
5	"5-out2234"	.00368	2	541	543
5	"5-out2235"	.00527	2	377	379
5	"5-out2238"	.01033	5	479	484
5	"5-out2239"	.00796	2	249	251
5	"5-out2240"	.02941	2	66	68
5	"5-out2242"	.01003	8	789	797
5	"5-out2244"	.00214	2	929	931
5	"5-out2245"	.00508	4	783	787
5	"5-out2246"	.00460	2	432	434
5	"5-out2247"	.00187	2	1067	1069
5	"5-out2249"	.00210	2	947	949
5	"5-out2250"	.00366	3	815	818
5	"5-out2251"	.00250	2	796	798
5	"5-out2252"	.00781	2	254	256
5	"5-out2254"	.00531	2	374	376
5	"5-out2257"	.04619	17	351	368
5	"5-out2258"	.00380	2	523	525
5	"5-out2261"	.00486	2	409	411
5	"5-out2262"	.00448	6	1331	1337
5	"5-out2263"	.00691	10	1437	1447
5	"5-out2265"	.01794	7	383	390
5	"5-out2267"	.00995	4	398	402
5	"5-out2268"	.01761	13	725	738
5	"5-out2270"	.01858	11	581	592
5	"5-out2277"	.00351	3	851	854
5	"5-out2279"	.00395	8	2016	2024
5	"5-out2280"	.00312	2	638	640
5	"5-out2281"	.01680	6	351	357
5	"5-out2282"	.00329	11	3325	3336
5	"5-out2285"	.00956	4	414	418
5	"5-out2286"	.01553	11	697	708
5	"5-out2290"	.00519	2	383	385
5	"5-out2293"	.00333	4	1197	1201
5	"5-out2295"	.01538	3	192	195
5	"5-out2296"	.01763	13	724	737
5	"5-out2298"	.02362	6	248	254
5	"5-out2299"	.00763	4	520	524
5	"5-out2300"	.01435	3	206	209
5	"5-out2301"	.02652	10	367	377
5	"5-out2303"	.00909	3	327	330
5	"5-out2306"	.01392	24	1700	1724
5	"5-out2309"	.00547	2	363	365
5	"5-out2310"	.00754	6	789	795
5	"5-out2311"	.00252	2	791	793
5	"5-out2313"	.01000	8	792	800
5	"5-out2316"	.00862	8	919	927
5	"5-out2317"	.01932	15	761	776
5	"5-out2318"	.00210	2	948	950
5	"5-out2319"	.00429	4	928	932
5	"5-out2321"	.02142	18	822	840
5	"5-out2322"	.00743	7	934	941
5	"5-out2323"	.00409	2	486	488
5	"5-out2324"	.00387	4	1029	1033
5	"5-out2325"	.00701	9	1274	1283
5	"5-out2328"	.01061	4	373	377
5	"5-out2329"	.01282	8	616	624
5	"5-out2331"	.01032	7	671	678
5	"5-out2333"	.01036	6	573	579
5	"5-out2337"	.00236	4	1685	1689
5	"5-out2338"	.00396	2	503	505
5	"5-out2339"	.00877	7	791	798
5	"5-out2340"	.00465	2	428	430
5	"5-out2343"	.00188	2	1058	1060
5	"5-out2344"	.00751	7	925	932
5	"5-out2347"	.00632	6	942	948
5	"5-out2348"	.00251	2	794	796
5	"5-out2350"	.00497	2	400	402
5	"5-out2352"	.02673	5	182	187
5	"5-out2353"	.02112	6	278	284
5	"5-out2354"	.00718	5	691	696
5	"5-out2356"	.00319	2	624	626
5	"5-out2359"	.00928	3	320	323
5	"5-out2361"	.00769	6	774	780
5	"5-out2362"	.02116	4	185	189
5	"5-out2363"	.00899	29	3195	3224
5	"5-out2364"	.00433	4	918	922
5	"5-out2369"	.00500	2	398	400
5	"5-out2371"	.01132	12	1048	1060
5	"5-out2373"	.00232	4	1713	1717
5	"5-out2374"	.01738	21	1187	1208
5	"5-out2376"	.05343	7	124	131
5	"5-out2377"	.00638	2	311	313
5	"5-out2379"	.00920	3	323	326
5	"5-out2380"	.02000	2	98	100
5	"5-out2382"	.00749	2	265	267
5	"5-out2383"	.02319	9	379	388
5	"5-out2384"	.00945	5	524	529
5	"5-out2385"	.00136	2	1461	1463
5	"5-out2386"	.00573	3	520	523
5	"5-out2387"	.00113	2	1754	1756
5	"5-out2389"	.03878	23	570	593
5	"5-out2395"	.00284	2	700	702
5	"5-out2396"	.00510	2	390	392
5	"5-out2397"	.00531	2	374	376
5	"5-out2400"	.01804	7	381	388
5	"5-out2401"	.00757	2	262	264
5	"5-out2402"	.01639	2	120	122
5	"5-out2405"	.00536	2	371	373
5	"5-out2406"	.00225	2	886	888
5	"5-out2407"	.01379	8	572	580
5	"5-out2408"	.00398	4	1000	1004
5	"5-out2409"	.00395	4	1008	1012
5	"5-out2410"	.00401	2	496	498
5	"5-out2413"	.00512	4	776	780
5	"5-out2421"	.00182	2	1094	1096
5	"5-out2422"	.00441	9	2030	2039
5	"5-out2423"	.00398	4	1000	1004
5	"5-out2425"	.00151	2	1321	1323
5	"5-out2426"	.00452	2	440	442
5	"5-out2427"	.00621	2	320	322
5	"5-out2428"	.00252	3	1183	1186
5	"5-out2430"	.00412	4	966	970
5	"5-out2432"	.00528	6	1130	1136
5	"5-out2433"	.01004	5	493	498
5	"5-out2435"	.01360	8	580	588
5	"5-out2436"	.01716	12	687	699
5	"5-out2437"	.01709	6	345	351
5	"5-out2438"	.01282	11	847	858
5	"5-out2440"	.00195	2	1023	1025
5	"5-out2445"	.00925	4	428	432
5	"5-out2446"	.01197	4	330	334
5	"5-out2451"	.00412	3	724	727
5	"5-out2452"	.00602	2	330	332
5	"5-out2453"	.00394	2	505	507
5	"5-out2455"	.00405	3	736	739
5	"5-out2457"	.02964	11	360	371
5	"5-out2459"	.00372	2	535	537
5	"5-out2464"	.00263	2	757	759
5	"5-out2465"	.00335	4	1190	1194
5	"5-out2470"	.03196	7	212	219
5	"5-out2472"	.00615	2	323	325
5	"5-out2474"	.00601	3	496	499
5	"5-out2475"	.00408	2	487	489
5	"5-out2476"	.00414	2	481	483
5	"5-out2477"	.01003	6	592	598
5	"5-out2479"	.00231	2	863	865
5	"5-out2480"	.02808	5	173	178
5	"5-out2483"	.00300	2	664	666
5	"5-out2484"	.04558	16	335	351
5	"5-out2486"	.00503	2	395	397
5	"5-out2491"	.00610	4	651	655
5	"5-out2493"	.01327	3	223	226
5	"5-out2494"	.01030	2	192	194
5	"5-out2495"	.01416	5	348	353
5	"5-out2496"	.01206	8	655	663
5	"5-out2497"	.01162	4	340	344
5	"5-out2498"	.00302	2	660	662
5	"5-out2500"	.00904	2	219	221
5	"5-out2502"	.01286	4	307	311
5	"5-out2505"	.00636	8	1249	1257
5	"5-out2506"	.00185	2	1074	1076
5	"5-out2507"	.00443	2	449	451
5	"5-out2508"	.00430	2	463	465
5	"5-out2509"	.00428	2	465	467
5	"5-out2510"	.00975	4	406	410
5	"5-out2511"	.00892	4	444	448
5	"5-out2514"	.00709	2	280	282
5	"5-out2516"	.00816	4	486	490
5	"5-out2517"	.00399	6	1497	1503
5	"5-out2524"	.07377	9	113	122
5	"5-out2525"	.01149	4	344	348
5	"5-out2526"	.00980	5	505	510
5	"5-out2531"	.00940	6	632	638
5	"5-out2532"	.00332	4	1198	1202
5	"5-out2534"	.00852	4	465	469
5	"5-out2535"	.00847	5	585	590
5	"5-out2536"	.00145	2	1372	1374
5	"5-out2538"	.00775	15	1920	1935
5	"5-out2539"	.00540	2	368	370
5	"5-out2540"	.00258	2	772	774
5	"5-out2541"	.00381	2	522	524
5	"5-out2543"	.00581	2	342	344
5	"5-out2544"	.01102	3	269	272
5	"5-out2546"	.00869	2	228	230
5	"5-out2548"	.00381	2	522	524
5	"5-out2549"	.00688	4	577	581
5	"5-out2551"	.00352	16	4528	4544
5	"5-out2552"	.00508	3	587	590
5	"5-out2553"	.01960	2	100	102
5	"5-out2554"	.00540	2	368	370
5	"5-out2557"	.00153	2	1301	1303
5	"5-out2558"	.00676	6	881	887
5	"5-out2560"	.00283	5	1761	1766
5	"5-out2562"	.03773	6	153	159
5	"5-out2563"	.00636	2	312	314
5	"5-out2564"	.05020	12	227	239
5	"5-out2566"	.00207	2	964	966
5	"5-out2567"	.01114	7	621	628
5	"5-out2568"	.00536	2	371	373
5	"5-out2570"	.01704	3	173	176
5	"5-out2573"	.00723	4	549	553
5	"5-out2574"	.00231	2	861	863
5	"5-out2577"	.01032	11	1054	1065
5	"5-out2578"	.00482	9	1857	1866
5	"5-out2579"	.00715	4	555	559
5	"5-out2580"	.00280	2	711	713
5	"5-out2581"	.00233	2	856	858
5	"5-out2582"	.02083	4	188	192
5	"5-out2583"	.00357	2	558	560
5	"5-out2586"	.00539	2	369	371
5	"5-out2588"	.01626	2	121	123
5	"5-out2589"	.05645	7	117	124
5	"5-out2590"	.03278	4	118	122
5	"5-out2596"	.00461	4	862	866
5	"5-out2599"	.07575	10	122	132
5	"5-out2602"	.00487	4	816	820
5	"5-out2603"	.00792	8	1001	1009
5	"5-out2604"	.01445	5	341	346
5	"5-out2606"	.01729	6	341	347
5	"5-out2608"	.00310	5	1603	1608
5	"5-out2609"	.02547	8	306	314
5	"5-out2610"	.00356	3	838	841
5	"5-out2611"	.00684	6	870	876
5	"5-out2612"	.00600	2	331	333
5	"5-out2614"	.00321	2	621	623
5	"5-out2615"	.03525	76	2080	2156
5	"5-out2616"	.00351	4	1134	1138
5	"5-out2618"	.01075	6	552	558
5	"5-out2619"	.00437	2	455	457
5	"5-out2621"	.01313	7	526	533
5	"5-out2623"	.00518	2	384	386
5	"5-out2624"	.00360	2	553	555
5	"5-out2627"	.00826	7	840	847
5	"5-out2632"	.00800	2	248	250
5	"5-out2634"	.00461	2	431	433
5	"5-out2636"	.02542	6	230	236
5	"5-out2637"	.00267	2	747	749
5	"5-out2638"	.00858	2	231	233
5	"5-out2639"	.00684	6	870	876
5	"5-out2641"	.00502	2	396	398
5	"5-out2642"	.00455	2	437	439
5	"5-out2644"	.01584	10	621	631
5	"5-out2645"	.01927	9	458	467
5	"5-out2646"	.00255	5	1955	1960
5	"5-out2647"	.00312	3	956	959
5	"5-out2649"	.01156	2	171	173
5	"5-out2652"	.01162	2	170	172
5	"5-out2653"	.00527	4	755	759
5	"5-out2654"	.00096	2	2065	2067
5	"5-out2656"	.00453	2	439	441
5	"5-out2657"	.00246	2	810	812
5	"5-out2658"	.00409	2	486	488
5	"5-out2659"	.00623	2	319	321
5	"5-out2660"	.00943	5	525	530
5	"5-out2661"	.00520	4	765	769
5	"5-out2666"	.00431	2	462	464
5	"5-out2668"	.00369	17	4582	4599
5	"5-out2673"	.01255	3	236	239
5	"5-out2674"	.02439	3	120	123
5	"5-out2676"	.00921	4	430	434
5	"5-out2677"	.00800	4	496	500
5	"5-out2678"	.01072	4	369	373
5	"5-out2679"	.01402	7	492	499
5	"5-out2680"	.03010	9	290	299
5	"5-out2681"	.00923	6	644	650
5	"5-out2682"	.00818	5	606	611
5	"5-out2683"	.00897	7	773	780
5	"5-out2684"	.01156	2	171	173
5	"5-out2685"	.01142	9	779	788
5	"5-out2686"	.00322	2	618	620
5	"5-out2690"	.00253	2	787	789
5	"5-out2691"	.00579	2	343	345
5	"5-out2692"	.00653	5	760	765
5	"5-out2699"	.00611	2	325	327
5	"5-out2702"	.00345	6	1732	1738
5	"5-out2703"	.01318	14	1048	1062
5	"5-out2706"	.00168	4	2367	2371
5	"5-out2709"	.00310	2	642	644
5	"5-out2712"	.00475	2	419	421
5	"5-out2713"	.02871	17	575	592
5	"5-out2716"	.02600	11	412	423
5	"5-out2717"	.02531	4	154	158
5	"5-out2719"	.03225	6	180	186
5	"5-out2720"	.01550	2	127	129
5	"5-out2722"	.00339	3	880	883
5	"5-out2726"	.01680	2	117	119
5	"5-out2727"	.00303	4	1315	1319
5	"5-out2728"	.00197	2	1012	1014
5	"5-out2729"	.02400	3	122	125
5	"5-out2731"	.01886	4	208	212
5	"5-out2733"	.01315	2	150	152
5	"5-out2735"	.00136	2	1459	1461
5	"5-out2736"	.00265	2	751	753
5	"5-out2737"	.00386	2	515	517
5	"5-out2741"	.00338	2	588	590
5	"5-out2742"	.00224	2	887	889
5	"5-out2743"	.00740	2	268	270
5	"5-out2745"	.00535	6	1114	1120
5	"5-out2746"	.00267	2	745	747
5	"5-out2747"	.02043	18	863	881
5	"5-out2748"	.01117	2	177	179
5	"5-out2749"	.01659	4	237	241
5	"5-out2750"	.00668	2	297	299
5	"5-out2751"	.00888	13	1450	1463
5	"5-out2754"	.01132	9	786	795
5	"5-out2756"	.00268	2	744	746
5	"5-out2757"	.00385	2	517	519
5	"5-out2758"	.00685	10	1448	1458
5	"5-out2765"	.00655	2	303	305
5	"5-out2769"	.00183	2	1087	1089
5	"5-out2772"	.02028	10	483	493
5	"5-out2773"	.02417	14	565	579
5	"5-out2774"	.00573	5	867	872
5	"5-out2777"	.05325	9	160	169
5	"5-out2779"	.00238	3	1255	1258
5	"5-out2780"	.02347	5	208	213
5	"5-out2781"	.00840	2	236	238
5	"5-out2783"	.00613	3	486	489
5	"5-out2784"	.00439	4	907	911
5	"5-out2786"	.00281	2	708	710
5	"5-out2788"	.00508	2	391	393
5	"5-out2789"	.04436	13	280	293
5	"5-out2790"	.00438	2	454	456
5	"5-out2793"	.01739	2	113	115
5	"5-out2795"	.01705	43	2478	2521
5	"5-out2796"	.01010	3	294	297
5	"5-out2797"	.00203	2	981	983
5	"5-out2798"	.00214	2	929	931
5	"5-out2800"	.01388	2	142	144
5	"5-out2807"	.00934	2	212	214
5	"5-out2809"	.00757	3	393	396
5	"5-out2810"	.00592	3	503	506
5	"5-out2811"	.00364	2	547	549
5	"5-out2812"	.01369	2	144	146
5	"5-out2813"	.00303	2	658	660
5	"5-out2815"	.00400	3	747	750
5	"5-out2818"	.02651	7	257	264
5	"5-out2821"	.00525	3	568	571
5	"5-out2825"	.02500	6	234	240
5	"5-out2827"	.00684	2	290	292
5	"5-out2831"	.00486	2	409	411
5	"5-out2832"	.00414	4	962	966
5	"5-out2835"	.00605	8	1313	1321
5	"5-out2838"	.00192	3	1559	1562
5	"5-out2840"	.00611	4	650	654
5	"5-out2841"	.00194	2	1024	1026
5	"5-out2842"	.00392	2	507	509
5	"5-out2843"	.00614	7	1132	1139
5	"5-out2846"	.00687	2	289	291
5	"5-out2847"	.02259	4	173	177
5	"5-out2848"	.00275	2	724	726
5	"5-out2850"	.00530	2	375	377
5	"5-out2851"	.00217	3	1379	1382
5	"5-out2852"	.00611	2	325	327
5	"5-out2859"	.00429	2	464	466
5	"5-out2861"	.00142	4	2800	2804
5	"5-out2863"	.00610	7	1139	1146
5	"5-out2866"	.03821	18	453	471
5	"5-out2867"	.00797	9	1119	1128
5	"5-out2868"	.00881	2	225	227
5	"5-out2869"	.01790	7	384	391
5	"5-out2870"	.01912	7	359	366
5	"5-out2875"	.00370	2	538	540
5	"5-out2876"	.00306	2	650	652
5	"5-out2880"	.00340	3	879	882
5	"5-out2881"	.00687	6	867	873
5	"5-out2885"	.00988	7	701	708
5	"5-out2886"	.01194	14	1158	1172
5	"5-out2889"	.00185	3	1618	1621
5	"5-out2891"	.00481	2	413	415
5	"5-out2892"	.00206	2	966	968
5	"5-out2893"	.10526	10	85	95
5	"5-out2896"	.00662	2	300	302
5	"5-out2897"	.00363	4	1095	1099
5	"5-out2899"	.00803	5	617	622
5	"5-out2900"	.02671	7	255	262
5	"5-out2901"	.01245	7	555	562
5	"5-out2902"	.00761	3	391	394
5	"5-out2903"	.00322	2	619	621
5	"5-out2905"	.00312	2	639	641
5	"5-out2906"	.01083	6	548	554
5	"5-out2909"	.00623	2	319	321
5	"5-out2911"	.00464	5	1071	1076
5	"5-out2913"	.00636	6	937	943
5	"5-out2914"	.01809	4	217	221
5	"5-out2918"	.00689	4	576	580
5	"5-out2919"	.00318	2	626	628
5	"5-out2920"	.01176	2	168	170
5	"5-out2921"	.00391	6	1525	1531
5	"5-out2922"	.00436	2	456	458
5	"5-out2923"	.01090	13	1179	1192
5	"5-out2926"	.01453	27	1830	1857
5	"5-out2928"	.00206	2	965	967
5	"5-out2930"	.00415	2	479	481
5	"5-out2931"	.01574	2	125	127
5	"5-out2932"	.00630	2	315	317
5	"5-out2934"	.02250	7	304	311
5	"5-out2935"	.01204	4	328	332
5	"5-out2942"	.01431	7	482	489
5	"5-out2943"	.02602	7	262	269
5	"5-out2945"	.01935	6	304	310
5	"5-out2947"	.01219	4	324	328
5	"5-out2951"	.01875	6	314	320
5	"5-out2952"	.00630	2	315	317
5	"5-out2953"	.01250	4	316	320
5	"5-out2954"	.01572	5	313	318
5	"5-out2956"	.00647	2	307	309
5	"5-out2958"	.00626	2	317	319
5	"5-out2959"	.00584	2	340	342
5	"5-out2961"	.01238	4	319	323
5	"5-out2964"	.02922	9	299	308
5	"5-out2965"	.00615	2	323	325
5	"5-out2967"	.00732	2	271	273
5	"5-out2968"	.00278	2	717	719
5	"5-out2969"	.04395	64	1392	1456
5	"5-out2970"	.00257	2	775	777
5	"5-out2973"	.00493	4	806	810
5	"5-out2977"	.00099	2	2013	2015
5	"5-out2978"	.00079	2	2525	2527
5	"5-out2981"	.00742	6	802	808
5	"5-out2984"	.01769	2	111	113
5	"5-out2985"	.00631	3	472	475
5	"5-out2987"	.00132	2	1510	1512
5	"5-out2988"	.01612	2	122	124
5	"5-out2989"	.01171	3	253	256
5	"5-out2990"	.00624	4	637	641
5	"5-out2991"	.00384	4	1036	1040
5	"5-out2992"	.00479	3	623	626
5	"5-out2993"	.00487	36	7352	7388
5	"5-out2994"	.00505	2	394	396
5	"5-out2996"	.00257	2	776	778
5	"5-out2998"	.00242	2	823	825
5	"5-out3000"	.01032	11	1054	1065
5	"5-out3001"	.01621	9	546	555
5	"5-out3004"	.00582	5	854	859
5	"5-out3006"	.00405	2	491	493
5	"5-out3007"	.00418	3	713	716
5	"5-out3008"	.02890	42	1411	1453
5	"5-out3009"	.00408	19	4636	4655
5	"5-out3011"	.01538	3	192	195
5	"5-out3012"	.00259	2	768	770
5	"5-out3013"	.00104	2	1903	1905
5	"5-out3014"	.00433	7	1606	1613
5	"5-out3015"	.00347	3	861	864
5	"5-out3019"	.03030	3	96	99
5	"5-out3020"	.01639	2	120	122
5	"5-out3021"	.02500	3	117	120
5	"5-out3022"	.00377	2	528	530
5	"5-out3023"	.00394	15	3786	3801
5	"5-out3025"	.01612	4	244	248
5	"5-out3026"	.00990	15	1499	1514
5	"5-out3027"	.00352	3	849	852
5	"5-out3031"	.00196	2	1014	1016
5	"5-out3032"	.00540	8	1473	1481
5	"5-out3035"	.07327	17	215	232
5	"5-out3036"	.01595	3	185	188
5	"5-out3037"	.05901	18	287	305
5	"5-out3038"	.01794	7	383	390
5	"5-out3043"	.00081	2	2438	2440
5	"5-out3044"	.01724	13	741	754
5	"5-out3045"	.00329	3	907	910
5	"5-out3046"	.01239	6	478	484
5	"5-out3047"	.00507	2	392	394
5	"5-out3050"	.01117	2	177	179
5	"5-out3051"	.01456	3	203	206
5	"5-out3052"	.00570	5	871	876
5	"5-out3053"	.01307	20	1510	1530
5	"5-out3055"	.00253	5	1971	1976
5	"5-out3056"	.00419	2	475	477
5	"5-out3061"	.00365	7	1907	1914
5	"5-out3062"	.00455	5	1093	1098
5	"5-out3065"	.00694	6	858	864
5	"5-out3066"	.01022	6	581	587
5	"5-out3067"	.01392	5	354	359
5	"5-out3069"	.00311	8	2559	2567
5	"5-out3070"	.00333	2	598	600
5	"5-out3071"	.00092	2	2155	2157
5	"5-out3072"	.00411	4	968	972
5	"5-out3075"	.01444	4	273	277
5	"5-out3076"	.00448	2	444	446
5	"5-out3078"	.00645	4	616	620
5	"5-out3079"	.00863	5	574	579
5	"5-out3082"	.02739	4	142	146
5	"5-out3084"	.00099	3	3023	3026
5	"5-out3087"	.03061	3	95	98
5	"5-out3088"	.05010	23	436	459
5	"5-out3090"	.01280	12	925	937
5	"5-out3094"	.00641	2	310	312
5	"5-out3095"	.00701	2	283	285
5	"5-out3097"	.00537	9	1665	1674
5	"5-out3098"	.00441	7	1578	1585
5	"5-out3099"	.01745	23	1295	1318
5	"5-out3100"	.00695	5	714	719
5	"5-out3101"	.00139	2	1435	1437
5	"5-out3102"	.01397	21	1482	1503
5	"5-out3103"	.00836	2	237	239
5	"5-out3106"	.01789	8	439	447
5	"5-out3113"	.00188	2	1061	1063
5	"5-out3117"	.00540	4	736	740
5	"5-out3119"	.00881	2	225	227
5	"5-out3124"	.00590	11	1852	1863
5	"5-out3126"	.00531	4	748	752
5	"5-out3128"	.01366	6	433	439
5	"5-out3131"	.00638	2	311	313
5	"5-out3132"	.00515	10	1930	1940
5	"5-out3133"	.00232	2	857	859
5	"5-out3134"	.00178	2	1119	1121
5	"5-out3137"	.00230	2	864	866
5	"5-out3140"	.00230	2	867	869
5	"5-out3141"	.00379	3	787	790
5	"5-out3142"	.00491	7	1417	1424
5	"5-out3144"	.00484	10	2053	2063
5	"5-out3145"	.00309	2	645	647
5	"5-out3148"	.00184	2	1081	1083
5	"5-out3149"	.00936	5	529	534
5	"5-out3153"	.00311	3	960	963
5	"5-out3154"	.03105	5	156	161
5	"5-out3156"	.04201	5	114	119
5	"5-out3157"	.02564	3	114	117
5	"5-out3158"	.02054	3	143	146
5	"5-out3160"	.01414	40	2788	2828
5	"5-out3163"	.00632	14	2201	2215
5	"5-out3165"	.00544	4	730	734
5	"5-out3166"	.00451	8	1762	1770
5	"5-out3170"	.01026	5	482	487
5	"5-out3172"	.00651	6	915	921
5	"5-out3173"	.01488	5	331	336
5	"5-out3174"	.00452	2	440	442
5	"5-out3175"	.00387	4	1029	1033
5	"5-out3176"	.00270	2	738	740
5	"5-out3177"	.00201	2	992	994
5	"5-out3180"	.05901	18	287	305
5	"5-out3181"	.01374	4	287	291
5	"5-out3182"	.00253	2	786	788
5	"5-out3184"	.01307	2	151	153
5	"5-out3185"	.00256	12	4666	4678
5	"5-out3187"	.00721	14	1927	1941
5	"5-out3189"	.01515	2	130	132
5	"5-out3190"	.00788	9	1132	1141
5	"5-out3191"	.00627	8	1266	1274
5	"5-out3192"	.00155	2	1288	1290
5	"5-out3193"	.00362	3	825	828
5	"5-out3195"	.00114	2	1740	1742
5	"5-out3196"	.00581	6	1026	1032
5	"5-out3198"	.00873	2	227	229
5	"5-out3199"	.00223	2	894	896
5	"5-out3200"	.00205	2	971	973
5	"5-out3201"	.00977	4	405	409
5	"5-out3202"	.00581	2	342	344
5	"5-out3203"	.01734	17	963	980
5	"5-out3204"	.00667	7	1041	1048
5	"5-out3206"	.01449	2	136	138
5	"5-out3207"	.00877	4	452	456
5	"5-out3208"	.00657	2	302	304
5	"5-out3209"	.00426	8	1869	1877
5	"5-out3213"	.02531	2	77	79
5	"5-out3214"	.09183	18	178	196
5	"5-out3216"	.00296	2	673	675
5	"5-out3217"	.00821	4	483	487
5	"5-out3219"	.01720	9	514	523
5	"5-out3222"	.00628	2	316	318
5	"5-out3223"	.00651	2	305	307
5	"5-out3226"	.00643	2	309	311
5	"5-out3229"	.01898	3	155	158
5	"5-out3231"	.00928	3	320	323
5	"5-out3234"	.01286	4	307	311
5	"5-out3235"	.02912	9	300	309
5	"5-out3236"	.02243	7	305	312
5	"5-out3238"	.01923	6	306	312
5	"5-out3239"	.01277	4	309	313
5	"5-out3240"	.01277	4	309	313
5	"5-out3241"	.00961	3	309	312
5	"5-out3242"	.04487	14	298	312
5	"5-out3244"	.00636	2	312	314
5	"5-out3245"	.02564	8	304	312
5	"5-out3246"	.02147	7	319	326
5	"5-out3248"	.00632	2	314	316
5	"5-out3250"	.02446	8	319	327
5	"5-out3251"	.01916	6	307	313
5	"5-out3252"	.00625	2	318	320
5	"5-out3255"	.00727	2	273	275
5	"5-out3256"	.00192	2	1038	1040
5	"5-out3257"	.00404	10	2461	2471
5	"5-out3258"	.00352	8	2263	2271
5	"5-out3259"	.01086	4	364	368
5	"5-out3260"	.00140	2	1425	1427
5	"5-out3261"	.00900	3	330	333
5	"5-out3262"	.00166	2	1201	1203
5	"5-out3265"	.00126	2	1580	1582
5	"5-out3267"	.00716	4	554	558
5	"5-out3268"	.00146	2	1363	1365
5	"5-out3269"	.01149	4	344	348
5	"5-out3272"	.02439	4	160	164
5	"5-out3273"	.00554	2	359	361
5	"5-out3285"	.00692	10	1435	1445
5	"5-out3290"	.01677	8	469	477
5	"5-out3291"	.00235	2	847	849
5	"5-out3292"	.03022	23	738	761
5	"5-out3293"	.00763	3	390	393
5	"5-out3294"	.00294	2	678	680
5	"5-out3296"	.00276	2	722	724
5	"5-out3299"	.01776	7	387	394
5	"5-out3302"	.00950	6	625	631
5	"5-out3305"	.00269	2	740	742
5	"5-out3306"	.00754	5	658	663
5	"5-out3308"	.00753	5	659	664
5	"5-out3311"	.03025	21	673	694
5	"5-out3312"	.03766	20	511	531
5	"5-out3314"	.00510	2	390	392
5	"5-out3319"	.02105	2	93	95
5	"5-out3320"	.03550	12	326	338
5	"5-out3321"	.04065	5	118	123
5	"5-out3323"	.00366	2	543	545
5	"5-out3325"	.00507	3	588	591
5	"5-out3329"	.00168	2	1184	1186
5	"5-out3330"	.00795	11	1372	1383
5	"5-out3332"	.00516	2	385	387
5	"5-out3335"	.02500	5	195	200
5	"5-out3336"	.00713	5	696	701
5	"5-out3338"	.01600	6	369	375
5	"5-out3339"	.00197	2	1012	1014
5	"5-out3340"	.00581	2	342	344
5	"5-out3342"	.00291	2	685	687
5	"5-out3345"	.00858	2	231	233
5	"5-out3346"	.00436	4	913	917
5	"5-out3347"	.00160	2	1247	1249
5	"5-out3351"	.00631	3	472	475
5	"5-out3352"	.01417	15	1043	1058
5	"5-out3355"	.01875	6	314	320
5	"5-out3358"	.00151	2	1316	1318
5	"5-out3359"	.00625	4	636	640
5	"5-out3362"	.00987	7	702	709
5	"5-out3363"	.02840	5	171	176
5	"5-out3366"	.00598	2	332	334
5	"5-out3374"	.00375	4	1062	1066
5	"5-out3376"	.01869	2	105	107
5	"5-out3377"	.03550	6	163	169
5	"5-out3379"	.02970	3	98	101
5	"5-out3380"	.00366	4	1088	1092
5	"5-out3382"	.00287	8	2777	2785
5	"5-out3384"	.02512	15	582	597
5	"5-out3386"	.00936	4	423	427
5	"5-out3387"	.04132	5	116	121
5	"5-out3389"	.03448	8	224	232
5	"5-out3390"	.00205	2	970	972
5	"5-out3392"	.04878	8	156	164
5	"5-out3393"	.00380	4	1048	1052
5	"5-out3394"	.02040	3	144	147
5	"5-out3395"	.00280	2	710	712
5	"5-out3396"	.00712	8	1115	1123
5	"5-out3397"	.00204	2	977	979
5	"5-out3398"	.01117	4	354	358
5	"5-out3399"	.00589	2	337	339
5	"5-out3403"	.00729	2	272	274
5	"5-out3404"	.05303	28	500	528
5	"5-out3406"	.04339	23	507	530
5	"5-out3407"	.01954	6	301	307
5	"5-out3408"	.01408	2	140	142
5	"5-out3409"	.00450	7	1548	1555
5	"5-out3410"	.00478	7	1457	1464
5	"5-out3411"	.01496	12	790	802
5	"5-out3413"	.00278	2	717	719
5	"5-out3414"	.02452	13	517	530
5	"5-out3415"	.01123	6	528	534
5	"5-out3416"	.03278	8	236	244
5	"5-out3417"	.02439	6	240	246
5	"5-out3419"	.01796	6	328	334
5	"5-out3420"	.02439	6	240	246
5	"5-out3421"	.00193	2	1034	1036
5	"5-out3422"	.00423	2	470	472
5	"5-out3424"	.00542	12	2202	2214
5	"5-out3425"	.00366	4	1086	1090
5	"5-out3426"	.00317	3	941	944
5	"5-out3428"	.00437	2	455	457
5	"5-out3429"	.00628	10	1581	1591
5	"5-out3431"	.00237	2	840	842
5	"5-out3432"	.00209	2	951	953
5	"5-out3433"	.00417	11	2624	2635
5	"5-out3434"	.00153	5	3253	3258
5	"5-out3436"	.00953	6	623	629
5	"5-out3437"	.00132	4	3023	3027
5	"5-out3439"	.00699	3	426	429
5	"5-out3440"	.00722	4	550	554
5	"5-out3447"	.00491	4	810	814
5	"5-out3450"	.01509	4	261	265
5	"5-out3452"	.00796	6	747	753
5	"5-out3453"	.00524	2	379	381
5	"5-out3454"	.01969	18	896	914
5	"5-out3455"	.00318	4	1252	1256
5	"5-out3456"	.02373	15	617	632
5	"5-out3457"	.00823	5	602	607
5	"5-out3460"	.00547	4	727	731
5	"5-out3461"	.01801	6	327	333
5	"5-out3462"	.00388	2	513	515
5	"5-out3465"	.01108	4	357	361
5	"5-out3466"	.00247	2	805	807
5	"5-out3467"	.00195	2	1019	1021
5	"5-out3473"	.00600	2	331	333
5	"5-out3477"	.00732	4	542	546
5	"5-out3478"	.00711	2	279	281
5	"5-out3481"	.00151	2	1320	1322
5	"5-out3482"	.00778	2	255	257
5	"5-out3483"	.02575	18	681	699
5	"5-out3484"	.00507	2	392	394
5	"5-out3485"	.00437	4	910	914
5	"5-out3487"	.00364	2	547	549
5	"5-out3488"	.01379	2	143	145
5	"5-out3491"	.03658	12	316	328
5	"5-out3492"	.00500	2	398	400
5	"5-out3493"	.01443	10	683	693
5	"5-out3494"	.01731	12	681	693
5	"5-out3495"	.01990	12	591	603
5	"5-out3496"	.01172	7	590	597
5	"5-out3497"	.01627	7	423	430
5	"5-out3498"	.00196	2	1017	1019
5	"5-out3499"	.00883	4	449	453
5	"5-out3500"	.00404	2	493	495
5	"5-out3505"	.00454	2	438	440
5	"5-out3506"	.00442	2	450	452
5	"5-out3507"	.02370	16	659	675
5	"5-out3510"	.06818	9	123	132
5	"5-out3512"	.00536	2	371	373
5	"5-out3513"	.00604	2	329	331
5	"5-out3514"	.00425	4	937	941
5	"5-out3515"	.00520	5	955	960
5	"5-out3519"	.01941	10	505	515
5	"5-out3522"	.00524	2	379	381
5	"5-out3526"	.01086	2	182	184
5	"5-out3528"	.00691	3	431	434
5	"5-out3533"	.00294	2	678	680
5	"5-out3534"	.01443	10	683	693
5	"5-out3535"	.00463	4	859	863
5	"5-out3538"	.01446	7	477	484
5	"5-out3539"	.00442	2	450	452
5	"5-out3541"	.01011	6	587	593
5	"5-out3544"	.01792	5	274	279
5	"5-out3546"	.01265	4	312	316
5	"5-out3548"	.01627	7	423	430
5	"5-out3550"	.00499	5	997	1002
5	"5-out3551"	.00089	2	2228	2230
5	"5-out3554"	.00748	3	398	401
5	"5-out3555"	.01002	4	395	399
5	"5-out3559"	.00203	2	981	983
5	"5-out3561"	.00843	10	1176	1186
5	"5-out3563"	.00149	2	1340	1342
5	"5-out3565"	.00320	4	1246	1250
5	"5-out3566"	.00868	6	685	691
5	"5-out3568"	.00451	2	441	443
5	"5-out3570"	.00522	8	1522	1530
5	"5-out3573"	.03676	5	131	136
5	"5-out3574"	.01488	10	662	672
5	"5-out3575"	.00569	2	349	351
5	"5-out3578"	.00281	4	1415	1419
5	"5-out3583"	.02857	6	204	210
5	"5-out3584"	.00347	14	4010	4024
5	"5-out3585"	.03448	4	112	116
5	"5-out3586"	.01129	2	175	177
5	"5-out3587"	.00313	14	4457	4471
5	"5-out3589"	.00374	2	532	534
5	"5-out3590"	.00368	2	541	543
5	"5-out3591"	.01971	18	895	913
5	"5-out3592"	.00560	2	355	357
5	"5-out3593"	.00961	2	206	208
5	"5-out3596"	.01369	8	576	584
5	"5-out3598"	.01047	2	189	191
5	"5-out3599"	.04979	24	458	482
5	"5-out3600"	.03392	19	541	560
5	"5-out3601"	.02861	20	679	699
5	"5-out3602"	.02578	18	680	698
5	"5-out3603"	.03061	18	570	588
5	"5-out3604"	.03177	21	640	661
5	"5-out3605"	.03673	9	236	245
5	"5-out3606"	.01532	4	257	261
5	"5-out3615"	.00732	4	542	546
5	"5-out3616"	.02222	6	264	270
5	"5-out3617"	.00751	6	792	798
5	"5-out3618"	.00731	4	543	547
5	"5-out3620"	.01706	5	288	293
5	"5-out3621"	.01368	31	2235	2266
5	"5-out3622"	.00707	3	421	424
5	"5-out3625"	.00754	2	263	265
5	"5-out3627"	.00102	2	1956	1958
5	"5-out3629"	.00201	2	991	993
5	"5-out3630"	.00189	2	1051	1053
5	"5-out3634"	.00414	2	481	483
5	"5-out3635"	.03973	12	290	302
5	"5-out3636"	.02649	8	294	302
5	"5-out3638"	.00487	2	408	410
5	"5-out3639"	.01520	8	518	526
5	"5-out3641"	.00349	2	571	573
5	"5-out3642"	.00377	2	528	530
5	"5-out3646"	.04430	7	151	158
5	"5-out3647"	.00476	2	418	420
5	"5-out3650"	.01169	10	845	855
5	"5-out3651"	.01449	7	476	483
5	"5-out3652"	.01060	7	653	660
5	"5-out3653"	.00717	19	2628	2647
5	"5-out3656"	.00881	5	562	567
5	"5-out3658"	.02508	14	544	558
5	"5-out3660"	.00787	10	1260	1270
5	"5-out3661"	.03166	12	367	379
5	"5-out3663"	.02196	53	2360	2413
5	"5-out3664"	.01002	4	395	399
5	"5-out3665"	.00221	2	902	904
5	"5-out3666"	.01724	2	114	116
5	"5-out3667"	.00785	4	505	509
5	"5-out3671"	.01089	4	363	367
5	"5-out3672"	.00720	5	689	694
5	"5-out3677"	.00181	2	1099	1101
5	"5-out3678"	.00586	7	1186	1193
5	"5-out3681"	.00465	2	428	430
5	"5-out3682"	.01265	4	312	316
5	"5-out3685"	.00558	2	356	358
5	"5-out3689"	.01592	9	556	565
5	"5-out3690"	.00360	15	4143	4158
5	"5-out3691"	.02259	4	173	177
5	"5-out3692"	.00485	15	3077	3092
5	"5-out3699"	.00327	4	1216	1220
5	"5-out3701"	.00753	4	527	531
5	"5-out3703"	.00252	2	791	793
5	"5-out3707"	.00418	2	476	478
5	"5-out3709"	.02083	2	94	96
5	"5-out3710"	.00286	2	697	699
5	"5-out3711"	.01650	7	417	424
5	"5-out3712"	.01015	2	195	197
5	"5-out3713"	.00287	2	693	695
5	"5-out3716"	.00578	8	1374	1382
5	"5-out3719"	.01694	4	232	236
5	"5-out3723"	.00663	3	449	452
5	"5-out3724"	.00330	4	1206	1210
5	"5-out3726"	.00162	2	1229	1231
5	"5-out3728"	.01950	11	553	564
5	"5-out3730"	.01003	3	296	299
5	"5-out3733"	.00203	4	1965	1969
5	"5-out3735"	.00450	6	1326	1332
5	"5-out3736"	.00242	2	824	826
5	"5-out3737"	.00393	4	1012	1016
5	"5-out3738"	.00261	2	764	766
5	"5-out3739"	.00350	4	1138	1142
5	"5-out3740"	.00826	2	240	242
5	"5-out3741"	.00269	2	741	743
5	"5-out3743"	.01428	5	345	350
5	"5-out3744"	.01700	5	289	294
5	"5-out3746"	.00361	2	551	553
5	"5-out3747"	.00558	3	534	537
5	"5-out3749"	.00339	2	587	589
5	"5-out3750"	.03370	6	172	178
5	"5-out3751"	.00438	3	681	684
5	"5-out3752"	.04907	8	155	163
5	"5-out3754"	.02962	8	262	270
5	"5-out3755"	.02222	8	352	360
5	"5-out3758"	.01913	4	205	209
5	"5-out3759"	.02051	4	191	195
5	"5-out3766"	.00833	2	238	240
5	"5-out3769"	.01568	4	251	255
5	"5-out3770"	.00975	2	203	205
5	"5-out3774"	.06052	23	357	380
5	"5-out3776"	.07594	6	73	79
5	"5-out3777"	.07594	6	73	79
5	"5-out3778"	.05633	8	134	142
5	"5-out3781"	.00769	2	258	260
5	"5-out3782"	.00708	5	701	706
5	"5-out3787"	.00220	6	2719	2725
5	"5-out3790"	.00928	3	320	323
5	"5-out3791"	.00619	2	321	323
5	"5-out3793"	.00156	2	1272	1274
5	"5-out3794"	.01196	7	578	585
5	"5-out3795"	.00166	2	1196	1198
5	"5-out3796"	.01593	4	247	251
5	"5-out3800"	.00258	2	771	773
5	"5-out3804"	.01466	5	336	341
5	"5-out3805"	.04081	4	94	98
5	"5-out3808"	.02985	2	65	67
5	"5-out3809"	.00168	2	1187	1189
5	"5-out3810"	.00147	3	2025	2028
5	"5-out3811"	.04109	3	70	73
5	"5-out3813"	.00508	2	391	393
5	"5-out3817"	.00153	4	2598	2602
5	"5-out3818"	.00586	10	1696	1706
5	"5-out3820"	.00155	2	1285	1287
5	"5-out3821"	.01134	6	523	529
5	"5-out3824"	.05154	10	184	194
5	"5-out3825"	.03125	2	62	64
5	"5-out3828"	.00185	2	1076	1078
5	"5-out3830"	.02380	2	82	84
5	"5-out3834"	.00175	2	1138	1140
5	"5-out3835"	.00219	2	911	913
5	"5-out3837"	.00216	2	923	925
5	"5-out3839"	.01302	8	606	614
5	"5-out3840"	.01460	25	1687	1712
5	"5-out3842"	.00249	2	799	801
5	"5-out3843"	.00431	4	924	928
5	"5-out3844"	.01479	12	799	811
5	"5-out3845"	.01276	3	232	235
5	"5-out3849"	.00740	3	402	405
5	"5-out3850"	.00157	2	1270	1272
5	"5-out3851"	.00775	4	512	516
5	"5-out3853"	.00723	4	549	553
5	"5-out3854"	.00732	2	271	273
5	"5-out3861"	.03943	14	341	355
5	"5-out3863"	.00192	2	1038	1040
5	"5-out3864"	.00947	9	941	950
5	"5-out3866"	.00639	6	932	938
5	"5-out3870"	.00333	2	597	599
5	"5-out3871"	.00666	4	596	600
5	"5-out3872"	.00270	2	738	740
5	"5-out3874"	.00646	4	615	619
5	"5-out3875"	.00364	3	821	824
5	"5-out3877"	.00776	4	511	515
5	"5-out3878"	.00493	2	403	405
5	"5-out3880"	.00810	13	1590	1603
5	"5-out3883"	.00591	2	336	338
5	"5-out3884"	.00641	2	310	312
5	"5-out3886"	.00955	9	933	942
5	"5-out3887"	.00271	2	734	736
5	"5-out3888"	.00269	2	741	743
5	"5-out3891"	.01045	3	284	287
5	"5-out3892"	.00928	4	427	431
5	"5-out3893"	.00499	7	1394	1401
5	"5-out3895"	.00511	4	778	782
5	"5-out3900"	.00652	3	457	460
5	"5-out3907"	.00516	4	771	775
5	"5-out3911"	.00626	7	1110	1117
5	"5-out3913"	.00595	6	1002	1008
5	"5-out3914"	.00544	5	914	919
5	"5-out3916"	.01540	12	767	779
5	"5-out3917"	.00178	4	2236	2240
5	"5-out3918"	.00514	8	1548	1556
5	"5-out3919"	.00925	7	749	756
5	"5-out3922"	.01652	4	238	242
5	"5-out3925"	.04109	3	70	73
5	"5-out3926"	.00275	2	723	725
5	"5-out3927"	.01567	5	314	319
5	"5-out3928"	.05185	35	640	675
5	"5-out3929"	.00968	7	716	723
5	"5-out3932"	.01162	9	765	774
5	"5-out3933"	.02159	10	453	463
5	"5-out3934"	.02095	7	327	334
5	"5-out3935"	.00813	4	488	492
5	"5-out3936"	.00324	2	615	617
5	"5-out3937"	.01369	4	288	292
5	"5-out3939"	.04210	8	182	190
5	"5-out3940"	.01960	2	100	102
5	"5-out3944"	.01085	8	729	737
5	"5-out3945"	.01371	12	863	875
5	"5-out3953"	.00276	2	722	724
5	"5-out3954"	.00755	5	657	662
5	"5-out3955"	.01443	14	956	970
5	"5-out3958"	.01234	3	240	243
5	"5-out3959"	.01171	6	506	512
5	"5-out3960"	.01010	2	196	198
5	"5-out3961"	.00267	4	1492	1496
5	"5-out3962"	.00419	8	1901	1909
5	"5-out3963"	.00496	3	601	604
5	"5-out3965"	.00909	2	218	220
5	"5-out3966"	.02508	14	544	558
5	"5-out3969"	.00630	2	315	317
5	"5-out3972"	.01257	2	157	159
5	"5-out3975"	.00589	2	337	339
5	"5-out3977"	.00187	2	1066	1068
5	"5-out3978"	.00992	9	898	907
5	"5-out3980"	.01418	2	139	141
5	"5-out3988"	.00836	2	237	239
5	"5-out3989"	.00772	2	257	259
5	"5-out3990"	.00583	2	341	343
5	"5-out3991"	.00764	4	519	523
5	"5-out3993"	.01158	3	256	259
5	"5-out3995"	.00425	2	468	470
5	"5-out3996"	.01333	12	888	900
5	"5-out3997"	.00281	2	709	711
5	"5-out3999"	.00370	2	538	540
5	"5-out4001"	.00792	5	626	631
5	"5-out4003"	.02238	15	655	670
5	"5-out4005"	.00475	2	419	421
5	"5-out4007"	.00352	6	1698	1704
5	"5-out4008"	.03940	8	195	203
5	"5-out4010"	.00451	3	661	664
5	"5-out4012"	.01818	3	162	165
5	"5-out4013"	.00437	2	455	457
5	"5-out4014"	.01020	2	194	196
5	"5-out4015"	.01801	4	218	222
5	"5-out4021"	.00329	2	605	607
5	"5-out4024"	.00209	2	953	955
5	"5-out4026"	.00355	2	560	562
5	"5-out4028"	.00619	2	321	323
5	"5-out4031"	.00429	2	464	466
5	"5-out4034"	.00221	2	901	903
5	"5-out4035"	.00428	2	465	467
5	"5-out4038"	.00719	2	276	278
5	"5-out4039"	.02162	4	181	185
5	"5-out4041"	.01058	2	187	189
5	"5-out4042"	.00129	2	1542	1544
5	"5-out4043"	.00729	6	817	823
5	"5-out4045"	.00278	2	715	717
5	"5-out4047"	.00420	2	474	476
5	"5-out4048"	.00508	2	391	393
5	"5-out4049"	.00435	2	457	459
5	"5-out4052"	.02604	5	187	192
5	"5-out4053"	.00410	2	485	487
5	"5-out4054"	.00104	2	1903	1905
5	"5-out4055"	.00829	6	717	723
5	"5-out4056"	.00337	2	591	593
5	"5-out4059"	.00646	6	922	928
5	"5-out4061"	.00765	3	389	392
5	"5-out4062"	.00690	4	575	579
5	"5-out4063"	.03571	3	81	84
5	"5-out4065"	.00881	2	225	227
5	"5-out4066"	.01118	10	884	894
5	"5-out4067"	.00708	9	1262	1271
5	"5-out4068"	.02906	5	167	172
5	"5-out4069"	.00281	2	709	711
5	"5-out4070"	.01413	13	907	920
5	"5-out4071"	.01550	2	127	129
5	"5-out4073"	.02457	16	635	651
5	"5-out4074"	.00485	2	410	412
5	"5-out4075"	.00781	4	508	512
5	"5-out4077"	.00611	4	650	654
5	"5-out4078"	.01117	2	177	179
5	"5-out4079"	.00847	2	234	236
5	"5-out4080"	.02000	10	490	500
5	"5-out4085"	.01652	2	119	121
5	"5-out4086"	.01063	2	186	188
5	"5-out4091"	.00764	7	909	916
5	"5-out4092"	.01162	7	595	602
5	"5-out4093"	.01877	4	209	213
5	"5-out4098"	.00441	2	451	453
5	"5-out4099"	.00369	3	809	812
5	"5-out4102"	.00956	4	414	418
5	"5-out4103"	.01904	4	206	210
5	"5-out4106"	.01158	7	597	604
5	"5-out4107"	.00888	6	669	675
5	"5-out4108"	.09523	10	95	105
5	"5-out4109"	.00772	2	257	259
5	"5-out4112"	.01436	11	755	766
5	"5-out4114"	.00275	2	724	726
5	"5-out4116"	.00909	5	545	550
5	"5-out4117"	.00389	2	511	513
5	"5-out4119"	.02307	3	127	130
5	"5-out4120"	.00414	2	480	482
5	"5-out4121"	.01431	6	413	419
5	"5-out4125"	.00793	2	250	252
5	"5-out4126"	.02054	3	143	146
5	"5-out4132"	.00292	5	1706	1711
5	"5-out4133"	.01077	9	826	835
5	"5-out4134"	.01043	5	474	479
5	"5-out4140"	.09578	25	236	261
5	"5-out4142"	.00241	2	826	828
5	"5-out4150"	.01061	6	559	565
5	"5-out4152"	.00091	2	2175	2177
5	"5-out4154"	.01417	7	487	494
5	"5-out4156"	.00497	2	400	402
5	"5-out4160"	.00863	9	1033	1042
5	"5-out4161"	.00324	3	922	925
5	"5-out4162"	.00770	4	515	519
5	"5-out4163"	.00324	6	1843	1849
5	"5-out4164"	.00492	2	404	406
5	"5-out4167"	.01408	2	140	142
5	"5-out4168"	.00439	2	453	455
5	"5-out4170"	.00516	2	385	387
5	"5-out4171"	.00510	2	390	392
5	"5-out4172"	.00375	2	530	532
5	"5-out4173"	.00272	3	1096	1099
5	"5-out4177"	.01169	6	507	513
5	"5-out4178"	.00101	4	3922	3926
5	"5-out4179"	.00851	2	233	235
5	"5-out4180"	.00843	2	235	237
5	"5-out4183"	.02448	12	478	490
5	"5-out4184"	.00849	3	350	353
5	"5-out4185"	.02139	4	183	187
5	"5-out4186"	.00082	4	4853	4857
5	"5-out4188"	.00497	2	400	402
5	"5-out4189"	.00291	2	683	685
5	"5-out4192"	.01404	18	1264	1282
5	"5-out4193"	.01680	2	117	119
5	"5-out4194"	.05172	6	110	116
5	"5-out4195"	.00460	3	648	651
5	"5-out4197"	.00566	7	1228	1235
5	"5-out4198"	.00697	3	427	430
5	"5-out4199"	.00383	2	520	522
5	"5-out4200"	.00555	19	3399	3418
5	"5-out4201"	.00980	6	606	612
5	"5-out4202"	.00362	4	1100	1104
5	"5-out4203"	.00190	2	1048	1050
5	"5-out4204"	.00184	2	1083	1085
5	"5-out4205"	.02206	16	709	725
5	"5-out4206"	.01724	2	114	116
5	"5-out4208"	.01097	7	631	638
5	"5-out4209"	.00550	2	361	363
5	"5-out4210"	.01012	5	489	494
5	"5-out4211"	.00511	2	389	391
5	"5-out4213"	.00211	3	1414	1417
5	"5-out4214"	.00538	6	1108	1114
5	"5-out4215"	.03243	6	179	185
5	"5-out4218"	.00913	2	217	219
5	"5-out4219"	.01273	4	310	314
5	"5-out4220"	.00952	2	208	210
5	"5-out4221"	.00560	2	355	357
5	"5-out4223"	.00938	7	739	746
5	"5-out4224"	.00781	2	254	256
5	"5-out4225"	.00295	9	3037	3046
5	"5-out4226"	.04000	3	72	75
5	"5-out4228"	.00679	5	731	736
5	"5-out4229"	.01988	25	1232	1257
5	"5-out4230"	.00837	5	592	597
5	"5-out4232"	.00630	2	315	317
5	"5-out4234"	.00205	2	973	975
5	"5-out4235"	.00800	4	496	500
5	"5-out4241"	.00391	2	509	511
5	"5-out4242"	.00567	3	526	529
5	"5-out4243"	.01828	10	537	547
5	"5-out4245"	.00192	3	1557	1560
5	"5-out4246"	.00396	2	502	504
5	"5-out4247"	.00921	2	215	217
5	"5-out4252"	.00430	5	1156	1161
5	"5-out4254"	.00488	3	611	614
5	"5-out4257"	.00675	4	588	592
5	"5-out4258"	.02758	4	141	145
5	"5-out4261"	.00919	7	754	761
5	"5-out4263"	.00497	2	400	402
5	"5-out4265"	.01898	3	155	158
5	"5-out4266"	.00711	2	279	281
5	"5-out4268"	.03703	19	494	513
5	"5-out4269"	.01379	2	143	145
5	"5-out4272"	.00831	3	358	361
5	"5-out4274"	.00290	2	687	689
5	"5-out4278"	.00363	2	548	550
5	"5-out4279"	.04938	4	77	81
5	"5-out4280"	.00858	2	231	233
5	"5-out4281"	.00316	2	629	631
5	"5-out4283"	.01005	4	394	398
5	"5-out4284"	.01238	4	319	323
5	"5-out4285"	.01126	4	351	355
5	"5-out4286"	.00344	2	578	580
5	"5-out4288"	.00802	3	371	374
5	"5-out4290"	.00333	3	897	900
5	"5-out4291"	.00821	6	724	730
5	"5-out4292"	.03734	18	464	482
5	"5-out4293"	.02012	16	779	795
5	"5-out4294"	.01592	5	309	314
5	"5-out4295"	.01709	2	115	117
5	"5-out4298"	.01310	3	226	229
5	"5-out4299"	.00539	3	553	556
5	"5-out4300"	.01498	8	526	534
5	"5-out4301"	.01201	4	329	333
5	"5-out4302"	.00483	3	617	620
5	"5-out4305"	.00684	7	1016	1023
5	"5-out4306"	.00152	2	1308	1310
5	"5-out4310"	.01960	2	100	102
5	"5-out4311"	.01901	10	516	526
5	"5-out4312"	.00161	4	2475	2479
5	"5-out4314"	.00895	10	1107	1117
5	"5-out4317"	.02230	6	263	269
5	"5-out4318"	.00740	2	268	270
5	"5-out4319"	.00507	2	392	394
5	"5-out4321"	.00411	2	484	486
5	"5-out4322"	.01041	4	380	384
5	"5-out4323"	.01666	5	295	300
5	"5-out4329"	.01328	10	743	753
5	"5-out4331"	.00646	3	461	464
5	"5-out4332"	.01123	3	264	267
5	"5-out4333"	.01677	5	293	298
5	"5-out4335"	.00335	2	595	597
5	"5-out4337"	.02688	15	543	558
5	"5-out4338"	.02307	3	127	130
5	"5-out4341"	.02542	3	115	118
5	"5-out4342"	.00306	2	650	652
5	"5-out4344"	.02631	2	74	76
5	"5-out4345"	.02150	4	182	186
5	"5-out4346"	.03937	5	122	127
5	"5-out4347"	.01428	2	138	140
5	"5-out4348"	.00161	3	1851	1854
5	"5-out4349"	.01793	4	219	223
5	"5-out4350"	.01506	48	3139	3187
5	"5-out4351"	.00806	5	615	620
5	"5-out4356"	.05660	9	150	159
5	"5-out4357"	.00522	2	381	383
5	"5-out4360"	.02040	6	288	294
5	"5-out4363"	.00939	9	949	958
5	"5-out4364"	.02941	6	198	204
5	"5-out4366"	.00727	2	273	275
5	"5-out4367"	.00534	2	372	374
5	"5-out4368"	.00527	5	943	948
5	"5-out4373"	.01440	5	342	347
5	"5-out4375"	.00253	2	786	788
5	"5-out4376"	.00242	2	822	824
5	"5-out4378"	.00632	3	471	474
5	"5-out4381"	.00677	6	879	885
5	"5-out4384"	.04929	14	270	284
5	"5-out4388"	.00441	7	1577	1584
5	"5-out4390"	.01793	4	219	223
5	"5-out4391"	.00677	2	293	295
5	"5-out4392"	.00155	3	1922	1925
5	"5-out4393"	.01062	10	931	941
5	"5-out4394"	.01846	6	319	325
5	"5-out4395"	.00857	5	578	583
5	"5-out4398"	.00680	2	292	294
5	"5-out4400"	.01069	2	185	187
5	"5-out4401"	.00390	2	510	512
5	"5-out4404"	.00204	5	2437	2442
5	"5-out4405"	.02504	13	506	519
5	"5-out4406"	.04411	15	325	340
5	"5-out4407"	.00505	3	590	593
5	"5-out4412"	.01104	2	179	181
5	"5-out4413"	.00291	2	683	685
5	"5-out4414"	.01481	2	133	135
5	"5-out4415"	.00442	2	450	452
5	"5-out4416"	.00145	2	1370	1372
5	"5-out4417"	.01444	4	273	277
5	"5-out4423"	.00357	2	558	560
5	"5-out4424"	.01213	5	407	412
5	"5-out4428"	.00684	2	290	292
5	"5-out4429"	.01481	2	133	135
5	"5-out4433"	.00819	4	484	488
5	"5-out4434"	.00531	5	936	941
5	"5-out4435"	.02521	3	116	119
5	"5-out4437"	.02711	8	287	295
5	"5-out4442"	.02043	16	767	783
5	"5-out4444"	.00179	2	1111	1113
5	"5-out4445"	.00711	2	279	281
5	"5-out4446"	.00343	2	581	583
5	"5-out4448"	.00423	2	470	472
5	"5-out4450"	.00607	2	327	329
5	"5-out4454"	.00236	2	843	845
5	"5-out4455"	.00539	2	369	371
5	"5-out4459"	.00264	4	1508	1512
5	"5-out4460"	.00269	7	2594	2601
5	"5-out4461"	.00766	2	259	261
5	"5-out4463"	.00385	4	1033	1037
5	"5-out4465"	.00568	4	699	703
5	"5-out4467"	.01993	13	639	652
5	"5-out4468"	.01339	3	221	224
5	"5-out4471"	.01226	2	161	163
5	"5-out4472"	.00413	6	1444	1450
5	"5-out4475"	.00749	4	530	534
5	"5-out4476"	.02307	6	254	260
5	"5-out4479"	.00906	3	328	331
5	"5-out4480"	.02000	2	98	100
5	"5-out4481"	.01214	3	244	247
5	"5-out4487"	.01333	2	148	150
5	"5-out4489"	.02419	9	363	372
5	"5-out4490"	.01056	8	749	757
5	"5-out4491"	.00568	2	350	352
5	"5-out4492"	.00550	4	722	726
5	"5-out4494"	.00990	2	200	202
5	"5-out4495"	.02747	10	354	364
5	"5-out4496"	.00595	2	334	336
5	"5-out4497"	.00389	2	512	514
5	"5-out4498"	.00407	5	1222	1227
5	"5-out4501"	.00569	2	349	351
5	"5-out4503"	.00398	2	500	502
5	"5-out4504"	.01117	4	354	358
5	"5-out4511"	.00434	6	1374	1380
5	"5-out4512"	.00672	3	443	446
5	"5-out4513"	.00220	2	904	906
5	"5-out4514"	.00338	2	589	591
5	"5-out4515"	.00751	4	528	532
5	"5-out4516"	.00729	2	272	274
5	"5-out4520"	.00629	6	947	953
5	"5-out4521"	.00914	3	325	328
5	"5-out4525"	.00492	2	404	406
5	"5-out4526"	.01879	5	261	266
5	"5-out4528"	.00621	3	480	483
5	"5-out4531"	.03669	4	105	109
5	"5-out4534"	.00573	8	1387	1395
5	"5-out4541"	.02057	5	238	243
5	"5-out4542"	.01098	2	180	182
5	"5-out4543"	.01091	5	453	458
5	"5-out4545"	.00746	2	266	268
5	"5-out4548"	.01010	2	196	198
5	"5-out4552"	.00606	9	1475	1484
5	"5-out4553"	.01432	5	344	349
5	"5-out4555"	.00621	5	800	805
5	"5-out4557"	.01449	2	136	138
5	"5-out4560"	.01324	2	149	151
5	"5-out4561"	.00731	9	1222	1231
5	"5-out4562"	.00349	2	571	573
5	"5-out4564"	.01224	6	484	490
5	"5-out4565"	.01853	26	1377	1403
5	"5-out4570"	.00479	3	623	626
5	"5-out4571"	.00192	2	1036	1038
5	"5-out4573"	.00714	2	278	280
5	"5-out4580"	.00216	4	1845	1849
5	"5-out4581"	.00566	2	351	353
5	"5-out4582"	.02380	2	82	84
5	"5-out4583"	.01754	3	168	171
5	"5-out4584"	.00598	2	332	334
5	"5-out4585"	.00692	2	287	289
5	"5-out4586"	.00790	2	251	253
5	"5-out4587"	.03167	7	214	221
5	"5-out4588"	.01652	6	357	363
5	"5-out4589"	.00802	5	618	623
5	"5-out4590"	.00204	2	976	978
5	"5-out4591"	.00711	2	279	281
5	"5-out4592"	.01652	6	357	363
5	"5-out4594"	.01234	3	240	243
5	"5-out4598"	.00506	4	786	790
5	"5-out4599"	.00647	5	767	772
5	"5-out4604"	.00460	2	432	434
5	"5-out4606"	.00660	2	301	303
5	"5-out4611"	.01941	8	404	412
5	"5-out4612"	.01851	3	159	162
5	"5-out4613"	.01030	2	192	194
5	"5-out4615"	.00522	3	571	574
5	"5-out4616"	.07913	11	128	139
5	"5-out4618"	.00886	8	894	902
5	"5-out4620"	.00699	7	994	1001
5	"5-out4623"	.01492	3	198	201
5	"5-out4624"	.00530	2	375	377
5	"5-out4627"	.00684	2	290	292
5	"5-out4629"	.03367	10	287	297
5	"5-out4630"	.01268	7	545	552
5	"5-out4631"	.00461	4	863	867
5	"5-out4634"	.01578	6	374	380
5	"5-out4636"	.00536	2	371	373
5	"5-out4637"	.00585	3	509	512
5	"5-out4639"	.01050	6	565	571
5	"5-out4642"	.01574	2	125	127
5	"5-out4643"	.00706	2	281	283
5	"5-out4648"	.01830	8	429	437
5	"5-out4649"	.00453	3	658	661
5	"5-out4651"	.01562	2	126	128
5	"5-out4652"	.01149	3	258	261
5	"5-out4653"	.02402	8	325	333
5	"5-out4654"	.02291	17	725	742
5	"5-out4658"	.00335	2	595	597
5	"5-out4662"	.00594	14	2339	2353
5	"5-out4663"	.00179	4	2219	2223
5	"5-out4665"	.00619	2	321	323
5	"5-out4666"	.00919	4	431	435
5	"5-out4668"	.01904	6	309	315
5	"5-out4670"	.00686	11	1591	1602
5	"5-out4671"	.00312	2	638	640
5	"5-out4672"	.00437	6	1365	1371
5	"5-out4673"	.00683	4	581	585
5	"5-out4676"	.00727	2	273	275
5	"5-out4677"	.00668	2	297	299
5	"5-out4679"	.06880	15	203	218
5	"5-out4681"	.03067	5	158	163
5	"5-out4683"	.00305	3	979	982
5	"5-out4684"	.00873	2	227	229
5	"5-out4685"	.00362	2	549	551
5	"5-out4686"	.00362	2	549	551
5	"5-out4689"	.00336	2	592	594
5	"5-out4690"	.00474	7	1469	1476
5	"5-out4691"	.00506	2	393	395
5	"5-out4692"	.00749	2	265	267
5	"5-out4694"	.00463	5	1074	1079
5	"5-out4697"	.00746	2	266	268
5	"5-out4698"	.00367	2	542	544
5	"5-out4700"	.00235	2	847	849
5	"5-out4701"	.01411	6	419	425
5	"5-out4703"	.01021	8	775	783
5	"5-out4705"	.00302	2	660	662
5	"5-out4708"	.02097	6	280	286
5	"5-out4709"	.00216	2	920	922
5	"5-out4710"	.01497	5	329	334
5	"5-out4711"	.01234	2	160	162
5	"5-out4712"	.05555	6	102	108
5	"5-out4713"	.01709	2	115	117
5	"5-out4714"	.00564	5	881	886
5	"5-out4723"	.00732	2	271	273
5	"5-out4724"	.01538	5	320	325
5	"5-out4726"	.00481	3	620	623
5	"5-out4727"	.00607	2	327	329
5	"5-out4728"	.00630	6	945	951
5	"5-out4730"	.03472	5	139	144
5	"5-out4731"	.00722	10	1375	1385
5	"5-out4733"	.05208	5	91	96
5	"5-out4734"	.01052	2	188	190
5	"5-out4736"	.00430	2	463	465
5	"5-out4739"	.01237	5	399	404
5	"5-out4740"	.04838	12	236	248
5	"5-out4741"	.00677	2	293	295
5	"5-out4742"	.00831	3	358	361
5	"5-out4743"	.00346	5	1440	1445
5	"5-out4747"	.00913	2	217	219
5	"5-out4750"	.00529	2	376	378
5	"5-out4751"	.01657	6	356	362
5	"5-out4754"	.03906	5	123	128
5	"5-out4755"	.00900	7	770	777
5	"5-out4756"	.00101	2	1975	1977
5	"5-out4757"	.02950	9	296	305
5	"5-out4758"	.01134	9	784	793
5	"5-out4759"	.00454	3	657	660
5	"5-out4765"	.00624	4	637	641
5	"5-out4768"	.00607	2	327	329
5	"5-out4769"	.01002	4	395	399
5	"5-out4770"	.02097	6	280	286
5	"5-out4772"	.01526	2	129	131
5	"5-out4773"	.00877	2	226	228
5	"5-out4777"	.00469	5	1061	1066
5	"5-out4780"	.01554	3	190	193
5	"5-out4783"	.00630	3	473	476
5	"5-out4785"	.00632	3	471	474
5	"5-out4786"	.00952	6	624	630
5	"5-out4787"	.00506	2	393	395
5	"5-out4789"	.00235	4	1697	1701
5	"5-out4790"	.00785	4	505	509
5	"5-out4791"	.00673	2	295	297
5	"5-out4792"	.00400	2	497	499
5	"5-out4799"	.01739	4	226	230
5	"5-out4801"	.00598	2	332	334
5	"5-out4802"	.00903	7	768	775
5	"5-out4803"	.00511	4	778	782
5	"5-out4805"	.00977	3	304	307
5	"5-out4806"	.01379	4	286	290
5	"5-out4811"	.01015	4	390	394
5	"5-out4812"	.00379	7	1838	1845
5	"5-out4814"	.00836	6	711	717
5	"5-out4815"	.00509	5	976	981
5	"5-out4817"	.00837	8	947	955
5	"5-out4818"	.02112	3	139	142
5	"5-out4821"	.02380	3	123	126
5	"5-out4823"	.01136	3	261	264
5	"5-out4824"	.00694	2	286	288
5	"5-out4827"	.00493	6	1211	1217
5	"5-out4828"	.00355	2	561	563
5	"5-out4829"	.00416	4	957	961
5	"5-out4832"	.01673	13	764	777
5	"5-out4834"	.01764	6	334	340
5	"5-out4836"	.00837	6	710	716
5	"5-out4840"	.00328	2	607	609
5	"5-out4841"	.03113	25	778	803
5	"5-out4844"	.01618	33	2006	2039
5	"5-out4847"	.02669	11	401	412
5	"5-out4849"	.00645	3	462	465
5	"5-out4851"	.01724	3	171	174
5	"5-out4855"	.00409	2	486	488
5	"5-out4856"	.00099	2	2015	2017
5	"5-out4858"	.02439	7	280	287
5	"5-out4861"	.00808	4	491	495
5	"5-out4871"	.02525	5	193	198
5	"5-out4872"	.01470	2	134	136
5	"5-out4874"	.04901	5	97	102
5	"5-out4875"	.01322	11	821	832
5	"5-out4876"	.00354	2	562	564
5	"5-out4879"	.00361	2	552	554
5	"5-out4881"	.02777	4	140	144
5	"5-out4882"	.01023	4	387	391
5	"5-out4884"	.00166	2	1200	1202
5	"5-out4885"	.01023	4	387	391
5	"5-out4886"	.00701	2	283	285
5	"5-out4887"	.01018	5	486	491
5	"5-out4888"	.00920	3	323	326
5	"5-out4889"	.02890	10	336	346
5	"5-out4891"	.01851	10	530	540
5	"5-out4892"	.01595	3	185	188
5	"5-out4894"	.00784	11	1392	1403
5	"5-out4895"	.01098	6	540	546
5	"5-out4896"	.00766	6	777	783
5	"5-out4897"	.00373	5	1333	1338
5	"5-out4899"	.01226	2	161	163
5	"5-out4900"	.02439	5	200	205
5	"5-out4902"	.00360	6	1659	1665
5	"5-out4903"	.01666	4	236	240
5	"5-out4908"	.02970	3	98	101
5	"5-out4909"	.00924	5	536	541
5	"5-out4912"	.00806	2	246	248
5	"5-out4914"	.00896	2	221	223
5	"5-out4919"	.02222	2	88	90
5	"5-out4921"	.06042	31	482	513
5	"5-out4922"	.00415	4	959	963
5	"5-out4923"	.00984	5	503	508
5	"5-out4924"	.01265	2	156	158
5	"5-out4925"	.02500	13	507	520
5	"5-out4926"	.01810	9	488	497
5	"5-out4927"	.00811	4	489	493
5	"5-out4928"	.00391	2	509	511
5	"5-out4929"	.00230	2	865	867
5	"5-out4930"	.01185	6	500	506
5	"5-out4931"	.00596	3	500	503
5	"5-out4932"	.00426	2	467	469
5	"5-out4933"	.00350	2	568	570
5	"5-out4934"	.00727	2	273	275
5	"5-out4937"	.02684	4	145	149
5	"5-out4941"	.02985	2	65	67
5	"5-out4944"	.04067	12	283	295
5	"5-out4948"	.00333	2	598	600
5	"5-out4949"	.01267	8	623	631
5	"5-out4950"	.00357	2	557	559
5	"5-out4951"	.00441	2	451	453
5	"5-out4953"	.01295	6	457	463
5	"5-out4954"	.00584	2	340	342
5	"5-out4956"	.00258	2	773	775
5	"5-out4957"	.01190	5	415	420
5	"5-out4962"	.00418	2	476	478
5	"5-out4963"	.00417	2	477	479
5	"5-out4966"	.00975	8	812	820
5	"5-out4968"	.00554	3	538	541
5	"5-out4972"	.04597	4	83	87
5	"5-out4973"	.02898	2	67	69
5	"5-out4975"	.00896	5	553	558
5	"5-out4976"	.00440	2	452	454
5	"5-out4979"	.00675	5	735	740
5	"5-out4980"	.00308	2	646	648
5	"5-out4983"	.00209	2	954	956
5	"5-out4984"	.00154	2	1296	1298
5	"5-out4987"	.06557	4	57	61
5	"5-out4988"	.04477	3	64	67
5	"5-out4991"	.00232	2	858	860
5	"5-out4992"	.02075	37	1746	1783
5	"5-out4993"	.00626	4	634	638
5	"5-out4996"	.01333	4	296	300
5	"5-out4997"	.03457	13	363	376
5	"5-out4999"	.03562	27	731	758
5	"5-out5003"	.01626	2	121	123
5	"5-out5004"	.03030	2	64	66
5	"5-out5006"	.02564	4	152	156
5	"5-out5008"	.02702	4	144	148
5	"5-out5010"	.00367	2	542	544
5	"5-out5011"	.01348	6	439	445
5	"5-out5015"	.00576	3	517	520
5	"5-out5017"	.01194	18	1489	1507
5	"5-out5019"	.00276	4	1443	1447
5	"5-out5022"	.00753	3	395	398
5	"5-out5026"	.01652	4	238	242
5	"5-out5027"	.01049	4	377	381
5	"5-out5028"	.00736	4	539	543
5	"5-out5029"	.02142	9	411	420
5	"5-out5030"	.00340	2	586	588
5	"5-out5034"	.01478	11	733	744
5	"5-out5035"	.01028	5	481	486
5	"5-out5036"	.01381	8	571	579
5	"5-out5037"	.00593	4	670	674
5	"5-out5038"	.01162	5	425	430
5	"5-out5039"	.00559	8	1422	1430
5	"5-out5040"	.00307	2	649	651
5	"5-out5043"	.01025	2	193	195
5	"5-out5044"	.03149	12	369	381
5	"5-out5049"	.00259	2	768	770
5	"5-out5051"	.00491	5	1012	1017
5	"5-out5054"	.00710	3	419	422
5	"5-out5056"	.00701	6	849	855
5	"5-out5057"	.03649	5	132	137
5	"5-out5058"	.01323	9	671	680
5	"5-out5060"	.00725	4	547	551
5	"5-out5063"	.01028	4	385	389
5	"5-out5064"	.01319	5	374	379
5	"5-out5065"	.00179	2	1112	1114
5	"5-out5066"	.01538	5	320	325
5	"5-out5067"	.02088	9	422	431
5	"5-out5068"	.00849	3	350	353
5	"5-out5070"	.00956	2	207	209
5	"5-out5071"	.02150	4	182	186
5	"5-out5074"	.00656	4	605	609
5	"5-out5075"	.00729	6	816	822
5	"5-out5078"	.00345	4	1154	1158
5	"5-out5079"	.00275	2	723	725
5	"5-out5082"	.01587	8	496	504
5	"5-out5084"	.02424	8	322	330
5	"5-out5085"	.00496	4	802	806
5	"5-out5086"	.01669	9	530	539
5	"5-out5087"	.01457	17	1149	1166
5	"5-out5089"	.00173	2	1149	1151
5	"5-out5094"	.01212	4	326	330
5	"5-out5096"	.00787	4	504	508
5	"5-out5098"	.00063	2	3167	3169
5	"5-out5104"	.02000	4	196	200
5	"5-out5107"	.00787	3	378	381
5	"5-out5108"	.03278	4	118	122
5	"5-out5110"	.01078	10	917	927
5	"5-out5111"	.00287	3	1042	1045
5	"5-out5112"	.00318	2	626	628
5	"5-out5114"	.01063	2	186	188
5	"5-out5116"	.01086	5	455	460
5	"5-out5117"	.00460	2	432	434
5	"5-out5120"	.02890	10	336	346
5	"5-out5121"	.00795	3	374	377
5	"5-out5122"	.00608	5	817	822
5	"5-out5123"	.01030	2	192	194
5	"5-out5124"	.00141	2	1410	1412
5	"5-out5125"	.01092	2	181	183
5	"5-out5126"	.01492	3	198	201
5	"5-out5127"	.00334	8	2383	2391
5	"5-out5128"	.00700	3	425	428
5	"5-out5129"	.00531	2	374	376
5	"5-out5130"	.00272	2	731	733
5	"5-out5131"	.00277	5	1796	1801
5	"5-out5132"	.00613	2	324	326
5	"5-out5133"	.00331	2	601	603
5	"5-out5134"	.00547	2	363	365
5	"5-out5135"	.00984	5	503	508
5	"5-out5137"	.00802	3	371	374
5	"5-out5138"	.00206	6	2906	2912
5	"5-out5139"	.00298	2	667	669
5	"5-out5140"	.00330	3	904	907
5	"5-out5141"	.03460	20	558	578
5	"5-out5142"	.05799	33	536	569
5	"5-out5143"	.01156	2	171	173
5	"5-out5146"	.01857	6	317	323
5	"5-out5147"	.00209	5	2381	2386
5	"5-out5151"	.00574	7	1212	1219
5	"5-out5152"	.01052	6	564	570
5	"5-out5158"	.05349	13	230	243
5	"5-out5161"	.00461	17	3668	3685
5	"5-out5162"	.00291	12	4104	4116
5	"5-out5163"	.00151	7	4617	4624
5	"5-out5164"	.00086	4	4642	4646
5	"5-out5165"	.00317	2	627	629
5	"5-out5166"	.00456	16	3491	3507
5	"5-out5169"	.00588	2	338	340
5	"5-out5172"	.01846	6	319	325
5	"5-out5173"	.00775	2	256	258
5	"5-out5174"	.00277	2	718	720
5	"5-out5175"	.00301	2	661	663
5	"5-out5176"	.00625	4	636	640
5	"5-out5178"	.01273	4	310	314
5	"5-out5179"	.01497	5	329	334
5	"5-out5181"	.00737	5	673	678
5	"5-out5183"	.04724	12	242	254
5	"5-out5184"	.01277	4	309	313
5	"5-out5188"	.00467	2	426	428
5	"5-out5189"	.00653	3	456	459
5	"5-out5191"	.00824	10	1203	1213
5	"5-out5192"	.00174	3	1719	1722
5	"5-out5195"	.01357	6	436	442
5	"5-out5197"	.00393	4	1013	1017
5	"5-out5200"	.00579	2	343	345
5	"5-out5201"	.01895	34	1760	1794
5	"5-out5202"	.00194	4	2053	2057
5	"5-out5203"	.00646	12	1845	1857
5	"5-out5207"	.00773	4	513	517
5	"5-out5209"	.00302	4	1318	1322
5	"5-out5212"	.00992	4	399	403
5	"5-out5213"	.00409	2	486	488
5	"5-out5214"	.01077	5	459	464
5	"5-out5215"	.00282	2	707	709
5	"5-out5216"	.02787	8	279	287
5	"5-out5217"	.00278	2	715	717
5	"5-out5218"	.00516	2	385	387
5	"5-out5219"	.00723	5	686	691
5	"5-out5221"	.00243	2	820	822
5	"5-out5222"	.00947	2	209	211
5	"5-out5223"	.00567	6	1051	1057
5	"5-out5224"	.00511	2	389	391
5	"5-out5227"	.02040	3	144	147
5	"5-out5229"	.01091	5	453	458
5	"5-out5230"	.00306	2	651	653
5	"5-out5231"	.00641	2	310	312
5	"5-out5232"	.00892	2	222	224
5	"5-out5234"	.00923	8	858	866
5	"5-out5235"	.00302	3	990	993
5	"5-out5236"	.00704	10	1409	1419
5	"5-out5237"	.02754	10	353	363
5	"5-out5244"	.00966	2	205	207
5	"5-out5248"	.00487	4	817	821
5	"5-out5249"	.02727	9	321	330
5	"5-out5251"	.00441	2	451	453
5	"5-out5255"	.01769	2	111	113
5	"5-out5256"	.00424	2	469	471
5	"5-out5258"	.03954	7	170	177
5	"5-out5259"	.02721	4	143	147
5	"5-out5264"	.03703	4	104	108
5	"5-out5266"	.00433	2	459	461
5	"5-out5268"	.00375	2	530	532
5	"5-out5270"	.00194	2	1026	1028
5	"5-out5272"	.01386	7	498	505
5	"5-out5273"	.00571	2	348	350
5	"5-out5274"	.01716	4	229	233
5	"5-out5275"	.01428	3	207	210
5	"5-out5277"	.00408	2	488	490
5	"5-out5278"	.00526	2	378	380
5	"5-out5279"	.02352	4	166	170
5	"5-out5281"	.00478	7	1455	1462
5	"5-out5286"	.01290	2	153	155
5	"5-out5290"	.02777	3	105	108
5	"5-out5295"	.01391	7	496	503
5	"5-out5296"	.00855	8	927	935
5	"5-out5297"	.00790	2	251	253
5	"5-out5299"	.00233	2	856	858
5	"5-out5303"	.01005	2	197	199
5	"5-out5309"	.02316	34	1434	1468
5	"5-out5310"	.00735	2	270	272
5	"5-out5312"	.00985	2	201	203
5	"5-out5313"	.00678	17	2489	2506
5	"5-out5315"	.00085	2	2337	2339
5	"5-out5316"	.00379	3	787	790
5	"5-out5317"	.00542	2	367	369
5	"5-out5319"	.00500	4	795	799
5	"5-out5320"	.00244	2	817	819
5	"5-out5321"	.00319	2	624	626
5	"5-out5322"	.01123	4	352	356
5	"5-out5323"	.00609	2	326	328
5	"5-out5324"	.01412	5	349	354
5	"5-out5326"	.00649	2	306	308
5	"5-out5327"	.01104	2	179	181
5	"5-out5328"	.02604	10	374	384
5	"5-out5330"	.00631	3	472	475
5	"5-out5332"	.00559	3	533	536
5	"5-out5333"	.01365	4	289	293
5	"5-out5334"	.01179	4	335	339
5	"5-out5335"	.10126	8	71	79
5	"5-out5336"	.00767	4	517	521
5	"5-out5338"	.00696	2	285	287
5	"5-out5339"	.01201	4	329	333
5	"5-out5347"	.00647	4	614	618
5	"5-out5348"	.00486	2	409	411
5	"5-out5349"	.00613	2	324	326
5	"5-out5351"	.00319	4	1249	1253
5	"5-out5353"	.03030	4	128	132
5	"5-out5355"	.01121	6	529	535
5	"5-out5356"	.00529	2	376	378
5	"5-out5357"	.00519	6	1150	1156
5	"5-out5360"	.00306	2	650	652
5	"5-out5361"	.00813	2	244	246
5	"5-out5363"	.00616	3	484	487
5	"5-out5364"	.00370	6	1614	1620
5	"5-out5366"	.00458	5	1086	1091
5	"5-out5370"	.00234	2	851	853
5	"5-out5371"	.01156	2	171	173
5	"5-out5375"	.01198	7	577	584
5	"5-out5376"	.05063	8	150	158
5	"5-out5380"	.00715	4	555	559
5	"5-out5382"	.00647	2	307	309
5	"5-out5383"	.01587	5	310	315
5	"5-out5384"	.00763	2	260	262
5	"5-out5385"	.00614	5	809	814
5	"5-out5387"	.00433	2	459	461
5	"5-out5389"	.00720	9	1240	1249
5	"5-out5392"	.01154	5	428	433
5	"5-out5393"	.01003	8	789	797
5	"5-out5394"	.00826	2	240	242
5	"5-out5396"	.02247	4	174	178
5	"5-out5397"	.00851	6	699	705
5	"5-out5398"	.00493	2	403	405
5	"5-out5400"	.00915	4	433	437
5	"5-out5402"	.02066	5	237	242
5	"5-out5403"	.00331	3	901	904
5	"5-out5404"	.00666	5	745	750
5	"5-out5405"	.00326	8	2444	2452
5	"5-out5407"	.00428	2	465	467
5	"5-out5408"	.00252	2	791	793
5	"5-out5409"	.00336	2	593	595
5	"5-out5413"	.02912	6	200	206
5	"5-out5417"	.01005	6	591	597
5	"5-out5418"	.01417	15	1043	1058
5	"5-out5419"	.01652	2	119	121
5	"5-out5424"	.00304	2	654	656
5	"5-out5425"	.00090	2	2219	2221
5	"5-out5428"	.00241	2	827	829
5	"5-out5430"	.00584	4	680	684
5	"5-out5433"	.00877	2	226	228
5	"5-out5434"	.00990	4	400	404
5	"5-out5436"	.00597	2	333	335
5	"5-out5437"	.00263	2	756	758
5	"5-out5438"	.02346	8	333	341
5	"5-out5439"	.01055	10	937	947
5	"5-out5440"	.01138	6	521	527
5	"5-out5442"	.01212	15	1222	1237
5	"5-out5446"	.00872	6	682	688
5	"5-out5448"	.00790	2	251	253
5	"5-out5450"	.02721	4	143	147
5	"5-out5452"	.00586	2	339	341
5	"5-out5456"	.00549	7	1267	1274
5	"5-out5457"	.00502	2	396	398
5	"5-out5460"	.00298	2	667	669
5	"5-out5461"	.00154	2	1294	1296
5	"5-out5462"	.00298	3	1001	1004
5	"5-out5463"	.00312	4	1274	1278
5	"5-out5465"	.00189	2	1056	1058
5	"5-out5466"	.00771	6	772	778
5	"5-out5467"	.00610	11	1791	1802
5	"5-out5471"	.01529	8	515	523
5	"5-out5472"	.01535	9	577	586
5	"5-out5473"	.02040	2	96	98
5	"5-out5474"	.02958	5	164	169
5	"5-out5475"	.04081	4	94	98
5	"5-out5477"	.01463	29	1953	1982
5	"5-out5482"	.02150	4	182	186
5	"5-out5483"	.00434	5	1145	1150
5	"5-out5486"	.00251	2	794	796
5	"5-out5487"	.01683	12	701	713
5	"5-out5488"	.00378	9	2368	2377
5	"5-out5489"	.00419	2	475	477
5	"5-out5490"	.00297	2	670	672
5	"5-out5495"	.01351	2	146	148
5	"5-out5496"	.00440	2	452	454
5	"5-out5498"	.00937	3	317	320
5	"5-out5500"	.01582	5	311	316
5	"5-out5502"	.01401	20	1407	1427
5	"5-out5503"	.03578	18	485	503
5	"5-out5505"	.00757	11	1442	1453
5	"5-out5506"	.00696	2	285	287
5	"5-out5507"	.04237	5	113	118
5	"5-out5509"	.01818	2	108	110
5	"5-out5510"	.00551	4	721	725
5	"5-out5515"	.00357	2	557	559
5	"5-out5519"	.00788	4	503	507
5	"5-out5521"	.00146	2	1360	1362
5	"5-out5523"	.00973	4	407	411
5	"5-out5525"	.01587	4	248	252
5	"5-out5526"	.00530	6	1126	1132
5	"5-out5527"	.00842	4	471	475
5	"5-out5528"	.01801	6	327	333
5	"5-out5531"	.00567	4	701	705
5	"5-out5533"	.00340	2	586	588
5	"5-out5535"	.00646	15	2305	2320
5	"5-out5536"	.00107	2	1861	1863
5	"5-out5537"	.00652	5	761	766
5	"5-out5538"	.00380	2	523	525
5	"5-out5539"	.00879	4	451	455
5	"5-out5540"	.01374	4	287	291
5	"5-out5541"	.00988	5	501	506
5	"5-out5544"	.00743	4	534	538
5	"5-out5545"	.02402	8	325	333
5	"5-out5546"	.00559	5	889	894
5	"5-out5547"	.00950	4	417	421
5	"5-out5548"	.00287	2	694	696
5	"5-out5549"	.00084	2	2351	2353
5	"5-out5550"	.00400	4	996	1000
5	"5-out5551"	.00954	4	415	419
5	"5-out5553"	.00439	5	1132	1137
5	"5-out5557"	.01500	6	394	400
5	"5-out5559"	.01052	4	376	380
5	"5-out5562"	.00405	2	491	493
5	"5-out5563"	.00302	7	2306	2313
5	"5-out5564"	.00240	2	830	832
5	"5-out5565"	.00452	2	440	442
5	"5-out5568"	.00134	2	1487	1489
5	"5-out5570"	.00541	4	735	739
5	"5-out5572"	.00556	4	715	719
5	"5-out5573"	.00369	3	810	813
5	"5-out5574"	.00853	6	697	703
5	"5-out5575"	.00434	3	687	690
5	"5-out5577"	.01410	10	699	709
5	"5-out5578"	.00177	2	1125	1127
5	"5-out5580"	.00290	3	1029	1032
5	"5-out5581"	.00646	4	615	619
5	"5-out5582"	.00709	2	280	282
5	"5-out5583"	.00283	2	704	706
5	"5-out5587"	.00320	2	622	624
5	"5-out5593"	.03200	4	121	125
5	"5-out5595"	.01769	2	111	113
5	"5-out5596"	.00270	6	2214	2220
5	"5-out5597"	.00362	4	1099	1103
5	"5-out5599"	.01818	2	108	110
5	"5-out5600"	.00249	2	799	801
5	"5-out5602"	.00323	7	2154	2161
5	"5-out5603"	.00609	2	326	328
5	"5-out5606"	.01153	3	257	260
5	"5-out5608"	.01892	6	311	317
5	"5-out5611"	.00106	2	1871	1873
5	"5-out5617"	.00984	5	503	508
5	"5-out5618"	.00161	2	1234	1236
5	"5-out5619"	.01289	14	1072	1086
5	"5-out5620"	.00858	4	462	466
5	"5-out5621"	.01918	8	409	417
5	"5-out5622"	.01196	5	413	418
5	"5-out5623"	.00152	2	1309	1311
5	"5-out5624"	.03448	4	112	116
5	"5-out5625"	.05128	6	111	117
5	"5-out5626"	.02552	17	649	666
5	"5-out5627"	.00425	4	937	941
5	"5-out5628"	.02552	17	649	666
5	"5-out5632"	.02976	5	163	168
5	"5-out5634"	.00147	3	2037	2040
5	"5-out5635"	.00144	3	2068	2071
5	"5-out5641"	.04516	7	148	155
5	"5-out5642"	.00715	6	832	838
5	"5-out5649"	.01709	2	115	117
5	"5-out5650"	.05714	2	33	35
5	"5-out5651"	.00819	2	242	244
5	"5-out5654"	.00704	3	423	426
5	"5-out5655"	.00660	3	451	454
5	"5-out5657"	.00943	3	315	318
5	"5-out5658"	.00332	4	1200	1204
5	"5-out5659"	.00158	3	1891	1894
5	"5-out5668"	.00716	2	277	279
5	"5-out5670"	.02285	4	171	175
5	"5-out5672"	.01395	3	212	215
5	"5-out5673"	.00152	2	1313	1315
5	"5-out5674"	.00557	2	357	359
5	"5-out5675"	.00706	2	281	283
5	"5-out5676"	.03225	10	300	310
5	"5-out5678"	.03004	7	226	233
5	"5-out5683"	.00224	2	887	889
5	"5-out5684"	.00272	2	732	734
5	"5-out5685"	.04040	8	190	198
5	"5-out5686"	.00371	2	537	539
5	"5-out5690"	.00851	2	233	235
5	"5-out5693"	.00308	2	647	649
5	"5-out5694"	.01176	3	252	255
5	"5-out5698"	.01923	8	408	416
5	"5-out5699"	.02264	12	518	530
5	"5-out5702"	.03448	4	112	116
5	"5-out5703"	.05454	6	104	110
5	"5-out5704"	.00347	2	573	575
5	"5-out5706"	.02998	20	647	667
5	"5-out5711"	.00303	2	657	659
5	"5-out5712"	.01139	4	347	351
5	"5-out5713"	.00149	6	4002	4008
5	"5-out5714"	.03319	16	466	482
5	"5-out5718"	.01612	8	488	496
5	"5-out5719"	.01948	6	302	308
5	"5-out5720"	.00626	3	476	479
5	"5-out5723"	.01123	2	176	178
5	"5-out5725"	.00347	2	573	575
5	"5-out5727"	.00547	2	363	365
5	"5-out5728"	.02552	17	649	666
5	"5-out5729"	.01321	6	448	454
5	"5-out5730"	.00770	4	515	519
5	"5-out5732"	.00383	2	520	522
5	"5-out5734"	.00712	3	418	421
5	"5-out5735"	.01783	12	661	673
5	"5-out5736"	.00738	2	269	271
5	"5-out5737"	.01431	7	482	489
5	"5-out5739"	.00792	4	501	505
5	"5-out5740"	.01298	2	152	154
5	"5-out5741"	.02406	9	365	374
5	"5-out5742"	.02046	7	335	342
5	"5-out5743"	.00959	5	516	521
5	"5-out5744"	.00583	4	681	685
5	"5-out5745"	.00784	5	632	637
5	"5-out5746"	.00442	3	675	678
5	"5-out5749"	.00279	4	1426	1430
5	"5-out5750"	.00617	30	4831	4861
5	"5-out5751"	.01386	67	4767	4834
5	"5-out5752"	.01879	10	522	532
5	"5-out5754"	.01081	6	549	555
5	"5-out5755"	.00333	4	1194	1198
5	"5-out5758"	.00911	4	435	439
5	"5-out5759"	.00916	6	649	655
5	"5-out5761"	.01058	2	187	189
5	"5-out5765"	.01923	8	408	416
5	"5-out5766"	.00855	6	695	701
5	"5-out5768"	.00369	4	1080	1084
5	"5-out5772"	.00798	4	497	501
5	"5-out5773"	.02400	18	732	750
5	"5-out5774"	.00527	2	377	379
5	"5-out5775"	.00450	2	442	444
5	"5-out5777"	.00744	3	400	403
5	"5-out5783"	.01092	2	181	183
5	"5-out5784"	.00564	17	2996	3013
5	"5-out5785"	.00504	11	2168	2179
5	"5-out5786"	.00248	2	803	805
5	"5-out5787"	.00251	2	792	794
5	"5-out5788"	.00322	2	619	621
5	"5-out5789"	.00445	3	670	673
5	"5-out5791"	.01918	8	409	417
5	"5-out5792"	.01671	6	353	359
5	"5-out5793"	.02552	17	649	666
5	"5-out5795"	.00420	2	474	476
5	"5-out5796"	.00197	2	1011	1013
5	"5-out5797"	.00135	2	1476	1478
5	"5-out5798"	.00622	4	639	643
5	"5-out5799"	.03095	10	313	323
5	"5-out5801"	.01045	11	1041	1052
5	"5-out5804"	.01556	4	253	257
5	"5-out5805"	.00388	2	513	515
5	"5-out5808"	.02857	7	238	245
5	"5-out5811"	.01388	3	213	216
5	"5-out5813"	.02222	6	264	270
5	"5-out5814"	.00263	2	757	759
5	"5-out5822"	.00690	4	575	579
5	"5-out5823"	.01059	5	467	472
5	"5-out5824"	.07392	19	238	257
5	"5-out5826"	.01250	4	316	320
5	"5-out5827"	.00126	2	1576	1578
5	"5-out5828"	.00280	2	712	714
5	"5-out5829"	.00594	3	502	505
5	"5-out5830"	.01416	12	835	847
5	"5-out5832"	.00390	27	6880	6907
5	"5-out5835"	.02102	7	326	333
5	"5-out5836"	.02627	17	630	647
5	"5-out5844"	.00202	2	984	986
5	"5-out5845"	.00380	2	524	526
5	"5-out5846"	.00168	2	1186	1188
5	"5-out5847"	.00498	4	799	803
5	"5-out5850"	.00249	2	800	802
5	"5-out5851"	.03672	13	341	354
5	"5-out5852"	.01015	2	195	197
5	"5-out5853"	.04519	8	169	177
5	"5-out5854"	.01069	6	555	561
5	"5-out5855"	.00318	4	1253	1257
5	"5-out5859"	.00817	4	485	489
5	"5-out5860"	.00219	2	911	913
5	"5-out5862"	.00263	2	756	758
5	"5-out5864"	.00238	2	835	837
5	"5-out5866"	.00320	6	1867	1873
5	"5-out5868"	.02263	44	1900	1944
5	"5-out5869"	.00583	2	341	343
5	"5-out5871"	.01547	5	318	323
5	"5-out5874"	.00440	6	1355	1361
5	"5-out5877"	.02688	5	181	186
5	"5-out5878"	.00674	4	589	593
5	"5-out5879"	.00970	4	408	412
5	"5-out5885"	.00290	2	687	689
5	"5-out5886"	.00458	4	868	872
5	"5-out5887"	.01324	2	149	151
5	"5-out5889"	.00100	2	1998	2000
5	"5-out5892"	.00276	8	2889	2897
5	"5-out5894"	.00182	2	1092	1094
5	"5-out5896"	.00539	2	369	371
5	"5-out5897"	.01047	2	189	191
5	"5-out5900"	.03571	3	81	84
5	"5-out5903"	.00500	3	596	599
5	"5-out5904"	.00514	2	387	389
5	"5-out5905"	.00302	3	990	993
5	"5-out5908"	.01621	6	364	370
5	"5-out5910"	.00369	3	809	812
5	"5-out5911"	.00583	2	341	343
5	"5-out5914"	.00358	2	556	558
5	"5-out5916"	.00907	4	437	441
5	"5-out5918"	.00350	6	1704	1710
5	"5-out5919"	.00266	8	2989	2997
5	"5-out5921"	.00109	5	4558	4563
5	"5-out5922"	.00751	2	264	266
5	"5-out5923"	.00623	2	319	321
5	"5-out5924"	.00767	4	517	521
5	"5-out5926"	.00564	2	352	354
5	"5-out5927"	.00649	2	306	308
5	"5-out5929"	.00514	4	773	777
5	"5-out5930"	.00329	5	1514	1519
5	"5-out5932"	.00477	7	1460	1467
5	"5-out5933"	.00511	7	1362	1369
5	"5-out5935"	.00268	6	2230	2236
5	"5-out5936"	.02500	5	195	200
5	"5-out5937"	.01604	3	184	187
5	"5-out5938"	.00229	2	869	871
5	"5-out5941"	.01884	13	677	690
5	"5-out5942"	.00751	12	1585	1597
5	"5-out5943"	.00877	8	904	912
5	"5-out5944"	.00259	4	1540	1544
5	"5-out5945"	.00237	2	839	841
5	"5-out5946"	.01949	7	352	359
5	"5-out5947"	.01812	6	325	331
5	"5-out5950"	.03351	6	173	179
5	"5-out5952"	.00505	3	591	594
5	"5-out5954"	.01127	3	263	266
5	"5-out5955"	.01104	4	358	362
5	"5-out5956"	.01104	4	358	362
5	"5-out5958"	.02465	9	356	365
5	"5-out5959"	.01333	4	296	300
5	"5-out5961"	.00891	5	556	561
5	"5-out5962"	.01458	12	811	823
5	"5-out5963"	.01416	5	348	353
5	"5-out5964"	.02643	12	442	454
5	"5-out5967"	.00424	2	469	471
5	"5-out5968"	.00636	8	1249	1257
5	"5-out5969"	.00593	2	335	337
5	"5-out5972"	.00197	2	1009	1011
5	"5-out5973"	.00803	2	247	249
5	"5-out5974"	.00425	2	468	470
5	"5-out5975"	.00404	2	492	494
5	"5-out5976"	.00757	2	262	264
5	"5-out5979"	.00660	4	602	606
5	"5-out5982"	.00412	2	483	485
5	"5-out5983"	.01739	6	339	345
5	"5-out5984"	.01880	6	313	319
5	"5-out5986"	.00811	4	489	493
5	"5-out5988"	.00584	10	1700	1710
5	"5-out5989"	.01121	11	970	981
5	"5-out5990"	.01199	5	412	417
5	"5-out5991"	.01465	14	941	955
5	"5-out5992"	.01196	5	413	418
5	"5-out5993"	.01346	7	513	520
5	"5-out5995"	.01401	6	422	428
5	"5-out5997"	.00619	3	481	484
5	"5-out5998"	.00303	3	987	990
5	"5-out6003"	.00787	2	252	254
5	"5-out6004"	.00202	2	984	986
5	"5-out6005"	.00236	2	843	845
5	"5-out6009"	.00381	2	522	524
5	"5-out6010"	.02531	4	154	158
5	"5-out6011"	.02409	2	81	83
5	"5-out6013"	.01385	6	427	433
5	"5-out6014"	.01749	6	337	343
5	"5-out6015"	.00581	3	513	516
5	"5-out6016"	.01701	14	809	823
5	"5-out6017"	.00777	5	638	643
5	"5-out6019"	.01587	7	434	441
5	"5-out6022"	.01156	4	342	346
5	"5-out6023"	.01901	12	619	631
5	"5-out6028"	.01941	4	202	206
5	"5-out6030"	.00609	3	489	492
5	"5-out6032"	.00462	2	430	432
5	"5-out6034"	.00844	5	587	592
5	"5-out6036"	.00502	3	594	597
5	"5-out6037"	.00863	6	689	695
5	"5-out6039"	.00369	2	539	541
5	"5-out6041"	.03418	4	113	117
5	"5-out6042"	.05128	6	111	117
5	"5-out6045"	.00228	2	874	876
5	"5-out6048"	.00682	4	582	586
5	"5-out6051"	.00604	2	329	331
5	"5-out6052"	.01044	16	1516	1532
5	"5-out6055"	.00649	2	306	308
5	"5-out6056"	.01344	5	367	372
5	"5-out6061"	.00659	3	452	455
5	"5-out6062"	.00888	4	446	450
5	"5-out6063"	.00271	2	734	736
5	"5-out6065"	.00704	4	564	568
5	"5-out6067"	.04137	6	139	145
5	"5-out6068"	.00760	2	261	263
5	"5-out6070"	.00760	2	261	263
5	"5-out6073"	.00980	2	202	204
5	"5-out6074"	.00944	8	839	847
5	"5-out6075"	.06194	7	106	113
5	"5-out6077"	.00757	6	786	792
5	"5-out6078"	.00531	2	374	376
5	"5-out6079"	.00439	4	906	910
5	"5-out6082"	.00904	2	219	221
5	"5-out6083"	.00985	2	201	203
5	"5-out6090"	.00936	4	423	427
5	"5-out6092"	.01798	15	819	834
5	"5-out6093"	.01716	4	229	233
5	"5-out6096"	.00560	4	710	714
5	"5-out6101"	.01976	5	248	253
5	"5-out6102"	.00245	2	813	815
5	"5-out6103"	.01120	4	353	357
5	"5-out6106"	.00305	2	653	655
5	"5-out6107"	.00215	2	928	930
5	"5-out6109"	.02265	7	302	309
5	"5-out6110"	.01077	10	918	928
5	"5-out6123"	.01492	3	198	201
5	"5-out6124"	.01005	2	197	199
5	"5-out6127"	.00633	4	627	631
5	"5-out6129"	.00838	11	1301	1312
5	"5-out6130"	.00401	3	744	747
5	"5-out6132"	.02233	9	394	403
5	"5-out6139"	.00498	4	799	803
5	"5-out6140"	.00296	3	1008	1011
5	"5-out6145"	.00468	5	1063	1068
5	"5-out6146"	.00445	5	1118	1123
5	"5-out6149"	.00402	2	495	497
5	"5-out6150"	.03125	6	186	192
5	"5-out6151"	.00133	2	1492	1494
5	"5-out6152"	.00216	2	921	923
5	"5-out6153"	.00348	6	1714	1720
5	"5-out6154"	.00301	2	661	663
5	"5-out6156"	.02333	14	586	600
5	"5-out6157"	.00655	2	303	305
5	"5-out6158"	.00595	2	334	336
5	"5-out6160"	.01404	5	351	356
5	"5-out6162"	.01842	7	373	380
5	"5-out6163"	.02228	8	351	359
5	"5-out6164"	.00502	2	396	398
5	"5-out6167"	.00617	2	322	324
5	"5-out6168"	.00743	2	267	269
5	"5-out6169"	.00630	2	315	317
5	"5-out6171"	.01970	8	398	406
5	"5-out6172"	.01323	7	522	529
5	"5-out6174"	.00717	3	415	418
5	"5-out6175"	.00240	2	830	832
5	"5-out6176"	.00859	6	692	698
5	"5-out6177"	.01512	9	586	595
5	"5-out6178"	.02525	10	386	396
5	"5-out6181"	.01814	10	541	551
5	"5-out6183"	.00255	2	781	783
5	"5-out6184"	.01556	4	253	257
5	"5-out6185"	.00630	2	315	317
5	"5-out6186"	.01754	2	112	114
5	"5-out6187"	.01167	8	677	685
5	"5-out6188"	.01311	4	301	305
5	"5-out6189"	.01041	2	190	192
5	"5-out6190"	.00238	2	836	838
5	"5-out6193"	.00673	2	295	297
5	"5-out6194"	.00537	2	370	372
5	"5-out6196"	.04195	12	274	286
5	"5-out6199"	.00170	2	1172	1174
5	"5-out6202"	.01125	6	527	533
5	"5-out6203"	.00574	4	692	696
5	"5-out6204"	.00503	2	395	397
5	"5-out6205"	.00274	2	727	729
5	"5-out6207"	.00684	2	290	292
5	"5-out6208"	.01123	2	176	178
5	"5-out6214"	.00350	2	568	570
5	"5-out6217"	.01923	3	153	156
5	"5-out6218"	.00860	4	461	465
5	"5-out6219"	.01550	4	254	258
5	"5-out6220"	.01666	7	413	420
5	"5-out6221"	.01086	2	182	184
5	"5-out6223"	.00573	2	347	349
5	"5-out6224"	.00949	3	313	316
5	"5-out6226"	.00716	2	277	279
5	"5-out6232"	.02614	4	149	153
5	"5-out6234"	.02060	13	618	631
5	"5-out6235"	.00816	2	243	245
5	"5-out6236"	.00851	2	233	235
5	"5-out6239"	.00294	2	677	679
5	"5-out6241"	.00909	2	218	220
5	"5-out6244"	.00588	2	338	340
5	"5-out6245"	.01515	4	260	264
5	"5-out6246"	.00787	3	378	381
5	"5-out6248"	.02068	9	426	435
5	"5-out6250"	.01562	4	252	256
5	"5-out6252"	.00287	4	1386	1390
5	"5-out6256"	.00547	4	726	730
5	"5-out6257"	.01960	20	1000	1020
5	"5-out6258"	.03735	13	335	348
5	"5-out6260"	.02287	7	299	306
5	"5-out6261"	.01941	2	101	103
5	"5-out6262"	.01562	2	126	128
5	"5-out6263"	.00611	2	325	327
5	"5-out6267"	.00797	3	373	376
5	"5-out6270"	.00983	3	302	305
5	"5-out6272"	.00297	3	1004	1007
5	"5-out6273"	.00566	2	351	353
5	"5-out6274"	.02242	5	218	223
5	"5-out6275"	.02027	3	145	148
5	"5-out6276"	.00288	2	692	694
5	"5-out6279"	.02453	4	159	163
5	"5-out6280"	.00458	2	434	436
5	"5-out6281"	.00338	2	589	591
5	"5-out6284"	.00349	2	571	573
5	"5-out6290"	.01149	3	258	261
5	"5-out6292"	.01360	2	145	147
5	"5-out6294"	.01075	4	368	372
5	"5-out6295"	.01886	4	208	212
5	"5-out6296"	.05172	3	55	58
5	"5-out6298"	.01507	6	392	398
5	"5-out6299"	.06557	8	114	122
5	"5-out6300"	.00952	2	208	210
5	"5-out6301"	.00975	2	203	205
5	"5-out6302"	.00327	2	608	610
5	"5-out6306"	.04608	10	207	217
5	"5-out6307"	.04137	6	139	145
5	"5-out6310"	.01515	4	260	264
5	"5-out6312"	.01020	2	194	196
5	"5-out6314"	.00462	4	861	865
5	"5-out6316"	.00333	2	598	600
5	"5-out6317"	.00585	4	679	683
5	"5-out6322"	.00760	2	261	263
5	"5-out6323"	.00975	2	203	205
5	"5-out6325"	.00530	2	375	377
5	"5-out6327"	.01675	3	176	179
5	"5-out6330"	.00806	4	492	496
5	"5-out6333"	.00251	2	794	796
5	"5-out6336"	.00413	7	1685	1692
5	"5-out6338"	.00514	2	387	389
5	"5-out6339"	.01395	3	212	215
5	"5-out6340"	.01063	2	186	188
5	"5-out6341"	.01470	2	134	136
5	"5-out6342"	.00743	2	267	269
5	"5-out6344"	.02955	6	197	203
5	"5-out6345"	.06153	8	122	130
5	"5-out6346"	.02953	14	460	474
5	"5-out6347"	.02531	12	462	474
5	"5-out6348"	.01890	9	467	476
5	"5-out6349"	.02320	11	463	474
5	"5-out6350"	.00447	3	667	670
5	"5-out6351"	.00796	12	1495	1507
5	"5-out6356"	.00142	2	1402	1404
5	"5-out6357"	.00249	2	799	801
5	"5-out6359"	.01098	2	180	182
5	"5-out6360"	.00212	2	939	941
5	"5-out6362"	.01046	7	662	669
5	"5-out6363"	.02719	13	465	478
5	"5-out6365"	.00572	6	1042	1048
5	"5-out6367"	.02272	4	172	176
5	"5-out6368"	.01194	4	331	335
5	"5-out6369"	.01643	7	419	426
5	"5-out6370"	.00542	10	1833	1843
5	"5-out6371"	.00571	2	348	350
5	"5-out6372"	.00757	2	262	264
5	"5-out6374"	.01043	8	759	767
5	"5-out6376"	.00623	3	478	481
5	"5-out6377"	.00404	2	493	495
5	"5-out6379"	.00176	2	1131	1133
5	"5-out6384"	.00757	5	655	660
5	"5-out6386"	.02105	8	372	380
5	"5-out6388"	.00449	2	443	445
5	"5-out6393"	.00257	2	775	777
5	"5-out6395"	.00775	6	768	774
5	"5-out6396"	.00793	3	375	378
5	"5-out6398"	.02009	13	634	647
5	"5-out6401"	.01080	19	1739	1758
5	"5-out6402"	.01029	6	577	583
5	"5-out6403"	.01257	2	157	159
5	"5-out6404"	.01711	7	402	409
5	"5-out6406"	.00265	2	752	754
5	"5-out6411"	.00529	4	751	755
5	"5-out6413"	.00465	2	428	430
5	"5-out6414"	.01075	4	368	372
5	"5-out6415"	.00290	2	687	689
5	"5-out6416"	.00671	6	888	894
5	"5-out6417"	.02296	11	468	479
5	"5-out6418"	.00282	2	705	707
5	"5-out6419"	.02946	15	494	509
5	"5-out6420"	.00771	8	1029	1037
5	"5-out6421"	.01882	9	469	478
5	"5-out6423"	.00311	5	1601	1606
5	"5-out6424"	.02116	4	185	189
5	"5-out6425"	.02398	99	4029	4128
5	"5-out6426"	.00813	5	610	615
5	"5-out6428"	.02127	2	92	94
5	"5-out6429"	.00894	6	665	671
5	"5-out6430"	.00370	2	538	540
5	"5-out6431"	.01550	2	127	129
5	"5-out6432"	.02169	10	451	461
5	"5-out6436"	.01858	5	264	269
5	"5-out6437"	.00581	2	342	344
5	"5-out6438"	.01404	5	351	356
5	"5-out6442"	.00506	2	393	395
5	"5-out6443"	.01492	9	594	603
5	"5-out6446"	.00260	3	1147	1150
5	"5-out6450"	.00308	2	647	649
5	"5-out6455"	.01421	3	208	211
5	"5-out6456"	.00803	2	247	249
5	"5-out6458"	.00186	2	1068	1070
5	"5-out6463"	.00340	4	1171	1175
5	"5-out6464"	.00790	4	502	506
5	"5-out6465"	.00797	3	373	376
5	"5-out6470"	.03508	34	935	969
5	"5-out6471"	.02709	22	790	812
5	"5-out6472"	.03289	48	1411	1459
5	"5-out6475"	.00980	6	606	612
5	"5-out6481"	.02074	5	236	241
5	"5-out6482"	.03960	12	291	303
5	"5-out6484"	.00740	2	268	270
5	"5-out6486"	.01308	23	1735	1758
5	"5-out6488"	.00621	9	1438	1447
5	"5-out6490"	.01043	6	569	575
5	"5-out6495"	.01976	5	248	253
5	"5-out6496"	.00586	2	339	341
5	"5-out6498"	.00539	3	553	556
5	"5-out6500"	.00203	2	981	983
5	"5-out6501"	.00384	7	1814	1821
5	"5-out6503"	.01201	9	740	749
5	"5-out6505"	.00909	4	436	440
5	"5-out6507"	.00195	2	1020	1022
5	"5-out6511"	.00751	3	396	399
5	"5-out6512"	.00314	2	633	635
5	"5-out6513"	.01960	4	200	204
5	"5-out6514"	.00566	2	351	353
5	"5-out6516"	.01904	4	206	210
5	"5-out6520"	.02222	13	572	585
5	"5-out6521"	.02362	6	248	254
5	"5-out6522"	.00183	2	1087	1089
5	"5-out6523"	.00462	2	430	432
5	"5-out6527"	.00527	2	377	379
5	"5-out6528"	.00424	18	4225	4243
5	"5-out6529"	.01541	8	511	519
5	"5-out6530"	.02046	8	383	391
5	"5-out6531"	.00319	13	4061	4074
5	"5-out6532"	.02285	4	171	175
5	"5-out6533"	.01265	2	156	158
5	"5-out6534"	.00216	3	1383	1386
5	"5-out6536"	.00907	8	874	882
5	"5-out6537"	.00793	2	250	252
5	"5-out6538"	.00264	2	754	756
5	"5-out6542"	.00608	3	490	493
5	"5-out6545"	.00425	2	468	470
5	"5-out6548"	.00204	9	4382	4391
5	"5-out6549"	.00118	3	2527	2530
5	"5-out6550"	.00331	2	602	604
5	"5-out6554"	.00706	2	281	283
5	"5-out6556"	.00162	2	1232	1234
5	"5-out6558"	.01492	8	528	536
5	"5-out6560"	.01190	2	166	168
5	"5-out6561"	.01036	2	191	193
5	"5-out6562"	.02032	5	241	246
5	"5-out6564"	.00881	4	450	454
5	"5-out6565"	.00292	2	682	684
5	"5-out6570"	.01020	2	194	196
5	"5-out6571"	.00896	2	221	223
5	"5-out6572"	.01538	2	128	130
5	"5-out6575"	.01226	2	161	163
5	"5-out6576"	.01321	3	224	227
5	"5-out6577"	.00510	2	390	392
5	"5-out6578"	.00175	5	2844	2849
5	"5-out6579"	.00742	3	401	404
5	"5-out6580"	.00252	2	791	793
5	"5-out6581"	.00311	2	641	643
5	"5-out6582"	.00633	5	784	789
5	"5-out6583"	.00339	2	587	589
5	"5-out6584"	.00262	2	760	762
5	"5-out6586"	.00294	4	1353	1357
5	"5-out6587"	.02517	7	271	278
5	"5-out6591"	.00498	2	399	401
5	"5-out6594"	.02666	6	219	225
5	"5-out6598"	.02136	37	1695	1732
5	"5-out6603"	.00160	2	1242	1244
5	"5-out6604"	.00667	9	1340	1349
5	"5-out6605"	.00505	7	1378	1385
5	"5-out6607"	.01442	9	615	624
5	"5-out6609"	.00623	2	319	321
5	"5-out6611"	.00493	3	605	608
5	"5-out6612"	.00168	2	1183	1185
5	"5-out6614"	.01111	9	801	810
5	"5-out6615"	.00237	3	1262	1265
5	"5-out6616"	.00282	4	1412	1416
5	"5-out6617"	.00694	13	1858	1871
5	"5-out6618"	.01038	6	572	578
5	"5-out6619"	.01015	4	390	394
5	"5-out6622"	.00164	2	1217	1219
5	"5-out6623"	.00253	2	788	790
5	"5-out6624"	.00470	2	423	425
5	"5-out6625"	.00358	4	1112	1116
5	"5-out6627"	.01420	15	1041	1056
5	"5-out6628"	.02285	4	171	175
5	"5-out6629"	.00696	6	855	861
5	"5-out6631"	.00383	4	1040	1044
5	"5-out6633"	.00650	28	4275	4303
5	"5-out6634"	.01621	3	182	185
5	"5-out6637"	.00460	2	432	434
5	"5-out6638"	.00399	9	2244	2253
5	"5-out6641"	.00697	9	1281	1290
5	"5-out6642"	.00118	2	1691	1693
5	"5-out6644"	.00177	2	1125	1127
5	"5-out6645"	.04024	13	310	323
5	"5-out6648"	.00949	7	730	737
5	"5-out6650"	.00105	2	1894	1896
5	"5-out6652"	.00261	5	1904	1909
5	"5-out6653"	.00127	2	1566	1568
5	"5-out6654"	.01258	22	1726	1748
5	"5-out6656"	.01076	19	1746	1765
5	"5-out6658"	.03508	4	110	114
5	"5-out6659"	.00476	2	418	420
5	"5-out6660"	.00650	5	764	769
5	"5-out6661"	.00944	15	1573	1588
5	"5-out6663"	.01005	2	197	199
5	"5-out6665"	.00135	2	1477	1479
5	"5-out6666"	.00159	2	1253	1255
5	"5-out6668"	.00759	6	784	790
5	"5-out6673"	.02040	4	192	196
5	"5-out6675"	.00167	2	1189	1191
5	"5-out6677"	.00687	2	289	291
5	"5-out6678"	.00146	2	1362	1364
5	"5-out6679"	.02666	8	292	300
5	"5-out6680"	.01283	10	769	779
5	"5-out6681"	.00178	2	1119	1121
5	"5-out6683"	.00977	4	405	409
5	"5-out6685"	.00927	20	2136	2156
5	"5-out6686"	.00591	2	336	338
5	"5-out6687"	.00185	2	1075	1077
5	"5-out6690"	.00208	2	956	958
5	"5-out6691"	.00471	2	422	424
5	"5-out6692"	.00823	16	1927	1943
5	"5-out6694"	.00275	2	723	725
5	"5-out6695"	.02330	12	503	515
5	"5-out6696"	.03191	9	273	282
5	"5-out6698"	.00740	2	268	270
5	"5-out6699"	.00673	6	885	891
5	"5-out6702"	.00614	6	971	977
5	"5-out6703"	.00238	2	835	837
5	"5-out6709"	.00416	2	478	480
5	"5-out6712"	.00682	2	291	293
5	"5-out6713"	.00464	2	429	431
5	"5-out6715"	.00772	2	257	259
5	"5-out6716"	.00421	2	473	475
5	"5-out6718"	.00321	4	1242	1246
5	"5-out6719"	.01265	2	156	158
5	"5-out6720"	.00725	7	958	965
5	"5-out6722"	.00599	5	829	834
5	"5-out6723"	.01503	12	786	798
5	"5-out6724"	.00688	4	577	581
5	"5-out6725"	.00509	6	1171	1177
5	"5-out6727"	.01204	4	328	332
5	"5-out6732"	.00344	2	578	580
5	"5-out6733"	.01162	2	170	172
5	"5-out6735"	.03947	9	219	228
5	"5-out6737"	.00287	2	694	696
5	"5-out6738"	.01428	4	276	280
5	"5-out6739"	.03636	6	159	165
5	"5-out6743"	.02139	8	366	374
5	"5-out6744"	.01324	4	298	302
5	"5-out6749"	.01039	5	476	481
5	"5-out6750"	.00255	2	781	783
5	"5-out6753"	.02173	2	90	92
5	"5-out6757"	.04210	4	91	95
5	"5-out6758"	.03636	2	53	55
5	"5-out6759"	.00299	2	665	667
5	"5-out6763"	.03030	4	128	132
5	"5-out6765"	.02150	2	91	93
5	"5-out6766"	.00383	2	520	522
5	"5-out6772"	.00154	2	1295	1297
5	"5-out6773"	.01758	7	391	398
5	"5-out6774"	.03409	6	170	176
5	"5-out6776"	.01941	2	101	103
5	"5-out6777"	.00438	2	454	456
5	"5-out6778"	.00256	2	779	781
5	"5-out6779"	.00784	2	253	255
5	"5-out6781"	.00485	2	410	412
5	"5-out6784"	.00241	2	826	828
5	"5-out6786"	.01002	5	494	499
5	"5-out6788"	.00302	4	1317	1321
5	"5-out6791"	.02702	2	72	74
5	"5-out6795"	.00314	4	1269	1273
5	"5-out6796"	.00172	2	1160	1162
5	"5-out6799"	.00563	2	353	355
5	"5-out6801"	.01228	8	643	651
5	"5-out6803"	.02325	9	378	387
5	"5-out6805"	.00125	2	1588	1590
5	"5-out6807"	.00136	2	1467	1469
5	"5-out6816"	.00668	6	891	897
5	"5-out6820"	.00511	3	583	586
5	"5-out6821"	.00242	4	1643	1647
5	"5-out6822"	.00709	2	280	282
5	"5-out6831"	.00352	4	1131	1135
5	"5-out6832"	.02450	5	199	204
5	"5-out6836"	.00249	4	1597	1601
5	"5-out6837"	.00155	2	1284	1286
5	"5-out6838"	.00634	2	313	315
5	"5-out6840"	.00943	4	420	424
5	"5-out6842"	.01758	7	391	398
5	"5-out6843"	.00650	3	458	461
5	"5-out6844"	.01892	6	311	317
5	"5-out6845"	.00492	2	404	406
5	"5-out6846"	.00346	2	575	577
5	"5-out6847"	.00345	2	577	579
5	"5-out6848"	.00404	2	493	495
5	"5-out6850"	.00602	2	330	332
5	"5-out6853"	.01863	3	158	161
5	"5-out6855"	.00260	2	766	768
5	"5-out6857"	.00867	3	343	346
5	"5-out6859"	.00911	3	326	329
5	"5-out6861"	.00843	4	470	474
5	"5-out6865"	.03947	9	219	228
5	"5-out6868"	.00630	2	315	317
5	"5-out6869"	.00242	2	824	826
5	"5-out6871"	.00145	2	1376	1378
5	"5-out6872"	.00288	4	1384	1388
5	"5-out6874"	.00943	2	210	212
5	"5-out6876"	.04477	3	64	67
5	"5-out6877"	.00956	4	414	418
5	"5-out6878"	.00351	6	1701	1707
5	"5-out6879"	.00356	7	1959	1966
5	"5-out6880"	.02439	30	1200	1230
5	"5-out6884"	.00768	40	5167	5207
5	"5-out6885"	.02222	4	176	180
5	"5-out6887"	.00550	2	361	363
5	"5-out6888"	.01045	3	284	287
5	"5-out6889"	.00903	3	329	332
5	"5-out6891"	.00706	4	562	566
5	"5-out6895"	.00479	4	830	834
5	"5-out6898"	.02988	13	422	435
5	"5-out6899"	.01912	10	513	523
5	"5-out6901"	.00660	2	301	303
5	"5-out6906"	.01428	2	138	140
5	"5-out6907"	.01724	2	114	116
5	"5-out6909"	.00728	3	409	412
5	"5-out6910"	.00522	2	381	383
5	"5-out6912"	.00455	2	437	439
5	"5-out6913"	.00459	2	433	435
5	"5-out6914"	.02083	10	470	480
5	"5-out6917"	.00386	2	516	518
5	"5-out6921"	.00769	2	258	260
5	"5-out6924"	.00473	2	420	422
5	"5-out6925"	.00497	2	400	402
5	"5-out6926"	.00514	2	387	389
5	"5-out6928"	.00884	2	224	226
5	"5-out6930"	.00568	6	1050	1056
5	"5-out6931"	.00195	2	1022	1024
5	"5-out6933"	.01081	2	183	185
5	"5-out6940"	.01626	8	484	492
5	"5-out6943"	.00156	2	1274	1276
5	"5-out6947"	.00643	4	618	622
5	"5-out6948"	.01268	7	545	552
5	"5-out6949"	.01560	10	631	641
5	"5-out6951"	.00500	2	398	400
5	"5-out6952"	.00790	2	251	253
5	"5-out6954"	.04000	15	360	375
5	"5-out6955"	.01829	6	322	328
5	"5-out6957"	.00958	3	310	313
5	"5-out6959"	.00714	2	278	280
5	"5-out6961"	.00613	2	324	326
5	"5-out6962"	.00985	4	402	406
5	"5-out6965"	.00595	3	501	504
5	"5-out6966"	.00220	2	906	908
5	"5-out6967"	.02510	6	233	239
5	"5-out6968"	.00545	3	547	550
5	"5-out6971"	.03267	5	148	153
5	"5-out6972"	.00841	7	825	832
5	"5-out6974"	.01775	12	664	676
5	"5-out6976"	.00148	2	1344	1346
5	"5-out6977"	.00904	2	219	221
5	"5-out6980"	.03181	7	213	220
5	"5-out6985"	.02625	11	408	419
5	"5-out6988"	.00638	2	311	313
5	"5-out6989"	.01444	4	273	277
5	"5-out6990"	.01190	4	332	336
5	"5-out6992"	.01250	7	553	560
5	"5-out6994"	.01428	2	138	140
5	"5-out6995"	.00801	4	495	499
5	"5-out6996"	.00588	2	338	340
5	"5-out6997"	.04716	15	303	318
5	"5-out6998"	.01414	13	906	919
5	"5-out7000"	.00438	2	454	456
5	"5-out7001"	.00271	2	735	737
5	"5-out7002"	.01063	2	186	188
5	"5-out7003"	.00729	2	272	274
5	"5-out7004"	.03378	5	143	148
5	"5-out7005"	.00341	2	583	585
5	"5-out7008"	.00906	3	328	331
5	"5-out7010"	.04347	8	176	184
5	"5-out7011"	.01063	4	372	376
5	"5-out7013"	.02112	9	417	426
5	"5-out7014"	.01234	4	320	324
5	"5-out7015"	.00793	5	625	630
5	"5-out7016"	.02301	11	467	478
5	"5-out7017"	.00208	2	955	957
5	"5-out7018"	.02320	11	463	474
5	"5-out7019"	.02513	9	349	358
5	"5-out7020"	.03196	7	212	219
5	"5-out7021"	.00631	5	787	792
5	"5-out7022"	.00245	3	1220	1223
5	"5-out7023"	.01149	2	172	174
5	"5-out7026"	.00666	2	298	300
5	"5-out7029"	.00336	2	593	595
5	"5-out7031"	.02691	13	470	483
5	"5-out7032"	.01878	9	470	479
5	"5-out7033"	.02109	10	464	474
5	"5-out7034"	.01890	9	467	476
5	"5-out7036"	.01882	9	469	478
5	"5-out7037"	.02649	4	147	151
5	"5-out7040"	.01894	9	466	475
5	"5-out7047"	.00645	3	462	465
5	"5-out7051"	.00317	3	943	946
5	"5-out7052"	.00345	2	577	579
5	"5-out7055"	.00441	2	451	453
5	"5-out7058"	.01694	4	232	236
5	"5-out7060"	.00877	2	226	228
5	"5-out7061"	.01740	9	508	517
5	"5-out7062"	.00533	5	932	937
5	"5-out7065"	.00851	4	466	470
5	"5-out7066"	.01158	6	512	518
5	"5-out7067"	.00621	2	320	322
5	"5-out7069"	.00767	3	388	391
5	"5-out7071"	.07619	8	97	105
5	"5-out7073"	.00205	2	969	971
5	"5-out7076"	.01256	7	550	557
5	"5-out7080"	.01945	5	252	257
5	"5-out7081"	.02116	4	185	189
5	"5-out7082"	.01421	3	208	211
5	"5-out7083"	.03614	6	160	166
5	"5-out7084"	.03614	6	160	166
5	"5-out7086"	.00127	4	3126	3130
5	"5-out7087"	.02439	7	280	287
5	"5-out7088"	.01557	9	569	578
5	"5-out7090"	.00429	2	464	466
5	"5-out7091"	.02839	9	308	317
5	"5-out7093"	.01577	5	312	317
5	"5-out7094"	.00306	2	651	653
5	"5-out7097"	.00484	2	411	413
5	"5-out7098"	.00856	9	1042	1051
5	"5-out7100"	.00551	6	1082	1088
5	"5-out7102"	.01340	7	515	522
5	"5-out7104"	.00488	2	407	409
5	"5-out7106"	.00630	2	315	317
5	"5-out7108"	.00995	2	199	201
5	"5-out7109"	.00173	6	3454	3460
5	"5-out7111"	.01910	3	154	157
5	"5-out7116"	.00213	5	2342	2347
5	"5-out7118"	.00817	3	364	367
5	"5-out7119"	.00836	2	237	239
5	"5-out7120"	.00813	2	244	246
5	"5-out7122"	.00586	2	339	341
5	"5-out7123"	.00191	3	1563	1566
5	"5-out7125"	.00158	2	1262	1264
5	"5-out7126"	.02439	7	280	287
5	"5-out7129"	.00287	4	1389	1393
5	"5-out7131"	.00412	2	483	485
5	"5-out7132"	.00376	2	529	531
5	"5-out7137"	.00155	2	1281	1283
5	"5-out7138"	.00264	2	754	756
5	"5-out7139"	.00252	2	790	792
5	"5-out7141"	.02571	9	341	350
5	"5-out7144"	.00179	2	1112	1114
5	"5-out7146"	.00174	2	1146	1148
5	"5-out7147"	.00585	3	509	512
5	"5-out7148"	.00408	3	732	735
5	"5-out7151"	.01208	4	327	331
5	"5-out7152"	.00921	13	1398	1411
5	"5-out7153"	.00974	3	305	308
5	"5-out7156"	.00335	3	892	895
5	"5-out7158"	.01139	4	347	351
5	"5-out7159"	.01327	6	446	452
5	"5-out7160"	.02808	5	173	178
5	"5-out7161"	.02369	5	206	211
5	"5-out7163"	.00604	2	329	331
5	"5-out7165"	.00409	5	1216	1221
5	"5-out7167"	.00473	2	420	422
5	"5-out7170"	.00769	2	258	260
5	"5-out7173"	.00949	6	626	632
5	"5-out7176"	.00862	8	920	928
5	"5-out7177"	.00975	2	203	205
5	"5-out7180"	.01414	7	488	495
5	"5-out7184"	.00468	2	425	427
5	"5-out7185"	.01492	3	198	201
5	"5-out7186"	.01140	6	520	526
5	"5-out7187"	.00740	2	268	270
5	"5-out7192"	.01315	2	150	152
5	"5-out7194"	.00801	6	743	749
5	"5-out7198"	.00934	2	212	214
5	"5-out7199"	.01479	7	466	473
5	"5-out7204"	.00208	2	958	960
5	"5-out7206"	.00474	4	839	843
5	"5-out7207"	.00397	4	1003	1007
5	"5-out7210"	.01769	2	111	113
5	"5-out7211"	.00806	4	492	496
5	"5-out7213"	.00806	4	492	496
5	"5-out7214"	.00806	4	492	496
5	"5-out7222"	.00164	2	1214	1216
5	"5-out7223"	.00671	2	296	298
5	"5-out7224"	.00628	8	1264	1272
5	"5-out7225"	.00368	2	541	543
5	"5-out7227"	.01231	5	401	406
5	"5-out7233"	.00170	2	1168	1170
5	"5-out7234"	.03202	9	272	281
5	"5-out7235"	.00214	2	930	932
5	"5-out7236"	.00536	2	371	373
5	"5-out7238"	.00806	4	492	496
5	"5-out7240"	.00638	7	1090	1097
5	"5-out7244"	.00399	2	499	501
5	"5-out7246"	.01212	2	163	165
5	"5-out7247"	.02839	9	308	317
5	"5-out7251"	.02547	4	153	157
5	"5-out7252"	.04435	11	237	248
5	"5-out7253"	.01351	2	146	148
5	"5-out7254"	.02515	4	155	159
5	"5-out7256"	.00983	3	302	305
5	"5-out7259"	.00788	4	503	507
5	"5-out7260"	.02659	5	183	188
5	"5-out7263"	.00152	2	1312	1314
5	"5-out7265"	.00187	2	1065	1067
5	"5-out7266"	.00609	2	326	328
5	"5-out7269"	.00208	4	1910	1914
5	"5-out7271"	.00766	2	259	261
5	"5-out7272"	.04400	11	239	250
5	"5-out7274"	.01113	5	444	449
5	"5-out7275"	.01290	2	153	155
5	"5-out7277"	.00769	3	387	390
5	"5-out7278"	.01408	2	140	142
5	"5-out7281"	.00407	2	489	491
5	"5-out7283"	.00591	2	336	338
5	"5-out7284"	.00796	2	249	251
5	"5-out7286"	.00402	4	990	994
5	"5-out7288"	.02448	6	239	245
5	"5-out7292"	.00310	4	1284	1288
5	"5-out7293"	.00472	2	421	423
5	"5-out7295"	.01315	4	300	304
5	"5-out7296"	.00320	2	623	625
5	"5-out7297"	.01459	2	135	137
5	"5-out7300"	.00881	2	225	227
5	"5-out7301"	.00462	2	430	432
5	"5-out7303"	.00873	12	1362	1374
5	"5-out7304"	.00508	3	587	590
5	"5-out7307"	.00839	9	1063	1072
5	"5-out7308"	.01578	3	187	190
5	"5-out7310"	.00144	2	1384	1386
5	"5-out7311"	.02255	6	260	266
5	"5-out7312"	.03500	14	386	400
5	"5-out7313"	.00847	6	702	708
5	"5-out7314"	.00688	4	577	581
5	"5-out7315"	.00603	3	494	497
5	"5-out7319"	.01659	11	652	663
5	"5-out7320"	.03726	6	155	161
5	"5-out7323"	.00369	2	539	541
5	"5-out7324"	.00739	6	805	811
5	"5-out7325"	.00369	6	1617	1623
5	"5-out7330"	.00875	6	679	685
5	"5-out7331"	.00824	4	481	485
5	"5-out7334"	.01111	2	178	180
5	"5-out7336"	.03164	5	153	158
5	"5-out7337"	.04081	6	141	147
5	"5-out7341"	.01307	2	151	153
5	"5-out7344"	.00461	4	862	866
5	"5-out7345"	.00315	2	632	634
5	"5-out7347"	.00255	2	781	783
5	"5-out7351"	.00909	2	218	220
5	"5-out7357"	.00273	4	1457	1461
5	"5-out7358"	.01666	2	118	120
5	"5-out7360"	.00510	4	780	784
5	"5-out7361"	.00149	2	1333	1335
5	"5-out7363"	.00362	2	549	551
5	"5-out7364"	.00806	4	492	496
5	"5-out7366"	.07070	14	184	198
5	"5-out7369"	.01503	4	262	266
5	"5-out7375"	.00555	4	716	720
5	"5-out7377"	.01212	2	163	165
5	"5-out7378"	.00311	2	640	642
5	"5-out7379"	.03076	14	441	455
5	"5-out7380"	.03018	16	514	530
5	"5-out7386"	.01709	8	460	468
5	"5-out7388"	.00488	5	1018	1023
5	"5-out7391"	.01152	4	343	347
5	"5-out7392"	.00890	3	334	337
5	"5-out7393"	.00641	2	310	312
5	"5-out7394"	.00915	8	866	874
5	"5-out7396"	.00480	6	1243	1249
5	"5-out7397"	.00479	4	830	834
5	"5-out7398"	.00488	6	1223	1229
5	"5-out7399"	.01369	4	288	292
5	"5-out7400"	.00675	2	294	296
5	"5-out7401"	.01232	6	481	487
5	"5-out7402"	.00211	4	1884	1888
5	"5-out7405"	.00503	2	395	397
5	"5-out7407"	.01176	7	588	595
5	"5-out7408"	.00530	2	375	377
5	"5-out7409"	.00244	4	1630	1634
5	"5-out7411"	.01949	7	352	359
5	"5-out7413"	.00415	2	479	481
5	"5-out7416"	.00600	5	828	833
5	"5-out7418"	.01682	14	818	832
5	"5-out7422"	.00337	2	591	593
5	"5-out7424"	.00244	2	816	818
5	"5-out7425"	.02127	11	506	517
5	"5-out7432"	.00817	7	849	856
5	"5-out7435"	.00277	2	718	720
5	"5-out7436"	.00166	2	1200	1202
5	"5-out7440"	.03296	3	88	91
5	"5-out7442"	.05932	7	111	118
5	"5-out7443"	.04210	4	91	95
5	"5-out7445"	.01481	2	133	135
5	"5-out7446"	.01162	2	170	172
5	"5-out7448"	.06862	7	95	102
5	"5-out7450"	.00458	4	868	872
5	"5-out7451"	.02941	2	66	68
5	"5-out7452"	.00191	2	1040	1042
5	"5-out7456"	.00704	2	282	284
5	"5-out7457"	.00687	2	289	291
5	"5-out7461"	.00274	2	726	728
5	"5-out7462"	.00499	5	996	1001
5	"5-out7463"	.00862	7	805	812
5	"5-out7465"	.00298	2	667	669
5	"5-out7468"	.00533	6	1118	1124
5	"5-out7471"	.01038	3	286	289
5	"5-out7472"	.00724	2	274	276
5	"5-out7474"	.00661	7	1051	1058
5	"5-out7475"	.00457	7	1522	1529
5	"5-out7476"	.00323	4	1231	1235
5	"5-out7477"	.01886	17	884	901
5	"5-out7478"	.01038	6	572	578
5	"5-out7479"	.00219	2	910	912
5	"5-out7480"	.00233	2	853	855
5	"5-out7481"	.00823	2	241	243
5	"5-out7483"	.00486	3	614	617
5	"5-out7486"	.01552	7	444	451
5	"5-out7489"	.03521	5	137	142
5	"5-out7491"	.00372	2	535	537
5	"5-out7492"	.01116	5	443	448
5	"5-out7493"	.00796	4	498	502
5	"5-out7498"	.01522	3	194	197
5	"5-out7501"	.01453	14	949	963
5	"5-out7504"	.00328	3	911	914
5	"5-out7505"	.00419	11	2609	2620
5	"5-out7506"	.00219	2	911	913
5	"5-out7507"	.00424	4	938	942
5	"5-out7508"	.00245	2	812	814
5	"5-out7511"	.00227	4	1751	1755
5	"5-out7513"	.00393	2	506	508
5	"5-out7514"	.00408	2	487	489
5	"5-out7515"	.00332	2	599	601
5	"5-out7516"	.00384	2	518	520
5	"5-out7518"	.00928	3	320	323
5	"5-out7520"	.02035	52	2503	2555
5	"5-out7521"	.00433	2	459	461
5	"5-out7523"	.00727	7	955	962
5	"5-out7525"	.00327	4	1218	1222
5	"5-out7526"	.00961	2	206	208
5	"5-out7528"	.02572	8	303	311
5	"5-out7529"	.00662	4	600	604
5	"5-out7531"	.01092	2	181	183
5	"5-out7532"	.03225	3	90	93
5	"5-out7533"	.03921	6	147	153
5	"5-out7534"	.02453	4	159	163
5	"5-out7535"	.02690	6	217	223
5	"5-out7536"	.01298	3	228	231
5	"5-out7538"	.00813	3	366	369
5	"5-out7539"	.04316	6	133	139
5	"5-out7542"	.00483	4	823	827
5	"5-out7544"	.01526	6	387	393
5	"5-out7548"	.01142	10	865	875
5	"5-out7549"	.00369	4	1079	1083
5	"5-out7550"	.00404	2	492	494
5	"5-out7553"	.00147	2	1350	1352
5	"5-out7554"	.00810	13	1591	1604
5	"5-out7555"	.00371	4	1073	1077
5	"5-out7558"	.00772	8	1027	1035
5	"5-out7559"	.00207	2	961	963
5	"5-out7560"	.00183	2	1085	1087
5	"5-out7561"	.01025	11	1062	1073
5	"5-out7564"	.01282	8	616	624
5	"5-out7565"	.00842	4	471	475
5	"5-out7567"	.02461	8	317	325
5	"5-out7568"	.00706	2	281	283
5	"5-out7569"	.02173	3	135	138
5	"5-out7572"	.01242	2	159	161
5	"5-out7574"	.00636	3	468	471
5	"5-out7577"	.00659	10	1506	1516
5	"5-out7581"	.04210	4	91	95
5	"5-out7582"	.03000	3	97	100
5	"5-out7585"	.00909	2	218	220
5	"5-out7589"	.00706	2	281	283
5	"5-out7590"	.00639	24	3729	3753
5	"5-out7591"	.04487	7	149	156
5	"5-out7593"	.01556	4	253	257
5	"5-out7595"	.01363	3	217	220
5	"5-out7600"	.04702	15	304	319
5	"5-out7603"	.03636	6	159	165
5	"5-out7607"	.00873	2	227	229
5	"5-out7610"	.01945	10	504	514
5	"5-out7611"	.01470	2	134	136
5	"5-out7612"	.00475	2	419	421
5	"5-out7619"	.02463	5	198	203
5	"5-out7621"	.01488	5	331	336
5	"5-out7623"	.03643	9	238	247
5	"5-out7624"	.02762	5	176	181
5	"5-out7625"	.01447	13	885	898
5	"5-out7626"	.00780	7	890	897
5	"5-out7628"	.00701	2	283	285
5	"5-out7630"	.00724	2	274	276
5	"5-out7635"	.00822	5	603	608
5	"5-out7636"	.00287	3	1042	1045
5	"5-out7637"	.00199	2	999	1001
5	"5-out7639"	.00644	4	617	621
5	"5-out7640"	.00784	6	759	765
5	"5-out7641"	.07857	11	129	140
5	"5-out7644"	.01428	2	138	140
5	"5-out7645"	.00696	10	1425	1435
5	"5-out7647"	.02107	11	511	522
5	"5-out7650"	.00518	2	384	386
5	"5-out7657"	.01754	2	112	114
5	"5-out7658"	.04761	5	100	105
5	"5-out7660"	.02752	3	106	109
5	"5-out7663"	.01769	2	111	113
5	"5-out7665"	.01754	2	112	114
5	"5-out7666"	.01769	2	111	113
5	"5-out7667"	.01785	2	110	112
5	"5-out7668"	.01754	2	112	114
5	"5-out7669"	.02608	3	112	115
5	"5-out7670"	.05504	6	103	109
5	"5-out7671"	.01612	2	122	124
5	"5-out7673"	.02702	3	108	111
5	"5-out7676"	.02608	3	112	115
5	"5-out7683"	.00641	2	310	312
5	"5-out7685"	.00584	4	680	684
5	"5-out7686"	.01286	4	307	311
5	"5-out7687"	.00680	2	292	294
5	"5-out7688"	.01343	7	514	521
5	"5-out7693"	.00913	4	434	438
5	"5-out7696"	.00380	2	523	525
5	"5-out7697"	.01518	6	389	395
5	"5-out7698"	.00389	2	512	514
5	"5-out7699"	.02801	10	347	357
5	"5-out7700"	.02994	15	486	501
5	"5-out7702"	.00238	2	838	840
5	"5-out7703"	.05769	9	147	156
5	"5-out7705"	.00787	4	504	508
5	"5-out7710"	.00566	2	351	353
5	"5-out7712"	.00384	2	518	520
5	"5-out7713"	.00611	2	325	327
5	"5-out7715"	.05769	9	147	156
5	"5-out7716"	.05769	9	147	156
5	"5-out7717"	.00701	2	283	285
5	"5-out7718"	.00924	5	536	541
5	"5-out7719"	.00429	2	464	466
5	"5-out7721"	.01449	3	204	207
5	"5-out7724"	.00165	2	1206	1208
5	"5-out7725"	.00197	2	1013	1015
5	"5-out7727"	.00259	2	770	772
5	"5-out7728"	.00783	6	760	766
5	"5-out7729"	.00717	3	415	418
5	"5-out7732"	.02631	3	111	114
5	"5-out7733"	.01600	2	123	125
5	"5-out7740"	.00913	2	217	219
5	"5-out7743"	.00619	2	321	323
5	"5-out7744"	.01353	8	583	591
5	"5-out7745"	.01557	10	632	642
5	"5-out7748"	.00575	11	1899	1910
5	"5-out7751"	.00175	2	1136	1138
5	"5-out7752"	.00653	4	608	612
5	"5-out7754"	.00349	2	570	572
5	"5-out7755"	.01133	5	436	441
5	"5-out7756"	.00887	3	335	338
5	"5-out7757"	.00607	3	491	494
5	"5-out7758"	.00246	2	809	811
5	"5-out7759"	.00508	4	782	786
5	"5-out7760"	.00637	5	779	784
5	"5-out7763"	.01418	6	417	423
5	"5-out7764"	.00456	2	436	438
5	"5-out7766"	.01434	10	687	697
5	"5-out7767"	.00571	2	348	350
5	"5-out7770"	.01265	4	312	316
5	"5-out7772"	.00713	4	557	561
5	"5-out7774"	.02978	7	228	235
5	"5-out7781"	.00732	2	271	273
5	"5-out7784"	.00657	5	755	760
5	"5-out7785"	.04000	11	264	275
5	"5-out7790"	.00406	2	490	492
5	"5-out7795"	.01886	3	156	159
5	"5-out7796"	.00655	2	303	305
5	"5-out7797"	.01428	2	138	140
5	"5-out7798"	.00314	2	634	636
5	"5-out7799"	.00597	2	333	335
5	"5-out7801"	.00587	9	1522	1531
5	"5-out7802"	.00409	2	486	488
5	"5-out7807"	.00384	2	518	520
5	"5-out7808"	.00904	4	438	442
5	"5-out7810"	.03508	4	110	114
5	"5-out7811"	.01754	2	112	114
5	"5-out7812"	.01007	10	983	993
5	"5-out7814"	.03571	7	189	196
5	"5-out7815"	.00638	2	311	313
5	"5-out7816"	.02112	3	139	142
5	"5-out7817"	.00484	4	821	825
5	"5-out7818"	.01626	4	242	246
5	"5-out7819"	.00833	2	238	240
5	"5-out7822"	.00458	2	434	436
5	"5-out7823"	.07000	7	93	100
5	"5-out7829"	.01680	2	117	119
5	"5-out7833"	.06748	11	152	163
5	"5-out7834"	.01176	2	168	170
5	"5-out7836"	.00436	2	456	458
5	"5-out7839"	.00453	4	878	882
5	"5-out7840"	.00478	4	832	836
5	"5-out7842"	.00623	2	319	321
5	"5-out7844"	.01052	5	470	475
5	"5-out7845"	.00711	2	279	281
5	"5-out7853"	.01342	2	147	149
5	"5-out7860"	.10666	8	67	75
5	"5-out7861"	.03246	5	149	154
5	"5-out7862"	.05517	8	137	145
5	"5-out7865"	.00664	2	299	301
5	"5-out7868"	.01165	9	763	772
5	"5-out7870"	.00259	2	768	770
5	"5-out7871"	.00757	2	262	264
5	"5-out7872"	.00947	2	209	211
5	"5-out7879"	.00496	2	401	403
5	"5-out7880"	.00913	2	217	219
5	"5-out7884"	.00921	2	215	217
5	"5-out7888"	.02547	4	153	157
5	"5-out7889"	.01528	9	580	589
5	"5-out7893"	.00875	4	453	457
5	"5-out7896"	.02482	7	275	282
5	"5-out7898"	.02142	6	274	280
5	"5-out7899"	.02612	11	410	421
5	"5-out7900"	.01136	2	174	176
5	"5-out7901"	.00722	2	275	277
5	"5-out7902"	.01162	3	255	258
5	"5-out7905"	.01200	22	1811	1833
5	"5-out7906"	.03734	9	232	241
5	"5-out7907"	.00579	2	343	345
5	"5-out7911"	.00719	3	414	417
5	"5-out7914"	.00831	3	358	361
5	"5-out7915"	.00490	4	812	816
5	"5-out7918"	.00689	2	288	290
5	"5-out7922"	.00562	4	707	711
5	"5-out7923"	.00401	3	744	747
5	"5-out7924"	.01544	4	255	259
5	"5-out7926"	.00694	3	429	432
5	"5-out7927"	.00606	2	328	330
5	"5-out7932"	.01684	8	467	475
5	"5-out7933"	.00833	2	238	240
5	"5-out7935"	.01047	8	756	764
5	"5-out7936"	.00863	4	459	463
5	"5-out7938"	.00934	3	318	321
5	"5-out7941"	.00555	3	537	540
5	"5-out7945"	.09589	7	66	73
5	"5-out7946"	.00227	3	1315	1318
5	"5-out7947"	.00352	4	1130	1134
5	"5-out7949"	.00445	6	1341	1347
5	"5-out7950"	.00254	2	783	785
5	"5-out7951"	.00751	6	792	798
5	"5-out7952"	.00305	3	978	981
5	"5-out7953"	.00284	3	1052	1055
5	"5-out7954"	.01612	6	366	372
5	"5-out7955"	.00648	23	3523	3546
5	"5-out7957"	.00216	2	920	922
5	"5-out7958"	.02094	8	374	382
5	"5-out7961"	.08695	12	126	138
5	"5-out7963"	.00608	10	1634	1644
5	"5-out7965"	.03902	8	197	205
5	"5-out7966"	.01754	2	112	114
5	"5-out7967"	.03703	4	104	108
5	"5-out7968"	.03773	4	102	106
5	"5-out7971"	.02586	3	113	116
5	"5-out7976"	.01769	2	111	113
5	"5-out7980"	.02678	3	109	112
5	"5-out7981"	.03478	4	111	115
5	"5-out7982"	.01785	2	110	112
5	"5-out7985"	.01739	2	113	115
5	"5-out7988"	.04347	5	110	115
5	"5-out7989"	.01739	2	113	115
5	"5-out7990"	.03508	4	110	114
5	"5-out7992"	.01754	2	112	114
5	"5-out7993"	.04385	5	109	114
5	"5-out7994"	.01754	2	112	114
5	"5-out7995"	.02631	3	111	114
5	"5-out7996"	.01400	10	704	714
5	"5-out7997"	.00303	2	656	658
5	"5-out8000"	.00706	4	562	566
5	"5-out16001"	.00578	2	344	346
5	"5-out16002"	.00781	2	254	256
5	"5-out16003"	.00320	2	623	625
5	"5-out16008"	.03614	3	80	83
5	"5-out16011"	.00684	2	290	292
5	"5-out16012"	.00724	4	548	552
5	"5-out16013"	.00540	5	920	925
5	"5-out16014"	.01740	11	621	632
5	"5-out16015"	.02056	13	619	632
5	"5-out16017"	.01746	8	450	458
5	"5-out16018"	.00467	2	426	428
5	"5-out16021"	.01818	8	432	440
5	"5-out16022"	.00204	2	974	976
5	"5-out16024"	.00871	5	569	574
5	"5-out16025"	.00478	2	416	418
5	"5-out16026"	.00573	2	347	349
5	"5-out16027"	.00921	4	430	434
5	"5-out16028"	.00534	2	372	374
5	"5-out16029"	.01315	6	450	456
5	"5-out16030"	.01902	9	464	473
5	"5-out16031"	.01056	3	281	284
5	"5-out16033"	.00884	8	896	904
5	"5-out16042"	.00424	6	1406	1412
5	"5-out16043"	.01360	2	145	147
5	"5-out16045"	.00241	2	826	828
5	"5-out16047"	.00754	6	789	795
5	"5-out16049"	.00547	3	545	548
5	"5-out16052"	.01035	5	478	483
5	"5-out16055"	.01068	5	463	468
5	"5-out16057"	.00428	2	465	467
5	"5-out16060"	.00539	5	921	926
5	"5-out16061"	.00492	2	404	406
5	"5-out16062"	.02356	25	1036	1061
5	"5-out16065"	.02935	14	463	477
5	"5-out16066"	.00276	2	721	723
5	"5-out16068"	.02690	6	217	223
5	"5-out16069"	.01086	2	182	184
5	"5-out16070"	.00702	6	848	854
5	"5-out16071"	.02252	5	217	222
5	"5-out16073"	.00573	2	347	349
5	"5-out16075"	.01217	7	568	575
5	"5-out16080"	.01403	13	913	926
5	"5-out16083"	.03389	2	57	59
5	"5-out16087"	.00787	2	252	254
5	"5-out16089"	.00907	4	437	441
5	"5-out16091"	.02424	4	161	165
5	"5-out16092"	.00446	2	446	448
5	"5-out16095"	.00402	2	495	497
5	"5-out16096"	.00660	3	451	454
5	"5-out16100"	.01025	6	579	585
5	"5-out16101"	.00646	4	615	619
5	"5-out16102"	.00539	2	369	371
5	"5-out16103"	.01798	5	273	278
5	"5-out16105"	.00494	3	604	607
5	"5-out16106"	.00759	4	523	527
5	"5-out16110"	.00468	7	1486	1493
5	"5-out16111"	.00505	2	394	396
5	"5-out16112"	.00152	2	1306	1308
5	"5-out16115"	.03524	8	219	227
5	"5-out16116"	.01180	10	837	847
5	"5-out16117"	.00422	3	707	710
5	"5-out16119"	.00232	2	857	859
5	"5-out16121"	.00872	8	909	917
5	"5-out16122"	.00930	2	213	215
5	"5-out16123"	.00287	3	1042	1045
5	"5-out16124"	.00043	2	4586	4588
5	"5-out16125"	.00180	9	4972	4981
5	"5-out16126"	.00563	2	353	355
5	"5-out16128"	.00859	3	346	349
5	"5-out16129"	.00692	3	430	433
5	"5-out16131"	.00568	4	699	703
5	"5-out16136"	.00423	3	705	708
5	"5-out16137"	.04285	12	268	280
5	"5-out16138"	.00479	2	415	417
5	"5-out16140"	.02184	9	403	412
5	"5-out16147"	.01757	18	1006	1024
5	"5-out16149"	.01515	2	130	132
5	"5-out16155"	.00561	2	354	356
5	"5-out16156"	.03603	12	321	333
5	"5-out16158"	.00360	2	553	555
5	"5-out16159"	.00544	2	365	367
5	"5-out16160"	.02208	7	310	317
5	"5-out16164"	.01090	3	272	275
5	"5-out16165"	.00324	2	615	617
5	"5-out16166"	.00817	3	364	367
5	"5-out16167"	.00523	2	380	382
5	"5-out16170"	.00208	2	959	961
5	"5-out16172"	.04545	4	84	88
5	"5-out16173"	.01345	3	220	223
5	"5-out16174"	.01736	5	283	288
5	"5-out16175"	.01323	7	522	529
5	"5-out16176"	.00190	2	1048	1050
5	"5-out16177"	.01663	17	1005	1022
5	"5-out16179"	.00814	4	487	491
5	"5-out16185"	.00812	33	4028	4061
5	"5-out16187"	.01408	2	140	142
5	"5-out16189"	.01025	4	386	390
5	"5-out16190"	.01714	3	172	175
5	"5-out16191"	.02531	2	77	79
5	"5-out16192"	.00268	2	743	745
5	"5-out16193"	.02197	4	178	182
5	"5-out16195"	.01515	2	130	132
5	"5-out16196"	.01081	2	183	185
5	"5-out16197"	.00975	2	203	205
5	"5-out16198"	.00798	4	497	501
5	"5-out16199"	.02531	2	77	79
5	"5-out16200"	.01632	4	241	245
5	"5-out16205"	.01785	2	110	112
5	"5-out16208"	.00347	9	2581	2590
5	"5-out16211"	.00814	6	731	737
5	"5-out16212"	.00261	2	764	766
5	"5-out16213"	.00231	2	863	865
5	"5-out16214"	.00445	4	894	898
5	"5-out16215"	.00347	3	860	863
5	"5-out16217"	.01257	2	157	159
5	"5-out16218"	.00657	2	302	304
5	"5-out16219"	.01724	2	114	116
5	"5-out16220"	.04188	8	183	191
5	"5-out16221"	.01445	6	409	415
5	"5-out16222"	.00488	2	407	409
5	"5-out16223"	.02020	2	97	99
5	"5-out16224"	.00195	2	1023	1025
5	"5-out16225"	.00349	2	570	572
5	"5-out16228"	.01923	11	561	572
5	"5-out16230"	.01127	3	263	266
5	"5-out16231"	.02631	7	259	266
5	"5-out16232"	.01879	5	261	266
5	"5-out16233"	.00445	2	447	449
5	"5-out16234"	.00486	4	818	822
5	"5-out16235"	.00270	2	738	740
5	"5-out16236"	.01239	6	478	484
5	"5-out16239"	.01397	7	494	501
5	"5-out16240"	.00272	2	733	735
5	"5-out16241"	.00343	3	871	874
5	"5-out16248"	.01467	7	470	477
5	"5-out16251"	.00549	2	362	364
5	"5-out16256"	.02127	4	184	188
5	"5-out16258"	.07518	10	123	133
5	"5-out16259"	.11764	4	30	34
5	"5-out16261"	.01086	2	182	184
5	"5-out16262"	.01333	2	148	150
5	"5-out16264"	.00259	3	1155	1158
5	"5-out16268"	.01811	5	271	276
5	"5-out16270"	.00781	25	3172	3197
5	"5-out16272"	.00354	2	562	564
5	"5-out16278"	.00975	2	203	205
5	"5-out16279"	.00362	2	549	551
5	"5-out16280"	.00181	3	1652	1655
5	"5-out16289"	.00568	8	1398	1406
5	"5-out16291"	.00682	4	582	586
5	"5-out16292"	.02793	10	348	358
5	"5-out16293"	.04587	5	104	109
5	"5-out16294"	.01217	8	649	657
5	"5-out16298"	.00222	2	895	897
5	"5-out16299"	.00303	2	656	658
5	"5-out16302"	.00197	4	2023	2027
5	"5-out16303"	.02702	4	144	148
5	"5-out16305"	.00512	4	776	780
5	"5-out16308"	.00706	12	1686	1698
5	"5-out16309"	.02620	6	223	229
5	"5-out16310"	.01411	6	419	425
5	"5-out16311"	.03432	15	422	437
5	"5-out16312"	.00466	4	854	858
5	"5-out16316"	.00924	9	964	973
5	"5-out16317"	.00808	4	491	495
5	"5-out16318"	.02568	15	569	584
5	"5-out16319"	.01897	10	517	527
5	"5-out16320"	.01002	4	395	399
5	"5-out16321"	.00506	2	393	395
5	"5-out16322"	.00947	2	209	211
5	"5-out16325"	.00635	4	625	629
5	"5-out16328"	.01047	4	378	382
5	"5-out16329"	.02473	7	276	283
5	"5-out16333"	.00919	4	431	435
5	"5-out16336"	.01515	3	195	198
5	"5-out16337"	.01492	2	132	134
5	"5-out16339"	.00384	2	518	520
5	"5-out16340"	.00175	2	1138	1140
5	"5-out16342"	.00568	43	7527	7570
5	"5-out16343"	.02772	14	491	505
5	"5-out16344"	.00521	4	763	767
5	"5-out16345"	.00272	2	732	734
5	"5-out16346"	.01737	11	622	633
5	"5-out16347"	.00796	4	498	502
5	"5-out16349"	.00848	16	1869	1885
5	"5-out16354"	.00433	2	459	461
5	"5-out16356"	.00214	3	1398	1401
5	"5-out16357"	.00314	2	633	635
5	"5-out16358"	.00456	3	654	657
5	"5-out16359"	.00682	8	1165	1173
5	"5-out16362"	.00716	8	1108	1116
5	"5-out16363"	.00420	4	947	951
5	"5-out16364"	.00690	8	1151	1159
5	"5-out16365"	.01000	2	198	200
5	"5-out16366"	.01041	5	475	480
5	"5-out16367"	.00429	2	464	466
5	"5-out16368"	.00420	7	1656	1663
5	"5-out16369"	.02358	5	207	212
5	"5-out16370"	.00681	5	729	734
5	"5-out16371"	.03597	5	134	139
5	"5-out16373"	.01408	2	140	142
5	"5-out16375"	.00283	4	1407	1411
5	"5-out16376"	.02721	12	429	441
5	"5-out16379"	.02597	12	450	462
5	"5-out16381"	.00556	14	2503	2517
5	"5-out16382"	.00547	5	908	913
5	"5-out16385"	.02649	4	147	151
5	"5-out16387"	.01408	2	140	142
5	"5-out16388"	.02390	6	245	251
5	"5-out16389"	.01423	4	277	281
5	"5-out16390"	.00550	5	903	908
5	"5-out16392"	.00275	2	723	725
5	"5-out16393"	.00635	3	469	472
5	"5-out16394"	.02531	2	77	79
5	"5-out16397"	.01388	2	142	144
5	"5-out16399"	.00668	4	594	598
5	"5-out16401"	.02325	2	84	86
5	"5-out16402"	.00397	2	501	503
5	"5-out16403"	.02272	2	86	88
5	"5-out16404"	.00552	3	540	543
5	"5-out16406"	.00600	2	331	333
5	"5-out16407"	.00751	2	264	266
5	"5-out16408"	.00732	2	271	273
5	"5-out16409"	.00558	2	356	358
5	"5-out16410"	.00766	2	259	261
5	"5-out16411"	.01792	5	274	279
5	"5-out16417"	.00480	4	829	833
5	"5-out16419"	.01071	12	1108	1120
5	"5-out16420"	.02061	6	285	291
5	"5-out16422"	.00578	2	344	346
5	"5-out16425"	.00247	3	1211	1214
5	"5-out16426"	.02124	27	1244	1271
5	"5-out16430"	.00819	2	242	244
5	"5-out16431"	.00338	3	882	885
5	"5-out16432"	.00584	8	1361	1369
5	"5-out16433"	.01342	2	147	149
5	"5-out16438"	.01714	3	172	175
5	"5-out16440"	.01223	10	807	817
5	"5-out16441"	.00945	8	838	846
5	"5-out16444"	.00117	5	4260	4265
5	"5-out16446"	.00262	2	761	763
5	"5-out16447"	.00301	13	4294	4307
5	"5-out16448"	.00310	14	4502	4516
5	"5-out16449"	.02673	5	182	187
5	"5-out16450"	.00694	31	4431	4462
5	"5-out16451"	.00340	2	586	588
5	"5-out16452"	.00431	4	923	927
5	"5-out16455"	.00229	2	868	870
5	"5-out16458"	.00370	2	538	540
5	"5-out16459"	.00960	6	619	625
5	"5-out16463"	.00467	2	426	428
5	"5-out16464"	.00684	3	435	438
5	"5-out16465"	.00441	2	451	453
5	"5-out16466"	.00465	2	428	430
5	"5-out16467"	.04076	15	353	368
5	"5-out16468"	.00221	2	900	902
5	"5-out16469"	.00220	2	905	907
5	"5-out16470"	.00599	4	663	667
5	"5-out16471"	.00195	2	1022	1024
5	"5-out16472"	.00378	2	526	528
5	"5-out16474"	.00514	4	773	777
5	"5-out16476"	.01568	16	1004	1020
5	"5-out16478"	.00434	3	687	690
5	"5-out16481"	.00648	4	613	617
5	"5-out16482"	.01221	6	485	491
5	"5-out16483"	.00359	2	555	557
5	"5-out16487"	.02643	6	221	227
5	"5-out16488"	.00420	2	474	476
5	"5-out16489"	.02922	18	598	616
5	"5-out16496"	.01583	7	435	442
5	"5-out16497"	.00241	2	825	827
5	"5-out16498"	.00432	3	690	693
5	"5-out16499"	.00763	3	390	393
5	"5-out16504"	.01075	2	184	186
5	"5-out16505"	.00900	2	220	222
5	"5-out16506"	.02452	18	716	734
5	"5-out16507"	.00738	4	538	542
5	"5-out16509"	.00250	2	796	798
5	"5-out16512"	.01000	4	396	400
5	"5-out16514"	.00571	2	348	350
5	"5-out16517"	.02257	10	433	443
5	"5-out16518"	.03005	11	355	366
5	"5-out16523"	.00235	8	3388	3396
5	"5-out16525"	.01030	2	192	194
5	"5-out16527"	.04081	6	141	147
5	"5-out16530"	.03608	7	187	194
5	"5-out16531"	.02645	5	184	189
5	"5-out16532"	.01058	2	187	189
5	"5-out16533"	.01058	2	187	189
5	"5-out16534"	.01587	3	186	189
5	"5-out16535"	.01587	3	186	189
5	"5-out16536"	.01058	2	187	189
5	"5-out16537"	.01587	3	186	189
5	"5-out16538"	.04375	7	153	160
5	"5-out16540"	.00301	2	661	663
5	"5-out16541"	.00687	5	722	727
5	"5-out16543"	.00671	5	740	745
5	"5-out16545"	.01673	13	764	777
5	"5-out16548"	.00612	4	649	653
5	"5-out16549"	.00317	2	627	629
5	"5-out16551"	.01492	4	264	268
5	"5-out16552"	.02118	10	462	472
5	"5-out16553"	.00626	5	793	798
5	"5-out16559"	.07142	10	130	140
5	"5-out16561"	.00452	2	440	442
5	"5-out16562"	.01212	2	163	165
5	"5-out16564"	.00828	30	3593	3623
5	"5-out16565"	.02597	12	450	462
5	"5-out16567"	.02807	13	450	463
5	"5-out16568"	.00268	2	743	745
5	"5-out16572"	.01077	15	1377	1392
5	"5-out16578"	.00909	2	218	220
5	"5-out16579"	.01041	2	190	192
5	"5-out16580"	.01184	9	751	760
5	"5-out16581"	.01081	7	640	647
5	"5-out16585"	.01666	8	472	480
5	"5-out16586"	.00755	3	394	397
5	"5-out16587"	.00588	2	338	340
5	"5-out16590"	.01388	7	497	504
5	"5-out16591"	.02205	6	266	272
5	"5-out16593"	.00784	2	253	255
5	"5-out16595"	.00709	3	420	423
5	"5-out16596"	.02763	11	387	398
5	"5-out16599"	.00900	2	220	222
5	"5-out16603"	.00576	2	345	347
5	"5-out16606"	.00300	2	663	665
5	"5-out16608"	.01336	5	369	374
5	"5-out16609"	.00702	3	424	427
5	"5-out16611"	.00295	2	674	676
5	"5-out16612"	.00111	5	4481	4486
5	"5-out16614"	.00462	4	860	864
5	"5-out16619"	.04016	10	239	249
5	"5-out16621"	.01033	4	383	387
5	"5-out16622"	.00383	4	1038	1042
5	"5-out16624"	.00542	2	367	369
5	"5-out16626"	.01277	4	309	313
5	"5-out16630"	.00276	2	721	723
5	"5-out16631"	.00284	5	1750	1755
5	"5-out16633"	.00379	4	1050	1054
5	"5-out16635"	.00471	5	1055	1060
5	"5-out16636"	.00566	4	702	706
5	"5-out16637"	.00252	2	789	791
5	"5-out16638"	.00522	5	952	957
5	"5-out16639"	.01607	10	612	622
5	"5-out16641"	.00323	2	617	619
5	"5-out16645"	.00677	2	293	295
5	"5-out16646"	.00921	2	215	217
5	"5-out16647"	.00700	3	425	428
5	"5-out16648"	.00757	3	393	396
5	"5-out16649"	.02450	5	199	204
5	"5-out16651"	.00709	2	280	282
5	"5-out16652"	.00617	2	322	324
5	"5-out16655"	.00613	2	324	326
5	"5-out16657"	.02242	5	218	223
5	"5-out16658"	.00483	3	618	621
5	"5-out16661"	.00895	3	332	335
5	"5-out16662"	.00770	4	515	519
5	"5-out16663"	.01915	5	256	261
5	"5-out16664"	.01865	5	263	268
5	"5-out16665"	.02135	6	275	281
5	"5-out16669"	.01503	4	262	266
5	"5-out16671"	.01126	4	351	355
5	"5-out16673"	.00840	3	354	357
5	"5-out16674"	.03495	18	497	515
5	"5-out16676"	.00662	2	300	302
5	"5-out16677"	.00312	6	1916	1922
5	"5-out16678"	.00294	2	676	678
5	"5-out16679"	.00251	3	1191	1194
5	"5-out16683"	.00846	5	586	591
5	"5-out16684"	.01274	9	697	706
5	"5-out16688"	.01176	2	168	170
5	"5-out16689"	.03553	7	190	197
5	"5-out16691"	.00298	2	668	670
5	"5-out16692"	.08823	3	31	34
5	"5-out16693"	.02552	17	649	666
5	"5-out16695"	.00340	3	877	880
5	"5-out16696"	.00720	5	689	694
5	"5-out16698"	.03135	18	556	574
5	"5-out16699"	.00361	16	4411	4427
5	"5-out16700"	.00244	11	4479	4490
5	"5-out16702"	.04424	5	108	113
5	"5-out16703"	.00730	6	815	821
5	"5-out16704"	.03092	3	94	97
5	"5-out16705"	.00308	2	646	648
5	"5-out16710"	.00069	2	2869	2871
5	"5-out16713"	.00666	2	298	300
5	"5-out16715"	.00719	2	276	278
5	"5-out16716"	.00288	4	1382	1386
5	"5-out16720"	.00853	13	1511	1524
5	"5-out16722"	.00401	9	2234	2243
5	"5-out16726"	.00778	2	255	257
5	"5-out16728"	.02941	3	99	102
5	"5-out16730"	.00724	22	3014	3036
5	"5-out16733"	.00193	2	1031	1033
5	"5-out16735"	.01054	6	563	569
5	"5-out16736"	.00362	2	549	551
5	"5-out16737"	.01834	2	107	109
5	"5-out16738"	.00348	6	1717	1723
5	"5-out16739"	.00942	28	2942	2970
5	"5-out16741"	.00179	2	1114	1116
5	"5-out16744"	.00689	2	288	290
5	"5-out16745"	.00476	2	418	420
5	"5-out16747"	.01864	8	421	429
5	"5-out16749"	.00486	2	409	411
5	"5-out16751"	.01423	4	277	281
5	"5-out16753"	.00621	2	320	322
5	"5-out16754"	.00289	3	1033	1036
5	"5-out16756"	.01886	7	364	371
5	"5-out16757"	.00551	7	1262	1269
5	"5-out16760"	.00409	3	730	733
5	"5-out16761"	.00666	6	894	900
5	"5-out16762"	.02466	11	435	446
5	"5-out16766"	.00620	5	801	806
5	"5-out16767"	.03846	3	75	78
5	"5-out16768"	.03937	5	122	127
5	"5-out16770"	.01307	2	151	153
5	"5-out16771"	.00535	3	557	560
5	"5-out16772"	.00448	16	3548	3564
5	"5-out16774"	.00053	2	3705	3707
5	"5-out16776"	.02392	5	204	209
5	"5-out16778"	.00519	4	766	770
5	"5-out16779"	.00246	2	809	811
5	"5-out16780"	.00398	5	1251	1256
5	"5-out16781"	.00655	5	758	763
5	"5-out16782"	.00421	2	472	474
5	"5-out16788"	.05517	8	137	145
5	"5-out16789"	.00826	3	360	363
5	"5-out16790"	.00313	3	953	956
5	"5-out16793"	.01342	2	147	149
5	"5-out16794"	.01960	2	100	102
5	"5-out16795"	.00509	6	1171	1177
5	"5-out16797"	.01666	3	177	180
5	"5-out16798"	.05405	4	70	74
5	"5-out16799"	.01415	11	766	777
5	"5-out16800"	.01415	11	766	777
5	"5-out16801"	.00381	2	522	524
5	"5-out16802"	.00783	5	633	638
5	"5-out16803"	.00806	3	369	372
5	"5-out16804"	.04137	6	139	145
5	"5-out16805"	.01574	2	125	127
5	"5-out16806"	.00216	2	923	925
5	"5-out16807"	.00209	2	953	955
5	"5-out16810"	.01086	2	182	184
5	"5-out16817"	.00293	4	1357	1361
5	"5-out16818"	.00289	9	3105	3114
5	"5-out16821"	.00469	5	1060	1065
5	"5-out16828"	.02343	3	125	128
5	"5-out16829"	.00285	2	699	701
5	"5-out16831"	.02349	9	374	383
5	"5-out16832"	.00689	2	288	290
5	"5-out16833"	.00362	2	549	551
5	"5-out16836"	.06666	6	84	90
5	"5-out16839"	.00270	4	1476	1480
5	"5-out16847"	.00497	2	400	402
5	"5-out16850"	.01224	6	484	490
5	"5-out16851"	.03061	15	475	490
5	"5-out16852"	.02182	11	493	504
5	"5-out16853"	.00954	5	519	524
5	"5-out16854"	.01571	8	501	509
5	"5-out16855"	.01207	6	491	497
5	"5-out16857"	.01449	2	136	138
5	"5-out16860"	.02040	3	144	147
5	"5-out16863"	.01058	2	187	189
5	"5-out16864"	.01587	3	186	189
5	"5-out16865"	.01058	2	187	189
5	"5-out16866"	.01470	2	134	136
5	"5-out16867"	.00975	2	203	205
5	"5-out16868"	.01160	5	426	431
5	"5-out16869"	.00553	5	899	904
5	"5-out16873"	.01415	11	766	777
5	"5-out16876"	.00283	2	704	706
5	"5-out16878"	.00334	2	596	598
5	"5-out16879"	.00417	3	716	719
5	"5-out16881"	.03105	5	156	161
5	"5-out16882"	.00760	2	261	263
5	"5-out16883"	.00760	2	261	263
5	"5-out16884"	.01509	8	522	530
5	"5-out16885"	.00446	4	891	895
5	"5-out16886"	.00256	2	779	781
5	"5-out16887"	.01260	3	235	238
5	"5-out16889"	.02469	2	79	81
5	"5-out16893"	.01470	3	201	204
5	"5-out16894"	.03846	2	50	52
5	"5-out16895"	.04761	6	120	126
5	"5-out16896"	.06250	4	60	64
5	"5-out16900"	.00403	5	1233	1238
5	"5-out16901"	.00781	6	762	768
5	"5-out16902"	.01025	8	772	780
5	"5-out16904"	.01369	6	432	438
5	"5-out16906"	.00266	4	1497	1501
5	"5-out16907"	.01600	2	123	125
5	"5-out16908"	.00778	4	510	514
5	"5-out16909"	.05504	6	103	109
5	"5-out16910"	.00900	2	220	222
5	"5-out16912"	.01506	5	327	332
5	"5-out16916"	.00226	2	881	883
5	"5-out16918"	.01126	4	351	355
5	"5-out16920"	.02469	2	79	81
5	"5-out16922"	.01169	4	338	342
5	"5-out16923"	.02571	9	341	350
5	"5-out16927"	.00842	8	942	950
5	"5-out16929"	.00632	3	471	474
5	"5-out16932"	.00934	4	424	428
5	"5-out16938"	.04360	15	329	344
5	"5-out16940"	.00354	3	844	847
5	"5-out16944"	.01030	4	384	388
5	"5-out16945"	.00357	2	558	560
5	"5-out16946"	.00990	4	400	404
5	"5-out16947"	.01428	3	207	210
5	"5-out16948"	.00718	6	829	835
5	"5-out16955"	.01937	5	253	258
5	"5-out16958"	.00790	4	502	506
5	"5-out16959"	.00337	2	590	592
5	"5-out16960"	.00467	8	1702	1710
5	"5-out16963"	.00430	2	463	465
5	"5-out16965"	.01115	3	266	269
5	"5-out16968"	.00775	2	256	258
5	"5-out16969"	.00581	2	342	344
5	"5-out16970"	.04194	25	571	596
5	"5-out16971"	.03754	11	282	293
5	"5-out16972"	.00265	8	3006	3014
5	"5-out16973"	.03244	11	328	339
5	"5-out16975"	.00259	7	2694	2701
5	"5-out16979"	.01393	4	283	287
5	"5-out16981"	.01639	4	240	244
5	"5-out16982"	.01328	4	297	301
5	"5-out16984"	.00348	4	1145	1149
5	"5-out16986"	.01275	5	387	392
5	"5-out16987"	.00643	4	618	622
5	"5-out16988"	.00257	7	2708	2715
5	"5-out16989"	.01127	6	526	532
5	"5-out16990"	.01227	38	3058	3096
5	"5-out16995"	.00369	2	540	542
5	"5-out17002"	.00347	2	573	575
5	"5-out17004"	.00180	2	1105	1107
5	"5-out17005"	.00852	4	465	469
5	"5-out17008"	.00087	2	2284	2286
5	"5-out17009"	.00379	2	525	527
5	"5-out17012"	.00322	4	1235	1239
5	"5-out17013"	.00618	3	482	485
5	"5-out17014"	.00273	4	1458	1462
5	"5-out17017"	.00404	2	492	494
5	"5-out17018"	.00444	4	896	900
5	"5-out17019"	.00929	5	533	538
5	"5-out17020"	.00505	8	1576	1584
5	"5-out17021"	.07594	6	73	79
5	"5-out17022"	.01630	9	543	552
5	"5-out17023"	.01846	6	319	325
5	"5-out17024"	.01073	7	645	652
5	"5-out17025"	.00555	2	358	360
5	"5-out17027"	.00271	2	734	736
5	"5-out17028"	.00657	6	906	912
5	"5-out17031"	.00317	5	1572	1577
5	"5-out17036"	.01385	5	356	361
5	"5-out17037"	.02649	8	294	302
5	"5-out17041"	.01098	3	270	273
5	"5-out17042"	.00594	13	2173	2186
5	"5-out17043"	.00868	18	2055	2073
5	"5-out17045"	.00485	2	410	412
5	"5-out17046"	.00214	4	1861	1865
5	"5-out17047"	.00327	6	1824	1830
5	"5-out17048"	.00147	3	2027	2030
5	"5-out17049"	.00254	5	1961	1966
5	"5-out17050"	.00427	8	1862	1870
5	"5-out17052"	.00093	2	2138	2140
5	"5-out17054"	.00096	2	2067	2069
5	"5-out17056"	.00831	4	477	481
5	"5-out17061"	.00604	2	329	331
5	"5-out17064"	.00706	4	562	566
5	"5-out17066"	.00087	2	2296	2298
5	"5-out17067"	.05084	6	112	118
5	"5-out17070"	.00260	4	1533	1537
5	"5-out17073"	.00564	4	705	709
5	"5-out17075"	.03252	4	119	123
5	"5-out17077"	.02325	6	252	258
5	"5-out17080"	.02676	11	400	411
5	"5-out17085"	.00451	2	441	443
5	"5-out17089"	.00701	2	283	285
5	"5-out17091"	.02654	12	440	452
5	"5-out17092"	.00769	2	258	260
5	"5-out17096"	.00714	2	278	280
5	"5-out17098"	.03571	4	108	112
5	"5-out17101"	.00431	2	462	464
5	"5-out17102"	.00452	2	440	442
5	"5-out17105"	.11068	29	233	262
5	"5-out17106"	.00819	2	242	244
5	"5-out17107"	.01139	8	694	702
5	"5-out17109"	.00536	2	371	373
5	"5-out17110"	.00961	4	412	416
5	"5-out17112"	.00264	2	754	756
5	"5-out17114"	.05263	3	54	57
5	"5-out17115"	.00309	2	645	647
5	"5-out17116"	.00384	2	518	520
5	"5-out17118"	.00262	2	760	762
5	"5-out17120"	.00782	6	761	767
5	"5-out17121"	.00749	2	265	267
5	"5-out17123"	.00778	4	510	514
5	"5-out17124"	.00261	2	762	764
5	"5-out17126"	.01515	2	130	132
5	"5-out17127"	.01310	3	226	229
5	"5-out17129"	.02608	6	224	230
5	"5-out17131"	.01069	2	185	187
5	"5-out17134"	.01709	2	115	117
5	"5-out17137"	.00566	2	351	353
5	"5-out17138"	.00271	2	735	737
5	"5-out17139"	.00252	12	4741	4753
5	"5-out17141"	.01058	2	187	189
5	"5-out17146"	.01581	4	249	253
5	"5-out17149"	.00198	2	1007	1009
5	"5-out17150"	.00219	2	909	911
5	"5-out17152"	.02197	4	178	182
5	"5-out17154"	.00485	6	1231	1237
5	"5-out17155"	.01183	2	167	169
5	"5-out17158"	.01369	2	144	146
5	"5-out17160"	.02314	5	211	216
5	"5-out17162"	.00344	2	578	580
5	"5-out17165"	.00221	2	899	901
5	"5-out17166"	.00223	2	894	896
5	"5-out17167"	.00099	2	2010	2012
5	"5-out17168"	.00097	2	2051	2053
5	"5-out17170"	.01694	2	116	118
5	"5-out17173"	.02684	4	145	149
5	"5-out17174"	.00742	9	1203	1212
5	"5-out17175"	.01148	11	947	958
5	"5-out17176"	.00571	6	1043	1049
5	"5-out17177"	.00626	7	1111	1118
5	"5-out17181"	.00153	2	1299	1301
5	"5-out17185"	.00512	4	777	781
5	"5-out17186"	.00273	2	728	730
5	"5-out17187"	.00269	2	741	743
5	"5-out17188"	.00318	2	625	627
5	"5-out17189"	.00657	2	302	304
5	"5-out17190"	.00671	2	296	298
5	"5-out17191"	.00806	5	615	620
5	"5-out17192"	.01650	7	417	424
5	"5-out17193"	.01650	7	417	424
5	"5-out17194"	.01658	7	415	422
5	"5-out17195"	.01650	7	417	424
5	"5-out17196"	.01650	7	417	424
5	"5-out17197"	.01650	7	417	424
5	"5-out17198"	.01031	16	1535	1551
5	"5-out17199"	.01033	16	1532	1548
5	"5-out17200"	.01052	2	188	190
5	"5-out17202"	.01354	6	437	443
5	"5-out17208"	.00520	2	382	384
5	"5-out17209"	.00727	2	273	275
5	"5-out17210"	.00368	2	541	543
5	"5-out17212"	.01076	13	1195	1208
5	"5-out17213"	.02657	8	293	301
5	"5-out17215"	.00415	6	1437	1443
5	"5-out17220"	.00495	2	402	404
5	"5-out17222"	.00302	2	659	661
5	"5-out17223"	.00263	2	757	759
5	"5-out17224"	.00465	7	1498	1505
5	"5-out17225"	.00403	6	1480	1486
5	"5-out17228"	.00689	2	288	290
5	"5-out17230"	.05263	7	126	133
5	"5-out17231"	.01801	2	109	111
5	"5-out17233"	.00532	8	1495	1503
5	"5-out17235"	.00680	2	292	294
5	"5-out17237"	.01951	4	201	205
5	"5-out17238"	.00461	2	431	433
5	"5-out17242"	.00455	2	437	439
5	"5-out17246"	.04201	5	114	119
5	"5-out17248"	.00701	4	566	570
5	"5-out17249"	.01052	2	188	190
5	"5-out17254"	.00636	2	312	314
5	"5-out17256"	.01515	4	260	264
5	"5-out17260"	.00592	4	671	675
5	"5-out17261"	.00452	2	440	442
5	"5-out17264"	.01269	8	622	630
5	"5-out17265"	.01328	4	297	301
5	"5-out17267"	.00667	11	1638	1649
5	"5-out17269"	.00590	3	505	508
5	"5-out17270"	.00900	4	440	444
5	"5-out17271"	.02285	4	171	175
5	"5-out17275"	.05194	4	73	77
5	"5-out17276"	.01923	4	204	208
5	"5-out17278"	.03212	8	241	249
5	"5-out17280"	.00353	3	845	848
5	"5-out17281"	.00315	2	632	634
5	"5-out17285"	.00761	5	652	657
5	"5-out17289"	.00337	2	591	593
5	"5-out17290"	.00205	2	970	972
5	"5-out17291"	.01538	4	256	260
5	"5-out17293"	.00239	2	834	836
5	"5-out17299"	.00735	2	270	272
5	"5-out17301"	.00172	4	2318	2322
5	"5-out17303"	.00776	5	639	644
5	"5-out17304"	.00239	2	834	836
5	"5-out17305"	.00249	2	800	802
5	"5-out17308"	.01369	2	144	146
5	"5-out17310"	.01728	13	739	752
5	"5-out17311"	.01156	4	342	346
5	"5-out17313"	.00205	3	1457	1460
5	"5-out17315"	.01162	4	340	344
5	"5-out17316"	.00278	4	1431	1435
5	"5-out17319"	.04048	10	237	247
5	"5-out17320"	.01040	13	1237	1250
5	"5-out17321"	.00574	3	519	522
5	"5-out17324"	.02484	4	157	161
5	"5-out17328"	.01418	2	139	141
5	"5-out17330"	.01339	3	221	224
5	"5-out17331"	.01151	6	515	521
5	"5-out17333"	.00197	2	1010	1012
5	"5-out17334"	.00432	2	460	462
5	"5-out17336"	.04453	22	472	494
5	"5-out17337"	.00763	4	520	524
5	"5-out17338"	.00288	6	2074	2080
5	"5-out17339"	.02135	11	504	515
5	"5-out17340"	.00346	2	576	578
5	"5-out17343"	.01060	6	560	566
5	"5-out17345"	.00384	2	518	520
5	"5-out17347"	.01174	6	505	511
5	"5-out17349"	.00374	2	532	534
5	"5-out17350"	.01193	5	414	419
5	"5-out17352"	.00484	2	411	413
5	"5-out17357"	.00639	5	777	782
5	"5-out17358"	.01442	3	205	208
5	"5-out17359"	.03734	18	464	482
5	"5-out17361"	.08510	8	86	94
5	"5-out17362"	.00385	2	517	519
5	"5-out17363"	.03225	6	180	186
5	"5-out17367"	.00711	2	279	281
5	"5-out17368"	.01990	4	197	201
5	"5-out17369"	.00312	2	637	639
5	"5-out17370"	.00684	2	290	292
5	"5-out17375"	.00157	4	2533	2537
5	"5-out17378"	.00182	2	1092	1094
5	"5-out17379"	.00256	8	3109	3117
5	"5-out17380"	.02641	7	258	265
5	"5-out17381"	.01739	8	452	460
5	"5-out17382"	.00740	2	268	270
5	"5-out17383"	.00310	4	1283	1287
5	"5-out17384"	.00411	2	484	486
5	"5-out17387"	.00060	2	3310	3312
5	"5-out17394"	.00477	2	417	419
5	"5-out17395"	.02542	3	115	118
5	"5-out17398"	.00350	4	1137	1141
5	"5-out17399"	.03174	4	122	126
5	"5-out17400"	.00597	3	499	502
5	"5-out17401"	.00389	2	512	514
5	"5-out17405"	.02504	13	506	519
5	"5-out17406"	.02584	13	490	503
5	"5-out17407"	.00255	2	780	782
5	"5-out17410"	.01357	3	218	221
5	"5-out17411"	.04964	7	134	141
5	"5-out17415"	.04210	4	91	95
5	"5-out17419"	.00722	2	275	277
5	"5-out17420"	.00241	3	1238	1241
5	"5-out17422"	.02040	8	384	392
5	"5-out17423"	.00888	2	223	225
5	"5-out17426"	.00669	3	445	448
5	"5-out17427"	.00835	4	475	479
5	"5-out17428"	.00501	2	397	399
5	"5-out17432"	.00281	3	1061	1064
5	"5-out17434"	.00155	2	1284	1286
5	"5-out17436"	.03571	3	81	84
5	"5-out17438"	.02077	8	377	385
5	"5-out17439"	.02272	2	86	88
5	"5-out17440"	.00210	2	950	952
5	"5-out17443"	.00149	2	1334	1336
5	"5-out17445"	.00496	2	401	403
5	"5-out17447"	.04746	15	301	316
5	"5-out17450"	.00409	7	1702	1709
5	"5-out17451"	.00197	2	1011	1013
5	"5-out17453"	.00309	5	1613	1618
5	"5-out17454"	.00162	3	1846	1849
5	"5-out17455"	.00572	10	1737	1747
5	"5-out17456"	.00252	3	1187	1190
5	"5-out17457"	.00342	2	582	584
5	"5-out17459"	.00404	2	492	494
5	"5-out17460"	.00439	22	4983	5005
5	"5-out17461"	.00500	2	398	400
5	"5-out17462"	.00422	2	471	473
5	"5-out17464"	.00925	4	428	432
5	"5-out17466"	.00930	4	426	430
5	"5-out17467"	.00354	2	562	564
5	"5-out17468"	.00354	2	562	564
5	"5-out17469"	.00677	8	1172	1180
5	"5-out17475"	.00190	2	1047	1049
5	"5-out17476"	.00268	2	744	746
5	"5-out17477"	.00570	4	697	701
5	"5-out17481"	.00495	2	402	404
5	"5-out17483"	.01092	4	362	366
5	"5-out17484"	.00331	2	601	603
5	"5-out17485"	.01632	4	241	245
5	"5-out17486"	.01322	5	373	378
5	"5-out17487"	.01322	5	373	378
5	"5-out17488"	.01229	3	241	244
5	"5-out17489"	.00819	2	242	244
5	"5-out17492"	.02325	3	126	129
5	"5-out17494"	.00573	9	1559	1568
5	"5-out17495"	.02409	4	162	166
5	"5-out17497"	.01421	6	416	422
5	"5-out17498"	.00603	4	659	663
5	"5-out17502"	.03921	2	49	51
5	"5-out17507"	.00310	2	642	644
5	"5-out17513"	.01724	2	114	116
5	"5-out17515"	.04395	12	261	273
5	"5-out17516"	.01785	6	330	336
5	"5-out17519"	.00209	2	953	955
5	"5-out17520"	.00211	2	944	946
5	"5-out17521"	.00292	2	681	683
5	"5-out17523"	.00469	2	424	426
5	"5-out17526"	.02631	2	74	76
5	"5-out17527"	.02403	10	406	416
5	"5-out17528"	.00205	2	973	975
5	"5-out17529"	.00311	3	960	963
5	"5-out17530"	.00185	2	1079	1081
5	"5-out17531"	.00963	10	1028	1038
5	"5-out17532"	.00867	9	1028	1037
5	"5-out17533"	.00975	2	203	205
5	"5-out17535"	.01221	6	485	491
5	"5-out17539"	.02422	7	282	289
5	"5-out17540"	.01466	12	806	818
5	"5-out17543"	.01219	2	162	164
5	"5-out17545"	.02702	4	144	148
5	"5-out17547"	.01397	7	494	501
5	"5-out17549"	.00676	8	1174	1182
5	"5-out17552"	.00355	2	561	563
5	"5-out17553"	.00884	7	784	791
5	"5-out17557"	.00287	2	694	696
5	"5-out17558"	.00728	5	681	686
5	"5-out17560"	.00149	2	1336	1338
5	"5-out17561"	.00763	3	390	393
5	"5-out17565"	.02325	2	84	86
5	"5-out17573"	.01709	2	115	117
5	"5-out17576"	.00583	2	341	343
5	"5-out17577"	.00739	5	671	676
5	"5-out17578"	.04273	5	112	117
5	"5-out17580"	.05000	6	114	120
5	"5-out17581"	.01893	5	259	264
5	"5-out17582"	.00714	3	417	420
5	"5-out17583"	.00468	2	425	427
5	"5-out17584"	.01709	2	115	117
5	"5-out17586"	.01168	7	592	599
5	"5-out17589"	.00778	4	510	514
5	"5-out17590"	.00400	5	1244	1249
5	"5-out17591"	.00613	3	486	489
5	"5-out17594"	.02666	16	584	600
5	"5-out17595"	.00394	2	505	507
5	"5-out17596"	.00325	2	613	615
5	"5-out17598"	.00599	4	663	667
5	"5-out17599"	.01118	5	442	447
5	"5-out17600"	.00404	2	492	494
5	"5-out17602"	.00346	4	1150	1154
5	"5-out17603"	.01015	4	390	394
5	"5-out17604"	.01867	13	683	696
5	"5-out17605"	.00935	7	741	748
5	"5-out17606"	.00508	6	1173	1179
5	"5-out17607"	.00598	7	1163	1170
5	"5-out17609"	.00984	22	2213	2235
5	"5-out17611"	.00186	2	1068	1070
5	"5-out17612"	.00874	9	1020	1029
5	"5-out17614"	.00333	4	1196	1200
5	"5-out17616"	.00438	2	454	456
5	"5-out17617"	.00354	2	562	564
5	"5-out17619"	.01442	6	410	416
5	"5-out17620"	.00190	4	2099	2103
5	"5-out17621"	.00370	2	538	540
5	"5-out17622"	.00346	2	576	578
5	"5-out17629"	.00400	2	498	500
5	"5-out17630"	.00508	9	1762	1771
5	"5-out17631"	.00790	4	502	506
5	"5-out17632"	.00118	2	1688	1690
5	"5-out17634"	.01906	9	463	472
5	"5-out17636"	.01572	5	313	318
5	"5-out17637"	.00638	7	1090	1097
5	"5-out17638"	.00480	5	1036	1041
5	"5-out17639"	.00975	2	203	205
5	"5-out17640"	.02970	6	196	202
5	"5-out17641"	.00342	2	582	584
5	"5-out17642"	.02608	12	448	460
5	"5-out17649"	.00091	2	2172	2174
5	"5-out17650"	.00943	2	210	212
5	"5-out17653"	.00365	5	1363	1368
5	"5-out17657"	.03367	10	287	297
5	"5-out17658"	.01152	4	343	347
5	"5-out17659"	.01978	11	545	556
5	"5-out17660"	.00664	6	897	903
5	"5-out17661"	.00473	4	840	844
5	"5-out17663"	.01342	4	294	298
5	"5-out17664"	.01542	12	766	778
5	"5-out17665"	.00431	2	461	463
5	"5-out17669"	.00196	2	1015	1017
5	"5-out17670"	.00404	4	984	988
5	"5-out17671"	.00402	4	990	994
5	"5-out17674"	.00969	12	1226	1238
5	"5-out17676"	.00441	5	1127	1132
5	"5-out17677"	.00485	4	820	824
5	"5-out17679"	.01273	8	620	628
5	"5-out17682"	.00373	4	1068	1072
5	"5-out17686"	.01143	9	778	787
5	"5-out17687"	.00719	13	1793	1806
5	"5-out17688"	.00312	4	1275	1279
5	"5-out17689"	.00279	2	714	716
5	"5-out17690"	.00641	3	465	468
5	"5-out17694"	.00630	4	630	634
5	"5-out17698"	.00384	2	518	520
5	"5-out17702"	.00374	2	532	534
5	"5-out17703"	.00986	3	301	304
5	"5-out17708"	.00778	2	255	257
5	"5-out17710"	.01384	4	285	289
5	"5-out17713"	.00715	3	416	419
5	"5-out17714"	.00234	2	850	852
5	"5-out17715"	.00378	4	1052	1056
5	"5-out17718"	.00641	10	1550	1560
5	"5-out17720"	.02749	8	283	291
5	"5-out17721"	.02730	8	285	293
5	"5-out17722"	.00431	6	1384	1390
5	"5-out17724"	.00790	4	502	506
5	"5-out17726"	.01214	9	732	741
5	"5-out17727"	.00684	2	290	292
5	"5-out17729"	.00262	2	760	762
5	"5-out17730"	.01680	2	117	119
5	"5-out17731"	.00346	2	576	578
5	"5-out17732"	.00200	2	997	999
5	"5-out17733"	.01694	2	116	118
5	"5-out17734"	.01680	2	117	119
5	"5-out17736"	.01612	6	366	372
5	"5-out17737"	.01092	4	362	366
5	"5-out17740"	.00483	2	412	414
5	"5-out17743"	.01454	8	542	550
5	"5-out17746"	.00564	7	1234	1241
5	"5-out17747"	.03463	8	223	231
5	"5-out17749"	.02845	7	239	246
5	"5-out17750"	.00764	6	779	785
5	"5-out17755"	.01436	8	549	557
5	"5-out17762"	.00990	3	300	303
5	"5-out17763"	.00190	2	1049	1051
5	"5-out17764"	.00505	6	1182	1188
5	"5-out17765"	.01015	8	780	788
5	"5-out17766"	.00176	2	1128	1130
5	"5-out17767"	.00381	2	522	524
5	"5-out17768"	.00428	2	465	467
5	"5-out17771"	.00416	2	478	480
5	"5-out17772"	.00415	2	479	481
5	"5-out17775"	.00448	2	444	446
5	"5-out17777"	.00407	2	489	491
5	"5-out17778"	.00285	16	5580	5596
5	"5-out17780"	.02424	4	161	165
5	"5-out17782"	.01146	4	345	349
5	"5-out17783"	.00156	2	1278	1280
5	"5-out17786"	.01951	4	201	205
5	"5-out17788"	.00854	2	232	234
5	"5-out17789"	.01459	4	270	274
5	"5-out17790"	.02513	9	349	358
5	"5-out17792"	.00536	2	371	373
5	"5-out17793"	.01561	34	2143	2177
5	"5-out17794"	.01876	7	366	373
5	"5-out17796"	.01866	7	368	375
5	"5-out17798"	.00333	2	598	600
5	"5-out17799"	.00237	2	840	842
5	"5-out17800"	.00903	11	1207	1218
5	"5-out17801"	.00236	6	2534	2540
5	"5-out17802"	.00193	2	1033	1035
5	"5-out17803"	.01119	13	1148	1161
5	"5-out17806"	.00286	3	1045	1048
5	"5-out17807"	.01449	2	136	138
5	"5-out17808"	.05200	13	237	250
5	"5-out17809"	.00415	4	958	962
5	"5-out17810"	.01222	5	404	409
5	"5-out17811"	.00515	2	386	388
5	"5-out17812"	.06837	8	109	117
5	"5-out17813"	.03389	4	114	118
5	"5-out17817"	.09401	11	106	117
5	"5-out17820"	.00432	4	920	924
5	"5-out17821"	.01687	4	233	237
5	"5-out17823"	.00176	4	2262	2266
5	"5-out17824"	.01221	12	970	982
5	"5-out17826"	.00686	7	1012	1019
5	"5-out17828"	.01724	2	114	116
5	"5-out17829"	.02643	6	221	227
5	"5-out17830"	.01762	4	223	227
5	"5-out17831"	.00275	2	725	727
5	"5-out17835"	.00449	7	1549	1556
5	"5-out17840"	.00303	2	656	658
5	"5-out17841"	.01453	14	949	963
5	"5-out17843"	.00318	3	939	942
5	"5-out17844"	.00281	3	1062	1065
5	"5-out17845"	.00093	2	2143	2145
5	"5-out17848"	.00836	5	593	598
5	"5-out17852"	.00696	2	285	287
5	"5-out17853"	.00207	2	961	963
5	"5-out17854"	.00537	8	1480	1488
5	"5-out17855"	.00190	3	1572	1575
5	"5-out17857"	.00983	7	705	712
5	"5-out17858"	.00320	2	623	625
5	"5-out17859"	.00345	2	577	579
5	"5-out17860"	.00231	3	1294	1297
5	"5-out17861"	.00144	2	1380	1382
5	"5-out17863"	.02816	6	207	213
5	"5-out17865"	.00182	4	2186	2190
5	"5-out17867"	.00300	3	996	999
5	"5-out17868"	.02762	5	176	181
5	"5-out17869"	.03212	8	241	249
5	"5-out17870"	.01644	5	299	304
5	"5-out17871"	.00569	2	349	351
5	"5-out17872"	.00497	11	2199	2210
5	"5-out17873"	.03278	14	413	427
5	"5-out17875"	.00159	2	1255	1257
5	"5-out17876"	.00798	4	497	501
5	"5-out17878"	.00700	5	709	714
5	"5-out17879"	.00325	4	1226	1230
5	"5-out17883"	.00253	4	1577	1581
5	"5-out17884"	.00512	2	388	390
5	"5-out17887"	.00774	6	769	775
5	"5-out17888"	.02071	15	709	724
5	"5-out17889"	.00624	4	637	641
5	"5-out17890"	.02392	10	408	418
5	"5-out17892"	.01680	2	117	119
5	"5-out17893"	.02564	3	114	117
5	"5-out17898"	.00346	2	576	578
5	"5-out17900"	.00806	2	246	248
5	"5-out17901"	.00566	2	351	353
5	"5-out17905"	.00829	4	478	482
5	"5-out17907"	.00696	12	1710	1722
5	"5-out17909"	.01000	4	396	400
5	"5-out17910"	.00668	2	297	299
5	"5-out17912"	.01269	4	311	315
5	"5-out17913"	.00877	2	226	228
5	"5-out17915"	.01058	2	187	189
5	"5-out17916"	.02116	4	185	189
5	"5-out17918"	.01346	8	586	594
5	"5-out17919"	.01000	2	198	200
5	"5-out17920"	.01020	2	194	196
5	"5-out17924"	.01105	9	805	814
5	"5-out17926"	.07258	9	115	124
5	"5-out17927"	.00159	2	1249	1251
5	"5-out17928"	.01822	7	377	384
5	"5-out17930"	.01886	2	104	106
5	"5-out17932"	.04825	18	355	373
5	"5-out17933"	.00221	2	901	903
5	"5-out17935"	.00299	4	1332	1336
5	"5-out17936"	.00837	10	1184	1194
5	"5-out17937"	.01228	5	402	407
5	"5-out17938"	.02725	13	464	477
5	"5-out17939"	.01090	9	816	825
5	"5-out17942"	.00925	5	535	540
5	"5-out17944"	.00673	4	590	594
5	"5-out17948"	.02777	4	140	144
5	"5-out17949"	.00357	2	558	560
5	"5-out17951"	.00448	3	666	669
5	"5-out17953"	.01851	2	106	108
5	"5-out17954"	.00853	6	697	703
5	"5-out17958"	.05128	6	111	117
5	"5-out17959"	.05128	6	111	117
5	"5-out17961"	.08287	60	664	724
5	"5-out17962"	.00578	2	344	346
5	"5-out17963"	.02857	7	238	245
5	"5-out17965"	.00126	2	1584	1586
5	"5-out17966"	.00751	2	264	266
5	"5-out17968"	.03200	4	121	125
5	"5-out17969"	.00613	2	324	326
5	"5-out17970"	.02985	10	325	335
5	"5-out17972"	.01219	2	162	164
5	"5-out17974"	.03174	12	366	378
5	"5-out17975"	.00831	5	596	601
5	"5-out17976"	.00476	2	418	420
5	"5-out17977"	.01525	14	904	918
5	"5-out17981"	.01388	2	142	144
5	"5-out17982"	.00366	2	544	546
5	"5-out17985"	.01440	5	342	347
5	"5-out17986"	.01367	10	721	731
5	"5-out17987"	.00833	5	595	600
5	"5-out17988"	.01034	9	861	870
5	"5-out17989"	.01194	4	331	335
5	"5-out17990"	.00789	3	377	380
5	"5-out17991"	.00411	5	1210	1215
5	"5-out17993"	.01133	4	349	353
5	"5-out17994"	.01183	4	334	338
5	"5-out17995"	.00495	2	402	404
5	"5-out17996"	.00600	2	331	333
5	"5-out17997"	.00984	7	704	711
5	"5-out17999"	.00784	4	506	510
5	"5-out18005"	.02857	2	68	70
5	"5-out18006"	.00675	4	588	592
5	"5-out18007"	.01250	8	632	640
5	"5-out18009"	.02985	2	65	67
5	"5-out18011"	.00585	3	509	512
5	"5-out18012"	.00475	8	1676	1684
5	"5-out18013"	.00598	2	332	334
5	"5-out18014"	.02512	5	194	199
5	"5-out18017"	.01941	4	202	206
5	"5-out18019"	.00873	2	227	229
5	"5-out18020"	.00875	4	453	457
5	"5-out18023"	.00641	3	465	468
5	"5-out18024"	.04222	22	499	521
5	"5-out18025"	.00527	2	377	379
5	"5-out18026"	.00442	2	450	452
5	"5-out18027"	.03597	20	536	556
5	"5-out18028"	.00521	3	572	575
5	"5-out18029"	.00921	4	430	434
5	"5-out18032"	.01142	15	1298	1313
5	"5-out18036"	.00826	2	240	242
5	"5-out18037"	.00806	2	246	248
5	"5-out18038"	.00213	4	1867	1871
5	"5-out18040"	.00323	2	616	618
5	"5-out18041"	.01041	6	570	576
5	"5-out18042"	.00495	6	1206	1212
5	"5-out18045"	.02852	19	647	666
5	"5-out18048"	.01724	6	342	348
5	"5-out18052"	.00386	4	1031	1035
5	"5-out18055"	.01015	4	390	394
5	"5-out18058"	.02752	3	106	109
5	"5-out18059"	.06736	45	623	668
5	"5-out18060"	.00198	3	1505	1508
5	"5-out18063"	.01250	2	158	160
5	"5-out18065"	.00673	4	590	594
5	"5-out18067"	.00630	2	315	317
5	"5-out18072"	.01234	2	160	162
5	"5-out18076"	.00350	2	568	570
5	"5-out18078"	.00361	2	551	553
5	"5-out18079"	.00378	2	527	529
5	"5-out18082"	.00351	2	567	569
5	"5-out18086"	.01754	3	168	171
5	"5-out18088"	.00715	4	555	559
5	"5-out18089"	.01897	7	362	369
5	"5-out18090"	.00675	2	294	296
5	"5-out18091"	.00652	4	609	613
5	"5-out18092"	.01410	9	629	638
5	"5-out18095"	.00877	2	226	228
5	"5-out18097"	.01058	2	187	189
5	"5-out18104"	.00657	2	302	304
5	"5-out18105"	.00591	4	672	676
5	"5-out18108"	.00563	2	353	355
5	"5-out18109"	.00595	2	334	336
5	"5-out18110"	.02262	5	216	221
5	"5-out18112"	.00813	2	244	246
5	"5-out18113"	.00338	2	588	590
5	"5-out18114"	.00217	2	916	918
5	"5-out18115"	.02463	5	198	203
5	"5-out18119"	.00232	4	1717	1721
5	"5-out18120"	.00896	4	442	446
5	"5-out18121"	.00468	4	850	854
5	"5-out18125"	.00808	3	368	371
5	"5-out18129"	.02259	4	173	177
5	"5-out18131"	.00223	2	892	894
5	"5-out18133"	.00535	12	2229	2241
5	"5-out18134"	.05072	7	131	138
5	"5-out18135"	.00477	2	417	419
5	"5-out18137"	.01377	7	501	508
5	"5-out18142"	.00649	3	459	462
5	"5-out18146"	.01479	14	932	946
5	"5-out18147"	.00224	2	888	890
5	"5-out18148"	.00430	4	926	930
5	"5-out18152"	.01488	5	331	336
5	"5-out18153"	.01916	6	307	313
5	"5-out18155"	.00371	2	537	539
5	"5-out18157"	.01757	10	559	569
5	"5-out18160"	.01382	3	214	217
5	"5-out18161"	.01796	3	164	167
5	"5-out18162"	.02479	6	236	242
5	"5-out18164"	.00365	2	545	547
5	"5-out18166"	.01886	2	104	106
5	"5-out18167"	.00195	2	1019	1021
5	"5-out18173"	.01046	7	662	669
5	"5-out18181"	.02249	13	565	578
5	"5-out18182"	.00296	2	673	675
5	"5-out18186"	.00332	3	899	902
5	"5-out18190"	.00376	3	794	797
5	"5-out18191"	.00320	2	623	625
5	"5-out18193"	.03532	13	355	368
5	"5-out18195"	.00330	3	905	908
5	"5-out18196"	.01359	13	943	956
5	"5-out18199"	.00589	4	675	679
5	"5-out18200"	.00185	5	2696	2701
5	"5-out18201"	.00581	2	342	344
5	"5-out18202"	.00416	2	478	480
5	"5-out18203"	.00595	2	334	336
5	"5-out18204"	.00648	11	1686	1697
5	"5-out18205"	.00332	5	1497	1502
5	"5-out18206"	.00757	2	262	264
5	"5-out18207"	.00344	3	869	872
5	"5-out18208"	.00319	2	624	626
5	"5-out18212"	.01365	4	289	293
5	"5-out18218"	.00413	2	482	484
5	"5-out18219"	.00836	2	237	239
5	"5-out18221"	.01432	5	344	349
5	"5-out18222"	.00729	2	272	274
5	"5-out18227"	.02739	26	923	949
5	"5-out18232"	.00608	3	490	493
5	"5-out18233"	.01223	4	323	327
5	"5-out18234"	.01333	4	296	300
5	"5-out18238"	.00415	3	719	722
5	"5-out18239"	.03658	6	158	164
5	"5-out18243"	.00860	5	576	581
5	"5-out18244"	.00625	4	635	639
5	"5-out18245"	.00451	2	441	443
5	"5-out18246"	.00334	2	596	598
5	"5-out18248"	.00917	3	324	327
5	"5-out18250"	.02631	5	185	190
5	"5-out18252"	.00757	3	393	396
5	"5-out18254"	.01426	12	829	841
5	"5-out18255"	.01345	6	440	446
5	"5-out18257"	.00165	2	1209	1211
5	"5-out18259"	.00564	2	352	354
5	"5-out18260"	.02675	27	982	1009
5	"5-out18265"	.00158	2	1257	1259
5	"5-out18266"	.00966	4	410	414
5	"5-out18267"	.00145	4	2754	2758
5	"5-out18268"	.00224	6	2665	2671
5	"5-out18271"	.00244	2	817	819
5	"5-out18272"	.00486	2	409	411
5	"5-out18273"	.01659	4	237	241
5	"5-out18275"	.00823	2	241	243
5	"5-out18277"	.01202	12	986	998
5	"5-out18279"	.05802	47	763	810
5	"5-out18284"	.02209	4	177	181
5	"5-out18285"	.01719	7	400	407
5	"5-out18286"	.00125	2	1597	1599
5	"5-out18287"	.00126	2	1583	1585
5	"5-out18290"	.00679	6	877	883
5	"5-out18291"	.00505	3	590	593
5	"5-out18293"	.01639	4	240	244
5	"5-out18294"	.00406	2	490	492
5	"5-out18295"	.00704	2	282	284
5	"5-out18298"	.01250	3	237	240
5	"5-out18299"	.00447	3	668	671
5	"5-out18300"	.00153	4	2606	2610
5	"5-out18301"	.00435	7	1599	1606
5	"5-out18303"	.02455	29	1152	1181
5	"5-out18307"	.00340	2	585	587
5	"5-out18308"	.00480	2	414	416
5	"5-out18311"	.00986	3	301	304
5	"5-out18312"	.01670	7	412	419
5	"5-out18315"	.02670	18	656	674
5	"5-out18316"	.01754	12	672	684
5	"5-out18318"	.02373	8	329	337
5	"5-out18319"	.01186	4	333	337
5	"5-out18325"	.00391	2	509	511
5	"5-out18326"	.00477	2	417	419
5	"5-out18327"	.00540	2	368	370
5	"5-out18337"	.01025	4	386	390
5	"5-out18339"	.00716	2	277	279
5	"5-out18342"	.00591	2	336	338
5	"5-out18343"	.00432	2	460	462
5	"5-out18345"	.00923	3	322	325
5	"5-out18346"	.00760	2	261	263
5	"5-out18355"	.00881	2	225	227
5	"5-out18356"	.02690	6	217	223
5	"5-out18357"	.00288	2	691	693
5	"5-out18358"	.02150	2	91	93
5	"5-out18359"	.01145	7	604	611
5	"5-out18363"	.00164	2	1213	1215
5	"5-out18364"	.00420	4	948	952
5	"5-out18365"	.00348	3	858	861
5	"5-out18366"	.00395	4	1007	1011
5	"5-out18367"	.01578	9	561	570
5	"5-out18370"	.00312	2	638	640
5	"5-out18371"	.00408	2	488	490
5	"5-out18381"	.00376	2	529	531
5	"5-out18382"	.04501	28	594	622
5	"5-out18383"	.00307	4	1295	1299
5	"5-out18384"	.01123	7	616	623
5	"5-out18385"	.02000	5	245	250
5	"5-out18388"	.03960	36	873	909
5	"5-out18389"	.00522	3	571	574
5	"5-out18390"	.00306	2	650	652
5	"5-out18391"	.00360	3	830	833
5	"5-out18392"	.00479	2	415	417
5	"5-out18393"	.02727	3	107	110
5	"5-out18394"	.04201	5	114	119
5	"5-out18396"	.00588	2	338	340
5	"5-out18397"	.01326	5	372	377
5	"5-out18398"	.01103	5	448	453
5	"5-out18399"	.01886	2	104	106
5	"5-out18403"	.00361	2	551	553
5	"5-out18411"	.02343	3	125	128
5	"5-out18412"	.00341	2	583	585
5	"5-out18414"	.01123	2	176	178
5	"5-out18415"	.02564	2	76	78
5	"5-out18416"	.01369	2	144	146
5	"5-out18421"	.01226	2	161	163
5	"5-out18422"	.00369	2	539	541
5	"5-out18423"	.00723	4	549	553
5	"5-out18424"	.00502	2	396	398
5	"5-out18427"	.00635	4	625	629
5	"5-out18428"	.02057	5	238	243
5	"5-out18432"	.00819	6	726	732
5	"5-out18433"	.02991	7	227	234
5	"5-out18434"	.00740	2	268	270
5	"5-out18435"	.00402	2	495	497
5	"5-out18436"	.01834	4	214	218
5	"5-out18437"	.00445	4	893	897
5	"5-out18440"	.00328	2	606	608
5	"5-out18442"	.00988	6	601	607
5	"5-out18443"	.01704	9	519	528
5	"5-out18445"	.00740	4	536	540
5	"5-out18446"	.00468	9	1914	1923
5	"5-out18448"	.01030	2	192	194
5	"5-out18449"	.00410	8	1941	1949
5	"5-out18450"	.00575	6	1037	1043
5	"5-out18454"	.00900	2	220	222
5	"5-out18455"	.01639	4	240	244
5	"5-out18458"	.00417	4	955	959
5	"5-out18459"	.00833	2	238	240
5	"5-out18460"	.02739	26	923	949
5	"5-out18462"	.00416	3	717	720
5	"5-out18463"	.00387	2	514	516
5	"5-out18464"	.00209	4	1907	1911
5	"5-out18466"	.02010	12	585	597
5	"5-out18467"	.00486	2	409	411
5	"5-out18468"	.00787	2	252	254
5	"5-out18471"	.00289	6	2067	2073
5	"5-out18476"	.00257	2	774	776
5	"5-out18477"	.00257	5	1937	1942
5	"5-out18478"	.00363	4	1097	1101
5	"5-out18479"	.01082	5	457	462
5	"5-out18480"	.02272	3	129	132
5	"5-out18481"	.01049	4	377	381
5	"5-out18482"	.02672	19	692	711
5	"5-out18484"	.00888	2	223	225
5	"5-out18485"	.02752	6	212	218
5	"5-out18489"	.00923	3	322	325
5	"5-out18490"	.00784	2	253	255
5	"5-out18492"	.00549	4	724	728
5	"5-out18494"	.01825	9	484	493
5	"5-out18500"	.00384	2	518	520
5	"5-out18501"	.00873	4	454	458
5	"5-out18506"	.00711	4	558	562
5	"5-out18507"	.00417	2	477	479
5	"5-out18508"	.02479	9	354	363
5	"5-out18511"	.00473	2	420	422
5	"5-out18513"	.00440	2	452	454
5	"5-out18517"	.02061	2	95	97
5	"5-out18530"	.00242	3	1233	1236
5	"5-out18533"	.00508	2	391	393
5	"5-out18536"	.00643	5	772	777
5	"5-out18537"	.00386	2	515	517
5	"5-out18538"	.02030	4	193	197
5	"5-out18542"	.00285	2	698	700
5	"5-out18543"	.00324	2	614	616
5	"5-out18544"	.03676	5	131	136
5	"5-out18545"	.02535	9	346	355
5	"5-out18550"	.00558	2	356	358
5	"5-out18551"	.03468	12	334	346
5	"5-out18552"	.01479	5	333	338
5	"5-out18553"	.02209	8	354	362
5	"5-out18559"	.00417	3	716	719
5	"5-out18560"	.00763	3	390	393
5	"5-out18561"	.02298	8	340	348
5	"5-out18566"	.01524	5	323	328
5	"5-out18567"	.00359	2	554	556
5	"5-out18568"	.00724	3	411	414
5	"5-out18570"	.00305	2	653	655
5	"5-out18571"	.00166	2	1196	1198
5	"5-out18572"	.03370	12	344	356
5	"5-out18573"	.07017	4	53	57
5	"5-out18576"	.01056	12	1124	1136
5	"5-out18577"	.01465	4	269	273
5	"5-out18578"	.00943	3	315	318
5	"5-out18581"	.05128	6	111	117
5	"5-out18582"	.05128	6	111	117
5	"5-out18583"	.05128	6	111	117
5	"5-out18584"	.00573	4	693	697
5	"5-out18585"	.00546	2	364	366
5	"5-out18586"	.01572	10	626	636
5	"5-out18587"	.01231	5	401	406
5	"5-out18588"	.00472	2	421	423
5	"5-out18589"	.01333	3	222	225
5	"5-out18590"	.00917	2	216	218
5	"5-out18594"	.01886	2	104	106
5	"5-out18595"	.00212	2	940	942
5	"5-out18596"	.00778	2	255	257
5	"5-out18599"	.00829	2	239	241
5	"5-out18601"	.02906	5	167	172
5	"5-out18603"	.00455	4	875	879
5	"5-out18612"	.01562	2	126	128
5	"5-out18623"	.01034	3	287	290
5	"5-out18624"	.00336	4	1185	1189
5	"5-out18625"	.00540	2	368	370
5	"5-out18626"	.01114	4	355	359
5	"5-out18631"	.00921	2	215	217
5	"5-out18632"	.00449	2	443	445
5	"5-out18633"	.00692	2	287	289
5	"5-out18637"	.02123	10	461	471
5	"5-out18639"	.00473	3	630	633
5	"5-out18640"	.04128	9	209	218
5	"5-out18641"	.05882	8	128	136
5	"5-out18644"	.00810	5	612	617
5	"5-out18647"	.00833	2	238	240
5	"5-out18648"	.05905	15	239	254
5	"5-out18649"	.01363	6	434	440
5	"5-out18654"	.00784	2	253	255
5	"5-out18655"	.09278	9	88	97
5	"5-out18657"	.02290	3	128	131
5	"5-out18664"	.01036	2	191	193
5	"5-out18665"	.01219	2	162	164
5	"5-out18670"	.00552	4	720	724
5	"5-out18671"	.00140	4	2846	2850
5	"5-out18673"	.01654	7	416	423
5	"5-out18674"	.01501	5	328	333
5	"5-out18675"	.00997	4	397	401
5	"5-out18679"	.01709	2	115	117
5	"5-out18681"	.00732	2	271	273
5	"5-out18684"	.00843	2	235	237
5	"5-out18685"	.02531	6	231	237
5	"5-out18687"	.00635	3	469	472
5	"5-out18688"	.00523	2	380	382
5	"5-out18692"	.00597	2	333	335
5	"5-out18695"	.00746	2	266	268
5	"5-out18698"	.00861	15	1727	1742
5	"5-out18699"	.00692	2	287	289
5	"5-out18702"	.00975	4	406	410
5	"5-out18704"	.00549	5	905	910
5	"5-out18706"	.00687	2	289	291
5	"5-out18708"	.00618	5	803	808
5	"5-out18709"	.01243	5	397	402
5	"5-out18712"	.00398	3	750	753
5	"5-out18715"	.01001	7	692	699
5	"5-out18716"	.00437	3	683	686
5	"5-out18720"	.00076	2	2621	2623
5	"5-out18725"	.01796	6	328	334
5	"5-out18727"	.00557	2	357	359
5	"5-out18728"	.01114	4	355	359
5	"5-out18729"	.01694	2	116	118
5	"5-out18730"	.03252	4	119	123
5	"5-out18731"	.05600	7	118	125
5	"5-out18733"	.00589	3	506	509
5	"5-out18734"	.00668	2	297	299
5	"5-out18735"	.00496	2	401	403
5	"5-out18737"	.00485	2	410	412
5	"5-out18738"	.05982	7	110	117
5	"5-out18739"	.01010	3	294	297
5	"5-out18740"	.01656	8	475	483
5	"5-out18743"	.00481	4	826	830
5	"5-out18746"	.00869	2	228	230
5	"5-out18749"	.00578	2	344	346
5	"5-out18750"	.01593	4	247	251
5	"5-out18751"	.00136	2	1460	1462
5	"5-out18753"	.00440	3	678	681
5	"5-out18756"	.00287	6	2083	2089
5	"5-out18757"	.01058	2	187	189
5	"5-out18758"	.01626	4	242	246
5	"5-out18760"	.00433	2	459	461
5	"5-out18764"	.01081	6	549	555
5	"5-out18768"	.00952	5	520	525
5	"5-out18770"	.00651	2	305	307
5	"5-out18771"	.00476	4	835	839
5	"5-out18773"	.01179	4	335	339
5	"5-out18778"	.00638	2	311	313
5	"5-out18779"	.00422	2	471	473
5	"5-out18781"	.00299	2	665	667
5	"5-out18783"	.01140	3	260	263
5	"5-out18784"	.00274	12	4362	4374
5	"5-out18786"	.02564	3	114	117
5	"5-out18787"	.00541	4	735	739
5	"5-out18789"	.00769	2	258	260
5	"5-out18792"	.00267	2	747	749
5	"5-out18793"	.00618	4	643	647
5	"5-out18794"	.00500	2	398	400
5	"5-out18797"	.02542	3	115	118
5	"5-out18798"	.01659	85	5036	5121
5	"5-out18799"	.01709	2	115	117
5	"5-out18800"	.03448	4	112	116
5	"5-out18802"	.05042	6	113	119
5	"5-out18803"	.00505	4	787	791
5	"5-out18804"	.05982	7	110	117
5	"5-out18808"	.00735	7	945	952
5	"5-out18811"	.00390	2	510	512
5	"5-out18812"	.00719	3	414	417
5	"5-out18813"	.01223	4	323	327
5	"5-out18817"	.00945	5	524	529
5	"5-out18819"	.00373	2	534	536
5	"5-out18824"	.00217	2	916	918
5	"5-out18825"	.00722	2	275	277
5	"5-out18829"	.00682	2	291	293
5	"5-out18831"	.00232	2	859	861
5	"5-out18832"	.00901	8	879	887
5	"5-out18833"	.00402	4	991	995
5	"5-out18836"	.00531	2	374	376
5	"5-out18838"	.02247	2	87	89
5	"5-out18839"	.00687	2	289	291
5	"5-out18840"	.01079	3	275	278
5	"5-out18841"	.00349	2	570	572
5	"5-out18842"	.01200	6	494	500
5	"5-out18843"	.01574	6	375	381
5	"5-out18844"	.00696	5	713	718
5	"5-out18845"	.01142	4	346	350
5	"5-out18846"	.00805	6	739	745
5	"5-out18848"	.01256	9	707	716
5	"5-out18850"	.00419	2	475	477
5	"5-out18856"	.00581	2	342	344
5	"5-out18857"	.00689	3	432	435
5	"5-out18859"	.00423	2	470	472
5	"5-out18862"	.00483	3	617	620
5	"5-out18864"	.00278	2	717	719
5	"5-out18865"	.00952	8	832	840
5	"5-out18866"	.00262	3	1140	1143
5	"5-out18867"	.00373	2	534	536
5	"5-out18868"	.00387	2	514	516
5	"5-out18872"	.01694	6	348	354
5	"5-out18873"	.00909	5	545	550
5	"5-out18874"	.00417	3	715	718
5	"5-out18876"	.00653	2	304	306
5	"5-out18878"	.00848	7	818	825
5	"5-out18879"	.04109	3	70	73
5	"5-out18880"	.01729	6	341	347
5	"5-out18881"	.00985	4	402	406
5	"5-out18884"	.00588	2	338	340
5	"5-out18885"	.05982	7	110	117
5	"5-out18887"	.00735	2	270	272
5	"5-out18888"	.02654	3	110	113
5	"5-out18889"	.01709	2	115	117
5	"5-out18893"	.01709	2	115	117
5	"5-out18894"	.00327	4	1216	1220
5	"5-out18895"	.00342	2	582	584
5	"5-out18898"	.01030	2	192	194
5	"5-out18902"	.00111	2	1799	1801
5	"5-out18904"	.00469	2	424	426
5	"5-out18906"	.00701	2	283	285
5	"5-out18907"	.00673	2	295	297
5	"5-out18908"	.01433	8	550	558
5	"5-out18909"	.00204	2	975	977
5	"5-out18910"	.00615	2	323	325
5	"5-out18913"	.00199	2	1002	1004
5	"5-out18917"	.03361	4	115	119
5	"5-out18918"	.01680	2	117	119
5	"5-out18920"	.01709	2	115	117
5	"5-out18924"	.00348	3	859	862
5	"5-out18926"	.05982	7	110	117
5	"5-out18927"	.07692	9	108	117
5	"5-out18929"	.00775	2	256	258
5	"5-out18933"	.00443	6	1347	1353
5	"5-out18934"	.01595	3	185	188
5	"5-out18938"	.00943	2	210	212
5	"5-out18942"	.01709	2	115	117
5	"5-out18944"	.01709	2	115	117
5	"5-out18945"	.00373	2	534	536
5	"5-out18949"	.00201	2	991	993
5	"5-out18950"	.01732	15	851	866
5	"5-out18951"	.01526	14	903	917
5	"5-out18956"	.01311	8	602	610
5	"5-out18964"	.00687	4	578	582
5	"5-out18965"	.00114	2	1747	1749
5	"5-out18967"	.01923	2	102	104
5	"5-out18968"	.02564	2	76	78
5	"5-out18969"	.01059	5	467	472
5	"5-out18972"	.00600	2	331	333
5	"5-out18973"	.01492	8	528	536
5	"5-out18974"	.01446	7	477	484
5	"5-out18975"	.00724	2	274	276
5	"5-out18976"	.01459	6	405	411
5	"5-out18979"	.00816	4	486	490
5	"5-out18981"	.01442	3	205	208
5	"5-out18982"	.00966	2	205	207
5	"5-out18983"	.01025	2	193	195
5	"5-out18985"	.00666	4	596	600
5	"5-out18986"	.01190	2	166	168
5	"5-out18987"	.01769	2	111	113
5	"5-out18991"	.00934	2	212	214
5	"5-out18992"	.00266	7	2616	2623
5	"5-out18994"	.02515	8	310	318
5	"5-out18996"	.00306	2	651	653
5	"5-out18998"	.00725	4	547	551
5	"5-out18999"	.04444	10	215	225
5	"5-out19001"	.02678	6	218	224
5	"5-out19003"	.01856	8	423	431
5	"5-out19006"	.03053	4	127	131
5	"5-out19009"	.00682	7	1018	1025
5	"5-out19010"	.00423	2	470	472
5	"5-out19011"	.03200	4	121	125
5	"5-out19012"	.04545	6	126	132
5	"5-out19013"	.06015	8	125	133
5	"5-out19018"	.01058	2	187	189
5	"5-out19020"	.01515	2	130	132
5	"5-out19024"	.00361	2	552	554
5	"5-out19025"	.00932	4	425	429
5	"5-out19026"	.00386	3	774	777
5	"5-out19027"	.00634	2	313	315
5	"5-out19028"	.00647	3	460	463
5	"5-out19030"	.00395	3	756	759
5	"5-out19031"	.09000	9	91	100
5	"5-out19032"	.00486	3	614	617
5	"5-out19033"	.01309	8	603	611
5	"5-out19034"	.01709	12	690	702
5	"5-out19035"	.04608	10	207	217
5	"5-out19038"	.02570	11	417	428
5	"5-out19042"	.02770	10	351	361
5	"5-out19043"	.00980	4	404	408
5	"5-out19045"	.03418	4	113	117
5	"5-out19050"	.02352	4	166	170
5	"5-out19051"	.00107	2	1857	1859
5	"5-out19053"	.00422	2	471	473
5	"5-out19056"	.00430	2	463	465
5	"5-out19058"	.00286	2	697	699
5	"5-out19063"	.00456	3	654	657
5	"5-out19064"	.00847	2	234	236
5	"5-out19065"	.01326	8	595	603
5	"5-out19066"	.00270	2	737	739
5	"5-out19067"	.01290	18	1377	1395
5	"5-out19070"	.01089	4	363	367
5	"5-out19071"	.00692	4	574	578
5	"5-out19072"	.02941	4	132	136
5	"5-out19074"	.00588	2	338	340
5	"5-out19077"	.00665	3	448	451
5	"5-out19078"	.29411	5	12	17
5	"5-out19079"	.00536	2	371	373
5	"5-out19080"	.00267	2	746	748
5	"5-out19082"	.00344	2	579	581
5	"5-out19083"	.00510	4	779	783
5	"5-out19085"	.03448	4	112	116
5	"5-out19086"	.05128	6	111	117
5	"5-out19087"	.00101	2	1978	1980
5	"5-out19088"	.02764	6	211	217
5	"5-out19091"	.00312	2	637	639
5	"5-out19092"	.00336	2	593	595
5	"5-out19093"	.01709	2	115	117
5	"5-out19094"	.02211	14	619	633
5	"5-out19097"	.00456	3	654	657
5	"5-out19099"	.00293	2	680	682
5	"5-out19100"	.00702	4	565	569
5	"5-out19101"	.01298	5	380	385
5	"5-out19103"	.03448	4	112	116
5	"5-out19104"	.00302	2	660	662
5	"5-out19105"	.01312	6	451	457
5	"5-out19106"	.01567	5	314	319
5	"5-out19107"	.00857	3	347	350
5	"5-out19110"	.02572	8	303	311
5	"5-out19111"	.00775	2	256	258
5	"5-out19112"	.00431	2	462	464
5	"5-out19113"	.00199	6	3007	3013
5	"5-out19114"	.00481	5	1034	1039
5	"5-out19115"	.00093	2	2137	2139
5	"5-out19116"	.00305	4	1305	1309
5	"5-out19117"	.01049	19	1791	1810
5	"5-out19118"	.00811	4	489	493
5	"5-out19121"	.08108	6	68	74
5	"5-out19122"	.01165	5	424	429
5	"5-out19123"	.02552	17	649	666
5	"5-out19124"	.00430	2	463	465
5	"5-out19127"	.00856	4	463	467
5	"5-out19129"	.02289	22	939	961
5	"5-out19131"	.02552	17	649	666
5	"5-out19134"	.00452	2	440	442
5	"5-out19135"	.00238	2	838	840
5	"5-out19136"	.00309	2	644	646
5	"5-out19142"	.00504	3	592	595
5	"5-out19144"	.00316	2	630	632
5	"5-out19145"	.01054	5	469	474
5	"5-out19147"	.00694	3	429	432
5	"5-out19148"	.00574	3	519	522
5	"5-out19149"	.00545	3	547	550
5	"5-out19150"	.00653	2	304	306
5	"5-out19151"	.00646	3	461	464
5	"5-out19152"	.01652	10	595	605
5	"5-out19154"	.05128	6	111	117
5	"5-out19155"	.00429	2	464	466
5	"5-out19157"	.01146	4	345	349
5	"5-out19158"	.01223	8	646	654
5	"5-out19161"	.01764	16	891	907
5	"5-out19162"	.01948	3	151	154
5	"5-out19163"	.00361	4	1102	1106
5	"5-out19169"	.00418	2	476	478
5	"5-out19170"	.02116	4	185	189
5	"5-out19173"	.01619	4	243	247
5	"5-out19178"	.04316	6	133	139
5	"5-out19180"	.00436	2	456	458
5	"5-out19182"	.00338	2	589	591
5	"5-out19184"	.02821	18	620	638
5	"5-out19186"	.01652	6	357	363
5	"5-out19187"	.00609	3	489	492
5	"5-out19189"	.00660	6	902	908
5	"5-out19190"	.00630	2	315	317
5	"5-out19191"	.03370	12	344	356
5	"5-out19193"	.00578	6	1031	1037
5	"5-out19194"	.00830	42	5017	5059
5	"5-out19196"	.00952	4	416	420
5	"5-out19197"	.00821	6	724	730
5	"5-out19198"	.00368	2	541	543
5	"5-out19202"	.02185	16	716	732
5	"5-out19204"	.00411	2	484	486
5	"5-out19206"	.00650	4	611	615
5	"5-out19207"	.01408	2	140	142
5	"5-out19208"	.00512	2	388	390
5	"5-out19210"	.01554	6	380	386
5	"5-out19211"	.00493	6	1209	1215
5	"5-out19216"	.00141	8	5627	5635
5	"5-out19217"	.00384	2	518	520
5	"5-out19219"	.04301	4	89	93
5	"5-out19223"	.01662	13	769	782
5	"5-out19224"	.00552	4	720	724
5	"5-out19227"	.00396	4	1005	1009
5	"5-out19232"	.00430	2	463	465
5	"5-out19235"	.00274	2	726	728
5	"5-out19239"	.00651	2	305	307
5	"5-out19240"	.00647	3	460	463
5	"5-out19244"	.01538	6	384	390
5	"5-out19248"	.00851	2	233	235
5	"5-out19251"	.01348	6	439	445
5	"5-out19252"	.00932	5	531	536
5	"5-out19257"	.01709	2	115	117
5	"5-out19266"	.00473	2	420	422
5	"5-out19267"	.00314	2	634	636
5	"5-out19270"	.04347	6	132	138
5	"5-out19271"	.00946	3	314	317
5	"5-out19273"	.00900	3	330	333
5	"5-out19274"	.00563	2	353	355
5	"5-out19277"	.01173	4	337	341
5	"5-out19280"	.06593	6	85	91
5	"5-out19283"	.03206	11	332	343
5	"5-out19285"	.01481	2	133	135
5	"5-out19290"	.08333	2	22	24
5	"5-out19292"	.01528	9	580	589
5	"5-out19293"	.00802	5	618	623
5	"5-out19297"	.05982	7	110	117
5	"5-out19298"	.05084	6	112	118
5	"5-out19302"	.00723	4	549	553
5	"5-out19303"	.00595	2	334	336
5	"5-out19304"	.11111	13	104	117
5	"5-out19305"	.00574	2	346	348
5	"5-out19306"	.00139	2	1433	1435
5	"5-out19307"	.01421	3	208	211
5	"5-out19308"	.01002	4	395	399
5	"5-out19309"	.00484	4	822	826
5	"5-out19310"	.04225	6	136	142
5	"5-out19312"	.04166	21	483	504
5	"5-out19314"	.00740	2	268	270
5	"5-out19315"	.02040	2	96	98
5	"5-out19316"	.00677	2	293	295
5	"5-out19317"	.00540	2	368	370
5	"5-out19318"	.00847	3	351	354
5	"5-out19319"	.00497	2	400	402
5	"5-out19322"	.01369	4	288	292
5	"5-out19323"	.00682	2	291	293
5	"5-out19324"	.00682	2	291	293
5	"5-out19326"	.00520	8	1530	1538
5	"5-out19327"	.00172	2	1157	1159
5	"5-out19328"	.00361	2	551	553
5	"5-out19330"	.00714	5	695	700
5	"5-out19331"	.03022	35	1123	1158
5	"5-out19332"	.03478	4	111	115
5	"5-out19333"	.00529	4	751	755
5	"5-out19340"	.00578	2	344	346
5	"5-out19344"	.00536	2	371	373
5	"5-out19347"	.00554	2	359	361
5	"5-out19353"	.01156	4	342	346
5	"5-out19355"	.01005	2	197	199
5	"5-out19357"	.00716	2	277	279
5	"5-out19358"	.03892	13	321	334
5	"5-out19359"	.00410	2	485	487
5	"5-out19360"	.01538	6	384	390
5	"5-out19361"	.00624	4	637	641
5	"5-out19363"	.02631	2	74	76
5	"5-out19366"	.01501	5	328	333
5	"5-out19367"	.00682	2	291	293
5	"5-out19373"	.01114	4	355	359
5	"5-out19376"	.00282	2	706	708
5	"5-out19377"	.00956	4	414	418
5	"5-out19378"	.01734	6	340	346
5	"5-out19380"	.01970	8	398	406
5	"5-out19383"	.02500	2	78	80
5	"5-out19386"	.01694	2	116	118
5	"5-out19387"	.05128	6	111	117
5	"5-out19390"	.00650	6	917	923
5	"5-out19392"	.00193	2	1030	1032
5	"5-out19393"	.00219	4	1818	1822
5	"5-out19395"	.00500	4	795	799
5	"5-out19398"	.00151	2	1319	1321
5	"5-out19399"	.01092	2	181	183
5	"5-out19400"	.00202	2	986	988
5	"5-out19404"	.01170	5	422	427
5	"5-out19408"	.00073	2	2713	2715
5	"5-out19409"	.00529	26	4885	4911
5	"5-out19410"	.00108	6	5531	5537
5	"5-out19411"	.00873	4	454	458
5	"5-out19412"	.00242	3	1232	1235
5	"5-out19413"	.00297	2	670	672
5	"5-out19415"	.00519	2	383	385
5	"5-out19416"	.01883	10	521	531
5	"5-out19417"	.01875	3	157	160
5	"5-out19424"	.00904	2	219	221
5	"5-out19425"	.01025	2	193	195
5	"5-out19426"	.00995	2	199	201
5	"5-out19427"	.03465	7	195	202
5	"5-out19428"	.07692	12	144	156
5	"5-out19429"	.00784	2	253	255
5	"5-out19434"	.09183	9	89	98
5	"5-out19435"	.07142	7	91	98
5	"5-out19439"	.02762	5	176	181
5	"5-out19440"	.01951	4	201	205
5	"5-out19441"	.00952	2	208	210
5	"5-out19442"	.01081	2	183	185
5	"5-out19443"	.00952	2	208	210
5	"5-out19444"	.01079	3	275	278
5	"5-out19445"	.02109	5	232	237
5	"5-out19446"	.02325	3	126	129
5	"5-out19447"	.03030	5	160	165
5	"5-out19448"	.01604	3	184	187
5	"5-out19449"	.01775	3	166	169
5	"5-out19453"	.01600	4	246	250
5	"5-out19454"	.01149	2	172	174
5	"5-out19455"	.01257	2	157	159
5	"5-out19457"	.01250	2	158	160
5	"5-out19458"	.01183	2	167	169
5	"5-out19461"	.00485	5	1025	1030
5	"5-out19465"	.00890	4	445	449
5	"5-out19466"	.00438	2	454	456
5	"5-out19469"	.01841	17	906	923
5	"5-out19470"	.00421	4	946	950
5	"5-out19472"	.00187	2	1064	1066
5	"5-out19473"	.00975	4	406	410
5	"5-out19474"	.00990	4	400	404
5	"5-out19478"	.02073	21	992	1013
5	"5-out19479"	.02564	2	76	78
5	"5-out19480"	.00881	2	225	227
5	"5-out19481"	.00978	11	1113	1124
5	"5-out19482"	.02349	9	374	383
5	"5-out19484"	.00377	2	528	530
5	"5-out19485"	.00427	2	466	468
5	"5-out19486"	.00477	4	833	837
5	"5-out19487"	.01018	5	486	491
5	"5-out19489"	.00454	8	1753	1761
5	"5-out19490"	.00167	2	1191	1193
5	"5-out19491"	.00126	2	1573	1575
5	"5-out19493"	.01577	5	312	317
5	"5-out19494"	.01498	11	723	734
5	"5-out19495"	.00442	5	1125	1130
5	"5-out19497"	.02450	10	398	408
5	"5-out19498"	.00717	5	692	697
5	"5-out19499"	.00390	4	1021	1025
5	"5-out19506"	.01083	3	274	277
5	"5-out19507"	.02155	5	227	232
5	"5-out19510"	.01129	2	175	177
5	"5-out19513"	.00237	2	841	843
5	"5-out19517"	.00434	4	917	921
5	"5-out19518"	.00290	2	687	689
5	"5-out19520"	.02298	2	85	87
5	"5-out19521"	.00609	2	326	328
5	"5-out19522"	.01384	4	285	289
5	"5-out19523"	.03191	3	91	94
5	"5-out19524"	.00230	4	1732	1736
5	"5-out19525"	.00249	3	1201	1204
5	"5-out19527"	.00123	2	1624	1626
5	"5-out19532"	.01339	3	221	224
5	"5-out19535"	.00412	2	483	485
5	"5-out19538"	.01142	2	173	175
5	"5-out19541"	.00233	4	1710	1714
5	"5-out19542"	.00219	2	909	911
5	"5-out19543"	.00547	4	727	731
5	"5-out19544"	.01208	4	327	331
5	"5-out19546"	.00602	3	495	498
5	"5-out19548"	.01184	5	417	422
5	"5-out19549"	.01587	6	372	378
5	"5-out19551"	.00911	3	326	329
5	"5-out19554"	.00200	2	996	998
5	"5-out19555"	.00481	5	1034	1039
5	"5-out19558"	.01111	2	178	180
5	"5-out19559"	.01904	2	103	105
5	"5-out19560"	.02140	7	320	327
5	"5-out19566"	.00399	2	499	501
5	"5-out19568"	.00347	2	573	575
5	"5-out19573"	.00254	2	783	785
5	"5-out19577"	.00716	2	277	279
5	"5-out19578"	.00613	3	486	489
5	"5-out19579"	.00380	2	523	525
5	"5-out19580"	.00107	2	1858	1860
5	"5-out19582"	.00128	2	1554	1556
5	"5-out19584"	.03218	15	451	466
5	"5-out19585"	.01459	6	405	411
5	"5-out19591"	.02512	10	388	398
5	"5-out19593"	.06611	8	113	121
5	"5-out19595"	.00668	3	446	449
5	"5-out19596"	.02555	8	305	313
5	"5-out19597"	.00904	2	219	221
5	"5-out19599"	.01036	2	191	193
5	"5-out19602"	.00238	4	1671	1675
5	"5-out19604"	.00341	2	584	586
5	"5-out19605"	.00809	2	245	247
5	"5-out19606"	.03162	8	245	253
5	"5-out19608"	.00548	3	544	547
5	"5-out19609"	.06611	8	113	121
5	"5-out19613"	.00236	2	844	846
5	"5-out19620"	.03384	11	314	325
5	"5-out19621"	.00943	2	210	212
5	"5-out19622"	.01890	10	519	529
5	"5-out19626"	.00239	2	833	835
5	"5-out19627"	.00196	8	4061	4069
5	"5-out19629"	.07228	6	77	83
5	"5-out19634"	.00598	2	332	334
5	"5-out19635"	.00647	2	307	309
5	"5-out19638"	.00672	5	739	744
5	"5-out19639"	.00392	2	508	510
5	"5-out19641"	.00423	2	470	472
5	"5-out19642"	.00555	2	358	360
5	"5-out19644"	.00363	4	1096	1100
5	"5-out19645"	.00450	6	1325	1331
5	"5-out19646"	.05319	5	89	94
5	"5-out19655"	.04958	6	115	121
5	"5-out19657"	.00134	2	1485	1487
5	"5-out19658"	.01383	23	1640	1663
5	"5-out19662"	.00917	16	1728	1744
5	"5-out19663"	.00917	16	1728	1744
5	"5-out19667"	.00088	2	2261	2263
5	"5-out19670"	.00676	4	587	591
5	"5-out19672"	.00357	2	557	559
5	"5-out19675"	.01600	2	123	125
5	"5-out19678"	.00387	7	1799	1806
5	"5-out19679"	.00396	5	1256	1261
5	"5-out19680"	.00725	10	1369	1379
5	"5-out19681"	.00238	2	835	837
5	"5-out19682"	.00310	6	1929	1935
5	"5-out19683"	.00302	8	2636	2644
5	"5-out19686"	.00182	2	1093	1095
5	"5-out19687"	.00579	7	1200	1207
5	"5-out19688"	.00421	2	473	475
5	"5-out19689"	.01209	13	1062	1075
5	"5-out19691"	.00589	2	337	339
5	"5-out19693"	.01985	8	395	403
5	"5-out19694"	.01162	4	340	344
5	"5-out19695"	.00293	9	3054	3063
5	"5-out19696"	.00363	2	548	550
5	"5-out19698"	.00219	2	911	913
5	"5-out19699"	.00390	2	510	512
5	"5-out19700"	.00338	2	589	591
5	"5-out19701"	.00347	2	573	575
5	"5-out19703"	.01554	3	190	193
5	"5-out19704"	.01204	2	164	166
5	"5-out19705"	.00144	2	1386	1388
5	"5-out19707"	.00446	2	446	448
5	"5-out19708"	.00434	2	458	460
5	"5-out19710"	.00282	2	705	707
5	"5-out19714"	.00668	3	446	449
5	"5-out19715"	.00458	6	1303	1309
5	"5-out19716"	.01075	3	276	279
5	"5-out19717"	.00166	2	1200	1202
5	"5-out19718"	.01038	8	762	770
5	"5-out19719"	.00371	2	536	538
5	"5-out19720"	.08547	10	107	117
5	"5-out19721"	.03200	4	121	125
5	"5-out19722"	.03278	4	118	122
5	"5-out19723"	.02469	8	316	324
5	"5-out19725"	.00917	4	432	436
5	"5-out19726"	.00347	2	574	576
5	"5-out19728"	.00600	9	1489	1498
5	"5-out19729"	.00591	3	504	507
5	"5-out19730"	.00159	2	1249	1251
5	"5-out19731"	.00741	6	803	809
5	"5-out19735"	.00607	2	327	329
5	"5-out19739"	.00265	2	751	753
5	"5-out19743"	.00275	2	723	725
5	"5-out19744"	.01630	21	1267	1288
5	"5-out19745"	.00389	4	1024	1028
5	"5-out19746"	.01630	21	1267	1288
5	"5-out19747"	.00764	10	1298	1308
5	"5-out19748"	.00306	4	1302	1306
5	"5-out19749"	.00258	6	2319	2325
5	"5-out19750"	.01273	2	155	157
5	"5-out19752"	.00409	6	1460	1466
5	"5-out19753"	.00671	2	296	298
5	"5-out19755"	.01960	4	200	204
5	"5-out19759"	.00628	12	1898	1910
5	"5-out19760"	.00330	4	1207	1211
5	"5-out19761"	.00441	11	2481	2492
5	"5-out19762"	.00430	4	926	930
5	"5-out19763"	.00376	6	1588	1594
5	"5-out19764"	.00440	2	452	454
5	"5-out19765"	.00245	3	1220	1223
5	"5-out19766"	.00163	2	1222	1224
5	"5-out19767"	.00310	3	964	967
5	"5-out19768"	.00290	2	687	689
5	"5-out19771"	.02535	9	346	355
5	"5-out19772"	.01108	4	357	361
5	"5-out19774"	.00555	7	1252	1259
5	"5-out19777"	.00269	2	740	742
5	"5-out19778"	.01298	2	152	154
5	"5-out19789"	.02694	9	325	334
5	"5-out19790"	.00264	2	755	757
5	"5-out19791"	.01107	3	268	271
5	"5-out19793"	.00162	2	1230	1232
5	"5-out19794"	.00406	4	979	983
5	"5-out19796"	.00898	3	331	334
5	"5-out19797"	.00928	3	320	323
5	"5-out19799"	.01194	4	331	335
5	"5-out19801"	.01511	6	391	397
5	"5-out19803"	.00529	2	376	378
5	"5-out19804"	.00920	3	323	326
5	"5-out19810"	.00526	2	378	380
5	"5-out19811"	.00539	2	369	371
5	"5-out19812"	.00656	3	454	457
5	"5-out19815"	.00579	2	343	345
5	"5-out19818"	.00454	12	2627	2639
5	"5-out19819"	.01282	10	770	780
5	"5-out19822"	.01626	4	242	246
5	"5-out19826"	.00134	2	1481	1483
5	"5-out19827"	.01574	2	125	127
5	"5-out19828"	.00184	4	2164	2168
5	"5-out19830"	.00281	2	708	710
5	"5-out19832"	.00459	4	866	870
5	"5-out19834"	.00425	2	468	470
5	"5-out19837"	.00740	13	1742	1755
5	"5-out19839"	.00283	2	704	706
5	"5-out19841"	.00333	5	1494	1499
5	"5-out19842"	.00280	4	1422	1426
5	"5-out19843"	.00874	3	340	343
5	"5-out19844"	.00724	19	2605	2624
5	"5-out19845"	.00843	5	588	593
5	"5-out19847"	.02150	6	273	279
5	"5-out19849"	.00683	4	581	585
5	"5-out19850"	.00598	4	664	668
5	"5-out19854"	.01886	2	104	106
5	"5-out19856"	.03200	4	121	125
5	"5-out19857"	.05405	6	105	111
5	"5-out19859"	.01801	2	109	111
5	"5-out19860"	.01333	6	444	450
5	"5-out19862"	.00481	2	413	415
5	"5-out19864"	.01694	6	348	354
5	"5-out19865"	.03517	14	384	398
5	"5-out19866"	.02654	6	220	226
5	"5-out19868"	.01685	6	350	356
5	"5-out19870"	.03174	10	305	315
5	"5-out19873"	.01223	4	323	327
5	"5-out19875"	.00913	2	217	219
5	"5-out19879"	.00943	2	210	212
5	"5-out19881"	.00294	2	677	679
5	"5-out19882"	.01886	2	104	106
5	"5-out19883"	.00690	5	719	724
5	"5-out19888"	.00139	2	1433	1435
5	"5-out19889"	.00440	5	1129	1134
5	"5-out19890"	.00254	3	1174	1177
5	"5-out19893"	.00169	2	1178	1180
5	"5-out19894"	.01386	17	1209	1226
5	"5-out19895"	.00334	4	1192	1196
5	"5-out19896"	.00321	4	1239	1243
5	"5-out19897"	.00716	2	277	279
5	"5-out19899"	.00348	3	858	861
5	"5-out19901"	.00444	2	448	450
5	"5-out19902"	.00171	2	1162	1164
5	"5-out19905"	.00298	2	668	670
5	"5-out19906"	.00193	2	1033	1035
5	"5-out19908"	.01746	4	225	229
5	"5-out19909"	.02666	6	219	225
5	"5-out19910"	.00607	6	982	988
5	"5-out19912"	.00657	5	755	760
5	"5-out19913"	.00248	2	803	805
5	"5-out19916"	.01310	3	226	229
5	"5-out19917"	.06074	13	201	214
5	"5-out19919"	.05752	13	213	226
5	"5-out19923"	.00995	2	199	201
5	"5-out19924"	.01675	6	352	358
5	"5-out19926"	.00557	3	535	538
5	"5-out19928"	.13235	9	59	68
5	"5-out19931"	.01156	4	342	346
5	"5-out19932"	.01210	5	408	413
5	"5-out19933"	.01287	6	460	466
5	"5-out19934"	.04081	6	141	147
5	"5-out19936"	.03217	12	361	373
5	"5-out19937"	.00119	2	1671	1673
5	"5-out19938"	.01197	2	165	167
5	"5-out19940"	.05714	6	99	105
5	"5-out19943"	.00142	2	1399	1401
5	"5-out19944"	.00174	2	1141	1143
5	"5-out19945"	.00330	2	603	605
5	"5-out19947"	.00483	5	1029	1034
5	"5-out19950"	.00360	2	553	555
5	"5-out19951"	.00168	4	2372	2376
5	"5-out19952"	.00347	2	573	575
5	"5-out19953"	.00359	2	555	557
5	"5-out19954"	.01403	4	281	285
5	"5-out19956"	.00668	2	297	299
5	"5-out19958"	.01612	4	244	248
5	"5-out19963"	.02419	9	363	372
5	"5-out19964"	.01000	2	198	200
5	"5-out19965"	.00142	2	1403	1405
5	"5-out19966"	.00384	4	1036	1040
5	"5-out19967"	.00194	2	1024	1026
5	"5-out19968"	.00194	2	1026	1028
5	"5-out19971"	.00531	4	748	752
5	"5-out19973"	.00177	3	1687	1690
5	"5-out19975"	.00217	4	1834	1838
5	"5-out19976"	.00114	2	1743	1745
5	"5-out19977"	.00119	2	1674	1676
5	"5-out19978"	.00062	2	3175	3177
5	"5-out19979"	.00535	14	2601	2615
5	"5-out19980"	.00793	2	250	252
5	"5-out19982"	.00375	2	531	533
5	"5-out19985"	.03636	6	159	165
5	"5-out19986"	.00680	4	584	588
5	"5-out19987"	.01355	4	291	295
5	"5-out19988"	.01554	3	190	193
5	"5-out19993"	.00643	2	309	311
5	"5-out19996"	.01293	3	229	232
5	"5-out19997"	.00316	2	629	631
5	"5-out19999"	.01149	4	344	348
5	"5-out20000"	.00566	5	877	882
5	"5-out20004"	.00568	2	350	352
5	"5-out20008"	.01329	5	371	376
5	"5-out20012"	.00836	2	237	239
5	"5-out20013"	.01980	2	99	101
5	"5-out20014"	.00985	2	201	203
5	"5-out20017"	.00433	8	1836	1844
5	"5-out20018"	.00576	2	345	347
5	"5-out20019"	.01769	23	1277	1300
5	"5-out20020"	.00587	7	1185	1192
5	"5-out20021"	.00143	2	1388	1390
5	"5-out20022"	.01080	7	641	648
5	"5-out20024"	.00404	2	492	494
5	"5-out20027"	.00144	3	2075	2078
5	"5-out20029"	.01587	2	124	126
5	"5-out20030"	.01639	2	120	122
5	"5-out20032"	.00649	6	918	924
5	"5-out20035"	.00113	2	1760	1762
5	"5-out20036"	.01787	17	934	951
5	"5-out20037"	.01449	6	408	414
5	"5-out20039"	.00321	2	620	622
5	"5-out20042"	.01204	2	164	166
5	"5-out20044"	.02409	4	162	166
5	"5-out20045"	.01486	4	265	269
5	"5-out20047"	.01261	4	313	317
5	"5-out20048"	.01379	2	143	145
5	"5-out20050"	.00343	2	581	583
5	"5-out20053"	.00168	2	1188	1190
5	"5-out20055"	.00318	3	940	943
5	"5-out20056"	.02474	17	670	687
5	"5-out20057"	.00488	4	814	818
5	"5-out20058"	.00268	2	744	746
5	"5-out20062"	.01149	3	258	261
5	"5-out20066"	.00909	2	218	220
5	"5-out20068"	.01197	2	165	167
5	"5-out20071"	.00426	3	701	704
5	"5-out20072"	.00783	5	633	638
5	"5-out20076"	.00133	2	1498	1500
5	"5-out20078"	.00315	2	631	633
5	"5-out20079"	.00884	2	224	226
5	"5-out20080"	.01780	6	331	337
5	"5-out20082"	.00139	2	1427	1429
5	"5-out20083"	.00248	3	1202	1205
5	"5-out20084"	.00179	2	1115	1117
5	"5-out20085"	.01423	24	1662	1686
5	"5-out20087"	.00140	2	1425	1427
5	"5-out20089"	.00609	8	1305	1313
5	"5-out20095"	.00584	3	510	513
5	"5-out20096"	.01174	7	589	596
5	"5-out20097"	.00332	2	600	602
5	"5-out20098"	.00445	8	1788	1796
5	"5-out20099"	.02439	8	320	328
5	"5-out20100"	.01501	5	328	333
5	"5-out20101"	.00589	2	337	339
5	"5-out20102"	.02752	9	318	327
5	"5-out20103"	.00988	10	1002	1012
5	"5-out20104"	.00464	4	858	862
5	"5-out20105"	.00765	3	389	392
5	"5-out20107"	.00271	2	736	738
5	"5-out20109"	.00476	4	835	839
5	"5-out20113"	.00200	3	1494	1497
5	"5-out20114"	.00285	5	1749	1754
5	"5-out20121"	.04032	5	119	124
5	"5-out20122"	.00749	2	265	267
5	"5-out20124"	.00497	2	400	402
5	"5-out20127"	.00498	2	399	401
5	"5-out20129"	.00441	4	902	906
5	"5-out20131"	.00481	2	413	415
5	"5-out20132"	.00391	2	509	511
5	"5-out20135"	.01148	10	861	871
5	"5-out20139"	.02173	4	180	184
5	"5-out20140"	.03157	6	184	190
5	"5-out20142"	.01129	2	175	177
5	"5-out20143"	.00952	2	208	210
5	"5-out20145"	.00237	2	839	841
5	"5-out20147"	.02168	8	361	369
5	"5-out20148"	.01190	2	166	168
5	"5-out20154"	.01834	2	107	109
5	"5-out20155"	.05128	2	37	39
5	"5-out20157"	.00947	2	209	211
5	"5-out20159"	.00385	2	517	519
5	"5-out20160"	.00274	2	727	729
5	"5-out20161"	.00551	3	541	544
5	"5-out20167"	.00729	2	272	274
5	"5-out20174"	.00947	2	209	211
5	"5-out20175"	.00355	4	1121	1125
5	"5-out20176"	.00472	2	421	423
5	"5-out20177"	.00483	2	412	414
5	"5-out20178"	.00879	3	338	341
5	"5-out20182"	.00065	2	3049	3051
5	"5-out20184"	.01158	3	256	259
5	"5-out20186"	.02320	10	421	431
5	"5-out20192"	.05063	4	75	79
5	"5-out20193"	.01562	2	126	128
5	"5-out20194"	.01049	4	377	381
5	"5-out20196"	.00224	4	1781	1785
5	"5-out20198"	.02429	12	482	494
5	"5-out20199"	.02777	4	140	144
5	"5-out20200"	.01196	5	413	418
5	"5-out20203"	.00579	3	515	518
5	"5-out20208"	.01139	4	347	351
5	"5-out20209"	.01507	3	196	199
5	"5-out20210"	.00259	2	770	772
5	"5-out20211"	.01010	4	392	396
5	"5-out20213"	.03012	10	322	332
5	"5-out20216"	.00478	2	416	418
5	"5-out20217"	.01060	12	1120	1132
5	"5-out20219"	.00291	3	1026	1029
5	"5-out20220"	.00656	8	1210	1218
5	"5-out20221"	.01650	5	298	303
5	"5-out20222"	.01400	5	352	357
5	"5-out20223"	.00491	6	1214	1220
5	"5-out20225"	.00402	5	1236	1241
5	"5-out20226"	.00217	2	917	919
5	"5-out20228"	.00775	2	256	258
5	"5-out20229"	.00168	2	1186	1188
5	"5-out20230"	.01488	18	1191	1209
5	"5-out20232"	.00222	2	896	898
5	"5-out20233"	.02150	2	91	93
5	"5-out20235"	.00896	2	221	223
5	"5-out20240"	.00428	2	465	467
5	"5-out20241"	.01515	2	130	132
5	"5-out20243"	.01843	4	213	217
5	"5-out20247"	.00727	2	273	275
5	"5-out20250"	.01587	5	310	315
5	"5-out20253"	.02564	2	76	78
5	"5-out20255"	.01581	8	498	506
5	"5-out20256"	.01610	11	672	683
5	"5-out20257"	.00442	9	2023	2032
5	"5-out20258"	.00295	5	1686	1691
5	"5-out20259"	.00569	6	1047	1053
5	"5-out20261"	.03811	17	429	446
5	"5-out20262"	.03811	17	429	446
5	"5-out20263"	.06617	9	127	136
5	"5-out20264"	.01000	4	396	400
5	"5-out20265"	.00154	2	1292	1294
5	"5-out20266"	.00425	13	3043	3056
5	"5-out20268"	.04597	8	166	174
5	"5-out20271"	.01315	2	150	152
5	"5-out20272"	.01246	4	317	321
5	"5-out20273"	.00848	5	584	589
5	"5-out20274"	.01913	4	205	209
5	"5-out20276"	.00547	5	909	914
5	"5-out20278"	.02290	6	256	262
5	"5-out20279"	.01612	4	244	248
5	"5-out20280"	.03921	2	49	51
5	"5-out20282"	.01088	6	545	551
5	"5-out20284"	.02328	16	671	687
5	"5-out20285"	.01851	2	106	108
5	"5-out20288"	.00930	2	213	215
5	"5-out20289"	.00966	2	205	207
5	"5-out20290"	.00655	2	303	305
5	"5-out20291"	.00892	2	222	224
5	"5-out20294"	.00909	2	218	220
5	"5-out20296"	.00909	2	218	220
5	"5-out20299"	.01895	4	207	211
5	"5-out20301"	.00655	4	606	610
5	"5-out20303"	.00191	2	1044	1046
5	"5-out20305"	.01603	8	491	499
5	"5-out20306"	.00668	2	297	299
5	"5-out20307"	.00199	2	1000	1002
5	"5-out20308"	.00456	2	436	438
5	"5-out20312"	.00769	2	258	260
5	"5-out20314"	.02030	4	193	197
5	"5-out20315"	.02320	10	421	431
5	"5-out20316"	.01081	2	183	185
5	"5-out20319"	.04150	11	254	265
5	"5-out20320"	.01257	2	157	159
5	"5-out20321"	.02463	5	198	203
5	"5-out20322"	.03636	14	371	385
5	"5-out20325"	.00458	2	434	436
5	"5-out20327"	.00240	2	831	833
5	"5-out20332"	.00506	2	393	395
5	"5-out20333"	.00424	3	704	707
5	"5-out20334"	.00506	2	393	395
5	"5-out20336"	.00434	5	1145	1150
5	"5-out20339"	.00318	2	625	627
5	"5-out20340"	.00730	5	679	684
5	"5-out20341"	.00355	2	561	563
5	"5-out20346"	.01027	3	289	292
5	"5-out20348"	.00380	2	524	526
5	"5-out20349"	.01690	6	349	355
5	"5-out20350"	.00557	2	357	359
5	"5-out20351"	.00558	4	712	716
5	"5-out20352"	.02631	2	74	76
5	"5-out20353"	.00627	9	1426	1435
5	"5-out20354"	.00737	5	673	678
5	"5-out20355"	.00505	2	394	396
5	"5-out20358"	.00453	9	1975	1984
5	"5-out20359"	.00687	4	578	582
5	"5-out20367"	.01492	3	198	201
5	"5-out20368"	.00803	4	494	498
5	"5-out20369"	.00506	2	393	395
5	"5-out20370"	.01789	8	439	447
5	"5-out20374"	.02163	23	1040	1063
5	"5-out20376"	.01276	3	232	235
5	"5-out20377"	.01587	6	372	378
5	"5-out20378"	.01065	6	557	563
5	"5-out20379"	.01980	2	99	101
5	"5-out20380"	.00706	2	281	283
5	"5-out20381"	.00350	4	1138	1142
5	"5-out20386"	.00599	5	829	834
5	"5-out20390"	.01346	4	293	297
5	"5-out20393"	.01834	6	321	327
5	"5-out20395"	.00895	3	332	335
5	"5-out20396"	.01202	6	493	499
5	"5-out20397"	.01857	6	317	323
5	"5-out20400"	.01848	10	531	541
5	"5-out20401"	.00388	4	1026	1030
5	"5-out20404"	.01423	4	277	281
5	"5-out20406"	.00848	8	935	943
5	"5-out20407"	.01705	14	807	821
5	"5-out20408"	.01388	4	284	288
5	"5-out20411"	.02234	12	525	537
5	"5-out20412"	.00811	4	489	493
6	"6-out1"	.48941	208	217	425
6	"6-out2"	.39753	258	391	649
6	"6-out3"	.09248	32	314	346
6	"6-out4"	.12711	45	309	354
6	"6-out5"	.14444	39	231	270
6	"6-out6"	.10059	34	304	338
6	"6-out7"	.26233	202	568	770
6	"6-out8"	.14126	89	541	630
6	"6-out9"	.13101	49	325	374
6	"6-out10"	.11253	220	1735	1955
6	"6-out11"	.32958	264	537	801
6	"6-out12"	.04244	140	3158	3298
6	"6-out13"	.06557	76	1083	1159
6	"6-out14"	.09427	107	1028	1135
6	"6-out15"	.30227	279	644	923
6	"6-out16"	.30678	285	644	929
6	"6-out17"	.05163	52	955	1007
6	"6-out18"	.04872	46	898	944
6	"6-out19"	.33404	311	620	931
6	"6-out20"	.33261	310	622	932
6	"6-out21"	.09003	140	1415	1555
6	"6-out22"	.09302	32	312	344
6	"6-out23"	.04400	11	239	250
6	"6-out24"	.15524	77	419	496
6	"6-out25"	.23566	185	600	785
6	"6-out26"	.07692	20	240	260
6	"6-out27"	.36423	275	480	755
6	"6-out28"	.08152	79	890	969
6	"6-out29"	.13008	48	321	369
6	"6-out30"	.04670	95	1939	2034
6	"6-out31"	.11689	137	1035	1172
6	"6-out32"	.08938	32	326	358
6	"6-out33"	.46875	135	153	288
6	"6-out34"	.56395	194	150	344
6	"6-out35"	.22807	104	352	456
6	"6-out36"	.19638	174	712	886
6	"6-out37"	.29742	254	600	854
6	"6-out38"	.11538	99	759	858
6	"6-out39"	.07331	25	316	341
6	"6-out40"	.06422	28	408	436
6	"6-out41"	.05769	21	343	364
6	"6-out42"	.10591	43	363	406
6	"6-out43"	.30575	170	386	556
6	"6-out44"	.07877	36	421	457
6	"6-out45"	.32218	106	223	329
6	"6-out46"	.52332	460	419	879
6	"6-out47"	.06517	35	502	537
6	"6-out48"	.25888	204	584	788
6	"6-out49"	.09022	24	242	266
6	"6-out50"	.32648	143	295	438
6	"6-out51"	.23513	87	283	370
6	"6-out52"	.35238	111	204	315
6	"6-out53"	.07479	46	569	615
6	"6-out54"	.04573	30	626	656
6	"6-out55"	.11605	86	655	741
6	"6-out56"	.20911	133	503	636
6	"6-out57"	.09770	81	748	829
6	"6-out58"	.17427	84	398	482
6	"6-out59"	.09417	76	731	807
6	"6-out60"	.11780	88	659	747
6	"6-out61"	.11643	34	258	292
6	"6-out62"	.13125	63	417	480
6	"6-out63"	.09131	81	806	887
6	"6-out64"	.11830	294	2191	2485
6	"6-out65"	.07160	85	1102	1187
6	"6-out66"	.04988	42	800	842
6	"6-out67"	.10911	97	792	889
6	"6-out68"	.10114	44	391	435
6	"6-out69"	.14250	115	692	807
6	"6-out70"	.05684	93	1543	1636
6	"6-out71"	.46987	195	220	415
6	"6-out72"	.06133	56	857	913
6	"6-out73"	.23529	80	260	340
6	"6-out74"	.12500	16	112	128
6	"6-out75"	.09075	54	541	595
6	"6-out76"	.46419	350	404	754
6	"6-out77"	.15073	153	862	1015
6	"6-out78"	.08728	70	732	802
6	"6-out79"	.09313	186	1811	1997
6	"6-out80"	.15543	203	1103	1306
6	"6-out81"	.05191	99	1808	1907
6	"6-out82"	.17219	192	923	1115
6	"6-out83"	.04063	59	1393	1452
6	"6-out84"	.46732	286	326	612
6	"6-out85"	.11235	10	79	89
6	"6-out86"	.08990	130	1316	1446
6	"6-out87"	.11447	106	820	926
6	"6-out88"	.07352	10	126	136
6	"6-out89"	.05755	16	262	278
6	"6-out90"	.05643	32	535	567
6	"6-out91"	.41371	175	248	423
6	"6-out92"	.35228	316	581	897
6	"6-out93"	.18348	80	356	436
6	"6-out94"	.15000	27	153	180
6	"6-out95"	.46312	157	182	339
6	"6-out96"	.16997	77	376	453
6	"6-out97"	.14497	49	289	338
6	"6-out98"	.20640	348	1338	1686
6	"6-out99"	.30163	92	213	305
6	"6-out100"	.08801	47	487	534
6	"6-out101"	.10845	59	485	544
6	"6-out102"	.10941	43	350	393
6	"6-out103"	.08944	50	509	559
6	"6-out104"	.37604	135	224	359
6	"6-out105"	.07407	14	175	189
6	"6-out106"	.07251	86	1100	1186
6	"6-out107"	.12539	40	279	319
6	"6-out108"	.32751	75	154	229
6	"6-out109"	.54112	125	106	231
6	"6-out110"	.10680	80	669	749
6	"6-out111"	.12014	65	476	541
6	"6-out112"	.10563	15	127	142
6	"6-out113"	.08333	14	154	168
6	"6-out114"	.41818	69	96	165
6	"6-out115"	.37567	139	231	370
6	"6-out116"	.05695	102	1689	1791
6	"6-out117"	.10912	67	547	614
6	"6-out118"	.59631	582	394	976
6	"6-out119"	.11797	63	471	534
6	"6-out120"	.12605	30	208	238
6	"6-out121"	.34536	354	671	1025
6	"6-out122"	.04316	18	399	417
6	"6-out123"	.06372	13	191	204
6	"6-out124"	.09610	37	348	385
6	"6-out125"	.06069	21	325	346
6	"6-out126"	.10900	46	376	422
6	"6-out127"	.09354	29	281	310
6	"6-out128"	.09782	126	1162	1288
6	"6-out129"	.29506	275	657	932
6	"6-out130"	.05936	32	507	539
6	"6-out131"	.03961	37	897	934
6	"6-out132"	.26371	250	698	948
6	"6-out133"	.09906	106	964	1070
6	"6-out134"	.31471	293	638	931
6	"6-out135"	.09368	43	416	459
6	"6-out136"	.33690	314	618	932
6	"6-out137"	.30210	287	663	950
6	"6-out138"	.29684	282	668	950
6	"6-out139"	.11969	31	228	259
6	"6-out140"	.28285	99	251	350
6	"6-out141"	.31018	134	298	432
6	"6-out142"	.08148	419	4723	5142
6	"6-out143"	.19157	50	211	261
6	"6-out144"	.19354	12	50	62
6	"6-out145"	.04231	19	430	449
6	"6-out146"	.52336	56	51	107
6	"6-out147"	.07849	146	1714	1860
6	"6-out148"	.18528	68	299	367
6	"6-out149"	.06450	151	2190	2341
6	"6-out150"	.11311	44	345	389
6	"6-out151"	.19339	41	171	212
6	"6-out152"	.10141	79	700	779
6	"6-out153"	.13195	64	421	485
6	"6-out154"	.10437	74	635	709
6	"6-out155"	.08182	77	864	941
6	"6-out156"	.07712	88	1053	1141
6	"6-out157"	.14937	72	410	482
6	"6-out158"	.07111	32	418	450
6	"6-out159"	.10385	280	2416	2696
6	"6-out160"	.07449	26	323	349
6	"6-out161"	.12571	44	306	350
6	"6-out162"	.50406	124	122	246
6	"6-out163"	.07500	24	296	320
6	"6-out164"	.48684	37	39	76
6	"6-out165"	.11098	100	801	901
6	"6-out166"	.06067	27	418	445
6	"6-out167"	.07773	44	522	566
6	"6-out168"	.08995	60	607	667
6	"6-out169"	.26086	192	544	736
6	"6-out170"	.10784	11	91	102
6	"6-out171"	.14893	42	240	282
6	"6-out172"	.14105	134	816	950
6	"6-out173"	.04107	23	537	560
6	"6-out174"	.09900	50	455	505
6	"6-out175"	.10869	50	410	460
6	"6-out176"	.12053	118	861	979
6	"6-out177"	.06899	81	1093	1174
6	"6-out178"	.04887	13	253	266
6	"6-out179"	.03846	12	300	312
6	"6-out180"	.54054	20	17	37
6	"6-out181"	.20302	188	738	926
6	"6-out182"	.10265	58	507	565
6	"6-out183"	.09722	35	325	360
6	"6-out184"	.19561	116	477	593
6	"6-out185"	.05000	5	95	100
6	"6-out186"	.49664	74	75	149
6	"6-out187"	.24299	52	162	214
6	"6-out188"	.07485	25	309	334
6	"6-out189"	.08917	28	286	314
6	"6-out190"	.09217	33	325	358
6	"6-out191"	.08442	122	1323	1445
6	"6-out192"	.07479	100	1237	1337
6	"6-out193"	.36705	733	1264	1997
6	"6-out194"	.12633	83	574	657
6	"6-out195"	.06930	135	1813	1948
6	"6-out196"	.09375	12	116	128
6	"6-out197"	.11076	36	289	325
6	"6-out198"	.08333	24	264	288
6	"6-out199"	.09330	216	2099	2315
6	"6-out200"	.12627	37	256	293
6	"6-out201"	.18620	27	118	145
6	"6-out202"	.06642	18	253	271
6	"6-out203"	.05176	22	403	425
6	"6-out204"	.15577	62	336	398
6	"6-out205"	.44973	501	613	1114
6	"6-out206"	.46261	99	115	214
6	"6-out207"	.10674	38	318	356
6	"6-out208"	.16193	57	295	352
6	"6-out209"	.04802	17	337	354
6	"6-out210"	.14395	56	333	389
6	"6-out211"	.35981	154	274	428
6	"6-out212"	.50338	521	514	1035
6	"6-out213"	.10358	52	450	502
6	"6-out214"	.13319	63	410	473
6	"6-out215"	.11602	118	899	1017
6	"6-out216"	.49103	137	142	279
6	"6-out217"	.49103	137	142	279
6	"6-out218"	.31188	63	139	202
6	"6-out219"	.45714	64	76	140
6	"6-out220"	.38007	103	168	271
6	"6-out221"	.03662	23	605	628
6	"6-out222"	.17965	83	379	462
6	"6-out223"	.42020	208	287	495
6	"6-out224"	.11344	27	211	238
6	"6-out225"	.10016	61	548	609
6	"6-out226"	.31200	117	258	375
6	"6-out227"	.48132	116	125	241
6	"6-out228"	.07345	44	555	599
6	"6-out229"	.06227	51	768	819
6	"6-out230"	.11447	208	1609	1817
6	"6-out231"	.33956	109	212	321
6	"6-out232"	.16507	52	263	315
6	"6-out233"	.36241	108	190	298
6	"6-out234"	.35534	113	205	318
6	"6-out235"	.43492	137	178	315
6	"6-out236"	.35782	112	201	313
6	"6-out237"	.44089	138	175	313
6	"6-out238"	.08024	26	298	324
6	"6-out239"	.33229	107	215	322
6	"6-out240"	.21316	68	251	319
6	"6-out241"	.36807	113	194	307
6	"6-out242"	.11003	34	275	309
6	"6-out243"	.30420	94	215	309
6	"6-out244"	.40939	122	176	298
6	"6-out245"	.38109	125	203	328
6	"6-out246"	.05144	16	295	311
6	"6-out247"	.11075	35	281	316
6	"6-out248"	.13548	42	268	310
6	"6-out249"	.09567	31	293	324
6	"6-out250"	.14364	52	310	362
6	"6-out251"	.34838	108	202	310
6	"6-out252"	.43769	137	176	313
6	"6-out253"	.41987	131	181	312
6	"6-out254"	.47115	147	165	312
6	"6-out255"	.45833	143	169	312
6	"6-out256"	.35897	112	200	312
6	"6-out257"	.46794	146	166	312
6	"6-out258"	.42628	133	179	312
6	"6-out259"	.39528	134	205	339
6	"6-out260"	.32894	100	204	304
6	"6-out261"	.09640	59	553	612
6	"6-out262"	.12252	31	222	253
6	"6-out263"	.10800	27	223	250
6	"6-out264"	.53296	194	170	364
6	"6-out265"	.52747	192	172	364
6	"6-out266"	.09198	31	306	337
6	"6-out267"	.07142	50	650	700
6	"6-out268"	.29957	213	498	711
6	"6-out269"	.20029	138	551	689
6	"6-out270"	.13167	37	244	281
6	"6-out271"	.09126	23	229	252
6	"6-out272"	.53598	216	187	403
6	"6-out273"	.11174	39	310	349
6	"6-out274"	.09146	30	298	328
6	"6-out275"	.21374	28	103	131
6	"6-out276"	.45896	274	323	597
6	"6-out277"	.23777	209	670	879
6	"6-out278"	.14003	92	565	657
6	"6-out279"	.17593	136	637	773
6	"6-out280"	.06417	24	350	374
6	"6-out281"	.42761	576	771	1347
6	"6-out282"	.45074	604	736	1340
6	"6-out283"	.07115	74	966	1040
6	"6-out284"	.05152	61	1123	1184
6	"6-out285"	.13151	53	350	403
6	"6-out286"	.06744	29	401	430
6	"6-out287"	.09478	69	659	728
6	"6-out288"	.11498	132	1016	1148
6	"6-out289"	.34445	320	609	929
6	"6-out290"	.31960	295	628	923
6	"6-out291"	.30537	284	646	930
6	"6-out292"	.03842	37	926	963
6	"6-out293"	.18376	172	764	936
6	"6-out294"	.08407	104	1133	1237
6	"6-out295"	.28281	265	672	937
6	"6-out296"	.28000	266	684	950
6	"6-out297"	.08677	21	221	242
6	"6-out298"	.11093	69	553	622
6	"6-out299"	.21606	78	283	361
6	"6-out300"	.44943	80	98	178
6	"6-out301"	.03676	5	131	136
6	"6-out302"	.06680	33	461	494
6	"6-out303"	.10989	30	243	273
6	"6-out304"	.07341	29	366	395
6	"6-out305"	.07889	37	432	469
6	"6-out306"	.06538	61	872	933
6	"6-out307"	.29600	37	88	125
6	"6-out308"	.60732	116	75	191
6	"6-out309"	.06716	36	500	536
6	"6-out310"	.34024	82	159	241
6	"6-out311"	.12078	86	626	712
6	"6-out312"	.08776	71	738	809
6	"6-out313"	.14118	157	955	1112
6	"6-out314"	.10494	87	742	829
6	"6-out315"	.08587	76	809	885
6	"6-out316"	.07567	28	342	370
6	"6-out317"	.05333	8	142	150
6	"6-out318"	.11848	25	186	211
6	"6-out319"	.06650	28	393	421
6	"6-out320"	.44752	226	279	505
6	"6-out321"	.10373	25	216	241
6	"6-out322"	.04668	19	388	407
6	"6-out323"	.10606	35	295	330
6	"6-out324"	.14765	88	508	596
6	"6-out325"	.43434	172	224	396
6	"6-out326"	.08641	14	148	162
6	"6-out327"	.04807	15	297	312
6	"6-out328"	.11023	28	226	254
6	"6-out329"	.45876	178	210	388
6	"6-out330"	.07042	50	660	710
6	"6-out331"	.07731	30	358	388
6	"6-out332"	.15925	136	718	854
6	"6-out333"	.34074	46	89	135
6	"6-out334"	.17099	125	606	731
6	"6-out335"	.11805	34	254	288
6	"6-out336"	.03773	14	357	371
6	"6-out337"	.31823	253	542	795
6	"6-out338"	.37531	298	496	794
6	"6-out339"	.33207	264	531	795
6	"6-out340"	.36684	343	592	935
6	"6-out341"	.40694	387	564	951
6	"6-out342"	.40190	295	439	734
6	"6-out343"	.10253	299	2617	2916
6	"6-out344"	.27243	258	689	947
6	"6-out345"	.29157	277	673	950
6	"6-out346"	.33690	314	618	932
6	"6-out347"	.26495	248	688	936
6	"6-out348"	.11807	49	366	415
6	"6-out349"	.07514	52	640	692
6	"6-out350"	.08329	178	1959	2137
6	"6-out351"	.09702	49	456	505
6	"6-out352"	.05862	17	273	290
6	"6-out353"	.10306	37	322	359
6	"6-out354"	.23847	207	661	868
6	"6-out355"	.04433	27	582	609
6	"6-out356"	.10841	58	477	535
6	"6-out357"	.12035	55	402	457
6	"6-out358"	.52719	126	113	239
6	"6-out359"	.09510	70	666	736
6	"6-out360"	.14857	130	745	875
6	"6-out361"	.14651	126	734	860
6	"6-out362"	.04794	28	556	584
6	"6-out363"	.06299	32	476	508
6	"6-out364"	.09090	32	320	352
6	"6-out365"	.04545	20	420	440
6	"6-out366"	.03571	3	81	84
6	"6-out367"	.10586	56	473	529
6	"6-out368"	.03007	4	129	133
6	"6-out369"	.20848	59	224	283
6	"6-out370"	.44776	210	259	469
6	"6-out371"	.35000	49	91	140
6	"6-out372"	.09827	279	2560	2839
6	"6-out373"	.44110	382	484	866
6	"6-out374"	.18371	264	1173	1437
6	"6-out375"	.25274	161	476	637
6	"6-out376"	.05484	116	1999	2115
6	"6-out377"	.26495	62	172	234
6	"6-out378"	.20784	53	202	255
6	"6-out379"	.14942	39	222	261
6	"6-out380"	.30368	99	227	326
6	"6-out381"	.16564	54	272	326
6	"6-out382"	.20263	77	303	380
6	"6-out383"	.18287	47	210	257
6	"6-out384"	.10204	40	352	392
6	"6-out385"	.06688	20	279	299
6	"6-out386"	.11827	33	246	279
6	"6-out387"	.13385	34	220	254
6	"6-out388"	.04615	6	124	130
6	"6-out389"	.08333	29	319	348
6	"6-out390"	.14243	48	289	337
6	"6-out391"	.39726	29	44	73
6	"6-out392"	.14814	12	69	81
6	"6-out393"	.09064	31	311	342
6	"6-out394"	.22636	91	311	402
6	"6-out395"	.53296	194	170	364
6	"6-out396"	.14877	79	452	531
6	"6-out397"	.09604	51	480	531
6	"6-out398"	.08333	46	506	552
6	"6-out399"	.07671	111	1336	1447
6	"6-out400"	.32954	29	59	88
6	"6-out401"	.09620	33	310	343
6	"6-out402"	.07476	32	396	428
6	"6-out403"	.10793	34	281	315
6	"6-out404"	.06102	49	754	803
6	"6-out405"	.07410	81	1012	1093
6	"6-out406"	.08484	61	658	719
6	"6-out407"	.07532	29	356	385
6	"6-out408"	.26315	25	70	95
6	"6-out409"	.11128	72	575	647
6	"6-out410"	.13684	221	1394	1615
6	"6-out411"	.23076	21	70	91
6	"6-out412"	.09278	9	88	97
6	"6-out413"	.05627	13	218	231
6	"6-out414"	.30357	34	78	112
6	"6-out415"	.41025	48	69	117
6	"6-out416"	.11751	214	1607	1821
6	"6-out417"	.17785	106	490	596
6	"6-out418"	.07453	24	298	322
6	"6-out419"	.35810	53	95	148
6	"6-out420"	.13047	158	1053	1211
6	"6-out421"	.19023	74	315	389
6	"6-out422"	.13669	19	120	139
6	"6-out423"	.01162	2	170	172
6	"6-out424"	.16232	106	547	653
6	"6-out425"	.11076	36	289	325
6	"6-out426"	.10723	40	333	373
6	"6-out427"	.17868	57	262	319
6	"6-out428"	.23229	82	271	353
6	"6-out429"	.08235	21	234	255
6	"6-out430"	.08810	311	3219	3530
6	"6-out431"	.15832	307	1632	1939
6	"6-out432"	.19082	370	1569	1939
6	"6-out433"	.14665	237	1379	1616
6	"6-out434"	.08724	117	1224	1341
6	"6-out435"	.09576	244	2304	2548
6	"6-out436"	.12337	19	135	154
6	"6-out437"	.27464	429	1133	1562
6	"6-out438"	.06620	48	677	725
6	"6-out439"	.28402	48	121	169
6	"6-out440"	.08391	24	262	286
6	"6-out441"	.08333	110	1210	1320
6	"6-out442"	.32179	316	666	982
6	"6-out443"	.05099	36	670	706
6	"6-out444"	.47335	302	336	638
6	"6-out445"	.42517	179	242	421
6	"6-out446"	.37456	324	541	865
6	"6-out447"	.37313	250	420	670
6	"6-out448"	.10076	53	473	526
6	"6-out449"	.05349	39	690	729
6	"6-out450"	.05022	34	643	677
6	"6-out451"	.11995	800	5869	6669
6	"6-out452"	.09259	10	98	108
6	"6-out453"	.09600	77	725	802
6	"6-out454"	.45652	588	700	1288
6	"6-out455"	.11940	48	354	402
6	"6-out456"	.13243	49	321	370
6	"6-out457"	.05459	19	329	348
6	"6-out458"	.03915	13	319	332
6	"6-out459"	.24358	76	236	312
6	"6-out460"	.36538	114	198	312
6	"6-out461"	.28343	89	225	314
6	"6-out462"	.35294	114	209	323
6	"6-out463"	.43731	150	193	343
6	"6-out464"	.18910	59	253	312
6	"6-out465"	.32692	102	210	312
6	"6-out466"	.13333	48	312	360
6	"6-out467"	.25723	80	231	311
6	"6-out468"	.23054	80	267	347
6	"6-out469"	.11254	35	276	311
6	"6-out470"	.10303	34	296	330
6	"6-out471"	.30817	98	220	318
6	"6-out472"	.21543	67	244	311
6	"6-out473"	.14845	53	304	357
6	"6-out474"	.31730	99	213	312
6	"6-out475"	.07886	25	292	317
6	"6-out476"	.29807	93	219	312
6	"6-out477"	.10312	33	287	320
6	"6-out478"	.26948	83	225	308
6	"6-out479"	.08181	27	303	330
6	"6-out480"	.31861	101	216	317
6	"6-out481"	.06796	21	288	309
6	"6-out482"	.18037	57	259	316
6	"6-out483"	.25000	79	237	316
6	"6-out484"	.26923	84	228	312
6	"6-out485"	.17101	59	286	345
6	"6-out486"	.28846	90	222	312
6	"6-out487"	.24679	77	235	312
6	"6-out488"	.32051	100	212	312
6	"6-out489"	.38616	134	213	347
6	"6-out490"	.08360	26	285	311
6	"6-out491"	.35256	110	202	312
6	"6-out492"	.15673	50	269	319
6	"6-out493"	.12466	46	323	369
6	"6-out494"	.34482	120	228	348
6	"6-out495"	.14610	45	263	308
6	"6-out496"	.35389	109	199	308
6	"6-out497"	.48437	155	165	320
6	"6-out498"	.34591	110	208	318
6	"6-out499"	.37356	130	218	348
6	"6-out500"	.37123	111	188	299
6	"6-out501"	.13907	42	260	302
6	"6-out502"	.48159	157	169	326
6	"6-out503"	.15806	49	261	310
6	"6-out504"	.32362	100	209	309
6	"6-out505"	.19677	61	249	310
6	"6-out506"	.28980	91	223	314
6	"6-out507"	.10191	32	282	314
6	"6-out508"	.16346	51	261	312
6	"6-out509"	.41401	130	184	314
6	"6-out510"	.21839	76	272	348
6	"6-out511"	.43589	136	176	312
6	"6-out512"	.45047	141	172	313
6	"6-out513"	.35126	111	205	316
6	"6-out514"	.16883	52	256	308
6	"6-out515"	.41800	130	181	311
6	"6-out516"	.06666	21	294	315
6	"6-out517"	.36624	115	199	314
6	"6-out518"	.11783	37	277	314
6	"6-out519"	.11146	35	279	314
6	"6-out520"	.24920	78	235	313
6	"6-out521"	.40764	128	186	314
6	"6-out522"	.25477	80	234	314
6	"6-out523"	.13057	41	273	314
6	"6-out524"	.22741	73	248	321
6	"6-out525"	.22741	73	248	321
6	"6-out526"	.32899	101	206	307
6	"6-out527"	.26045	81	230	311
6	"6-out528"	.10491	32	273	305
6	"6-out529"	.19292	60	251	311
6	"6-out530"	.09567	31	293	324
6	"6-out531"	.27914	91	235	326
6	"6-out532"	.36764	125	215	340
6	"6-out533"	.05144	16	295	311
6	"6-out534"	.25961	81	231	312
6	"6-out535"	.44871	140	172	312
6	"6-out536"	.38834	120	189	309
6	"6-out537"	.34582	120	227	347
6	"6-out538"	.22356	74	257	331
6	"6-out539"	.10576	33	279	312
6	"6-out540"	.09463	30	287	317
6	"6-out541"	.11538	36	276	312
6	"6-out542"	.17868	57	262	319
6	"6-out543"	.24271	75	234	309
6	"6-out544"	.36858	115	197	312
6	"6-out545"	.31832	99	212	311
6	"6-out546"	.32051	100	212	312
6	"6-out547"	.34193	106	204	310
6	"6-out548"	.33440	104	207	311
6	"6-out549"	.18037	57	259	316
6	"6-out550"	.14626	49	286	335
6	"6-out551"	.09032	28	282	310
6	"6-out552"	.21656	68	246	314
6	"6-out553"	.10169	30	265	295
6	"6-out554"	.27567	102	268	370
6	"6-out555"	.04269	33	740	773
6	"6-out556"	.04867	22	430	452
6	"6-out557"	.06632	26	366	392
6	"6-out558"	.10220	65	571	636
6	"6-out559"	.07594	66	803	869
6	"6-out560"	.06830	61	832	893
6	"6-out561"	.08189	38	426	464
6	"6-out562"	.47222	51	57	108
6	"6-out563"	.13455	250	1608	1858
6	"6-out564"	.07216	28	360	388
6	"6-out565"	.07585	109	1328	1437
6	"6-out566"	.37595	882	1464	2346
6	"6-out567"	.05978	11	173	184
6	"6-out568"	.04901	35	679	714
6	"6-out569"	.09657	107	1001	1108
6	"6-out570"	.13203	244	1604	1848
6	"6-out571"	.15447	321	1757	2078
6	"6-out572"	.13168	32	211	243
6	"6-out573"	.14502	86	507	593
6	"6-out574"	.05911	12	191	203
6	"6-out575"	.11384	74	576	650
6	"6-out576"	.26233	101	284	385
6	"6-out577"	.08130	30	339	369
6	"6-out578"	.06443	25	363	388
6	"6-out579"	.41735	101	141	242
6	"6-out580"	.53296	194	170	364
6	"6-out581"	.14731	85	492	577
6	"6-out582"	.18122	56	253	309
6	"6-out583"	.21359	66	243	309
6	"6-out584"	.34083	106	205	311
6	"6-out585"	.33234	112	225	337
6	"6-out586"	.13099	41	272	313
6	"6-out587"	.12112	43	312	355
6	"6-out588"	.16770	54	268	322
6	"6-out589"	.08306	26	287	313
6	"6-out590"	.06962	22	294	316
6	"6-out591"	.12621	39	270	309
6	"6-out592"	.39354	122	188	310
6	"6-out593"	.39354	122	188	310
6	"6-out594"	.12500	39	273	312
6	"6-out595"	.32051	100	212	312
6	"6-out596"	.08125	26	294	320
6	"6-out597"	.06687	21	293	314
6	"6-out598"	.10191	32	282	314
6	"6-out599"	.15238	48	267	315
6	"6-out600"	.27414	88	233	321
6	"6-out601"	.19292	60	251	311
6	"6-out602"	.30491	93	212	305
6	"6-out603"	.24342	74	230	304
6	"6-out604"	.39297	123	190	313
6	"6-out605"	.41025	128	184	312
6	"6-out606"	.12459	38	267	305
6	"6-out607"	.12541	38	265	303
6	"6-out608"	.12345	40	284	324
6	"6-out609"	.38834	120	189	309
6	"6-out610"	.42038	132	182	314
6	"6-out611"	.07766	24	285	309
6	"6-out612"	.04062	13	307	320
6	"6-out613"	.12738	40	274	314
6	"6-out614"	.34146	112	216	328
6	"6-out615"	.40822	129	187	316
6	"6-out616"	.14953	48	273	321
6	"6-out617"	.11290	35	275	310
6	"6-out618"	.08562	28	299	327
6	"6-out619"	.26888	89	242	331
6	"6-out620"	.43408	135	176	311
6	"6-out621"	.06818	21	287	308
6	"6-out622"	.22740	78	265	343
6	"6-out623"	.11182	35	278	313
6	"6-out624"	.06948	23	308	331
6	"6-out625"	.08306	26	287	313
6	"6-out626"	.09717	31	288	319
6	"6-out627"	.25641	80	232	312
6	"6-out628"	.39936	125	188	313
6	"6-out629"	.08090	25	284	309
6	"6-out630"	.13183	41	270	311
6	"6-out631"	.08116	25	283	308
6	"6-out632"	.09967	31	280	311
6	"6-out633"	.24126	76	239	315
6	"6-out634"	.08653	27	285	312
6	"6-out635"	.06963	25	334	359
6	"6-out636"	.21035	65	244	309
6	"6-out637"	.29126	90	219	309
6	"6-out638"	.16878	53	261	314
6	"6-out639"	.09785	32	295	327
6	"6-out640"	.17049	52	253	305
6	"6-out641"	.10509	33	281	314
6	"6-out642"	.11417	29	225	254
6	"6-out643"	.10336	89	772	861
6	"6-out644"	.17940	54	247	301
6	"6-out645"	.80392	82	20	102
6	"6-out646"	.07142	39	507	546
6	"6-out647"	.12447	89	626	715
6	"6-out648"	.11178	74	588	662
6	"6-out649"	.09510	33	314	347
6	"6-out650"	.09599	115	1083	1198
6	"6-out651"	.10227	72	632	704
6	"6-out652"	.16393	90	459	549
6	"6-out653"	.14543	113	664	777
6	"6-out654"	.07334	52	657	709
6	"6-out655"	.03899	14	345	359
6	"6-out656"	.07185	36	465	501
6	"6-out657"	.62770	145	86	231
6	"6-out658"	.37055	375	637	1012
6	"6-out659"	.11409	102	792	894
6	"6-out660"	.08285	29	321	350
6	"6-out661"	.13915	145	897	1042
6	"6-out662"	.07228	54	693	747
6	"6-out663"	.09291	118	1152	1270
6	"6-out664"	.26615	70	193	263
6	"6-out665"	.07029	71	939	1010
6	"6-out666"	.26014	141	401	542
6	"6-out667"	.11373	77	600	677
6	"6-out668"	.33789	1851	3627	5478
6	"6-out669"	.10546	54	458	512
6	"6-out670"	.18181	82	369	451
6	"6-out671"	.45116	6545	7962	14507
6	"6-out672"	.18050	811	3682	4493
6	"6-out673"	.07585	49	597	646
6	"6-out674"	.38215	3204	5180	8384
6	"6-out675"	.10756	135	1120	1255
6	"6-out676"	.18551	105	461	566
6	"6-out677"	.44049	781	992	1773
6	"6-out678"	.36590	1895	3284	5179
6	"6-out679"	.49469	1073	1096	2169
6	"6-out680"	.37141	2100	3554	5654
6	"6-out681"	.16710	63	314	377
6	"6-out682"	.22222	58	203	261
6	"6-out683"	.08888	8	82	90
6	"6-out684"	.17408	90	427	517
6	"6-out685"	.04403	24	521	545
6	"6-out686"	.07142	18	234	252
6	"6-out687"	.17460	88	416	504
6	"6-out688"	.15991	79	415	494
6	"6-out689"	.15189	24	134	158
6	"6-out690"	.26815	48	131	179
6	"6-out691"	.16312	23	118	141
6	"6-out692"	.15362	53	292	345
6	"6-out693"	.24742	24	73	97
6	"6-out694"	.05329	55	977	1032
6	"6-out695"	.06571	55	782	837
6	"6-out696"	.57169	311	233	544
6	"6-out697"	.06936	24	322	346
6	"6-out698"	.28076	162	415	577
6	"6-out699"	.35474	254	462	716
6	"6-out700"	.24252	73	228	301
6	"6-out701"	.25936	90	257	347
6	"6-out702"	.35220	112	206	318
6	"6-out703"	.37341	118	198	316
6	"6-out704"	.24924	82	247	329
6	"6-out705"	.39549	123	188	311
6	"6-out706"	.10355	32	277	309
6	"6-out707"	.07894	12	140	152
6	"6-out708"	.08633	72	762	834
6	"6-out709"	.36593	116	201	317
6	"6-out710"	.07926	26	302	328
6	"6-out711"	.09829	69	633	702
6	"6-out712"	.17708	34	158	192
6	"6-out713"	.31147	19	42	61
6	"6-out714"	.15596	34	184	218
6	"6-out715"	.16326	40	205	245
6	"6-out716"	.10227	27	237	264
6	"6-out717"	.08921	163	1664	1827
6	"6-out718"	.14823	134	770	904
6	"6-out719"	.18918	63	270	333
6	"6-out720"	.13989	108	664	772
6	"6-out721"	.12751	95	650	745
6	"6-out722"	.10619	12	101	113
6	"6-out723"	.14893	35	200	235
6	"6-out724"	.14499	281	1657	1938
6	"6-out725"	.10277	200	1746	1946
6	"6-out726"	.07240	149	1909	2058
6	"6-out727"	.09558	197	1864	2061
6	"6-out728"	.08626	81	858	939
6	"6-out729"	.04491	15	319	334
6	"6-out730"	.65269	109	58	167
6	"6-out731"	.04456	16	343	359
6	"6-out732"	.62500	10	6	16
6	"6-out733"	.02739	4	142	146
6	"6-out734"	.14571	226	1325	1551
6	"6-out735"	.35640	103	186	289
6	"6-out736"	.07313	113	1432	1545
6	"6-out737"	.46583	150	172	322
6	"6-out738"	.40683	131	191	322
6	"6-out739"	.05500	22	378	400
6	"6-out740"	.10377	33	285	318
6	"6-out741"	.12101	38	276	314
6	"6-out742"	.16932	53	260	313
6	"6-out743"	.06481	21	303	324
6	"6-out744"	.39297	123	190	313
6	"6-out745"	.43333	143	187	330
6	"6-out746"	.17197	54	260	314
6	"6-out747"	.32615	106	219	325
6	"6-out748"	.42461	138	187	325
6	"6-out749"	.37419	116	194	310
6	"6-out750"	.08306	26	287	313
6	"6-out751"	.09265	29	284	313
6	"6-out752"	.30283	96	221	317
6	"6-out753"	.06624	21	296	317
6	"6-out754"	.28481	90	226	316
6	"6-out755"	.25320	79	233	312
6	"6-out756"	.32371	101	211	312
6	"6-out757"	.29903	93	218	311
6	"6-out758"	.34294	107	205	312
6	"6-out759"	.27243	85	227	312
6	"6-out760"	.36111	117	207	324
6	"6-out761"	.39622	126	192	318
6	"6-out762"	.34920	110	205	315
6	"6-out763"	.31410	98	214	312
6	"6-out764"	.22222	70	245	315
6	"6-out765"	.22857	72	243	315
6	"6-out766"	.09003	28	283	311
6	"6-out767"	.27414	88	233	321
6	"6-out768"	.39682	125	190	315
6	"6-out769"	.39682	125	190	315
6	"6-out770"	.15533	48	261	309
6	"6-out771"	.29773	92	217	309
6	"6-out772"	.39805	123	186	309
6	"6-out773"	.12025	38	278	316
6	"6-out774"	.17096	53	257	310
6	"6-out775"	.26710	82	225	307
6	"6-out776"	.09748	31	287	318
6	"6-out777"	.25723	80	231	311
6	"6-out778"	.36825	116	199	315
6	"6-out779"	.06070	19	294	313
6	"6-out780"	.41666	130	182	312
6	"6-out781"	.29180	89	216	305
6	"6-out782"	.12218	38	273	311
6	"6-out783"	.38095	120	195	315
6	"6-out784"	.06501	21	302	323
6	"6-out785"	.11935	37	273	310
6	"6-out786"	.14603	46	269	315
6	"6-out787"	.34853	107	200	307
6	"6-out788"	.36807	113	194	307
6	"6-out789"	.38977	122	191	313
6	"6-out790"	.25242	78	231	309
6	"6-out791"	.21656	68	246	314
6	"6-out792"	.39936	125	188	313
6	"6-out793"	.38461	125	200	325
6	"6-out794"	.39610	122	186	308
6	"6-out795"	.14423	45	267	312
6	"6-out796"	.34740	107	201	308
6	"6-out797"	.21543	67	244	311
6	"6-out798"	.27652	86	225	311
6	"6-out799"	.26349	83	232	315
6	"6-out800"	.15161	47	263	310
6	"6-out801"	.29841	94	221	315
6	"6-out802"	.13975	45	277	322
6	"6-out803"	.25905	93	266	359
6	"6-out804"	.57371	179	133	312
6	"6-out805"	.50000	157	157	314
6	"6-out806"	.04012	13	311	324
6	"6-out807"	.13249	42	275	317
6	"6-out808"	.08201	26	291	317
6	"6-out809"	.03405	11	312	323
6	"6-out810"	.09846	32	293	325
6	"6-out811"	.24193	75	235	310
6	"6-out812"	.21359	66	243	309
6	"6-out813"	.20625	66	254	320
6	"6-out814"	.35185	114	210	324
6	"6-out815"	.15950	52	274	326
6	"6-out816"	.37699	118	195	313
6	"6-out817"	.18064	56	254	310
6	"6-out818"	.16560	52	262	314
6	"6-out819"	.45664	158	188	346
6	"6-out820"	.23472	73	238	311
6	"6-out821"	.37500	117	195	312
6	"6-out822"	.33012	103	209	312
6	"6-out823"	.34516	107	203	310
6	"6-out824"	.21587	68	247	315
6	"6-out825"	.09404	30	289	319
6	"6-out826"	.12377	38	269	307
6	"6-out827"	.22257	71	248	319
6	"6-out828"	.42585	112	151	263
6	"6-out829"	.20322	63	247	310
6	"6-out830"	.21311	65	240	305
6	"6-out831"	.05882	9	144	153
6	"6-out832"	.10457	16	137	153
6	"6-out833"	.10299	31	270	301
6	"6-out834"	.14345	34	203	237
6	"6-out835"	.37209	80	135	215
6	"6-out836"	.07511	32	394	426
6	"6-out837"	.08916	51	521	572
6	"6-out838"	.07259	40	511	551
6	"6-out839"	.05298	32	572	604
6	"6-out840"	.24422	74	229	303
6	"6-out841"	.06125	37	567	604
6	"6-out842"	.32571	114	236	350
6	"6-out843"	.11417	58	450	508
6	"6-out844"	.10546	195	1654	1849
6	"6-out845"	.07698	92	1103	1195
6	"6-out846"	.04134	27	626	653
6	"6-out847"	.11433	71	550	621
6	"6-out848"	.12727	84	576	660
6	"6-out849"	.16960	77	377	454
6	"6-out850"	.09025	63	635	698
6	"6-out851"	.11163	47	374	421
6	"6-out852"	.04123	16	372	388
6	"6-out853"	.12636	173	1196	1369
6	"6-out854"	.04662	20	409	429
6	"6-out855"	.34120	159	307	466
6	"6-out856"	.13646	125	791	916
6	"6-out857"	.31029	220	489	709
6	"6-out858"	.11167	22	175	197
6	"6-out859"	.49503	1645	1678	3323
6	"6-out860"	.46806	579	658	1237
6	"6-out861"	.24418	1407	4355	5762
6	"6-out862"	.17466	426	2013	2439
6	"6-out863"	.03977	14	338	352
6	"6-out864"	.15441	42	230	272
6	"6-out865"	.10122	66	586	652
6	"6-out866"	.10256	28	245	273
6	"6-out867"	.17938	94	430	524
6	"6-out868"	.10312	99	861	960
6	"6-out869"	.10251	49	429	478
6	"6-out870"	.07044	41	541	582
6	"6-out871"	.39384	128	197	325
6	"6-out872"	.05529	12	205	217
6	"6-out873"	.03896	12	296	308
6	"6-out874"	.61616	61	38	99
6	"6-out875"	.11414	96	745	841
6	"6-out876"	.13376	82	531	613
6	"6-out877"	.07339	8	101	109
6	"6-out878"	.10465	54	462	516
6	"6-out879"	.23000	92	308	400
6	"6-out880"	.12658	40	276	316
6	"6-out881"	.39261	117	181	298
6	"6-out882"	.38730	122	193	315
6	"6-out883"	.44202	122	154	276
6	"6-out884"	.13099	41	272	313
6	"6-out885"	.07592	41	499	540
6	"6-out886"	.12460	39	274	313
6	"6-out887"	.36809	120	206	326
6	"6-out888"	.20371	241	942	1183
6	"6-out889"	.16176	33	171	204
6	"6-out890"	.20952	88	332	420
6	"6-out891"	.09448	36	345	381
6	"6-out892"	.11194	45	357	402
6	"6-out893"	.07881	32	374	406
6	"6-out894"	.05686	29	481	510
6	"6-out895"	.15867	43	228	271
6	"6-out896"	.16718	54	269	323
6	"6-out897"	.08266	62	688	750
6	"6-out898"	.14014	59	362	421
6	"6-out899"	.12727	56	384	440
6	"6-out900"	.11042	18	145	163
6	"6-out901"	.46788	51	58	109
6	"6-out902"	.20134	30	119	149
6	"6-out903"	.63414	78	45	123
6	"6-out904"	.47668	92	101	193
6	"6-out905"	.09604	34	320	354
6	"6-out906"	.07258	27	345	372
6	"6-out907"	.05526	21	359	380
6	"6-out908"	.11494	40	308	348
6	"6-out909"	.18251	71	318	389
6	"6-out910"	.14960	285	1620	1905
6	"6-out911"	.07434	31	386	417
6	"6-out912"	.07727	50	597	647
6	"6-out913"	.10457	16	137	153
6	"6-out914"	.08771	50	520	570
6	"6-out915"	.08124	55	622	677
6	"6-out916"	.17869	104	478	582
6	"6-out917"	.10571	172	1455	1627
6	"6-out918"	.07785	103	1220	1323
6	"6-out919"	.15873	20	106	126
6	"6-out920"	.04081	4	94	98
6	"6-out921"	.08771	20	208	228
6	"6-out922"	.41899	150	208	358
6	"6-out923"	.09797	29	267	296
6	"6-out924"	.11612	229	1743	1972
6	"6-out925"	.37921	416	681	1097
6	"6-out926"	.16658	323	1616	1939
6	"6-out927"	.09395	56	540	596
6	"6-out928"	.09735	206	1910	2116
6	"6-out929"	.07121	120	1565	1685
6	"6-out930"	.06985	38	506	544
6	"6-out931"	.10655	65	545	610
6	"6-out932"	.11266	209	1646	1855
6	"6-out933"	.09364	28	271	299
6	"6-out934"	.17424	46	218	264
6	"6-out935"	.05753	29	475	504
6	"6-out936"	.56432	329	254	583
6	"6-out937"	.06265	25	374	399
6	"6-out938"	.39436	84	129	213
6	"6-out939"	.11910	48	355	403
6	"6-out940"	.31649	94	203	297
6	"6-out941"	.06944	15	201	216
6	"6-out942"	.39772	35	53	88
6	"6-out943"	.03773	8	204	212
6	"6-out944"	.07870	17	199	216
6	"6-out945"	.06273	17	254	271
6	"6-out946"	.03974	19	459	478
6	"6-out947"	.22391	88	305	393
6	"6-out948"	.03726	6	155	161
6	"6-out949"	.26072	79	224	303
6	"6-out950"	.40705	127	185	312
6	"6-out951"	.28617	89	222	311
6	"6-out952"	.14062	45	275	320
6	"6-out953"	.19230	60	252	312
6	"6-out954"	.12140	38	275	313
6	"6-out955"	.35582	116	210	326
6	"6-out956"	.22093	190	670	860
6	"6-out957"	.06205	26	393	419
6	"6-out958"	.28034	97	249	346
6	"6-out959"	.42400	53	72	125
6	"6-out960"	.09025	25	252	277
6	"6-out961"	.10795	19	157	176
6	"6-out962"	.07234	17	218	235
6	"6-out963"	.04069	7	165	172
6	"6-out964"	.10500	42	358	400
6	"6-out965"	.07707	114	1365	1479
6	"6-out966"	.05539	19	324	343
6	"6-out967"	.29503	95	227	322
6	"6-out968"	.43939	145	185	330
6	"6-out969"	.28717	56	139	195
6	"6-out970"	.07913	22	256	278
6	"6-out971"	.15277	143	793	936
6	"6-out972"	.10294	140	1220	1360
6	"6-out973"	.37500	21	35	56
6	"6-out974"	.25000	51	153	204
6	"6-out975"	.12364	91	645	736
6	"6-out976"	.10533	79	671	750
6	"6-out977"	.05750	23	377	400
6	"6-out978"	.07205	148	1906	2054
6	"6-out979"	.09954	22	199	221
6	"6-out980"	.07030	103	1362	1465
6	"6-out981"	.22429	48	166	214
6	"6-out982"	.37804	31	51	82
6	"6-out983"	.10212	24	211	235
6	"6-out984"	.08437	27	293	320
6	"6-out985"	.16528	40	202	242
6	"6-out986"	.08356	30	329	359
6	"6-out987"	.12718	131	899	1030
6	"6-out988"	.05685	17	282	299
6	"6-out989"	.09618	63	592	655
6	"6-out990"	.50916	250	241	491
6	"6-out991"	.03225	6	180	186
6	"6-out992"	.08586	48	511	559
6	"6-out993"	.09677	33	308	341
6	"6-out994"	.11507	58	446	504
6	"6-out995"	.04761	30	600	630
6	"6-out996"	.18241	112	502	614
6	"6-out997"	.17543	20	94	114
6	"6-out998"	.19083	25	106	131
6	"6-out999"	.48811	349	366	715
6	"6-out1000"	.21722	58	209	267
6	"6-out1001"	.40816	20	29	49
6	"6-out1002"	.56457	153	118	271
6	"6-out1003"	.31147	19	42	61
6	"6-out1004"	.23754	124	398	522
6	"6-out1005"	.42201	46	63	109
6	"6-out1006"	.01869	2	105	107
6	"6-out1007"	.06923	27	363	390
6	"6-out1008"	.21229	38	141	179
6	"6-out1009"	.09483	68	649	717
6	"6-out1010"	.12711	15	103	118
6	"6-out1011"	.08011	29	333	362
6	"6-out1012"	.09400	58	559	617
6	"6-out1013"	.08476	64	691	755
6	"6-out1014"	.03816	5	126	131
6	"6-out1015"	.06410	20	292	312
6	"6-out1016"	.17428	61	289	350
6	"6-out1017"	.17241	55	264	319
6	"6-out1018"	.12173	42	303	345
6	"6-out1019"	.07671	28	337	365
6	"6-out1020"	.16467	55	279	334
6	"6-out1021"	.10994	115	931	1046
6	"6-out1022"	.50252	199	197	396
6	"6-out1023"	.47619	400	440	840
6	"6-out1024"	.08370	19	208	227
6	"6-out1025"	.08095	51	579	630
6	"6-out1026"	.08239	22	245	267
6	"6-out1027"	.15789	24	128	152
6	"6-out1028"	.12650	168	1160	1328
6	"6-out1029"	.05652	65	1085	1150
6	"6-out1030"	.10140	36	319	355
6	"6-out1031"	.13402	39	252	291
6	"6-out1032"	.35428	62	113	175
6	"6-out1033"	.14634	24	140	164
6	"6-out1034"	.28378	21	53	74
6	"6-out1035"	.14077	116	708	824
6	"6-out1036"	.08137	38	429	467
6	"6-out1037"	.06702	74	1030	1104
6	"6-out1038"	.31764	27	58	85
6	"6-out1039"	.07941	196	2272	2468
6	"6-out1040"	.06171	59	897	956
6	"6-out1041"	.50000	43	43	86
6	"6-out1042"	.07676	38	457	495
6	"6-out1043"	.08031	102	1168	1270
6	"6-out1044"	.04620	14	289	303
6	"6-out1045"	.07899	41	478	519
6	"6-out1046"	.10113	80	711	791
6	"6-out1047"	.08539	38	407	445
6	"6-out1048"	.04219	20	454	474
6	"6-out1049"	.09090	16	160	176
6	"6-out1050"	.34459	51	97	148
6	"6-out1051"	.14925	30	171	201
6	"6-out1052"	.18875	47	202	249
6	"6-out1053"	.58913	271	189	460
6	"6-out1054"	.06921	47	632	679
6	"6-out1055"	.09809	36	331	367
6	"6-out1056"	.64553	224	123	347
6	"6-out1057"	.08517	50	537	587
6	"6-out1058"	.07475	61	755	816
6	"6-out1059"	.11213	61	483	544
6	"6-out1060"	.10000	57	513	570
6	"6-out1061"	.12380	91	644	735
6	"6-out1062"	.06603	28	396	424
6	"6-out1063"	.09134	38	378	416
6	"6-out1064"	.10650	54	453	507
6	"6-out1065"	.21212	7	26	33
6	"6-out1066"	.47085	105	118	223
6	"6-out1067"	.19195	191	804	995
6	"6-out1068"	.08806	31	321	352
6	"6-out1069"	.17482	25	118	143
6	"6-out1070"	.51304	59	56	115
6	"6-out1071"	.08894	33	338	371
6	"6-out1072"	.07272	40	510	550
6	"6-out1073"	.09865	22	201	223
6	"6-out1074"	.16782	289	1433	1722
6	"6-out1075"	.07142	17	221	238
6	"6-out1076"	.06902	43	580	623
6	"6-out1077"	.16800	84	416	500
6	"6-out1078"	.09623	23	216	239
6	"6-out1079"	.10670	164	1373	1537
6	"6-out1080"	.24069	207	653	860
6	"6-out1081"	.11821	61	455	516
6	"6-out1082"	.12030	16	117	133
6	"6-out1083"	.14417	47	279	326
6	"6-out1084"	.17789	66	305	371
6	"6-out1085"	.30894	38	85	123
6	"6-out1086"	.37606	44	73	117
6	"6-out1087"	.39316	46	71	117
6	"6-out1088"	.04136	29	672	701
6	"6-out1089"	.13461	91	585	676
6	"6-out1090"	.22857	96	324	420
6	"6-out1091"	.47972	71	77	148
6	"6-out1092"	.12762	146	998	1144
6	"6-out1093"	.26530	39	108	147
6	"6-out1094"	.09555	99	937	1036
6	"6-out1095"	.06946	43	576	619
6	"6-out1096"	.21867	89	318	407
6	"6-out1097"	.41401	130	184	314
6	"6-out1098"	.46896	68	77	145
6	"6-out1099"	.12568	92	640	732
6	"6-out1100"	.43750	77	99	176
6	"6-out1101"	.27216	175	468	643
6	"6-out1102"	.10876	103	844	947
6	"6-out1103"	.06333	19	281	300
6	"6-out1104"	.21629	284	1029	1313
6	"6-out1105"	.04166	9	207	216
6	"6-out1106"	.17868	171	786	957
6	"6-out1107"	.11078	76	610	686
6	"6-out1108"	.15633	121	653	774
6	"6-out1109"	.06451	32	464	496
6	"6-out1110"	.03703	20	520	540
6	"6-out1111"	.07258	18	230	248
6	"6-out1112"	.32330	86	180	266
6	"6-out1113"	.09677	27	252	279
6	"6-out1114"	.51162	44	42	86
6	"6-out1115"	.07387	84	1053	1137
6	"6-out1116"	.16346	85	435	520
6	"6-out1117"	.16458	79	401	480
6	"6-out1118"	.06566	35	498	533
6	"6-out1119"	.10294	35	305	340
6	"6-out1120"	.18446	19	84	103
6	"6-out1121"	.16573	119	599	718
6	"6-out1122"	.11853	55	409	464
6	"6-out1123"	.08333	30	330	360
6	"6-out1124"	.05753	21	344	365
6	"6-out1125"	.10000	36	324	360
6	"6-out1126"	.22828	113	382	495
6	"6-out1127"	.42265	153	209	362
6	"6-out1128"	.09452	107	1025	1132
6	"6-out1129"	.07710	66	790	856
6	"6-out1130"	.35613	557	1007	1564
6	"6-out1131"	.09586	167	1575	1742
6	"6-out1132"	.29166	84	204	288
6	"6-out1133"	.06138	38	581	619
6	"6-out1134"	.28346	36	91	127
6	"6-out1135"	.47603	298	328	626
6	"6-out1136"	.48614	193	204	397
6	"6-out1137"	.06751	16	221	237
6	"6-out1138"	.29695	166	393	559
6	"6-out1139"	.11000	55	445	500
6	"6-out1140"	.05053	33	620	653
6	"6-out1141"	.10579	219	1851	2070
6	"6-out1142"	.11641	61	463	524
6	"6-out1143"	.26461	86	239	325
6	"6-out1144"	.07255	23	294	317
6	"6-out1145"	.08448	49	531	580
6	"6-out1146"	.26129	81	229	310
6	"6-out1147"	.09365	31	300	331
6	"6-out1148"	.16257	53	273	326
6	"6-out1149"	.31565	125	271	396
6	"6-out1150"	.27826	96	249	345
6	"6-out1151"	.36809	120	206	326
6	"6-out1152"	.19444	63	261	324
6	"6-out1153"	.21172	65	242	307
6	"6-out1154"	.20408	110	429	539
6	"6-out1155"	.10412	53	456	509
6	"6-out1156"	.16426	57	290	347
6	"6-out1157"	.33333	106	212	318
6	"6-out1158"	.04166	13	299	312
6	"6-out1159"	.18446	57	252	309
6	"6-out1160"	.32574	143	296	439
6	"6-out1161"	.10161	176	1556	1732
6	"6-out1162"	.09117	156	1555	1711
6	"6-out1163"	.16355	35	179	214
6	"6-out1164"	.50659	461	449	910
6	"6-out1165"	.31139	511	1130	1641
6	"6-out1166"	.12905	171	1154	1325
6	"6-out1167"	.10963	149	1210	1359
6	"6-out1168"	.13537	31	198	229
6	"6-out1169"	.09813	21	193	214
6	"6-out1170"	.32278	51	107	158
6	"6-out1171"	.13281	34	222	256
6	"6-out1172"	.21645	121	438	559
6	"6-out1173"	.29818	82	193	275
6	"6-out1174"	.08808	17	176	193
6	"6-out1175"	.11304	39	306	345
6	"6-out1176"	.10466	119	1018	1137
6	"6-out1177"	.13082	59	392	451
6	"6-out1178"	.17886	22	101	123
6	"6-out1179"	.23744	1892	6076	7968
6	"6-out1180"	.09546	181	1715	1896
6	"6-out1181"	.10482	50	427	477
6	"6-out1182"	.13414	11	71	82
6	"6-out1183"	.40526	231	339	570
6	"6-out1184"	.24193	15	47	62
6	"6-out1185"	.29694	68	161	229
6	"6-out1186"	.09523	6	57	63
6	"6-out1187"	.08333	22	242	264
6	"6-out1188"	.10294	7	61	68
6	"6-out1189"	.29580	134	319	453
6	"6-out1190"	.03940	16	390	406
6	"6-out1191"	.36624	115	199	314
6	"6-out1192"	.16181	50	259	309
6	"6-out1193"	.09569	20	189	209
6	"6-out1194"	.25131	287	855	1142
6	"6-out1195"	.07608	14	170	184
6	"6-out1196"	.15358	135	744	879
6	"6-out1197"	.13855	46	286	332
6	"6-out1198"	.29765	203	479	682
6	"6-out1199"	.08228	72	803	875
6	"6-out1200"	.02539	8	307	315
6	"6-out1201"	.49440	221	226	447
6	"6-out1202"	.13219	62	407	469
6	"6-out1203"	.50181	138	137	275
6	"6-out1204"	.48728	115	121	236
6	"6-out1205"	.65354	83	44	127
6	"6-out1206"	.11673	30	227	257
6	"6-out1207"	.12380	26	184	210
6	"6-out1208"	.19551	61	251	312
6	"6-out1209"	.04035	9	214	223
6	"6-out1210"	.06360	18	265	283
6	"6-out1211"	.38154	335	543	878
6	"6-out1212"	.38952	342	536	878
6	"6-out1213"	.38337	309	497	806
6	"6-out1214"	.39521	347	531	878
6	"6-out1215"	.34126	258	498	756
6	"6-out1216"	.33873	251	490	741
6	"6-out1217"	.08719	47	492	539
6	"6-out1218"	.08679	46	484	530
6	"6-out1219"	.11052	21	169	190
6	"6-out1220"	.09330	39	379	418
6	"6-out1221"	.11219	46	364	410
6	"6-out1222"	.16860	58	286	344
6	"6-out1223"	.11055	88	708	796
6	"6-out1224"	.08394	69	753	822
6	"6-out1225"	.09535	80	759	839
6	"6-out1226"	.10918	101	824	925
6	"6-out1227"	.09515	110	1046	1156
6	"6-out1228"	.11254	166	1309	1475
6	"6-out1229"	.14953	208	1183	1391
6	"6-out1230"	.07799	112	1324	1436
6	"6-out1231"	.07547	132	1617	1749
6	"6-out1232"	.54716	174	144	318
6	"6-out1233"	.06461	130	1882	2012
6	"6-out1234"	.06363	133	1957	2090
6	"6-out1235"	.50000	35	35	70
6	"6-out1236"	.17637	109	509	618
6	"6-out1237"	.10355	64	554	618
6	"6-out1238"	.34246	75	144	219
6	"6-out1239"	.17857	65	299	364
6	"6-out1240"	.08430	36	391	427
6	"6-out1241"	.15913	74	391	465
6	"6-out1242"	.10548	75	636	711
6	"6-out1243"	.53550	181	157	338
6	"6-out1244"	.04214	11	250	261
6	"6-out1245"	.24533	197	606	803
6	"6-out1246"	.07804	16	189	205
6	"6-out1247"	.06312	19	282	301
6	"6-out1248"	.22879	259	873	1132
6	"6-out1249"	.08361	25	274	299
6	"6-out1250"	.44868	153	188	341
6	"6-out1251"	.08146	69	778	847
6	"6-out1252"	.37790	472	777	1249
6	"6-out1253"	.43319	321	420	741
6	"6-out1254"	.10857	95	780	875
6	"6-out1255"	.06216	35	528	563
6	"6-out1256"	.14438	27	160	187
6	"6-out1257"	.16540	153	772	925
6	"6-out1258"	.07941	27	313	340
6	"6-out1259"	.13743	391	2454	2845
6	"6-out1260"	.10885	75	614	689
6	"6-out1261"	.14285	85	510	595
6	"6-out1262"	.06403	81	1184	1265
6	"6-out1263"	.04373	22	481	503
6	"6-out1264"	.11785	66	494	560
6	"6-out1265"	.06463	34	492	526
6	"6-out1266"	.08780	18	187	205
6	"6-out1267"	.20689	48	184	232
6	"6-out1268"	.33061	81	164	245
6	"6-out1269"	.04221	16	363	379
6	"6-out1270"	.41608	300	421	721
6	"6-out1271"	.40273	118	175	293
6	"6-out1272"	.33609	162	320	482
6	"6-out1273"	.36907	179	306	485
6	"6-out1274"	.05008	28	531	559
6	"6-out1275"	.34502	59	112	171
6	"6-out1276"	.33720	58	114	172
6	"6-out1277"	.15839	67	356	423
6	"6-out1278"	.13295	117	763	880
6	"6-out1279"	.09420	52	500	552
6	"6-out1280"	.31570	197	427	624
6	"6-out1281"	.38228	177	286	463
6	"6-out1282"	.16993	52	254	306
6	"6-out1283"	.10194	21	185	206
6	"6-out1284"	.50819	31	30	61
6	"6-out1285"	.52027	77	71	148
6	"6-out1286"	.10833	26	214	240
6	"6-out1287"	.03619	8	213	221
6	"6-out1288"	.15522	52	283	335
6	"6-out1289"	.07748	96	1143	1239
6	"6-out1290"	.21608	43	156	199
6	"6-out1291"	.13941	52	321	373
6	"6-out1292"	.18840	65	280	345
6	"6-out1293"	.32420	71	148	219
6	"6-out1294"	.05714	22	363	385
6	"6-out1295"	.08738	79	825	904
6	"6-out1296"	.08285	29	321	350
6	"6-out1297"	.15868	53	281	334
6	"6-out1298"	.10056	53	474	527
6	"6-out1299"	.10253	105	919	1024
6	"6-out1300"	.09979	147	1326	1473
6	"6-out1301"	.06370	66	970	1036
6	"6-out1302"	.12431	68	479	547
6	"6-out1303"	.12051	47	343	390
6	"6-out1304"	.12396	15	106	121
6	"6-out1305"	.10582	118	997	1115
6	"6-out1306"	.17929	187	856	1043
6	"6-out1307"	.33399	168	335	503
6	"6-out1308"	.07308	107	1357	1464
6	"6-out1309"	.07075	105	1379	1484
6	"6-out1310"	.13138	162	1071	1233
6	"6-out1311"	.16392	219	1117	1336
6	"6-out1312"	.20682	194	744	938
6	"6-out1313"	.31325	26	57	83
6	"6-out1314"	.14006	43	264	307
6	"6-out1315"	.31899	89	190	279
6	"6-out1316"	.13355	41	266	307
6	"6-out1317"	.14682	37	215	252
6	"6-out1318"	.06354	19	280	299
6	"6-out1319"	.09150	14	139	153
6	"6-out1320"	.06172	5	76	81
6	"6-out1321"	.14985	52	295	347
6	"6-out1322"	.10307	77	670	747
6	"6-out1323"	.41666	120	168	288
6	"6-out1324"	.38500	77	123	200
6	"6-out1325"	.11182	192	1525	1717
6	"6-out1326"	.04629	10	206	216
6	"6-out1327"	.16521	76	384	460
6	"6-out1328"	.05061	33	619	652
6	"6-out1329"	.06779	68	935	1003
6	"6-out1330"	.09852	187	1711	1898
6	"6-out1331"	.21568	110	400	510
6	"6-out1332"	.20700	65	249	314
6	"6-out1333"	.32797	102	209	311
6	"6-out1334"	.12684	60	413	473
6	"6-out1335"	.34493	109	207	316
6	"6-out1336"	.17403	63	299	362
6	"6-out1337"	.15047	48	271	319
6	"6-out1338"	.14239	44	265	309
6	"6-out1339"	.10819	33	272	305
6	"6-out1340"	.41818	138	192	330
6	"6-out1341"	.45222	142	172	314
6	"6-out1342"	.37540	116	193	309
6	"6-out1343"	.36195	371	654	1025
6	"6-out1344"	.09375	30	290	320
6	"6-out1345"	.38428	181	290	471
6	"6-out1346"	.12682	26	179	205
6	"6-out1347"	.36245	112	197	309
6	"6-out1348"	.36392	115	201	316
6	"6-out1349"	.34603	109	206	315
6	"6-out1350"	.24709	85	259	344
6	"6-out1351"	.14102	44	268	312
6	"6-out1352"	.08974	28	284	312
6	"6-out1353"	.10185	33	291	324
6	"6-out1354"	.10000	32	288	320
6	"6-out1355"	.11214	36	285	321
6	"6-out1356"	.07284	22	280	302
6	"6-out1357"	.07278	23	293	316
6	"6-out1358"	.03809	12	303	315
6	"6-out1359"	.13880	44	273	317
6	"6-out1360"	.16199	52	269	321
6	"6-out1361"	.13141	41	271	312
6	"6-out1362"	.12693	41	282	323
6	"6-out1363"	.11783	37	277	314
6	"6-out1364"	.07761	26	309	335
6	"6-out1365"	.17350	55	262	317
6	"6-out1366"	.40740	132	192	324
6	"6-out1367"	.39428	138	212	350
6	"6-out1368"	.18649	58	253	311
6	"6-out1369"	.34076	107	207	314
6	"6-out1370"	.31210	98	216	314
6	"6-out1371"	.32218	106	223	329
6	"6-out1372"	.32601	104	215	319
6	"6-out1373"	.41640	132	185	317
6	"6-out1374"	.07812	25	295	320
6	"6-out1375"	.12149	39	282	321
6	"6-out1376"	.26234	85	239	324
6	"6-out1377"	.06853	22	299	321
6	"6-out1378"	.53002	256	227	483
6	"6-out1379"	.29319	168	405	573
6	"6-out1380"	.17635	270	1261	1531
6	"6-out1381"	.15160	52	291	343
6	"6-out1382"	.13157	30	198	228
6	"6-out1383"	.43915	83	106	189
6	"6-out1384"	.32909	233	475	708
6	"6-out1385"	.05150	12	221	233
6	"6-out1386"	.08915	97	991	1088
6	"6-out1387"	.31477	164	357	521
6	"6-out1388"	.07718	45	538	583
6	"6-out1389"	.30248	134	309	443
6	"6-out1390"	.02197	4	178	182
6	"6-out1391"	.40588	69	101	170
6	"6-out1392"	.41764	71	99	170
6	"6-out1393"	.20161	50	198	248
6	"6-out1394"	.03043	14	446	460
6	"6-out1395"	.05280	16	287	303
6	"6-out1396"	.21311	13	48	61
6	"6-out1397"	.27868	17	44	61
6	"6-out1398"	.36065	22	39	61
6	"6-out1399"	.47540	29	32	61
6	"6-out1400"	.32786	20	41	61
6	"6-out1401"	.22950	14	47	61
6	"6-out1402"	.29508	18	43	61
6	"6-out1403"	.19480	30	124	154
6	"6-out1404"	.09561	72	681	753
6	"6-out1405"	.21201	60	223	283
6	"6-out1406"	.10182	39	344	383
6	"6-out1407"	.08864	57	586	643
6	"6-out1408"	.12603	76	527	603
6	"6-out1409"	.19954	88	353	441
6	"6-out1410"	.16708	67	334	401
6	"6-out1411"	.30627	83	188	271
6	"6-out1412"	.09722	21	195	216
6	"6-out1413"	.15751	66	353	419
6	"6-out1414"	.03238	8	239	247
6	"6-out1415"	.06250	15	225	240
6	"6-out1416"	.46323	63	73	136
6	"6-out1417"	.08543	44	471	515
6	"6-out1418"	.17515	55	259	314
6	"6-out1419"	.29573	118	281	399
6	"6-out1420"	.05965	38	599	637
6	"6-out1421"	.19375	31	129	160
6	"6-out1422"	.08510	36	387	423
6	"6-out1423"	.11708	37	279	316
6	"6-out1424"	.33018	105	213	318
6	"6-out1425"	.06853	22	299	321
6	"6-out1426"	.49635	68	69	137
6	"6-out1427"	.18404	60	266	326
6	"6-out1428"	.05782	17	277	294
6	"6-out1429"	.08647	94	993	1087
6	"6-out1430"	.19548	78	321	399
6	"6-out1431"	.11428	44	341	385
6	"6-out1432"	.10075	67	598	665
6	"6-out1433"	.08993	59	597	656
6	"6-out1434"	.16733	125	622	747
6	"6-out1435"	.12135	50	362	412
6	"6-out1436"	.06626	11	155	166
6	"6-out1437"	.19914	372	1496	1868
6	"6-out1438"	.40119	134	200	334
6	"6-out1439"	.08983	229	2320	2549
6	"6-out1440"	.59049	323	224	547
6	"6-out1441"	.10416	60	516	576
6	"6-out1442"	.08097	20	227	247
6	"6-out1443"	.10311	53	461	514
6	"6-out1444"	.05762	88	1439	1527
6	"6-out1445"	.10355	137	1186	1323
6	"6-out1446"	.24680	58	177	235
6	"6-out1447"	.06501	97	1395	1492
6	"6-out1448"	.30252	36	83	119
6	"6-out1449"	.05416	13	227	240
6	"6-out1450"	.14239	133	801	934
6	"6-out1451"	.09392	34	328	362
6	"6-out1452"	.05372	31	546	577
6	"6-out1453"	.24232	71	222	293
6	"6-out1454"	.17985	25	114	139
6	"6-out1455"	.09859	21	192	213
6	"6-out1456"	.11583	60	458	518
6	"6-out1457"	.05531	13	222	235
6	"6-out1458"	.05957	14	221	235
6	"6-out1459"	.36206	42	74	116
6	"6-out1460"	.18055	39	177	216
6	"6-out1461"	.18811	19	82	101
6	"6-out1462"	.08629	17	180	197
6	"6-out1463"	.09186	79	781	860
6	"6-out1464"	.08814	84	869	953
6	"6-out1465"	.07171	18	233	251
6	"6-out1466"	.41666	235	329	564
6	"6-out1467"	.09673	74	691	765
6	"6-out1468"	.18237	60	269	329
6	"6-out1469"	.14159	16	97	113
6	"6-out1470"	.14344	105	627	732
6	"6-out1471"	.19624	261	1069	1330
6	"6-out1472"	.07042	45	594	639
6	"6-out1473"	.13188	79	520	599
6	"6-out1474"	.35222	87	160	247
6	"6-out1475"	.32388	80	167	247
6	"6-out1476"	.09976	43	388	431
6	"6-out1477"	.09124	25	249	274
6	"6-out1478"	.10651	67	562	629
6	"6-out1479"	.09523	60	570	630
6	"6-out1480"	.11363	40	312	352
6	"6-out1481"	.10625	17	143	160
6	"6-out1482"	.06188	38	576	614
6	"6-out1483"	.06866	39	529	568
6	"6-out1484"	.30714	129	291	420
6	"6-out1485"	.07908	73	850	923
6	"6-out1486"	.13513	90	576	666
6	"6-out1487"	.11336	28	219	247
6	"6-out1488"	.30392	62	142	204
6	"6-out1489"	.03618	11	293	304
6	"6-out1490"	.38575	287	457	744
6	"6-out1491"	.07881	80	935	1015
6	"6-out1492"	.17619	74	346	420
6	"6-out1493"	.49427	604	618	1222
6	"6-out1494"	.14625	117	683	800
6	"6-out1495"	.14922	77	439	516
6	"6-out1496"	.17169	74	357	431
6	"6-out1497"	.13799	73	456	529
6	"6-out1498"	.13097	63	418	481
6	"6-out1499"	.04255	16	360	376
6	"6-out1500"	.08118	22	249	271
6	"6-out1501"	.09286	186	1817	2003
6	"6-out1502"	.47826	187	204	391
6	"6-out1503"	.12837	38	258	296
6	"6-out1504"	.09072	45	451	496
6	"6-out1505"	.38133	143	232	375
6	"6-out1506"	.20294	234	919	1153
6	"6-out1507"	.36203	412	726	1138
6	"6-out1508"	.21192	32	119	151
6	"6-out1509"	.07902	101	1177	1278
6	"6-out1510"	.07587	39	475	514
6	"6-out1511"	.51886	55	51	106
6	"6-out1512"	.32659	97	200	297
6	"6-out1513"	.48299	142	152	294
6	"6-out1514"	.37809	397	653	1050
6	"6-out1515"	.38664	440	698	1138
6	"6-out1516"	.39541	448	685	1133
6	"6-out1517"	.45176	192	233	425
6	"6-out1518"	.44685	185	229	414
6	"6-out1519"	.43981	190	242	432
6	"6-out1520"	.45454	195	234	429
6	"6-out1521"	.06852	32	435	467
6	"6-out1522"	.06854	39	530	569
6	"6-out1523"	.08333	35	385	420
6	"6-out1524"	.28089	25	64	89
6	"6-out1525"	.58965	171	119	290
6	"6-out1526"	.11041	53	427	480
6	"6-out1527"	.14396	37	220	257
6	"6-out1528"	.08478	39	421	460
6	"6-out1529"	.10779	65	538	603
6	"6-out1530"	.05369	24	423	447
6	"6-out1531"	.16585	68	342	410
6	"6-out1532"	.13861	56	348	404
6	"6-out1533"	.50174	144	143	287
6	"6-out1534"	.10812	141	1163	1304
6	"6-out1535"	.16014	45	236	281
6	"6-out1536"	.14720	29	168	197
6	"6-out1537"	.15658	44	237	281
6	"6-out1538"	.20882	71	269	340
6	"6-out1539"	.54022	94	80	174
6	"6-out1540"	.08169	54	607	661
6	"6-out1541"	.32596	59	122	181
6	"6-out1542"	.29878	49	115	164
6	"6-out1543"	.44078	67	85	152
6	"6-out1544"	.19528	58	239	297
6	"6-out1545"	.09146	30	298	328
6	"6-out1546"	.14224	66	398	464
6	"6-out1547"	.27272	54	144	198
6	"6-out1548"	.09172	122	1208	1330
6	"6-out1549"	.14667	280	1629	1909
6	"6-out1550"	.08333	37	407	444
6	"6-out1551"	.12211	53	381	434
6	"6-out1552"	.07359	34	428	462
6	"6-out1553"	.25290	718	2121	2839
6	"6-out1554"	.07284	44	560	604
6	"6-out1555"	.19111	172	728	900
6	"6-out1556"	.41062	85	122	207
6	"6-out1557"	.07339	32	404	436
6	"6-out1558"	.14146	58	352	410
6	"6-out1559"	.04225	6	136	142
6	"6-out1560"	.51082	118	113	231
6	"6-out1561"	.10804	43	355	398
6	"6-out1562"	.09278	45	440	485
6	"6-out1563"	.24833	112	339	451
6	"6-out1564"	.30645	95	215	310
6	"6-out1565"	.21024	78	293	371
6	"6-out1566"	.05860	16	257	273
6	"6-out1567"	.17560	72	338	410
6	"6-out1568"	.19734	119	484	603
6	"6-out1569"	.05864	19	305	324
6	"6-out1570"	.38970	318	498	816
6	"6-out1571"	.12848	83	563	646
6	"6-out1572"	.07728	49	585	634
6	"6-out1573"	.13438	34	219	253
6	"6-out1574"	.15845	45	239	284
6	"6-out1575"	.13636	69	437	506
6	"6-out1576"	.08983	53	537	590
6	"6-out1577"	.06593	12	170	182
6	"6-out1578"	.13509	97	621	718
6	"6-out1579"	.07012	23	305	328
6	"6-out1580"	.12772	41	280	321
6	"6-out1581"	.24800	31	94	125
6	"6-out1582"	.44597	227	282	509
6	"6-out1583"	.11744	136	1022	1158
6	"6-out1584"	.18461	36	159	195
6	"6-out1585"	.13958	61	376	437
6	"6-out1586"	.10576	55	465	520
6	"6-out1587"	.11448	49	379	428
6	"6-out1588"	.27419	85	225	310
6	"6-out1589"	.09268	19	186	205
6	"6-out1590"	.40785	135	196	331
6	"6-out1591"	.18471	29	128	157
6	"6-out1592"	.22222	54	189	243
6	"6-out1593"	.31753	201	432	633
6	"6-out1594"	.46708	298	340	638
6	"6-out1595"	.36696	331	571	902
6	"6-out1596"	.12280	14	100	114
6	"6-out1597"	.22580	28	96	124
6	"6-out1598"	.23456	19	62	81
6	"6-out1599"	.15209	40	223	263
6	"6-out1600"	.44672	109	135	244
6	"6-out1601"	.37470	157	262	419
6	"6-out1602"	.06583	42	596	638
6	"6-out1603"	.09230	90	885	975
6	"6-out1604"	.13798	89	556	645
6	"6-out1605"	.11644	114	865	979
6	"6-out1606"	.09044	89	895	984
6	"6-out1607"	.08744	94	981	1075
6	"6-out1608"	.41322	200	284	484
6	"6-out1609"	.11597	53	404	457
6	"6-out1610"	.13827	289	1801	2090
6	"6-out1611"	.15579	43	233	276
6	"6-out1612"	.09178	19	188	207
6	"6-out1613"	.47916	46	50	96
6	"6-out1614"	.29864	66	155	221
6	"6-out1615"	.06706	34	473	507
6	"6-out1616"	.05726	26	428	454
6	"6-out1617"	.09451	81	776	857
6	"6-out1618"	.23640	113	365	478
6	"6-out1619"	.05303	14	250	264
6	"6-out1620"	.49333	37	38	75
6	"6-out1621"	.07730	62	740	802
6	"6-out1622"	.14822	75	431	506
6	"6-out1623"	.48532	215	228	443
6	"6-out1624"	.05504	42	721	763
6	"6-out1625"	.15305	208	1151	1359
6	"6-out1626"	.07218	41	527	568
6	"6-out1627"	.08837	38	392	430
6	"6-out1628"	.10701	29	242	271
6	"6-out1629"	.06085	37	571	608
6	"6-out1630"	.07162	183	2372	2555
6	"6-out1631"	.48000	168	182	350
6	"6-out1632"	.44986	166	203	369
6	"6-out1633"	.46000	161	189	350
6	"6-out1634"	.44715	165	204	369
6	"6-out1635"	.44715	165	204	369
6	"6-out1636"	.15420	33	181	214
6	"6-out1637"	.32000	160	340	500
6	"6-out1638"	.13775	27	169	196
6	"6-out1639"	.30303	50	115	165
6	"6-out1640"	.04362	26	570	596
6	"6-out1641"	.17283	84	402	486
6	"6-out1642"	.06912	30	404	434
6	"6-out1643"	.15638	71	383	454
6	"6-out1644"	.12658	30	207	237
6	"6-out1645"	.07746	11	131	142
6	"6-out1646"	.07253	14	179	193
6	"6-out1647"	.36699	338	583	921
6	"6-out1648"	.11341	137	1071	1208
6	"6-out1649"	.09549	36	341	377
6	"6-out1650"	.09084	133	1331	1464
6	"6-out1651"	.11917	46	340	386
6	"6-out1652"	.10182	256	2258	2514
6	"6-out1653"	.10994	21	170	191
6	"6-out1654"	.40425	76	112	188
6	"6-out1655"	.21839	95	340	435
6	"6-out1656"	.40243	99	147	246
6	"6-out1657"	.29887	133	312	445
6	"6-out1658"	.18373	61	271	332
6	"6-out1659"	.16033	97	508	605
6	"6-out1660"	.10791	45	372	417
6	"6-out1661"	.07765	41	487	528
6	"6-out1662"	.11873	180	1336	1516
6	"6-out1663"	.11578	44	336	380
6	"6-out1664"	.10416	35	301	336
6	"6-out1665"	.04274	33	739	772
6	"6-out1666"	.09943	70	634	704
6	"6-out1667"	.09110	43	429	472
6	"6-out1668"	.36010	287	510	797
6	"6-out1669"	.11979	46	338	384
6	"6-out1670"	.32863	70	143	213
6	"6-out1671"	.03608	45	1202	1247
6	"6-out1672"	.40522	62	91	153
6	"6-out1673"	.10367	48	415	463
6	"6-out1674"	.22094	154	543	697
6	"6-out1675"	.10144	21	186	207
6	"6-out1676"	.04357	19	417	436
6	"6-out1677"	.49918	610	612	1222
6	"6-out1678"	.47142	165	185	350
6	"6-out1679"	.12921	23	155	178
6	"6-out1680"	.09736	37	343	380
6	"6-out1681"	.07537	30	368	398
6	"6-out1682"	.07874	30	351	381
6	"6-out1683"	.11805	51	381	432
6	"6-out1684"	.13207	49	322	371
6	"6-out1685"	.14583	56	328	384
6	"6-out1686"	.07359	17	214	231
6	"6-out1687"	.44117	30	38	68
6	"6-out1688"	.46788	51	58	109
6	"6-out1689"	.09873	266	2428	2694
6	"6-out1690"	.09326	36	350	386
6	"6-out1691"	.10123	82	728	810
6	"6-out1692"	.50200	125	124	249
6	"6-out1693"	.08571	18	192	210
6	"6-out1694"	.07179	28	362	390
6	"6-out1695"	.09104	63	629	692
6	"6-out1696"	.12663	116	800	916
6	"6-out1697"	.33858	86	168	254
6	"6-out1698"	.05875	53	849	902
6	"6-out1699"	.06174	46	699	745
6	"6-out1700"	.33064	164	332	496
6	"6-out1701"	.06424	23	335	358
6	"6-out1702"	.11326	187	1464	1651
6	"6-out1703"	.06725	315	4369	4684
6	"6-out1704"	.36571	128	222	350
6	"6-out1705"	.19917	48	193	241
6	"6-out1706"	.11637	27	205	232
6	"6-out1707"	.05075	27	505	532
6	"6-out1708"	.49333	37	38	75
6	"6-out1709"	.07601	109	1325	1434
6	"6-out1710"	.42826	197	263	460
6	"6-out1711"	.35692	116	209	325
6	"6-out1712"	.05686	29	481	510
6	"6-out1713"	.54205	58	49	107
6	"6-out1714"	.26530	39	108	147
6	"6-out1715"	.41003	237	341	578
6	"6-out1716"	.36163	115	203	318
6	"6-out1717"	.08045	42	480	522
6	"6-out1718"	.10939	156	1270	1426
6	"6-out1719"	.53982	305	260	565
6	"6-out1720"	.14687	47	273	320
6	"6-out1721"	.08695	60	630	690
6	"6-out1722"	.09794	43	396	439
6	"6-out1723"	.18933	71	304	375
6	"6-out1724"	.04719	21	424	445
6	"6-out1725"	.07216	7	90	97
6	"6-out1726"	.07496	47	580	627
6	"6-out1727"	.13617	64	406	470
6	"6-out1728"	.07393	40	501	541
6	"6-out1729"	.10362	60	519	579
6	"6-out1730"	.07194	10	129	139
6	"6-out1731"	.38644	325	516	841
6	"6-out1732"	.16023	108	566	674
6	"6-out1733"	.09950	20	181	201
6	"6-out1734"	.06672	166	2322	2488
6	"6-out1735"	.09601	229	2156	2385
6	"6-out1736"	.15217	42	234	276
6	"6-out1737"	.08333	34	374	408
6	"6-out1738"	.04263	11	247	258
6	"6-out1739"	.50977	313	301	614
6	"6-out1740"	.25261	531	1571	2102
6	"6-out1741"	.05392	44	772	816
6	"6-out1742"	.14438	27	160	187
6	"6-out1743"	.05988	40	628	668
6	"6-out1744"	.05964	60	946	1006
6	"6-out1745"	.28467	39	98	137
6	"6-out1746"	.04337	18	397	415
6	"6-out1747"	.51141	112	107	219
6	"6-out1748"	.09600	36	339	375
6	"6-out1749"	.11079	39	313	352
6	"6-out1750"	.03906	5	123	128
6	"6-out1751"	.10541	37	314	351
6	"6-out1752"	.27730	226	589	815
6	"6-out1753"	.11296	95	746	841
6	"6-out1754"	.08888	24	246	270
6	"6-out1755"	.25830	70	201	271
6	"6-out1756"	.44431	383	479	862
6	"6-out1757"	.03271	14	414	428
6	"6-out1758"	.04795	34	675	709
6	"6-out1759"	.11869	40	297	337
6	"6-out1760"	.26111	47	133	180
6	"6-out1761"	.47916	46	50	96
6	"6-out1762"	.38446	193	309	502
6	"6-out1763"	.08577	129	1375	1504
6	"6-out1764"	.05476	46	794	840
6	"6-out1765"	.21933	186	662	848
6	"6-out1766"	.08613	59	626	685
6	"6-out1767"	.35647	267	482	749
6	"6-out1768"	.12320	86	612	698
6	"6-out1769"	.05345	34	602	636
6	"6-out1770"	.07142	36	468	504
6	"6-out1771"	.46666	35	40	75
6	"6-out1772"	.14648	340	1981	2321
6	"6-out1773"	.22140	60	211	271
6	"6-out1774"	.06752	63	870	933
6	"6-out1775"	.06769	22	303	325
6	"6-out1776"	.19241	66	277	343
6	"6-out1777"	.41946	487	674	1161
6	"6-out1778"	.03455	17	475	492
6	"6-out1779"	.07973	24	277	301
6	"6-out1780"	.08460	105	1136	1241
6	"6-out1781"	.42569	169	228	397
6	"6-out1782"	.16814	57	282	339
6	"6-out1783"	.46739	129	147	276
6	"6-out1784"	.13747	405	2541	2946
6	"6-out1785"	.11111	41	328	369
6	"6-out1786"	.11043	73	588	661
6	"6-out1787"	.06077	33	510	543
6	"6-out1788"	.03030	6	192	198
6	"6-out1789"	.28804	53	131	184
6	"6-out1790"	.05952	25	395	420
6	"6-out1791"	.11814	28	209	237
6	"6-out1792"	.09191	25	247	272
6	"6-out1793"	.09367	37	358	395
6	"6-out1794"	.06132	13	199	212
6	"6-out1795"	.62000	93	57	150
6	"6-out1796"	.08256	36	400	436
6	"6-out1797"	.08817	41	424	465
6	"6-out1798"	.01923	4	204	208
6	"6-out1799"	.08450	18	195	213
6	"6-out1800"	.16415	120	611	731
6	"6-out1801"	.28620	334	833	1167
6	"6-out1802"	.12289	73	521	594
6	"6-out1803"	.04727	26	524	550
6	"6-out1804"	.07012	27	358	385
6	"6-out1805"	.08092	140	1590	1730
6	"6-out1806"	.15789	18	96	114
6	"6-out1807"	.05518	33	565	598
6	"6-out1808"	.14217	89	537	626
6	"6-out1809"	.10078	116	1035	1151
6	"6-out1810"	.08075	94	1070	1164
6	"6-out1811"	.07500	48	592	640
6	"6-out1812"	.09529	81	769	850
6	"6-out1813"	.07633	20	242	262
6	"6-out1814"	.07826	18	212	230
6	"6-out1815"	.09383	35	338	373
6	"6-out1816"	.10874	46	377	423
6	"6-out1817"	.17954	295	1348	1643
6	"6-out1818"	.07456	17	211	228
6	"6-out1819"	.09874	63	575	638
6	"6-out1820"	.49408	626	641	1267
6	"6-out1821"	.19066	49	208	257
6	"6-out1822"	.17441	120	568	688
6	"6-out1823"	.15307	107	592	699
6	"6-out1824"	.06916	24	323	347
6	"6-out1825"	.11888	51	378	429
6	"6-out1826"	.07568	61	745	806
6	"6-out1827"	.50000	32	32	64
6	"6-out1828"	.06109	19	292	311
6	"6-out1829"	.11072	128	1028	1156
6	"6-out1830"	.04854	40	784	824
6	"6-out1831"	.08862	53	545	598
6	"6-out1832"	.08582	43	458	501
6	"6-out1833"	.03177	17	518	535
6	"6-out1834"	.02923	5	166	171
6	"6-out1835"	.04580	30	625	655
6	"6-out1836"	.17662	68	317	385
6	"6-out1837"	.08150	26	293	319
6	"6-out1838"	.50295	85	84	169
6	"6-out1839"	.14579	85	498	583
6	"6-out1840"	.30555	55	125	180
6	"6-out1841"	.42682	70	94	164
6	"6-out1842"	.39487	77	118	195
6	"6-out1843"	.29657	78	185	263
6	"6-out1844"	.06758	44	607	651
6	"6-out1845"	.05572	18	305	323
6	"6-out1846"	.06854	17	231	248
6	"6-out1847"	.06644	20	281	301
6	"6-out1848"	.35827	522	935	1457
6	"6-out1849"	.22222	22	77	99
6	"6-out1850"	.12765	48	328	376
6	"6-out1851"	.05990	39	612	651
6	"6-out1852"	.05294	27	483	510
6	"6-out1853"	.11700	322	2430	2752
6	"6-out1854"	.09859	56	512	568
6	"6-out1855"	.10000	7	63	70
6	"6-out1856"	.06842	52	708	760
6	"6-out1857"	.37037	30	51	81
6	"6-out1858"	.50862	59	57	116
6	"6-out1859"	.59183	58	40	98
6	"6-out1860"	.13492	68	436	504
6	"6-out1861"	.11839	130	968	1098
6	"6-out1862"	.11299	40	314	354
6	"6-out1863"	.23977	129	409	538
6	"6-out1864"	.07052	95	1252	1347
6	"6-out1865"	.10413	63	542	605
6	"6-out1866"	.40922	284	410	694
6	"6-out1867"	.10198	36	317	353
6	"6-out1868"	.10256	24	210	234
6	"6-out1869"	.05449	20	347	367
6	"6-out1870"	.36603	97	168	265
6	"6-out1871"	.10909	18	147	165
6	"6-out1872"	.08196	50	560	610
6	"6-out1873"	.12318	85	605	690
6	"6-out1874"	.17171	68	328	396
6	"6-out1875"	.09118	30	299	329
6	"6-out1876"	.22777	82	278	360
6	"6-out1877"	.15254	54	300	354
6	"6-out1878"	.09960	50	452	502
6	"6-out1879"	.38848	317	499	816
6	"6-out1880"	.07949	19	220	239
6	"6-out1881"	.11619	33	251	284
6	"6-out1882"	.10839	31	255	286
6	"6-out1883"	.16082	156	814	970
6	"6-out1884"	.47916	161	175	336
6	"6-out1885"	.28021	51	131	182
6	"6-out1886"	.05921	9	143	152
6	"6-out1887"	.38106	157	255	412
6	"6-out1888"	.41446	298	421	719
6	"6-out1889"	.11143	77	614	691
6	"6-out1890"	.10256	72	630	702
6	"6-out1891"	.31272	430	945	1375
6	"6-out1892"	.22095	291	1026	1317
6	"6-out1893"	.24424	191	591	782
6	"6-out1894"	.36974	176	300	476
6	"6-out1895"	.38541	111	177	288
6	"6-out1896"	.41333	31	44	75
6	"6-out1897"	.03940	16	390	406
6	"6-out1898"	.17627	52	243	295
6	"6-out1899"	.06686	45	628	673
6	"6-out1900"	.07103	13	170	183
6	"6-out1901"	.08024	13	149	162
6	"6-out1902"	.43174	136	179	315
6	"6-out1903"	.20596	76	293	369
6	"6-out1904"	.43589	187	242	429
6	"6-out1905"	.12184	111	800	911
6	"6-out1906"	.08639	40	423	463
6	"6-out1907"	.07428	13	162	175
6	"6-out1908"	.27619	145	380	525
6	"6-out1909"	.03107	11	343	354
6	"6-out1910"	.02769	9	316	325
6	"6-out1911"	.37575	62	103	165
6	"6-out1912"	.06653	70	982	1052
6	"6-out1913"	.03793	22	558	580
6	"6-out1914"	.08657	49	517	566
6	"6-out1915"	.17977	32	146	178
6	"6-out1916"	.05666	34	566	600
6	"6-out1917"	.45337	141	170	311
6	"6-out1918"	.15925	43	227	270
6	"6-out1919"	.11382	28	218	246
6	"6-out1920"	.06909	36	485	521
6	"6-out1921"	.10313	112	974	1086
6	"6-out1922"	.09218	72	709	781
6	"6-out1923"	.12356	129	915	1044
6	"6-out1924"	.08108	81	918	999
6	"6-out1925"	.15642	28	151	179
6	"6-out1926"	.15650	154	830	984
6	"6-out1927"	.19540	85	350	435
6	"6-out1928"	.05150	29	534	563
6	"6-out1929"	.13297	25	163	188
6	"6-out1930"	.30714	43	97	140
6	"6-out1931"	.07826	9	106	115
6	"6-out1932"	.04570	25	522	547
6	"6-out1933"	.02580	12	453	465
6	"6-out1934"	.13819	161	1004	1165
6	"6-out1935"	.12820	10	68	78
6	"6-out1936"	.08256	45	500	545
6	"6-out1937"	.12478	73	512	585
6	"6-out1938"	.11461	109	842	951
6	"6-out1939"	.10033	91	816	907
6	"6-out1940"	.49889	226	227	453
6	"6-out1941"	.09447	82	786	868
6	"6-out1942"	.17210	174	837	1011
6	"6-out1943"	.43243	208	273	481
6	"6-out1944"	.08997	44	445	489
6	"6-out1945"	.11712	171	1289	1460
6	"6-out1946"	.46110	326	381	707
6	"6-out1947"	.52713	68	61	129
6	"6-out1948"	.20499	345	1338	1683
6	"6-out1949"	.12857	72	488	560
6	"6-out1950"	.65647	837	438	1275
6	"6-out1951"	.15156	87	487	574
6	"6-out1952"	.07650	14	169	183
6	"6-out1953"	.10714	96	800	896
6	"6-out1954"	.03431	21	591	612
6	"6-out1955"	.12974	65	436	501
6	"6-out1956"	.39750	159	241	400
6	"6-out1957"	.06751	37	511	548
6	"6-out1958"	.30810	114	256	370
6	"6-out1959"	.11740	29	218	247
6	"6-out1960"	.10500	21	179	200
6	"6-out1961"	.15682	85	457	542
6	"6-out1962"	.07078	47	617	664
6	"6-out1963"	.14964	104	591	695
6	"6-out1964"	.19859	85	343	428
6	"6-out1965"	.09950	40	362	402
6	"6-out1966"	.05517	8	137	145
6	"6-out1967"	.10054	55	492	547
6	"6-out1968"	.13939	270	1667	1937
6	"6-out1969"	.06091	12	185	197
6	"6-out1970"	.12936	100	673	773
6	"6-out1971"	.06924	59	793	852
6	"6-out1972"	.06179	55	835	890
6	"6-out1973"	.06462	55	796	851
6	"6-out1974"	.03490	20	553	573
6	"6-out1975"	.05934	40	634	674
6	"6-out1976"	.07641	46	556	602
6	"6-out1977"	.50897	482	465	947
6	"6-out1978"	.15109	76	427	503
6	"6-out1979"	.08250	66	734	800
6	"6-out1980"	.12025	38	278	316
6	"6-out1981"	.17226	41	197	238
6	"6-out1982"	.40983	150	216	366
6	"6-out1983"	.14901	83	474	557
6	"6-out1984"	.03581	13	350	363
6	"6-out1985"	.04433	18	388	406
6	"6-out1986"	.19298	77	322	399
6	"6-out1987"	.04347	9	198	207
6	"6-out1988"	.06360	43	633	676
6	"6-out1989"	.07804	59	697	756
6	"6-out1990"	.08791	32	332	364
6	"6-out1991"	.13440	259	1668	1927
6	"6-out1992"	.01709	6	345	351
6	"6-out1993"	.05458	28	485	513
6	"6-out1994"	.10443	33	283	316
6	"6-out1995"	.06417	43	627	670
6	"6-out1996"	.04545	9	189	198
6	"6-out1997"	.04687	30	610	640
6	"6-out1998"	.56856	709	538	1247
6	"6-out1999"	.08592	246	2617	2863
6	"6-out2000"	.07161	54	700	754
6	"6-out2001"	.09600	24	226	250
6	"6-out2002"	.10377	99	855	954
6	"6-out2003"	.02571	26	985	1011
6	"6-out2004"	.09101	77	769	846
6	"6-out2005"	.51051	267	256	523
6	"6-out2006"	.08469	26	281	307
6	"6-out2007"	.10060	150	1341	1491
6	"6-out2008"	.09861	114	1042	1156
6	"6-out2009"	.11966	87	640	727
6	"6-out2010"	.18497	32	141	173
6	"6-out2011"	.12987	60	402	462
6	"6-out2012"	.09204	258	2545	2803
6	"6-out2013"	.08230	40	446	486
6	"6-out2014"	.10000	16	144	160
6	"6-out2015"	.11764	14	105	119
6	"6-out2016"	.33295	297	595	892
6	"6-out2017"	.26639	264	727	991
6	"6-out2018"	.05846	57	918	975
6	"6-out2019"	.05340	29	514	543
6	"6-out2020"	.06048	30	466	496
6	"6-out2021"	.04016	20	478	498
6	"6-out2022"	.02347	10	416	426
6	"6-out2023"	.08940	130	1324	1454
6	"6-out2024"	.12048	50	365	415
6	"6-out2025"	.12068	21	153	174
6	"6-out2026"	.15482	122	666	788
6	"6-out2027"	.16761	147	730	877
6	"6-out2028"	.04545	12	252	264
6	"6-out2029"	.04347	43	946	989
6	"6-out2030"	.10687	14	117	131
6	"6-out2031"	.17415	31	147	178
6	"6-out2032"	.14592	34	199	233
6	"6-out2033"	.08493	31	334	365
6	"6-out2034"	.10782	51	422	473
6	"6-out2035"	.05701	65	1075	1140
6	"6-out2036"	.08637	52	550	602
6	"6-out2037"	.55950	315	248	563
6	"6-out2038"	.11335	45	352	397
6	"6-out2039"	.51343	172	163	335
6	"6-out2040"	.10700	55	459	514
6	"6-out2041"	.09266	24	235	259
6	"6-out2042"	.32908	129	263	392
6	"6-out2043"	.07482	22	272	294
6	"6-out2044"	.13229	34	223	257
6	"6-out2045"	.22985	77	258	335
6	"6-out2046"	.13276	94	614	708
6	"6-out2047"	.11486	85	655	740
6	"6-out2048"	.10555	38	322	360
6	"6-out2049"	.06250	22	330	352
6	"6-out2050"	.08997	35	354	389
6	"6-out2051"	.44444	60	75	135
6	"6-out2052"	.10619	12	101	113
6	"6-out2053"	.04918	81	1566	1647
6	"6-out2054"	.31761	101	217	318
6	"6-out2055"	.09771	30	277	307
6	"6-out2056"	.10951	38	309	347
6	"6-out2057"	.05238	45	814	859
6	"6-out2058"	.17492	60	283	343
6	"6-out2059"	.38853	122	192	314
6	"6-out2060"	.21135	67	250	317
6	"6-out2061"	.14516	18	106	124
6	"6-out2062"	.16099	71	370	441
6	"6-out2063"	.11077	37	297	334
6	"6-out2064"	.06535	10	143	153
6	"6-out2065"	.10294	35	305	340
6	"6-out2066"	.09882	59	538	597
6	"6-out2067"	.10058	155	1386	1541
6	"6-out2068"	.06122	78	1196	1274
6	"6-out2069"	.19428	102	423	525
6	"6-out2070"	.08208	22	246	268
6	"6-out2071"	.47058	32	36	68
6	"6-out2072"	.08020	47	539	586
6	"6-out2073"	.02604	10	374	384
6	"6-out2074"	.12790	44	300	344
6	"6-out2075"	.48728	115	121	236
6	"6-out2076"	.28070	32	82	114
6	"6-out2077"	.19491	23	95	118
6	"6-out2078"	.05050	10	188	198
6	"6-out2079"	.17391	32	152	184
6	"6-out2080"	.56441	92	71	163
6	"6-out2081"	.10285	18	157	175
6	"6-out2082"	.55113	97	79	176
6	"6-out2083"	.10465	63	539	602
6	"6-out2084"	.10000	8	72	80
6	"6-out2085"	.06569	27	384	411
6	"6-out2086"	.01876	7	366	373
6	"6-out2087"	.20481	68	264	332
6	"6-out2088"	.26946	90	244	334
6	"6-out2089"	.31024	103	229	332
6	"6-out2090"	.38356	56	90	146
6	"6-out2091"	.13441	66	425	491
6	"6-out2092"	.05838	39	629	668
6	"6-out2093"	.11609	44	335	379
6	"6-out2094"	.06698	28	390	418
6	"6-out2095"	.40710	149	217	366
6	"6-out2096"	.11481	31	239	270
6	"6-out2097"	.12500	23	161	184
6	"6-out2098"	.20454	45	175	220
6	"6-out2099"	.17046	187	910	1097
6	"6-out2100"	.10886	129	1056	1185
6	"6-out2101"	.24067	71	224	295
6	"6-out2102"	.09507	85	809	894
6	"6-out2103"	.17647	75	350	425
6	"6-out2104"	.19148	27	114	141
6	"6-out2105"	.03398	7	199	206
6	"6-out2106"	.12920	188	1267	1455
6	"6-out2107"	.06593	12	170	182
6	"6-out2108"	.47712	73	80	153
6	"6-out2109"	.08293	35	387	422
6	"6-out2110"	.28082	41	105	146
6	"6-out2111"	.12413	90	635	725
6	"6-out2112"	.08440	59	640	699
6	"6-out2113"	.21929	100	356	456
6	"6-out2114"	.53071	216	191	407
6	"6-out2115"	.11565	65	497	562
6	"6-out2116"	.11622	53	403	456
6	"6-out2117"	.21158	95	354	449
6	"6-out2118"	.12355	64	454	518
6	"6-out2119"	.13428	103	664	767
6	"6-out2120"	.05097	21	391	412
6	"6-out2121"	.07333	33	417	450
6	"6-out2122"	.29603	127	302	429
6	"6-out2123"	.43578	1096	1419	2515
6	"6-out2124"	.56497	300	231	531
6	"6-out2125"	.08656	29	306	335
6	"6-out2126"	.10492	49	418	467
6	"6-out2127"	.05633	8	134	142
6	"6-out2128"	.33805	215	421	636
6	"6-out2129"	.09129	43	428	471
6	"6-out2130"	.52104	260	239	499
6	"6-out2131"	.02582	11	415	426
6	"6-out2132"	.28888	91	224	315
6	"6-out2133"	.06730	21	291	312
6	"6-out2134"	.27009	84	227	311
6	"6-out2135"	.08547	50	535	585
6	"6-out2136"	.10714	48	400	448
6	"6-out2137"	.11464	36	278	314
6	"6-out2138"	.12874	43	291	334
6	"6-out2139"	.04573	15	313	328
6	"6-out2140"	.29874	95	223	318
6	"6-out2141"	.39428	207	318	525
6	"6-out2142"	.08952	223	2268	2491
6	"6-out2143"	.15605	49	265	314
6	"6-out2144"	.04777	15	299	314
6	"6-out2145"	.42532	131	177	308
6	"6-out2146"	.39794	271	410	681
6	"6-out2147"	.32876	96	196	292
6	"6-out2148"	.57931	336	244	580
6	"6-out2149"	.05901	18	287	305
6	"6-out2150"	.37454	103	172	275
6	"6-out2151"	.05819	38	615	653
6	"6-out2152"	.09652	25	234	259
6	"6-out2153"	.10724	37	308	345
6	"6-out2154"	.04054	15	355	370
6	"6-out2155"	.36507	92	160	252
6	"6-out2156"	.54676	76	63	139
6	"6-out2157"	.11864	77	572	649
6	"6-out2158"	.12500	37	259	296
6	"6-out2159"	.11926	39	288	327
6	"6-out2160"	.35353	70	128	198
6	"6-out2161"	.10456	71	608	679
6	"6-out2162"	.08875	71	729	800
6	"6-out2163"	.28912	109	268	377
6	"6-out2164"	.07827	49	577	626
6	"6-out2165"	.07142	24	312	336
6	"6-out2166"	.21981	71	252	323
6	"6-out2167"	.09679	133	1241	1374
6	"6-out2168"	.07755	47	559	606
6	"6-out2169"	.07755	47	559	606
6	"6-out2170"	.47630	191	210	401
6	"6-out2171"	.08059	27	308	335
6	"6-out2172"	.34146	56	108	164
6	"6-out2173"	.08120	86	973	1059
6	"6-out2174"	.02805	17	589	606
6	"6-out2175"	.14663	111	646	757
6	"6-out2176"	.12562	50	348	398
6	"6-out2177"	.12529	53	370	423
6	"6-out2178"	.17486	64	302	366
6	"6-out2179"	.10526	42	357	399
6	"6-out2180"	.08507	53	570	623
6	"6-out2181"	.17192	109	525	634
6	"6-out2182"	.13703	74	466	540
6	"6-out2183"	.06027	22	343	365
6	"6-out2184"	.07231	41	526	567
6	"6-out2185"	.07536	52	638	690
6	"6-out2186"	.19600	49	201	250
6	"6-out2187"	.05446	108	1875	1983
6	"6-out2188"	.15251	115	639	754
6	"6-out2189"	.11858	37	275	312
6	"6-out2190"	.07304	55	698	753
6	"6-out2191"	.50000	66	66	132
6	"6-out2192"	.13701	191	1203	1394
6	"6-out2193"	.24207	84	263	347
6	"6-out2194"	.05434	10	174	184
6	"6-out2195"	.14697	51	296	347
6	"6-out2196"	.18815	54	233	287
6	"6-out2197"	.16763	115	571	686
6	"6-out2198"	.12418	38	268	306
6	"6-out2199"	.09472	106	1013	1119
6	"6-out2200"	.15600	161	871	1032
6	"6-out2201"	.04950	15	288	303
6	"6-out2202"	.41496	61	86	147
6	"6-out2203"	.09009	20	202	222
6	"6-out2204"	.23287	51	168	219
6	"6-out2205"	.56617	77	59	136
6	"6-out2206"	.23728	56	180	236
6	"6-out2207"	.18309	130	580	710
6	"6-out2208"	.25932	299	854	1153
6	"6-out2209"	.17024	397	1935	2332
6	"6-out2210"	.08854	259	2666	2925
6	"6-out2211"	.11530	55	422	477
6	"6-out2212"	.10142	57	505	562
6	"6-out2213"	.05482	79	1362	1441
6	"6-out2214"	.09134	77	766	843
6	"6-out2215"	.15070	85	479	564
6	"6-out2216"	.24532	118	363	481
6	"6-out2217"	.09106	52	519	571
6	"6-out2218"	.10135	45	399	444
6	"6-out2219"	.54177	642	543	1185
6	"6-out2220"	.08735	38	397	435
6	"6-out2221"	.03472	5	139	144
6	"6-out2222"	.19463	29	120	149
6	"6-out2223"	.13103	19	126	145
6	"6-out2224"	.08522	15	161	176
6	"6-out2225"	.29255	55	133	188
6	"6-out2226"	.08872	59	606	665
6	"6-out2227"	.14630	97	566	663
6	"6-out2228"	.07051	33	435	468
6	"6-out2229"	.06957	67	896	963
6	"6-out2230"	.05624	50	839	889
6	"6-out2231"	.10033	89	798	887
6	"6-out2232"	.07374	100	1256	1356
6	"6-out2233"	.09003	28	283	311
6	"6-out2234"	.09576	52	491	543
6	"6-out2235"	.42744	162	217	379
6	"6-out2236"	.06593	24	340	364
6	"6-out2237"	.06042	20	311	331
6	"6-out2238"	.07024	34	450	484
6	"6-out2239"	.48207	121	130	251
6	"6-out2240"	.27941	19	49	68
6	"6-out2241"	.12078	43	313	356
6	"6-out2242"	.37264	297	500	797
6	"6-out2243"	.34461	275	523	798
6	"6-out2244"	.26960	251	680	931
6	"6-out2245"	.33799	266	521	787
6	"6-out2246"	.05069	22	412	434
6	"6-out2247"	.08419	90	979	1069
6	"6-out2248"	.30457	293	669	962
6	"6-out2249"	.31822	302	647	949
6	"6-out2250"	.05256	43	775	818
6	"6-out2251"	.21553	172	626	798
6	"6-out2252"	.10937	28	228	256
6	"6-out2253"	.07428	26	324	350
6	"6-out2254"	.08510	32	344	376
6	"6-out2255"	.11973	71	522	593
6	"6-out2256"	.07246	25	320	345
6	"6-out2257"	.47282	174	194	368
6	"6-out2258"	.29333	154	371	525
6	"6-out2259"	.11317	73	572	645
6	"6-out2260"	.09826	51	468	519
6	"6-out2261"	.10462	43	368	411
6	"6-out2262"	.24457	327	1010	1337
6	"6-out2263"	.12646	183	1264	1447
6	"6-out2264"	.16067	76	397	473
6	"6-out2265"	.11282	44	346	390
6	"6-out2266"	.13215	30	197	227
6	"6-out2267"	.49502	199	203	402
6	"6-out2268"	.54336	401	337	738
6	"6-out2269"	.13967	113	696	809
6	"6-out2270"	.44763	265	327	592
6	"6-out2271"	.16431	105	534	639
6	"6-out2272"	.08747	51	532	583
6	"6-out2273"	.11880	127	942	1069
6	"6-out2274"	.12570	67	466	533
6	"6-out2275"	.07614	45	546	591
6	"6-out2276"	.07551	91	1114	1205
6	"6-out2277"	.10304	88	766	854
6	"6-out2278"	.04398	15	326	341
6	"6-out2279"	.15069	305	1719	2024
6	"6-out2280"	.08125	52	588	640
6	"6-out2281"	.25210	90	267	357
6	"6-out2282"	.11270	376	2960	3336
6	"6-out2283"	.09736	170	1576	1746
6	"6-out2284"	.12246	127	910	1037
6	"6-out2285"	.04545	19	399	418
6	"6-out2286"	.29661	210	498	708
6	"6-out2287"	.27472	50	132	182
6	"6-out2288"	.08910	27	276	303
6	"6-out2289"	.06923	9	121	130
6	"6-out2290"	.07012	27	358	385
6	"6-out2291"	.05787	25	407	432
6	"6-out2292"	.07785	58	687	745
6	"6-out2293"	.10574	127	1074	1201
6	"6-out2294"	.09705	66	614	680
6	"6-out2295"	.06153	12	183	195
6	"6-out2296"	.45725	337	400	737
6	"6-out2297"	.06562	21	299	320
6	"6-out2298"	.33464	85	169	254
6	"6-out2299"	.17175	90	434	524
6	"6-out2300"	.20574	43	166	209
6	"6-out2301"	.41909	158	219	377
6	"6-out2302"	.06227	17	256	273
6	"6-out2303"	.10606	35	295	330
6	"6-out2304"	.06366	24	353	377
6	"6-out2305"	.15343	29	160	189
6	"6-out2306"	.38979	672	1052	1724
6	"6-out2307"	.01278	5	386	391
6	"6-out2308"	.03777	17	433	450
6	"6-out2309"	.17808	65	300	365
6	"6-out2310"	.36729	292	503	795
6	"6-out2311"	.33921	269	524	793
6	"6-out2312"	.08239	44	490	534
6	"6-out2313"	.35625	285	515	800
6	"6-out2314"	.34378	274	523	797
6	"6-out2315"	.13419	73	471	544
6	"6-out2316"	.30528	283	644	927
6	"6-out2317"	.36082	280	496	776
6	"6-out2318"	.26526	252	698	950
6	"6-out2319"	.30793	287	645	932
6	"6-out2320"	.33905	316	616	932
6	"6-out2321"	.29642	249	591	840
6	"6-out2322"	.28586	269	672	941
6	"6-out2323"	.06762	33	455	488
6	"6-out2324"	.24298	251	782	1033
6	"6-out2325"	.16757	215	1068	1283
6	"6-out2326"	.07142	11	143	154
6	"6-out2327"	.59390	117	80	197
6	"6-out2328"	.13527	51	326	377
6	"6-out2329"	.11057	69	555	624
6	"6-out2330"	.11382	205	1596	1801
6	"6-out2331"	.10766	73	605	678
6	"6-out2332"	.06994	27	359	386
6	"6-out2333"	.14335	83	496	579
6	"6-out2334"	.09882	42	383	425
6	"6-out2335"	.05636	27	452	479
6	"6-out2336"	.12058	41	299	340
6	"6-out2337"	.11663	197	1492	1689
6	"6-out2338"	.10297	52	453	505
6	"6-out2339"	.31954	255	543	798
6	"6-out2340"	.16511	71	359	430
6	"6-out2341"	.25894	246	704	950
6	"6-out2342"	.05117	48	890	938
6	"6-out2343"	.32924	349	711	1060
6	"6-out2344"	.28111	262	670	932
6	"6-out2345"	.12280	49	350	399
6	"6-out2346"	.03977	28	676	704
6	"6-out2347"	.27742	263	685	948
6	"6-out2348"	.35678	284	512	796
6	"6-out2349"	.10082	61	544	605
6	"6-out2350"	.27114	109	293	402
6	"6-out2351"	.05865	21	337	358
6	"6-out2352"	.46524	87	100	187
6	"6-out2353"	.25704	73	211	284
6	"6-out2354"	.13505	94	602	696
6	"6-out2355"	.03861	10	249	259
6	"6-out2356"	.07987	50	576	626
6	"6-out2357"	.17532	27	127	154
6	"6-out2358"	.05918	58	922	980
6	"6-out2359"	.15479	50	273	323
6	"6-out2360"	.38805	52	82	134
6	"6-out2361"	.04615	36	744	780
6	"6-out2362"	.45502	86	103	189
6	"6-out2363"	.33622	1084	2140	3224
6	"6-out2364"	.17570	162	760	922
6	"6-out2365"	.01538	3	192	195
6	"6-out2366"	.07520	27	332	359
6	"6-out2367"	.10204	20	176	196
6	"6-out2368"	.14826	94	540	634
6	"6-out2369"	.28250	113	287	400
6	"6-out2370"	.24289	94	293	387
6	"6-out2371"	.31698	336	724	1060
6	"6-out2372"	.08943	22	224	246
6	"6-out2373"	.07454	128	1589	1717
6	"6-out2374"	.38079	460	748	1208
6	"6-out2375"	.09586	95	896	991
6	"6-out2376"	.44274	58	73	131
6	"6-out2377"	.05111	16	297	313
6	"6-out2378"	.04501	14	297	311
6	"6-out2379"	.26380	86	240	326
6	"6-out2380"	.42000	42	58	100
6	"6-out2381"	.07655	32	386	418
6	"6-out2382"	.11235	30	237	267
6	"6-out2383"	.45618	177	211	388
6	"6-out2384"	.10586	56	473	529
6	"6-out2385"	.09227	135	1328	1463
6	"6-out2386"	.09942	52	471	523
6	"6-out2387"	.05580	98	1658	1756
6	"6-out2388"	.05405	30	525	555
6	"6-out2389"	.39629	235	358	593
6	"6-out2390"	.29256	122	295	417
6	"6-out2391"	.04701	52	1054	1106
6	"6-out2392"	.03349	7	202	209
6	"6-out2393"	.03993	23	553	576
6	"6-out2394"	.09481	53	506	559
6	"6-out2395"	.10113	71	631	702
6	"6-out2396"	.10714	42	350	392
6	"6-out2397"	.04787	18	358	376
6	"6-out2398"	.08994	51	516	567
6	"6-out2399"	.08379	105	1148	1253
6	"6-out2400"	.46391	180	208	388
6	"6-out2401"	.21969	58	206	264
6	"6-out2402"	.33606	41	81	122
6	"6-out2403"	.11147	34	271	305
6	"6-out2404"	.10723	40	333	373
6	"6-out2405"	.07238	27	346	373
6	"6-out2406"	.13626	121	767	888
6	"6-out2407"	.09655	56	524	580
6	"6-out2408"	.33466	336	668	1004
6	"6-out2409"	.07015	71	941	1012
6	"6-out2410"	.35742	178	320	498
6	"6-out2411"	.08866	36	370	406
6	"6-out2412"	.07520	27	332	359
6	"6-out2413"	.06666	52	728	780
6	"6-out2414"	.09290	55	537	592
6	"6-out2415"	.03481	18	499	517
6	"6-out2416"	.22054	73	258	331
6	"6-out2417"	.16034	93	487	580
6	"6-out2418"	.17437	98	464	562
6	"6-out2419"	.37132	101	171	272
6	"6-out2420"	.11295	34	267	301
6	"6-out2421"	.24361	267	829	1096
6	"6-out2422"	.16037	327	1712	2039
6	"6-out2423"	.12450	125	879	1004
6	"6-out2424"	.11548	44	337	381
6	"6-out2425"	.10959	145	1178	1323
6	"6-out2426"	.36199	160	282	442
6	"6-out2427"	.14906	48	274	322
6	"6-out2428"	.07841	93	1093	1186
6	"6-out2429"	.12396	30	212	242
6	"6-out2430"	.08969	87	883	970
6	"6-out2431"	.12765	48	328	376
6	"6-out2432"	.08274	94	1042	1136
6	"6-out2433"	.11445	57	441	498
6	"6-out2434"	.31012	49	109	158
6	"6-out2435"	.17857	105	483	588
6	"6-out2436"	.17596	123	576	699
6	"6-out2437"	.45868	161	190	351
6	"6-out2438"	.48251	414	444	858
6	"6-out2439"	.34712	1334	2509	3843
6	"6-out2440"	.06731	69	956	1025
6	"6-out2441"	.08188	118	1323	1441
6	"6-out2442"	.13862	89	553	642
6	"6-out2443"	.10769	49	406	455
6	"6-out2444"	.05357	21	371	392
6	"6-out2445"	.13425	58	374	432
6	"6-out2446"	.09580	32	302	334
6	"6-out2447"	.36363	40	70	110
6	"6-out2448"	.21348	19	70	89
6	"6-out2449"	.32608	30	62	92
6	"6-out2450"	.12923	42	283	325
6	"6-out2451"	.07427	54	673	727
6	"6-out2452"	.13554	45	287	332
6	"6-out2453"	.08284	42	465	507
6	"6-out2454"	.04419	8	173	181
6	"6-out2455"	.25169	186	553	739
6	"6-out2456"	.22580	14	48	62
6	"6-out2457"	.52830	196	175	371
6	"6-out2458"	.06993	50	665	715
6	"6-out2459"	.10055	54	483	537
6	"6-out2460"	.09203	37	365	402
6	"6-out2461"	.10098	41	365	406
6	"6-out2462"	.07086	9	118	127
6	"6-out2463"	.08130	20	226	246
6	"6-out2464"	.12384	94	665	759
6	"6-out2465"	.10050	120	1074	1194
6	"6-out2466"	.11363	30	234	264
6	"6-out2467"	.05389	9	158	167
6	"6-out2468"	.05172	30	550	580
6	"6-out2469"	.13752	70	439	509
6	"6-out2470"	.25114	55	164	219
6	"6-out2471"	.10961	65	528	593
6	"6-out2472"	.28923	94	231	325
6	"6-out2473"	.05865	20	321	341
6	"6-out2474"	.13226	66	433	499
6	"6-out2475"	.38445	188	301	489
6	"6-out2476"	.33954	164	319	483
6	"6-out2477"	.38628	231	367	598
6	"6-out2478"	.05052	24	451	475
6	"6-out2479"	.31213	270	595	865
6	"6-out2480"	.11797	21	157	178
6	"6-out2481"	.26315	55	154	209
6	"6-out2482"	.11401	83	645	728
6	"6-out2483"	.15315	102	564	666
6	"6-out2484"	.36467	128	223	351
6	"6-out2485"	.03076	12	378	390
6	"6-out2486"	.09571	38	359	397
6	"6-out2487"	.15365	61	336	397
6	"6-out2488"	.08620	10	106	116
6	"6-out2489"	.25652	118	342	460
6	"6-out2490"	.14432	56	332	388
6	"6-out2491"	.09312	61	594	655
6	"6-out2492"	.04822	34	671	705
6	"6-out2493"	.13274	30	196	226
6	"6-out2494"	.07731	15	179	194
6	"6-out2495"	.13597	48	305	353
6	"6-out2496"	.14932	99	564	663
6	"6-out2497"	.24127	83	261	344
6	"6-out2498"	.26132	173	489	662
6	"6-out2499"	.18320	24	107	131
6	"6-out2500"	.18552	41	180	221
6	"6-out2501"	.55357	93	75	168
6	"6-out2502"	.10610	33	278	311
6	"6-out2503"	.05056	18	338	356
6	"6-out2504"	.11842	27	201	228
6	"6-out2505"	.28957	364	893	1257
6	"6-out2506"	.08921	96	980	1076
6	"6-out2507"	.10199	46	405	451
6	"6-out2508"	.16129	75	390	465
6	"6-out2509"	.20770	97	370	467
6	"6-out2510"	.26585	109	301	410
6	"6-out2511"	.43973	197	251	448
6	"6-out2512"	.04347	7	154	161
6	"6-out2513"	.11572	39	298	337
6	"6-out2514"	.07446	21	261	282
6	"6-out2515"	.14285	6	36	42
6	"6-out2516"	.14489	71	419	490
6	"6-out2517"	.07318	110	1393	1503
6	"6-out2518"	.05759	22	360	382
6	"6-out2519"	.08532	50	536	586
6	"6-out2520"	.04642	39	801	840
6	"6-out2521"	.08212	34	380	414
6	"6-out2522"	.10456	55	471	526
6	"6-out2523"	.07878	13	152	165
6	"6-out2524"	.51639	63	59	122
6	"6-out2525"	.14080	49	299	348
6	"6-out2526"	.12549	64	446	510
6	"6-out2527"	.01980	4	198	202
6	"6-out2528"	.04354	27	593	620
6	"6-out2529"	.08614	51	541	592
6	"6-out2530"	.12365	46	326	372
6	"6-out2531"	.18808	120	518	638
6	"6-out2532"	.08236	99	1103	1202
6	"6-out2533"	.04060	8	189	197
6	"6-out2534"	.22388	105	364	469
6	"6-out2535"	.36101	213	377	590
6	"6-out2536"	.08733	120	1254	1374
6	"6-out2537"	.04775	17	339	356
6	"6-out2538"	.17519	339	1596	1935
6	"6-out2539"	.16756	62	308	370
6	"6-out2540"	.08527	66	708	774
6	"6-out2541"	.08969	47	477	524
6	"6-out2542"	.12377	38	269	307
6	"6-out2543"	.11337	39	305	344
6	"6-out2544"	.11397	31	241	272
6	"6-out2545"	.04145	33	763	796
6	"6-out2546"	.07826	18	212	230
6	"6-out2547"	.03691	11	287	298
6	"6-out2548"	.08396	44	480	524
6	"6-out2549"	.07228	42	539	581
6	"6-out2550"	.02384	17	696	713
6	"6-out2551"	.17319	787	3757	4544
6	"6-out2552"	.10338	61	529	590
6	"6-out2553"	.46078	47	55	102
6	"6-out2554"	.17837	66	304	370
6	"6-out2555"	.07774	51	605	656
6	"6-out2556"	.10291	60	523	583
6	"6-out2557"	.08979	117	1186	1303
6	"6-out2558"	.15445	137	750	887
6	"6-out2559"	.34666	52	98	150
6	"6-out2560"	.16251	287	1479	1766
6	"6-out2561"	.04684	23	468	491
6	"6-out2562"	.63522	101	58	159
6	"6-out2563"	.10509	33	281	314
6	"6-out2564"	.48953	117	122	239
6	"6-out2565"	.09012	63	636	699
6	"6-out2566"	.04037	39	927	966
6	"6-out2567"	.12101	76	552	628
6	"6-out2568"	.09115	34	339	373
6	"6-out2569"	.14495	69	407	476
6	"6-out2570"	.14772	26	150	176
6	"6-out2571"	.23255	70	231	301
6	"6-out2572"	.06806	55	753	808
6	"6-out2573"	.09403	52	501	553
6	"6-out2574"	.08458	73	790	863
6	"6-out2575"	.05313	39	695	734
6	"6-out2576"	.06213	21	317	338
6	"6-out2577"	.15868	169	896	1065
6	"6-out2578"	.19721	368	1498	1866
6	"6-out2579"	.12343	69	490	559
6	"6-out2580"	.04488	32	681	713
6	"6-out2581"	.10722	92	766	858
6	"6-out2582"	.49479	95	97	192
6	"6-out2583"	.09642	54	506	560
6	"6-out2584"	.10439	76	652	728
6	"6-out2585"	.25531	36	105	141
6	"6-out2586"	.21832	81	290	371
6	"6-out2587"	.25641	30	87	117
6	"6-out2588"	.33333	41	82	123
6	"6-out2589"	.39516	49	75	124
6	"6-out2590"	.38524	47	75	122
6	"6-out2591"	.38211	47	76	123
6	"6-out2592"	.17567	39	183	222
6	"6-out2593"	.08955	18	183	201
6	"6-out2594"	.16793	66	327	393
6	"6-out2595"	.14418	31	184	215
6	"6-out2596"	.09006	78	788	866
6	"6-out2597"	.10526	20	170	190
6	"6-out2598"	.12101	38	276	314
6	"6-out2599"	.61363	81	51	132
6	"6-out2600"	.10256	16	140	156
6	"6-out2601"	.07683	64	769	833
6	"6-out2602"	.08658	71	749	820
6	"6-out2603"	.24578	248	761	1009
6	"6-out2604"	.15606	54	292	346
6	"6-out2605"	.14739	51	295	346
6	"6-out2606"	.40057	139	208	347
6	"6-out2607"	.12345	40	284	324
6	"6-out2608"	.09328	150	1458	1608
6	"6-out2609"	.40764	128	186	314
6	"6-out2610"	.08442	71	770	841
6	"6-out2611"	.15867	139	737	876
6	"6-out2612"	.21021	70	263	333
6	"6-out2613"	.07142	92	1196	1288
6	"6-out2614"	.07223	45	578	623
6	"6-out2615"	.58116	1253	903	2156
6	"6-out2616"	.10984	125	1013	1138
6	"6-out2617"	.12396	30	212	242
6	"6-out2618"	.09498	53	505	558
6	"6-out2619"	.15973	73	384	457
6	"6-out2620"	.06439	17	247	264
6	"6-out2621"	.11069	59	474	533
6	"6-out2622"	.14475	131	774	905
6	"6-out2623"	.15025	58	328	386
6	"6-out2624"	.10450	58	497	555
6	"6-out2625"	.20000	25	100	125
6	"6-out2626"	.04180	26	596	622
6	"6-out2627"	.29634	251	596	847
6	"6-out2628"	.05263	17	306	323
6	"6-out2629"	.05412	21	367	388
6	"6-out2630"	.39655	69	105	174
6	"6-out2631"	.04918	3	58	61
6	"6-out2632"	.13200	33	217	250
6	"6-out2633"	.11952	71	523	594
6	"6-out2634"	.28868	125	308	433
6	"6-out2635"	.08169	79	888	967
6	"6-out2636"	.19067	45	191	236
6	"6-out2637"	.12817	96	653	749
6	"6-out2638"	.09442	22	211	233
6	"6-out2639"	.06849	60	816	876
6	"6-out2640"	.08225	19	212	231
6	"6-out2641"	.12814	51	347	398
6	"6-out2642"	.41230	181	258	439
6	"6-out2643"	.21134	41	153	194
6	"6-out2644"	.38510	243	388	631
6	"6-out2645"	.13704	64	403	467
6	"6-out2646"	.14438	283	1677	1960
6	"6-out2647"	.08863	85	874	959
6	"6-out2648"	.08205	16	179	195
6	"6-out2649"	.46242	80	93	173
6	"6-out2650"	.20192	42	166	208
6	"6-out2651"	.33112	50	101	151
6	"6-out2652"	.26162	45	127	172
6	"6-out2653"	.07641	58	701	759
6	"6-out2654"	.07837	162	1905	2067
6	"6-out2655"	.07795	29	343	372
6	"6-out2656"	.13378	59	382	441
6	"6-out2657"	.21428	174	638	812
6	"6-out2658"	.08401	41	447	488
6	"6-out2659"	.09657	31	290	321
6	"6-out2660"	.16226	86	444	530
6	"6-out2661"	.14694	113	656	769
6	"6-out2662"	.05732	36	592	628
6	"6-out2663"	.06141	39	596	635
6	"6-out2664"	.06217	24	362	386
6	"6-out2665"	.06389	20	293	313
6	"6-out2666"	.28232	131	333	464
6	"6-out2667"	.14308	89	533	622
6	"6-out2668"	.11219	516	4083	4599
6	"6-out2669"	.08483	146	1575	1721
6	"6-out2670"	.42741	53	71	124
6	"6-out2671"	.32173	37	78	115
6	"6-out2672"	.40178	45	67	112
6	"6-out2673"	.04602	11	228	239
6	"6-out2674"	.30081	37	86	123
6	"6-out2675"	.10861	29	238	267
6	"6-out2676"	.10368	45	389	434
6	"6-out2677"	.04800	24	476	500
6	"6-out2678"	.18766	70	303	373
6	"6-out2679"	.30060	150	349	499
6	"6-out2680"	.44481	133	166	299
6	"6-out2681"	.35384	230	420	650
6	"6-out2682"	.14402	88	523	611
6	"6-out2683"	.15512	121	659	780
6	"6-out2684"	.08092	14	159	173
6	"6-out2685"	.46827	369	419	788
6	"6-out2686"	.05645	35	585	620
6	"6-out2687"	.07666	46	554	600
6	"6-out2688"	.08491	58	625	683
6	"6-out2689"	.69811	111	48	159
6	"6-out2690"	.08998	71	718	789
6	"6-out2691"	.04347	15	330	345
6	"6-out2692"	.13594	104	661	765
6	"6-out2693"	.11254	61	481	542
6	"6-out2694"	.06504	8	115	123
6	"6-out2695"	.12462	82	576	658
6	"6-out2696"	.34782	40	75	115
6	"6-out2697"	.31304	36	79	115
6	"6-out2698"	.07299	30	381	411
6	"6-out2699"	.07645	25	302	327
6	"6-out2700"	.08916	93	950	1043
6	"6-out2701"	.10887	119	974	1093
6	"6-out2702"	.10069	175	1563	1738
6	"6-out2703"	.45291	481	581	1062
6	"6-out2704"	.39785	483	731	1214
6	"6-out2705"	.08571	27	288	315
6	"6-out2706"	.06621	157	2214	2371
6	"6-out2707"	.29611	61	145	206
6	"6-out2708"	.18302	138	616	754
6	"6-out2709"	.08540	55	589	644
6	"6-out2710"	.04188	16	366	382
6	"6-out2711"	.07389	30	376	406
6	"6-out2712"	.03325	14	407	421
6	"6-out2713"	.53209	315	277	592
6	"6-out2714"	.13475	38	244	282
6	"6-out2715"	.03503	22	606	628
6	"6-out2716"	.53664	227	196	423
6	"6-out2717"	.23417	37	121	158
6	"6-out2718"	.07439	43	535	578
6	"6-out2719"	.26344	49	137	186
6	"6-out2720"	.34883	45	84	129
6	"6-out2721"	.36619	26	45	71
6	"6-out2722"	.06342	56	827	883
6	"6-out2723"	.13281	17	111	128
6	"6-out2724"	.11280	37	291	328
6	"6-out2725"	.11842	9	67	76
6	"6-out2726"	.19327	23	96	119
6	"6-out2727"	.14859	196	1123	1319
6	"6-out2728"	.12623	128	886	1014
6	"6-out2729"	.47200	59	66	125
6	"6-out2730"	.06042	20	311	331
6	"6-out2731"	.07547	16	196	212
6	"6-out2732"	.04838	9	177	186
6	"6-out2733"	.07236	11	141	152
6	"6-out2734"	.18421	28	124	152
6	"6-out2735"	.09171	134	1327	1461
6	"6-out2736"	.10889	82	671	753
6	"6-out2737"	.24758	128	389	517
6	"6-out2738"	.06666	34	476	510
6	"6-out2739"	.08836	41	423	464
6	"6-out2740"	.03642	11	291	302
6	"6-out2741"	.08474	50	540	590
6	"6-out2742"	.06974	62	827	889
6	"6-out2743"	.19259	52	218	270
6	"6-out2744"	.10104	58	516	574
6	"6-out2745"	.09821	110	1010	1120
6	"6-out2746"	.04953	37	710	747
6	"6-out2747"	.32463	286	595	881
6	"6-out2748"	.48044	86	93	179
6	"6-out2749"	.07883	19	222	241
6	"6-out2750"	.07023	21	278	299
6	"6-out2751"	.16131	236	1227	1463
6	"6-out2752"	.08200	41	459	500
6	"6-out2753"	.08654	119	1256	1375
6	"6-out2754"	.14591	116	679	795
6	"6-out2755"	.07543	70	858	928
6	"6-out2756"	.09785	73	673	746
6	"6-out2757"	.43545	226	293	519
6	"6-out2758"	.10905	159	1299	1458
6	"6-out2759"	.08180	58	651	709
6	"6-out2760"	.09868	15	137	152
6	"6-out2761"	.08108	33	374	407
6	"6-out2762"	.37168	42	71	113
6	"6-out2763"	.14779	77	444	521
6	"6-out2764"	.09268	19	186	205
6	"6-out2765"	.07213	22	283	305
6	"6-out2766"	.07045	62	818	880
6	"6-out2767"	.12462	42	295	337
6	"6-out2768"	.05861	33	530	563
6	"6-out2769"	.10560	115	974	1089
6	"6-out2770"	.23232	23	76	99
6	"6-out2771"	.15476	13	71	84
6	"6-out2772"	.38539	190	303	493
6	"6-out2773"	.40759	236	343	579
6	"6-out2774"	.10550	92	780	872
6	"6-out2775"	.27325	47	125	172
6	"6-out2776"	.24836	38	115	153
6	"6-out2777"	.53254	90	79	169
6	"6-out2778"	.46226	49	57	106
6	"6-out2779"	.14546	183	1075	1258
6	"6-out2780"	.24882	53	160	213
6	"6-out2781"	.08403	20	218	238
6	"6-out2782"	.05003	65	1234	1299
6	"6-out2783"	.18813	92	397	489
6	"6-out2784"	.11635	106	805	911
6	"6-out2785"	.01587	5	310	315
6	"6-out2786"	.07183	51	659	710
6	"6-out2787"	.05361	20	353	373
6	"6-out2788"	.15776	62	331	393
6	"6-out2789"	.45392	133	160	293
6	"6-out2790"	.05263	24	432	456
6	"6-out2791"	.08645	30	317	347
6	"6-out2792"	.08943	11	112	123
6	"6-out2793"	.24347	28	87	115
6	"6-out2794"	.19200	96	404	500
6	"6-out2795"	.32050	808	1713	2521
6	"6-out2796"	.24242	72	225	297
6	"6-out2797"	.07527	74	909	983
6	"6-out2798"	.16863	157	774	931
6	"6-out2799"	.03759	5	128	133
6	"6-out2800"	.16666	24	120	144
6	"6-out2801"	.05405	30	525	555
6	"6-out2802"	.07619	8	97	105
6	"6-out2803"	.06589	17	241	258
6	"6-out2804"	.05820	11	178	189
6	"6-out2805"	.09655	28	262	290
6	"6-out2806"	.17777	56	259	315
6	"6-out2807"	.17757	38	176	214
6	"6-out2808"	.46296	25	29	54
6	"6-out2809"	.07828	31	365	396
6	"6-out2810"	.15217	77	429	506
6	"6-out2811"	.13843	76	473	549
6	"6-out2812"	.08904	13	133	146
6	"6-out2813"	.14848	98	562	660
6	"6-out2814"	.08811	83	859	942
6	"6-out2815"	.10666	80	670	750
6	"6-out2816"	.08858	45	463	508
6	"6-out2817"	.18222	123	552	675
6	"6-out2818"	.17424	46	218	264
6	"6-out2820"	.07204	25	322	347
6	"6-out2821"	.16637	95	476	571
6	"6-out2822"	.06645	107	1503	1610
6	"6-out2823"	.35622	83	150	233
6	"6-out2824"	.08108	27	306	333
6	"6-out2825"	.56250	135	105	240
6	"6-out2826"	.44936	71	87	158
6	"6-out2827"	.15068	44	248	292
6	"6-out2828"	.09203	37	365	402
6	"6-out2829"	.11276	53	417	470
6	"6-out2830"	.09917	145	1317	1462
6	"6-out2831"	.29197	120	291	411
6	"6-out2832"	.07142	69	897	966
6	"6-out2833"	.15469	28	153	181
6	"6-out2834"	.11947	100	737	837
6	"6-out2835"	.10673	141	1180	1321
6	"6-out2836"	.11304	39	306	345
6	"6-out2837"	.13842	58	361	419
6	"6-out2838"	.04993	78	1484	1562
6	"6-out2839"	.35937	46	82	128
6	"6-out2840"	.12385	81	573	654
6	"6-out2841"	.18323	188	838	1026
6	"6-out2842"	.06483	33	476	509
6	"6-out2843"	.07550	86	1053	1139
6	"6-out2844"	.09933	15	136	151
6	"6-out2845"	.10280	22	192	214
6	"6-out2846"	.26116	76	215	291
6	"6-out2847"	.20338	36	141	177
6	"6-out2848"	.10881	79	647	726
6	"6-out2849"	.47422	46	51	97
6	"6-out2850"	.10344	39	338	377
6	"6-out2851"	.10057	139	1243	1382
6	"6-out2852"	.04281	14	313	327
6	"6-out2853"	.19855	55	222	277
6	"6-out2854"	.04326	9	199	208
6	"6-out2855"	.18313	76	339	415
6	"6-out2856"	.12648	64	442	506
6	"6-out2857"	.10299	86	749	835
6	"6-out2858"	.12362	45	319	364
6	"6-out2859"	.09227	43	423	466
6	"6-out2860"	.16279	49	252	301
6	"6-out2861"	.13088	367	2437	2804
6	"6-out2862"	.20786	37	141	178
6	"6-out2863"	.10471	120	1026	1146
6	"6-out2864"	.05439	26	452	478
6	"6-out2865"	.03694	30	782	812
6	"6-out2866"	.50318	237	234	471
6	"6-out2867"	.15248	172	956	1128
6	"6-out2868"	.42290	96	131	227
6	"6-out2869"	.53452	209	182	391
6	"6-out2870"	.51092	187	179	366
6	"6-out2871"	.03370	12	344	356
6	"6-out2872"	.10824	147	1211	1358
6	"6-out2873"	.06250	26	390	416
6	"6-out2874"	.05325	9	160	169
6	"6-out2875"	.08333	45	495	540
6	"6-out2876"	.08435	55	597	652
6	"6-out2877"	.05952	15	237	252
6	"6-out2878"	.05390	20	351	371
6	"6-out2879"	.39416	54	83	137
6	"6-out2880"	.03741	33	849	882
6	"6-out2881"	.10652	93	780	873
6	"6-out2882"	.03684	14	366	380
6	"6-out2883"	.14534	25	147	172
6	"6-out2884"	.16727	46	229	275
6	"6-out2885"	.17372	123	585	708
6	"6-out2886"	.31058	364	808	1172
6	"6-out2887"	.12169	69	498	567
6	"6-out2888"	.08620	50	530	580
6	"6-out2889"	.09932	161	1460	1621
6	"6-out2890"	.09189	85	840	925
6	"6-out2891"	.07951	33	382	415
6	"6-out2892"	.07851	76	892	968
6	"6-out2893"	.68421	65	30	95
6	"6-out2894"	.06681	184	2570	2754
6	"6-out2895"	.06315	24	356	380
6	"6-out2896"	.39735	120	182	302
6	"6-out2897"	.10009	110	989	1099
6	"6-out2898"	.03887	18	445	463
6	"6-out2899"	.28295	176	446	622
6	"6-out2900"	.46564	122	140	262
6	"6-out2901"	.30960	174	388	562
6	"6-out2902"	.12690	50	344	394
6	"6-out2903"	.05797	36	585	621
6	"6-out2904"	.13870	105	652	757
6	"6-out2905"	.12324	79	562	641
6	"6-out2906"	.18772	104	450	554
6	"6-out2907"	.10552	63	534	597
6	"6-out2908"	.10171	83	733	816
6	"6-out2909"	.22429	72	249	321
6	"6-out2910"	.43307	110	144	254
6	"6-out2911"	.16078	173	903	1076
6	"6-out2912"	.08626	27	286	313
6	"6-out2913"	.11770	111	832	943
6	"6-out2914"	.13122	29	192	221
6	"6-out2915"	.16533	83	419	502
6	"6-out2916"	.03157	9	276	285
6	"6-out2917"	.36641	96	166	262
6	"6-out2918"	.10862	63	517	580
6	"6-out2919"	.08757	55	573	628
6	"6-out2920"	.15882	27	143	170
6	"6-out2921"	.12671	194	1337	1531
6	"6-out2922"	.22707	104	354	458
6	"6-out2923"	.18204	217	975	1192
6	"6-out2924"	.05753	29	475	504
6	"6-out2925"	.10231	31	272	303
6	"6-out2926"	.29456	547	1310	1857
6	"6-out2927"	.02439	2	80	82
6	"6-out2928"	.11995	116	851	967
6	"6-out2929"	.26587	67	185	252
6	"6-out2930"	.07692	37	444	481
6	"6-out2931"	.22834	29	98	127
6	"6-out2932"	.25236	80	237	317
6	"6-out2933"	.11182	35	278	313
6	"6-out2934"	.27009	84	227	311
6	"6-out2935"	.45180	150	182	332
6	"6-out2936"	.14626	49	286	335
6	"6-out2937"	.08888	28	287	315
6	"6-out2938"	.18923	109	467	576
6	"6-out2939"	.10869	35	287	322
6	"6-out2940"	.12852	41	278	319
6	"6-out2941"	.08012	25	287	312
6	"6-out2942"	.28629	140	349	489
6	"6-out2943"	.32342	87	182	269
6	"6-out2944"	.16451	51	259	310
6	"6-out2945"	.27419	85	225	310
6	"6-out2946"	.23417	74	242	316
6	"6-out2947"	.10670	35	293	328
6	"6-out2948"	.13134	44	291	335
6	"6-out2949"	.25000	80	240	320
6	"6-out2950"	.41987	131	181	312
6	"6-out2951"	.40000	128	192	320
6	"6-out2952"	.35646	113	204	317
6	"6-out2953"	.38750	124	196	320
6	"6-out2954"	.40880	130	188	318
6	"6-out2955"	.35294	114	209	323
6	"6-out2956"	.36569	113	196	309
6	"6-out2957"	.19354	60	250	310
6	"6-out2958"	.10344	33	286	319
6	"6-out2959"	.14912	51	291	342
6	"6-out2960"	.09554	30	284	314
6	"6-out2961"	.12383	40	283	323
6	"6-out2962"	.07645	25	302	327
6	"6-out2963"	.09433	30	288	318
6	"6-out2964"	.42532	131	177	308
6	"6-out2965"	.21230	69	256	325
6	"6-out2966"	.28348	91	230	321
6	"6-out2967"	.12820	35	238	273
6	"6-out2968"	.10152	73	646	719
6	"6-out2969"	.60439	880	576	1456
6	"6-out2970"	.11583	90	687	777
6	"6-out2971"	.08100	55	624	679
6	"6-out2972"	.03242	25	746	771
6	"6-out2973"	.05925	48	762	810
6	"6-out2974"	.21164	40	149	189
6	"6-out2975"	.10081	37	330	367
6	"6-out2976"	.11456	59	456	515
6	"6-out2977"	.08387	169	1846	2015
6	"6-out2978"	.14206	359	2168	2527
6	"6-out2979"	.05054	14	263	277
6	"6-out2980"	.07279	38	484	522
6	"6-out2981"	.32425	262	546	808
6	"6-out2982"	.06711	109	1515	1624
6	"6-out2983"	.07692	26	312	338
6	"6-out2984"	.35398	40	73	113
6	"6-out2985"	.15578	74	401	475
6	"6-out2986"	.07772	52	617	669
6	"6-out2987"	.09259	140	1372	1512
6	"6-out2988"	.55645	69	55	124
6	"6-out2989"	.17968	46	210	256
6	"6-out2990"	.17628	113	528	641
6	"6-out2991"	.12403	129	911	1040
6	"6-out2992"	.09424	59	567	626
6	"6-out2993"	.16432	1214	6174	7388
6	"6-out2994"	.07828	31	365	396
6	"6-out2995"	.17277	66	316	382
6	"6-out2996"	.14524	113	665	778
6	"6-out2997"	.08682	29	305	334
6	"6-out2998"	.09333	77	748	825
6	"6-out2999"	.06646	44	618	662
6	"6-out3000"	.45258	482	583	1065
6	"6-out3001"	.14054	78	477	555
6	"6-out3002"	.08381	58	634	692
6	"6-out3003"	.03927	28	685	713
6	"6-out3004"	.08265	71	788	859
6	"6-out3005"	.03846	13	325	338
6	"6-out3006"	.07302	36	457	493
6	"6-out3007"	.07262	52	664	716
6	"6-out3008"	.53544	778	675	1453
6	"6-out3009"	.08464	394	4261	4655
6	"6-out3010"	.07056	41	540	581
6	"6-out3011"	.45641	89	106	195
6	"6-out3012"	.11818	91	679	770
6	"6-out3013"	.10446	199	1706	1905
6	"6-out3014"	.05703	92	1521	1613
6	"6-out3015"	.09490	82	782	864
6	"6-out3016"	.09722	35	325	360
6	"6-out3017"	.02919	4	133	137
6	"6-out3018"	.13600	17	108	125
6	"6-out3019"	.48484	48	51	99
6	"6-out3020"	.56557	69	53	122
6	"6-out3021"	.32500	39	81	120
6	"6-out3022"	.12075	64	466	530
6	"6-out3023"	.11970	455	3346	3801
6	"6-out3024"	.56965	184	139	323
6	"6-out3025"	.23387	58	190	248
6	"6-out3026"	.36525	553	961	1514
6	"6-out3027"	.12910	110	742	852
6	"6-out3028"	.10181	28	247	275
6	"6-out3029"	.45454	80	96	176
6	"6-out3030"	.09939	66	598	664
6	"6-out3031"	.10826	110	906	1016
6	"6-out3032"	.18771	278	1203	1481
6	"6-out3033"	.05336	23	408	431
6	"6-out3034"	.04618	49	1012	1061
6	"6-out3035"	.66810	155	77	232
6	"6-out3036"	.52127	98	90	188
6	"6-out3037"	.60000	183	122	305
6	"6-out3038"	.53333	208	182	390
6	"6-out3039"	.26027	152	432	584
6	"6-out3040"	.06862	7	95	102
6	"6-out3041"	.15263	29	161	190
6	"6-out3042"	.42948	67	89	156
6	"6-out3043"	.09713	237	2203	2440
6	"6-out3044"	.48143	363	391	754
6	"6-out3045"	.07912	72	838	910
6	"6-out3046"	.26859	130	354	484
6	"6-out3047"	.12944	51	343	394
6	"6-out3048"	.03795	29	735	764
6	"6-out3049"	.31034	18	40	58
6	"6-out3050"	.27374	49	130	179
6	"6-out3051"	.07766	16	190	206
6	"6-out3052"	.33105	290	586	876
6	"6-out3053"	.42156	645	885	1530
6	"6-out3054"	.09375	60	580	640
6	"6-out3055"	.04858	96	1880	1976
6	"6-out3056"	.11530	55	422	477
6	"6-out3057"	.08089	36	409	445
6	"6-out3058"	.07906	91	1060	1151
6	"6-out3059"	.08501	97	1044	1141
6	"6-out3060"	.13090	61	405	466
6	"6-out3061"	.17345	332	1582	1914
6	"6-out3062"	.06466	71	1027	1098
6	"6-out3063"	.07968	20	231	251
6	"6-out3064"	.05523	29	496	525
6	"6-out3065"	.31134	269	595	864
6	"6-out3066"	.27257	160	427	587
6	"6-out3067"	.27576	99	260	359
6	"6-out3068"	.09183	9	89	98
6	"6-out3069"	.11063	284	2283	2567
6	"6-out3070"	.17166	103	497	600
6	"6-out3071"	.06861	148	2009	2157
6	"6-out3072"	.09362	91	881	972
6	"6-out3073"	.25581	55	160	215
6	"6-out3074"	.13567	108	688	796
6	"6-out3075"	.11552	32	245	277
6	"6-out3076"	.36995	165	281	446
6	"6-out3077"	.09090	16	160	176
6	"6-out3078"	.11451	71	549	620
6	"6-out3079"	.09153	53	526	579
6	"6-out3080"	.12527	57	398	455
6	"6-out3081"	.11196	58	460	518
6	"6-out3082"	.36986	54	92	146
6	"6-out3083"	.21075	98	367	465
6	"6-out3084"	.08889	269	2757	3026
6	"6-out3085"	.11594	24	183	207
6	"6-out3086"	.06236	29	436	465
6	"6-out3087"	.47959	47	51	98
6	"6-out3088"	.61437	282	177	459
6	"6-out3089"	.09615	15	141	156
6	"6-out3090"	.20917	196	741	937
6	"6-out3091"	.03030	8	256	264
6	"6-out3092"	.07882	70	818	888
6	"6-out3093"	.01626	4	242	246
6	"6-out3094"	.11858	37	275	312
6	"6-out3095"	.51578	147	138	285
6	"6-out3096"	.07082	25	328	353
6	"6-out3097"	.22998	385	1289	1674
6	"6-out3098"	.13438	213	1372	1585
6	"6-out3099"	.36722	484	834	1318
6	"6-out3100"	.27260	196	523	719
6	"6-out3101"	.08211	118	1319	1437
6	"6-out3102"	.20425	307	1196	1503
6	"6-out3103"	.38912	93	146	239
6	"6-out3104"	.09344	87	844	931
6	"6-out3105"	.08075	73	831	904
6	"6-out3106"	.41163	184	263	447
6	"6-out3107"	.09500	19	181	200
6	"6-out3108"	.04000	28	672	700
6	"6-out3109"	.04611	92	1903	1995
6	"6-out3110"	.09677	24	224	248
6	"6-out3111"	.10989	90	729	819
6	"6-out3112"	.08482	19	205	224
6	"6-out3113"	.06961	74	989	1063
6	"6-out3114"	.03932	7	171	178
6	"6-out3115"	.09433	75	720	795
6	"6-out3116"	.13157	65	429	494
6	"6-out3117"	.16621	123	617	740
6	"6-out3118"	.28629	71	177	248
6	"6-out3119"	.39207	89	138	227
6	"6-out3120"	.07729	16	191	207
6	"6-out3121"	.37533	417	694	1111
6	"6-out3122"	.07599	44	535	579
6	"6-out3123"	.09660	91	851	942
6	"6-out3124"	.10574	197	1666	1863
6	"6-out3125"	.12962	84	564	648
6	"6-out3126"	.12898	97	655	752
6	"6-out3127"	.26213	27	76	103
6	"6-out3128"	.24145	106	333	439
6	"6-out3129"	.06358	11	162	173
6	"6-out3130"	.07180	68	879	947
6	"6-out3131"	.09265	29	284	313
6	"6-out3132"	.14329	278	1662	1940
6	"6-out3133"	.09662	83	776	859
6	"6-out3134"	.08385	94	1027	1121
6	"6-out3135"	.25949	41	117	158
6	"6-out3136"	.11878	43	319	362
6	"6-out3137"	.12817	111	755	866
6	"6-out3138"	.04554	24	503	527
6	"6-out3139"	.08222	31	346	377
6	"6-out3140"	.37974	330	539	869
6	"6-out3141"	.06455	51	739	790
6	"6-out3142"	.09269	132	1292	1424
6	"6-out3143"	.09494	107	1020	1127
6	"6-out3144"	.09355	193	1870	2063
6	"6-out3145"	.12519	81	566	647
6	"6-out3146"	.54700	64	53	117
6	"6-out3147"	.54700	64	53	117
6	"6-out3148"	.16712	181	902	1083
6	"6-out3149"	.08239	44	490	534
6	"6-out3150"	.10300	72	627	699
6	"6-out3151"	.08044	58	663	721
6	"6-out3152"	.06362	46	677	723
6	"6-out3153"	.08826	85	878	963
6	"6-out3154"	.05590	9	152	161
6	"6-out3155"	.30769	28	63	91
6	"6-out3156"	.43697	52	67	119
6	"6-out3157"	.39316	46	71	117
6	"6-out3158"	.08904	13	133	146
6	"6-out3159"	.18956	69	295	364
6	"6-out3160"	.49115	1389	1439	2828
6	"6-out3161"	.28431	58	146	204
6	"6-out3162"	.03163	33	1010	1043
6	"6-out3163"	.17200	381	1834	2215
6	"6-out3164"	.10052	19	170	189
6	"6-out3165"	.30653	225	509	734
6	"6-out3166"	.13898	246	1524	1770
6	"6-out3167"	.05268	53	953	1006
6	"6-out3168"	.07465	76	942	1018
6	"6-out3169"	.05177	48	879	927
6	"6-out3170"	.27720	135	352	487
6	"6-out3171"	.33953	73	142	215
6	"6-out3172"	.19543	180	741	921
6	"6-out3173"	.18452	62	274	336
6	"6-out3174"	.11312	50	392	442
6	"6-out3175"	.11713	121	912	1033
6	"6-out3176"	.08513	63	677	740
6	"6-out3177"	.10965	109	885	994
6	"6-out3178"	.05916	71	1129	1200
6	"6-out3179"	.08092	14	159	173
6	"6-out3180"	.61311	187	118	305
6	"6-out3181"	.47766	139	152	291
6	"6-out3182"	.26395	208	580	788
6	"6-out3183"	.31937	1663	3544	5207
6	"6-out3184"	.21568	33	120	153
6	"6-out3185"	.11222	525	4153	4678
6	"6-out3186"	.07356	69	869	938
6	"6-out3187"	.16125	313	1628	1941
6	"6-out3188"	.09428	122	1172	1294
6	"6-out3189"	.16666	22	110	132
6	"6-out3190"	.31901	364	777	1141
6	"6-out3191"	.04709	60	1214	1274
6	"6-out3192"	.06821	88	1202	1290
6	"6-out3193"	.18357	152	676	828
6	"6-out3194"	.15476	13	71	84
6	"6-out3195"	.14925	260	1482	1742
6	"6-out3196"	.04941	51	981	1032
6	"6-out3197"	.11392	27	210	237
6	"6-out3198"	.06986	16	213	229
6	"6-out3199"	.13839	124	772	896
6	"6-out3200"	.09969	97	876	973
6	"6-out3201"	.42298	173	236	409
6	"6-out3202"	.11337	39	305	344
6	"6-out3203"	.46326	454	526	980
6	"6-out3204"	.07538	79	969	1048
6	"6-out3205"	.14726	43	249	292
6	"6-out3206"	.07971	11	127	138
6	"6-out3207"	.13377	61	395	456
6	"6-out3208"	.57236	174	130	304
6	"6-out3209"	.08950	168	1709	1877
6	"6-out3210"	.14328	48	287	335
6	"6-out3211"	.16939	31	152	183
6	"6-out3212"	.06841	34	463	497
6	"6-out3213"	.24050	19	60	79
6	"6-out3214"	.57142	112	84	196
6	"6-out3215"	.23809	75	240	315
6	"6-out3216"	.10814	73	602	675
6	"6-out3217"	.26694	130	357	487
6	"6-out3218"	.11485	58	447	505
6	"6-out3219"	.32504	170	353	523
6	"6-out3220"	.17295	55	263	318
6	"6-out3221"	.36423	55	96	151
6	"6-out3222"	.27672	88	230	318
6	"6-out3223"	.07491	23	284	307
6	"6-out3224"	.11688	36	272	308
6	"6-out3225"	.16759	30	149	179
6	"6-out3226"	.35048	109	202	311
6	"6-out3227"	.06511	14	201	215
6	"6-out3228"	.26771	34	93	127
6	"6-out3229"	.41772	66	92	158
6	"6-out3230"	.23225	72	238	310
6	"6-out3231"	.11145	36	287	323
6	"6-out3232"	.18987	60	256	316
6	"6-out3233"	.28353	93	235	328
6	"6-out3234"	.45337	141	170	311
6	"6-out3235"	.41423	128	181	309
6	"6-out3236"	.14423	45	267	312
6	"6-out3237"	.29836	91	214	305
6	"6-out3238"	.41346	129	183	312
6	"6-out3239"	.45047	141	172	313
6	"6-out3240"	.44089	138	175	313
6	"6-out3241"	.13461	42	270	312
6	"6-out3242"	.36858	115	197	312
6	"6-out3243"	.05993	19	298	317
6	"6-out3244"	.09235	29	285	314
6	"6-out3245"	.10256	32	280	312
6	"6-out3246"	.15337	50	276	326
6	"6-out3247"	.15789	48	256	304
6	"6-out3248"	.11392	36	280	316
6	"6-out3249"	.17948	56	256	312
6	"6-out3250"	.37920	124	203	327
6	"6-out3251"	.19808	62	251	313
6	"6-out3252"	.19062	61	259	320
6	"6-out3253"	.24038	50	158	208
6	"6-out3254"	.07628	37	448	485
6	"6-out3255"	.12363	34	241	275
6	"6-out3256"	.04711	49	991	1040
6	"6-out3257"	.09955	246	2225	2471
6	"6-out3258"	.07529	171	2100	2271
6	"6-out3259"	.20380	75	293	368
6	"6-out3260"	.18640	266	1161	1427
6	"6-out3261"	.09309	31	302	333
6	"6-out3262"	.10640	128	1075	1203
6	"6-out3263"	.16610	49	246	295
6	"6-out3264"	.07303	68	863	931
6	"6-out3265"	.09481	150	1432	1582
6	"6-out3266"	.05063	4	75	79
6	"6-out3267"	.39068	218	340	558
6	"6-out3268"	.08205	112	1253	1365
6	"6-out3269"	.06321	22	326	348
6	"6-out3270"	.24539	40	123	163
6	"6-out3271"	.11494	10	77	87
6	"6-out3272"	.32317	53	111	164
6	"6-out3273"	.19667	71	290	361
6	"6-out3274"	.02325	4	168	172
6	"6-out3275"	.09090	32	320	352
6	"6-out3276"	.11798	82	613	695
6	"6-out3277"	.09493	30	286	316
6	"6-out3278"	.44554	90	112	202
6	"6-out3279"	.11677	55	416	471
6	"6-out3280"	.07474	29	359	388
6	"6-out3281"	.05347	20	354	374
6	"6-out3282"	.19298	66	276	342
6	"6-out3283"	.17514	62	292	354
6	"6-out3284"	.01608	6	367	373
6	"6-out3285"	.13287	192	1253	1445
6	"6-out3286"	.12500	92	644	736
6	"6-out3287"	.11299	80	628	708
6	"6-out3288"	.07744	57	679	736
6	"6-out3289"	.11026	29	234	263
6	"6-out3290"	.45073	215	262	477
6	"6-out3291"	.18138	154	695	849
6	"6-out3292"	.56504	430	331	761
6	"6-out3293"	.10687	42	351	393
6	"6-out3294"	.10441	71	609	680
6	"6-out3295"	.06161	39	594	633
6	"6-out3296"	.08149	59	665	724
6	"6-out3297"	.03846	28	700	728
6	"6-out3298"	.06756	10	138	148
6	"6-out3299"	.57614	227	167	394
6	"6-out3300"	.05797	8	130	138
6	"6-out3301"	.14795	58	334	392
6	"6-out3302"	.30110	190	441	631
6	"6-out3303"	.11645	75	569	644
6	"6-out3304"	.14659	56	326	382
6	"6-out3305"	.10377	77	665	742
6	"6-out3306"	.13273	88	575	663
6	"6-out3307"	.06378	31	455	486
6	"6-out3308"	.10692	71	593	664
6	"6-out3309"	.10135	30	266	296
6	"6-out3310"	.14112	35	213	248
6	"6-out3311"	.45100	313	381	694
6	"6-out3312"	.45574	242	289	531
6	"6-out3313"	.11711	13	98	111
6	"6-out3314"	.07653	30	362	392
6	"6-out3315"	.12925	57	384	441
6	"6-out3316"	.19178	28	118	146
6	"6-out3317"	.44144	49	62	111
6	"6-out3318"	.13274	15	98	113
6	"6-out3319"	.25263	24	71	95
6	"6-out3320"	.50887	172	166	338
6	"6-out3321"	.13821	17	106	123
6	"6-out3322"	.41753	200	279	479
6	"6-out3323"	.05871	32	513	545
6	"6-out3324"	.17748	93	431	524
6	"6-out3325"	.24365	144	447	591
6	"6-out3326"	.50609	83	81	164
6	"6-out3327"	.43292	71	93	164
6	"6-out3328"	.45121	74	90	164
6	"6-out3329"	.12141	144	1042	1186
6	"6-out3330"	.15328	212	1171	1383
6	"6-out3331"	.13192	50	329	379
6	"6-out3332"	.07493	29	358	387
6	"6-out3333"	.12876	77	521	598
6	"6-out3334"	.07328	45	569	614
6	"6-out3335"	.36500	73	127	200
6	"6-out3336"	.11982	84	617	701
6	"6-out3337"	.08385	27	295	322
6	"6-out3338"	.22400	84	291	375
6	"6-out3339"	.27416	278	736	1014
6	"6-out3340"	.18895	65	279	344
6	"6-out3341"	.11838	47	350	397
6	"6-out3342"	.07132	49	638	687
6	"6-out3343"	.10483	39	333	372
6	"6-out3344"	.04569	17	355	372
6	"6-out3345"	.55364	129	104	233
6	"6-out3346"	.12868	118	799	917
6	"6-out3347"	.08486	106	1143	1249
6	"6-out3348"	.06837	32	436	468
6	"6-out3349"	.16818	37	183	220
6	"6-out3350"	.58823	30	21	51
6	"6-out3351"	.04842	23	452	475
6	"6-out3352"	.41398	438	620	1058
6	"6-out3353"	.13088	89	591	680
6	"6-out3354"	.08710	25	262	287
6	"6-out3355"	.42812	137	183	320
6	"6-out3356"	.42622	26	35	61
6	"6-out3358"	.06600	87	1231	1318
6	"6-out3359"	.20781	133	507	640
6	"6-out3360"	.09957	70	633	703
6	"6-out3361"	.37931	22	36	58
6	"6-out3362"	.12552	89	620	709
6	"6-out3363"	.52272	92	84	176
6	"6-out3364"	.03816	15	378	393
6	"6-out3365"	.06779	8	110	118
6	"6-out3366"	.09281	31	303	334
6	"6-out3367"	.24390	60	186	246
6	"6-out3368"	.22033	26	92	118
6	"6-out3369"	.04848	8	157	165
6	"6-out3370"	.14705	35	203	238
6	"6-out3371"	.07253	14	179	193
6	"6-out3372"	.18357	38	169	207
6	"6-out3373"	.06060	10	155	165
6	"6-out3374"	.10412	111	955	1066
6	"6-out3375"	.45247	119	144	263
6	"6-out3376"	.44859	48	59	107
6	"6-out3377"	.55029	93	76	169
6	"6-out3378"	.09677	9	84	93
6	"6-out3379"	.17821	18	83	101
6	"6-out3380"	.12362	135	957	1092
6	"6-out3381"	.19354	66	275	341
6	"6-out3382"	.10556	294	2491	2785
6	"6-out3383"	.15322	19	105	124
6	"6-out3384"	.51758	309	288	597
6	"6-out3385"	.13161	92	607	699
6	"6-out3386"	.09133	39	388	427
6	"6-out3387"	.39669	48	73	121
6	"6-out3388"	.23655	44	142	186
6	"6-out3389"	.28017	65	167	232
6	"6-out3390"	.07818	76	896	972
6	"6-out3391"	.06832	11	150	161
6	"6-out3392"	.35365	58	106	164
6	"6-out3393"	.14543	153	899	1052
6	"6-out3394"	.10884	16	131	147
6	"6-out3395"	.08005	57	655	712
6	"6-out3396"	.14959	168	955	1123
6	"6-out3397"	.11133	109	870	979
6	"6-out3398"	.57541	206	152	358
6	"6-out3399"	.10914	37	302	339
6	"6-out3400"	.16143	36	187	223
6	"6-out3401"	.07029	31	410	441
6	"6-out3402"	.07480	49	606	655
6	"6-out3403"	.35766	98	176	274
6	"6-out3404"	.59659	315	213	528
6	"6-out3405"	.07371	23	289	312
6	"6-out3406"	.61132	324	206	530
6	"6-out3407"	.35179	108	199	307
6	"6-out3408"	.22535	32	110	142
6	"6-out3409"	.08874	138	1417	1555
6	"6-out3410"	.14002	205	1259	1464
6	"6-out3411"	.29177	234	568	802
6	"6-out3412"	.20440	65	253	318
6	"6-out3413"	.11961	86	633	719
6	"6-out3414"	.49245	261	269	530
6	"6-out3415"	.19850	106	428	534
6	"6-out3416"	.52868	129	115	244
6	"6-out3417"	.47967	118	128	246
6	"6-out3418"	.19262	47	197	244
6	"6-out3419"	.51497	172	162	334
6	"6-out3420"	.45528	112	134	246
6	"6-out3421"	.10328	107	929	1036
6	"6-out3422"	.09110	43	429	472
6	"6-out3423"	.08125	39	441	480
6	"6-out3424"	.12556	278	1936	2214
6	"6-out3425"	.09724	106	984	1090
6	"6-out3426"	.06461	61	883	944
6	"6-out3427"	.07948	74	857	931
6	"6-out3428"	.14879	68	389	457
6	"6-out3429"	.16844	268	1323	1591
6	"6-out3430"	.13513	35	224	259
6	"6-out3431"	.08551	72	770	842
6	"6-out3432"	.06925	66	887	953
6	"6-out3433"	.10550	278	2357	2635
6	"6-out3434"	.07612	248	3010	3258
6	"6-out3435"	.09012	73	737	810
6	"6-out3436"	.27344	172	457	629
6	"6-out3437"	.10934	331	2696	3027
6	"6-out3438"	.08872	37	380	417
6	"6-out3439"	.09557	41	388	429
6	"6-out3440"	.14259	79	475	554
6	"6-out3441"	.25536	119	347	466
6	"6-out3442"	.05319	10	178	188
6	"6-out3443"	.02424	4	161	165
6	"6-out3444"	.04375	7	153	160
6	"6-out3445"	.05031	8	151	159
6	"6-out3446"	.08191	48	538	586
6	"6-out3447"	.12162	99	715	814
6	"6-out3448"	.09401	11	106	117
6	"6-out3449"	.16412	129	657	786
6	"6-out3450"	.16226	43	222	265
6	"6-out3451"	.11148	33	263	296
6	"6-out3452"	.23240	175	578	753
6	"6-out3453"	.12073	46	335	381
6	"6-out3454"	.54923	502	412	914
6	"6-out3455"	.10429	131	1125	1256
6	"6-out3456"	.47151	298	334	632
6	"6-out3457"	.20593	125	482	607
6	"6-out3458"	.07142	107	1391	1498
6	"6-out3459"	.11320	54	423	477
6	"6-out3460"	.15321	112	619	731
6	"6-out3461"	.39339	131	202	333
6	"6-out3462"	.05825	30	485	515
6	"6-out3463"	.04576	20	417	437
6	"6-out3464"	.09740	15	139	154
6	"6-out3465"	.14127	51	310	361
6	"6-out3466"	.10161	82	725	807
6	"6-out3467"	.06856	70	951	1021
6	"6-out3468"	.09507	56	533	589
6	"6-out3469"	.20657	88	338	426
6	"6-out3470"	.31941	130	277	407
6	"6-out3471"	.10426	22	189	211
6	"6-out3472"	.38876	173	272	445
6	"6-out3473"	.12012	40	293	333
6	"6-out3474"	.06367	17	250	267
6	"6-out3475"	.08290	32	354	386
6	"6-out3476"	.21578	134	487	621
6	"6-out3477"	.35897	196	350	546
6	"6-out3478"	.07829	22	259	281
6	"6-out3479"	.12137	46	333	379
6	"6-out3480"	.12698	56	385	441
6	"6-out3481"	.08245	109	1213	1322
6	"6-out3482"	.12451	32	225	257
6	"6-out3483"	.57510	402	297	699
6	"6-out3484"	.12690	50	344	394
6	"6-out3485"	.11050	101	813	914
6	"6-out3486"	.22508	131	451	582
6	"6-out3487"	.13296	73	476	549
6	"6-out3488"	.11724	17	128	145
6	"6-out3489"	.08996	26	263	289
6	"6-out3490"	.06557	20	285	305
6	"6-out3491"	.37804	124	204	328
6	"6-out3492"	.23000	92	308	400
6	"6-out3493"	.36796	255	438	693
6	"6-out3494"	.37373	259	434	693
6	"6-out3495"	.39800	240	363	603
6	"6-out3496"	.41373	247	350	597
6	"6-out3497"	.42325	182	248	430
6	"6-out3498"	.12855	131	888	1019
6	"6-out3499"	.15231	69	384	453
6	"6-out3500"	.12121	60	435	495
6	"6-out3501"	.10869	10	82	92
6	"6-out3502"	.14000	14	86	100
6	"6-out3503"	.08658	40	422	462
6	"6-out3504"	.10152	40	354	394
6	"6-out3505"	.05454	24	416	440
6	"6-out3506"	.07743	35	417	452
6	"6-out3507"	.43851	296	379	675
6	"6-out3508"	.22800	57	193	250
6	"6-out3509"	.28301	60	152	212
6	"6-out3510"	.58333	77	55	132
6	"6-out3511"	.15047	48	271	319
6	"6-out3512"	.42091	157	216	373
6	"6-out3513"	.15105	50	281	331
6	"6-out3514"	.18916	178	763	941
6	"6-out3515"	.09062	87	873	960
6	"6-out3516"	.18152	57	257	314
6	"6-out3517"	.09800	49	451	500
6	"6-out3518"	.07801	22	260	282
6	"6-out3519"	.42135	217	298	515
6	"6-out3520"	.05277	19	341	360
6	"6-out3521"	.20891	75	284	359
6	"6-out3522"	.07611	29	352	381
6	"6-out3523"	.11936	45	332	377
6	"6-out3524"	.11549	41	314	355
6	"6-out3525"	.16844	63	311	374
6	"6-out3526"	.44021	81	103	184
6	"6-out3527"	.14132	79	480	559
6	"6-out3528"	.23502	102	332	434
6	"6-out3529"	.12442	54	380	434
6	"6-out3530"	.19585	85	349	434
6	"6-out3531"	.27855	100	259	359
6	"6-out3532"	.06779	24	330	354
6	"6-out3533"	.12058	82	598	680
6	"6-out3534"	.36940	256	437	693
6	"6-out3535"	.07531	65	798	863
6	"6-out3536"	.09902	61	555	616
6	"6-out3537"	.13793	96	600	696
6	"6-out3538"	.10743	52	432	484
6	"6-out3539"	.08407	38	414	452
6	"6-out3540"	.09819	38	349	387
6	"6-out3541"	.29510	175	418	593
6	"6-out3542"	.11915	51	377	428
6	"6-out3543"	.09090	37	370	407
6	"6-out3544"	.14695	41	238	279
6	"6-out3545"	.18333	132	588	720
6	"6-out3546"	.41455	131	185	316
6	"6-out3547"	.06884	19	257	276
6	"6-out3548"	.41162	177	253	430
6	"6-out3549"	.15314	134	741	875
6	"6-out3550"	.28542	286	716	1002
6	"6-out3551"	.12780	285	1945	2230
6	"6-out3552"	.58677	71	50	121
6	"6-out3553"	.10262	43	376	419
6	"6-out3554"	.48628	195	206	401
6	"6-out3555"	.45864	183	216	399
6	"6-out3556"	.09731	29	269	298
6	"6-out3557"	.20792	21	80	101
6	"6-out3558"	.07296	61	775	836
6	"6-out3559"	.05188	51	932	983
6	"6-out3560"	.09022	12	121	133
6	"6-out3561"	.10708	127	1059	1186
6	"6-out3562"	.03550	6	163	169
6	"6-out3563"	.05514	74	1268	1342
6	"6-out3564"	.05433	52	905	957
6	"6-out3565"	.12800	160	1090	1250
6	"6-out3566"	.15774	109	582	691
6	"6-out3567"	.16101	57	297	354
6	"6-out3568"	.08803	39	404	443
6	"6-out3569"	.14102	22	134	156
6	"6-out3570"	.13398	205	1325	1530
6	"6-out3571"	.13076	17	113	130
6	"6-out3572"	.11010	73	590	663
6	"6-out3573"	.42647	58	78	136
6	"6-out3574"	.43750	294	378	672
6	"6-out3575"	.13105	46	305	351
6	"6-out3576"	.09751	98	907	1005
6	"6-out3577"	.05089	37	690	727
6	"6-out3578"	.07047	100	1319	1419
6	"6-out3579"	.07924	42	488	530
6	"6-out3580"	.07203	34	438	472
6	"6-out3581"	.12662	68	469	537
6	"6-out3582"	.25842	23	66	89
6	"6-out3583"	.33333	70	140	210
6	"6-out3584"	.12400	499	3525	4024
6	"6-out3585"	.51724	60	56	116
6	"6-out3586"	.27683	49	128	177
6	"6-out3587"	.08029	359	4112	4471
6	"6-out3588"	.18410	44	195	239
6	"6-out3589"	.08426	45	489	534
6	"6-out3590"	.06813	37	506	543
6	"6-out3591"	.54983	502	411	913
6	"6-out3592"	.35854	128	229	357
6	"6-out3593"	.06730	14	194	208
6	"6-out3594"	.02886	17	572	589
6	"6-out3595"	.12280	70	500	570
6	"6-out3596"	.52910	309	275	584
6	"6-out3597"	.10526	8	68	76
6	"6-out3598"	.58115	111	80	191
6	"6-out3599"	.58713	283	199	482
6	"6-out3600"	.60892	341	219	560
6	"6-out3601"	.58226	407	292	699
6	"6-out3602"	.60458	422	276	698
6	"6-out3603"	.59523	350	238	588
6	"6-out3604"	.59455	393	268	661
6	"6-out3605"	.56734	139	106	245
6	"6-out3606"	.16858	44	217	261
6	"6-out3607"	.06497	23	331	354
6	"6-out3608"	.15801	70	373	443
6	"6-out3609"	.41224	101	144	245
6	"6-out3610"	.12026	73	534	607
6	"6-out3611"	.04745	14	281	295
6	"6-out3612"	.09090	32	320	352
6	"6-out3613"	.08174	30	337	367
6	"6-out3614"	.02368	9	371	380
6	"6-out3615"	.36813	201	345	546
6	"6-out3616"	.07777	21	249	270
6	"6-out3617"	.11904	95	703	798
6	"6-out3618"	.11517	63	484	547
6	"6-out3619"	.44067	52	66	118
6	"6-out3620"	.17406	51	242	293
6	"6-out3621"	.43954	996	1270	2266
6	"6-out3622"	.11556	49	375	424
6	"6-out3623"	.12048	10	73	83
6	"6-out3624"	.05639	15	251	266
6	"6-out3625"	.16226	43	222	265
6	"6-out3626"	.41284	135	192	327
6	"6-out3627"	.08529	167	1791	1958
6	"6-out3628"	.04580	12	250	262
6	"6-out3629"	.05941	59	934	993
6	"6-out3630"	.09211	97	956	1053
6	"6-out3631"	.03821	6	151	157
6	"6-out3632"	.11111	28	224	252
6	"6-out3633"	.15059	89	502	591
6	"6-out3634"	.32919	159	324	483
6	"6-out3635"	.48013	145	157	302
6	"6-out3636"	.60927	184	118	302
6	"6-out3637"	.02380	12	492	504
6	"6-out3638"	.05121	21	389	410
6	"6-out3639"	.52471	276	250	526
6	"6-out3640"	.10215	38	334	372
6	"6-out3641"	.08726	50	523	573
6	"6-out3642"	.06415	34	496	530
6	"6-out3643"	.23943	34	108	142
6	"6-out3644"	.09859	14	128	142
6	"6-out3645"	.07010	68	902	970
6	"6-out3646"	.51265	81	77	158
6	"6-out3647"	.09523	40	380	420
6	"6-out3648"	.03478	12	333	345
6	"6-out3649"	.05172	18	330	348
6	"6-out3650"	.08187	70	785	855
6	"6-out3651"	.40786	197	286	483
6	"6-out3652"	.39848	263	397	660
6	"6-out3653"	.37627	996	1651	2647
6	"6-out3654"	.06918	22	296	318
6	"6-out3655"	.13265	39	255	294
6	"6-out3656"	.17636	100	467	567
6	"6-out3657"	.05705	19	314	333
6	"6-out3658"	.51792	289	269	558
6	"6-out3659"	.03934	62	1514	1576
6	"6-out3660"	.33070	420	850	1270
6	"6-out3661"	.40369	153	226	379
6	"6-out3662"	.03916	15	368	383
6	"6-out3663"	.27103	654	1759	2413
6	"6-out3664"	.12280	49	350	399
6	"6-out3665"	.09734	88	816	904
6	"6-out3666"	.43965	51	65	116
6	"6-out3667"	.12966	66	443	509
6	"6-out3668"	.12121	68	493	561
6	"6-out3669"	.08928	45	459	504
6	"6-out3670"	.07602	26	316	342
6	"6-out3671"	.07084	26	341	367
6	"6-out3672"	.14841	103	591	694
6	"6-out3673"	.05040	25	471	496
6	"6-out3674"	.07766	8	95	103
6	"6-out3675"	.07681	54	649	703
6	"6-out3676"	.43333	143	187	330
6	"6-out3677"	.15985	176	925	1101
6	"6-out3678"	.15507	185	1008	1193
6	"6-out3679"	.03938	41	1000	1041
6	"6-out3680"	.12149	52	376	428
6	"6-out3681"	.15116	65	365	430
6	"6-out3682"	.35126	111	205	316
6	"6-out3683"	.10256	28	245	273
6	"6-out3684"	.08119	57	645	702
6	"6-out3685"	.12290	44	314	358
6	"6-out3686"	.08333	20	220	240
6	"6-out3687"	.09885	26	237	263
6	"6-out3688"	.08160	55	619	674
6	"6-out3689"	.38407	217	348	565
6	"6-out3690"	.11303	470	3688	4158
6	"6-out3691"	.21468	38	139	177
6	"6-out3692"	.14359	444	2648	3092
6	"6-out3693"	.09776	35	323	358
6	"6-out3694"	.08955	18	183	201
6	"6-out3695"	.11556	176	1347	1523
6	"6-out3696"	.07734	42	501	543
6	"6-out3697"	.10303	17	148	165
6	"6-out3698"	.12812	41	279	320
6	"6-out3699"	.05000	61	1159	1220
6	"6-out3700"	.05489	23	396	419
6	"6-out3701"	.11864	63	468	531
6	"6-out3702"	.13418	42	271	313
6	"6-out3703"	.18789	149	644	793
6	"6-out3704"	.06420	33	481	514
6	"6-out3705"	.14646	29	169	198
6	"6-out3706"	.07692	8	96	104
6	"6-out3707"	.11297	54	424	478
6	"6-out3708"	.08290	81	896	977
6	"6-out3709"	.08333	8	88	96
6	"6-out3710"	.08440	59	640	699
6	"6-out3711"	.37028	157	267	424
6	"6-out3712"	.55329	109	88	197
6	"6-out3713"	.29640	206	489	695
6	"6-out3714"	.06929	51	685	736
6	"6-out3715"	.03431	7	197	204
6	"6-out3716"	.10057	139	1243	1382
6	"6-out3717"	.04280	25	559	584
6	"6-out3718"	.04347	7	154	161
6	"6-out3719"	.33474	79	157	236
6	"6-out3720"	.31192	68	150	218
6	"6-out3721"	.02785	10	349	359
6	"6-out3722"	.05507	45	772	817
6	"6-out3723"	.21902	99	353	452
6	"6-out3724"	.08512	103	1107	1210
6	"6-out3725"	.09574	63	595	658
6	"6-out3726"	.08448	104	1127	1231
6	"6-out3727"	.23893	27	86	113
6	"6-out3728"	.39184	221	343	564
6	"6-out3729"	.12168	55	397	452
6	"6-out3730"	.16722	50	249	299
6	"6-out3731"	.05398	44	771	815
6	"6-out3732"	.06696	60	836	896
6	"6-out3733"	.09801	193	1776	1969
6	"6-out3734"	.17624	46	215	261
6	"6-out3735"	.19669	262	1070	1332
6	"6-out3736"	.09685	80	746	826
6	"6-out3737"	.07185	73	943	1016
6	"6-out3738"	.09268	71	695	766
6	"6-out3739"	.14185	162	980	1142
6	"6-out3740"	.08677	21	221	242
6	"6-out3741"	.11305	84	659	743
6	"6-out3742"	.13373	67	434	501
6	"6-out3743"	.34857	122	228	350
6	"6-out3744"	.37414	110	184	294
6	"6-out3745"	.06250	18	270	288
6	"6-out3746"	.22784	126	427	553
6	"6-out3747"	.11173	60	477	537
6	"6-out3748"	.05967	33	520	553
6	"6-out3749"	.07640	45	544	589
6	"6-out3750"	.53370	95	83	178
6	"6-out3751"	.15789	108	576	684
6	"6-out3752"	.50306	82	81	163
6	"6-out3753"	.19597	39	160	199
6	"6-out3754"	.37037	100	170	270
6	"6-out3755"	.21111	76	284	360
6	"6-out3756"	.04797	19	377	396
6	"6-out3757"	.07384	24	301	325
6	"6-out3758"	.41148	86	123	209
6	"6-out3759"	.14358	28	167	195
6	"6-out3760"	.10248	33	289	322
6	"6-out3761"	.10785	81	670	751
6	"6-out3762"	.05371	13	229	242
6	"6-out3763"	.07534	11	135	146
6	"6-out3764"	.10280	77	672	749
6	"6-out3765"	.12133	29	210	239
6	"6-out3766"	.18333	44	196	240
6	"6-out3767"	.08878	19	195	214
6	"6-out3768"	.10619	24	202	226
6	"6-out3769"	.19215	49	206	255
6	"6-out3770"	.07804	16	189	205
6	"6-out3771"	.09389	20	193	213
6	"6-out3772"	.14285	34	204	238
6	"6-out3773"	.10964	25	203	228
6	"6-out3774"	.63157	240	140	380
6	"6-out3775"	.12131	37	268	305
6	"6-out3776"	.58227	46	33	79
6	"6-out3777"	.58227	46	33	79
6	"6-out3778"	.57042	81	61	142
6	"6-out3779"	.10256	36	315	351
6	"6-out3780"	.37383	40	67	107
6	"6-out3781"	.17307	45	215	260
6	"6-out3782"	.12039	85	621	706
6	"6-out3783"	.03947	21	511	532
6	"6-out3784"	.10972	44	357	401
6	"6-out3785"	.09166	44	436	480
6	"6-out3786"	.37234	35	59	94
6	"6-out3787"	.11376	310	2415	2725
6	"6-out3788"	.23529	16	52	68
6	"6-out3789"	.11877	93	690	783
6	"6-out3790"	.16408	53	270	323
6	"6-out3791"	.08978	29	294	323
6	"6-out3792"	.08325	84	925	1009
6	"6-out3793"	.08869	113	1161	1274
6	"6-out3794"	.18461	108	477	585
6	"6-out3795"	.06093	73	1125	1198
6	"6-out3796"	.11155	28	223	251
6	"6-out3797"	.34736	33	62	95
6	"6-out3798"	.07738	13	155	168
6	"6-out3799"	.10979	37	300	337
6	"6-out3800"	.04010	31	742	773
6	"6-out3801"	.05578	41	694	735
6	"6-out3802"	.10000	30	270	300
6	"6-out3803"	.08064	25	285	310
6	"6-out3804"	.48973	167	174	341
6	"6-out3805"	.26530	26	72	98
6	"6-out3806"	.15862	23	122	145
6	"6-out3807"	.18556	18	79	97
6	"6-out3808"	.44776	30	37	67
6	"6-out3809"	.07737	92	1097	1189
6	"6-out3810"	.07840	159	1869	2028
6	"6-out3811"	.73972	54	19	73
6	"6-out3812"	.07666	46	554	600
6	"6-out3813"	.22646	89	304	393
6	"6-out3814"	.32565	99	205	304
6	"6-out3815"	.04569	35	731	766
6	"6-out3816"	.07671	28	337	365
6	"6-out3817"	.08724	227	2375	2602
6	"6-out3818"	.20574	351	1355	1706
6	"6-out3819"	.06418	31	452	483
6	"6-out3820"	.05516	71	1216	1287
6	"6-out3821"	.11153	59	470	529
6	"6-out3822"	.07234	34	436	470
6	"6-out3823"	.40606	67	98	165
6	"6-out3824"	.33505	65	129	194
6	"6-out3825"	.54687	35	29	64
6	"6-out3826"	.07960	64	740	804
6	"6-out3827"	.54285	38	32	70
6	"6-out3828"	.11224	121	957	1078
6	"6-out3829"	.29761	50	118	168
6	"6-out3830"	.58333	49	35	84
6	"6-out3831"	.07828	31	365	396
6	"6-out3832"	.04029	22	524	546
6	"6-out3833"	.04511	18	381	399
6	"6-out3834"	.05175	59	1081	1140
6	"6-out3835"	.05585	51	862	913
6	"6-out3836"	.05992	51	800	851
6	"6-out3837"	.14702	136	789	925
6	"6-out3838"	.30000	30	70	100
6	"6-out3839"	.14495	89	525	614
6	"6-out3840"	.24357	417	1295	1712
6	"6-out3841"	.14285	10	60	70
6	"6-out3842"	.10362	83	718	801
6	"6-out3843"	.12715	118	810	928
6	"6-out3844"	.54007	438	373	811
6	"6-out3845"	.12765	30	205	235
6	"6-out3846"	.11924	127	938	1065
6	"6-out3847"	.04000	19	456	475
6	"6-out3848"	.06101	41	631	672
6	"6-out3849"	.07901	32	373	405
6	"6-out3850"	.09433	120	1152	1272
6	"6-out3851"	.09108	47	469	516
6	"6-out3852"	.11557	23	176	199
6	"6-out3853"	.10307	57	496	553
6	"6-out3854"	.36630	100	173	273
6	"6-out3855"	.12658	20	138	158
6	"6-out3856"	.04049	49	1161	1210
6	"6-out3857"	.64102	50	28	78
6	"6-out3858"	.17466	91	430	521
6	"6-out3859"	.48387	45	48	93
6	"6-out3860"	.12320	43	306	349
6	"6-out3861"	.50422	179	176	355
6	"6-out3862"	.11967	59	434	493
6	"6-out3863"	.11250	117	923	1040
6	"6-out3864"	.46526	442	508	950
6	"6-out3865"	.11641	39	296	335
6	"6-out3866"	.12686	119	819	938
6	"6-out3867"	.06157	29	442	471
6	"6-out3868"	.14655	34	198	232
6	"6-out3869"	.12456	107	752	859
6	"6-out3870"	.15191	91	508	599
6	"6-out3871"	.20333	122	478	600
6	"6-out3872"	.10405	77	663	740
6	"6-out3873"	.24468	23	71	94
6	"6-out3874"	.13731	85	534	619
6	"6-out3875"	.10800	89	735	824
6	"6-out3876"	.10475	108	923	1031
6	"6-out3877"	.06990	36	479	515
6	"6-out3878"	.11111	45	360	405
6	"6-out3879"	.08820	89	920	1009
6	"6-out3880"	.14909	239	1364	1603
6	"6-out3881"	.09433	20	192	212
6	"6-out3882"	.06948	23	308	331
6	"6-out3883"	.26627	90	248	338
6	"6-out3884"	.25000	78	234	312
6	"6-out3885"	.05491	67	1153	1220
6	"6-out3886"	.27707	261	681	942
6	"6-out3887"	.15353	113	623	736
6	"6-out3888"	.09555	71	672	743
6	"6-out3889"	.21872	250	893	1143
6	"6-out3890"	.07012	27	358	385
6	"6-out3891"	.09756	28	259	287
6	"6-out3892"	.26914	116	315	431
6	"6-out3893"	.08850	124	1277	1401
6	"6-out3894"	.15463	60	328	388
6	"6-out3895"	.09079	71	711	782
6	"6-out3896"	.18421	56	248	304
6	"6-out3897"	.11812	73	545	618
6	"6-out3898"	.13445	64	412	476
6	"6-out3899"	.12147	56	405	461
6	"6-out3900"	.12826	59	401	460
6	"6-out3901"	.04705	8	162	170
6	"6-out3902"	.09016	22	222	244
6	"6-out3903"	.08080	32	364	396
6	"6-out3904"	.11475	49	378	427
6	"6-out3905"	.05466	34	588	622
6	"6-out3907"	.28774	223	552	775
6	"6-out3908"	.13815	84	524	608
6	"6-out3909"	.20920	50	189	239
6	"6-out3910"	.14024	46	282	328
6	"6-out3911"	.30796	344	773	1117
6	"6-out3912"	.15714	44	236	280
6	"6-out3913"	.13095	132	876	1008
6	"6-out3914"	.09684	89	830	919
6	"6-out3915"	.08383	97	1060	1157
6	"6-out3916"	.37740	294	485	779
6	"6-out3917"	.07633	171	2069	2240
6	"6-out3918"	.13046	203	1353	1556
6	"6-out3919"	.11904	90	666	756
6	"6-out3920"	.04398	15	326	341
6	"6-out3921"	.10000	35	315	350
6	"6-out3922"	.23553	57	185	242
6	"6-out3923"	.07560	75	917	992
6	"6-out3924"	.05110	37	687	724
6	"6-out3925"	.72602	53	20	73
6	"6-out3926"	.11172	81	644	725
6	"6-out3927"	.17241	55	264	319
6	"6-out3928"	.48148	325	350	675
6	"6-out3929"	.34439	249	474	723
6	"6-out3930"	.65277	47	25	72
6	"6-out3931"	.12687	76	523	599
6	"6-out3932"	.15762	122	652	774
6	"6-out3933"	.29805	138	325	463
6	"6-out3934"	.44311	148	186	334
6	"6-out3935"	.15243	75	417	492
6	"6-out3936"	.14586	90	527	617
6	"6-out3937"	.10616	31	261	292
6	"6-out3938"	.11065	27	217	244
6	"6-out3939"	.25263	48	142	190
6	"6-out3940"	.30392	31	71	102
6	"6-out3941"	.03859	11	274	285
6	"6-out3942"	.11122	111	887	998
6	"6-out3943"	.47761	64	70	134
6	"6-out3944"	.32971	243	494	737
6	"6-out3945"	.32800	287	588	875
6	"6-out3946"	.05732	18	296	314
6	"6-out3947"	.05521	18	308	326
6	"6-out3948"	.05663	32	533	565
6	"6-out3949"	.06593	30	425	455
6	"6-out3950"	.03912	50	1228	1278
6	"6-out3951"	.04269	33	740	773
6	"6-out3952"	.10973	53	430	483
6	"6-out3953"	.13535	98	626	724
6	"6-out3954"	.33081	219	443	662
6	"6-out3955"	.45773	444	526	970
6	"6-out3956"	.26474	193	536	729
6	"6-out3957"	.39361	37	57	94
6	"6-out3958"	.31687	77	166	243
6	"6-out3959"	.30468	156	356	512
6	"6-out3960"	.42929	85	113	198
6	"6-out3961"	.06350	95	1401	1496
6	"6-out3962"	.14091	269	1640	1909
6	"6-out3963"	.20860	126	478	604
6	"6-out3964"	.08762	34	354	388
6	"6-out3965"	.44545	98	122	220
6	"6-out3966"	.48745	272	286	558
6	"6-out3967"	.03892	13	321	334
6	"6-out3968"	.53846	35	30	65
6	"6-out3969"	.10410	33	284	317
6	"6-out3970"	.03960	28	679	707
6	"6-out3971"	.51820	185	172	357
6	"6-out3972"	.40251	64	95	159
6	"6-out3973"	.10436	110	944	1054
6	"6-out3974"	.13409	35	226	261
6	"6-out3975"	.10324	35	304	339
6	"6-out3976"	.05786	46	749	795
6	"6-out3977"	.10861	116	952	1068
6	"6-out3978"	.46527	422	485	907
6	"6-out3979"	.42553	60	81	141
6	"6-out3980"	.40425	57	84	141
6	"6-out3981"	.08575	65	693	758
6	"6-out3982"	.09523	18	171	189
6	"6-out3983"	.22222	34	119	153
6	"6-out3984"	.15686	16	86	102
6	"6-out3985"	.18292	15	67	82
6	"6-out3986"	.45454	40	48	88
6	"6-out3987"	.11688	9	68	77
6	"6-out3988"	.17154	41	198	239
6	"6-out3989"	.10038	26	233	259
6	"6-out3990"	.16034	55	288	343
6	"6-out3991"	.15296	80	443	523
6	"6-out3992"	.10909	12	98	110
6	"6-out3993"	.40540	105	154	259
6	"6-out3994"	.14767	35	202	237
6	"6-out3995"	.10425	49	421	470
6	"6-out3996"	.15111	136	764	900
6	"6-out3997"	.09985	71	640	711
6	"6-out3998"	.09422	75	721	796
6	"6-out3999"	.05740	31	509	540
6	"6-out4000"	.11261	75	591	666
6	"6-out4001"	.13787	87	544	631
6	"6-out4002"	.07604	67	814	881
6	"6-out4003"	.44776	300	370	670
6	"6-out4004"	.07861	43	504	547
6	"6-out4005"	.17102	72	349	421
6	"6-out4006"	.08813	26	269	295
6	"6-out4007"	.15199	259	1445	1704
6	"6-out4008"	.47783	97	106	203
6	"6-out4009"	.12121	16	116	132
6	"6-out4010"	.05421	36	628	664
6	"6-out4011"	.12946	29	195	224
6	"6-out4012"	.11515	19	146	165
6	"6-out4013"	.12910	59	398	457
6	"6-out4014"	.37244	73	123	196
6	"6-out4015"	.38288	85	137	222
6	"6-out4016"	.24324	54	168	222
6	"6-out4017"	.32820	64	131	195
6	"6-out4018"	.10204	20	176	196
6	"6-out4019"	.13429	56	361	417
6	"6-out4020"	.49107	55	57	112
6	"6-out4021"	.11696	71	536	607
6	"6-out4022"	.07947	12	139	151
6	"6-out4023"	.09664	49	458	507
6	"6-out4024"	.13089	125	830	955
6	"6-out4025"	.09582	39	368	407
6	"6-out4026"	.09786	55	507	562
6	"6-out4027"	.23247	63	208	271
6	"6-out4028"	.21052	68	255	323
6	"6-out4029"	.06814	40	547	587
6	"6-out4030"	.07726	35	418	453
6	"6-out4031"	.13733	64	402	466
6	"6-out4032"	.05373	18	317	335
6	"6-out4033"	.16500	66	334	400
6	"6-out4034"	.08637	78	825	903
6	"6-out4035"	.05353	25	442	467
6	"6-out4036"	.07627	18	218	236
6	"6-out4037"	.08333	15	165	180
6	"6-out4038"	.31654	88	190	278
6	"6-out4039"	.40000	74	111	185
6	"6-out4040"	.14507	28	165	193
6	"6-out4041"	.14285	27	162	189
6	"6-out4042"	.08549	132	1412	1544
6	"6-out4043"	.07654	63	760	823
6	"6-out4044"	.05555	10	170	180
6	"6-out4045"	.05020	36	681	717
6	"6-out4046"	.07731	61	728	789
6	"6-out4047"	.22268	106	370	476
6	"6-out4048"	.03816	15	378	393
6	"6-out4049"	.10239	47	412	459
6	"6-out4050"	.07692	36	432	468
6	"6-out4051"	.17821	54	249	303
6	"6-out4052"	.15104	29	163	192
6	"6-out4053"	.12525	61	426	487
6	"6-out4054"	.07191	137	1768	1905
6	"6-out4055"	.15629	113	610	723
6	"6-out4056"	.06745	40	553	593
6	"6-out4057"	.07080	57	748	805
6	"6-out4058"	.35869	33	59	92
6	"6-out4059"	.09590	89	839	928
6	"6-out4060"	.09326	36	350	386
6	"6-out4061"	.12755	50	342	392
6	"6-out4062"	.12780	74	505	579
6	"6-out4063"	.58333	49	35	84
6	"6-out4064"	.23239	33	109	142
6	"6-out4065"	.56387	128	99	227
6	"6-out4066"	.10402	93	801	894
6	"6-out4067"	.25649	326	945	1271
6	"6-out4068"	.30232	52	120	172
6	"6-out4069"	.15049	107	604	711
6	"6-out4070"	.39347	362	558	920
6	"6-out4071"	.17054	22	107	129
6	"6-out4072"	.27192	31	83	114
6	"6-out4073"	.57910	377	274	651
6	"6-out4074"	.05825	24	388	412
6	"6-out4075"	.07812	40	472	512
6	"6-out4076"	.12452	65	457	522
6	"6-out4077"	.38073	249	405	654
6	"6-out4078"	.08379	15	164	179
6	"6-out4079"	.54661	129	107	236
6	"6-out4080"	.35800	179	321	500
6	"6-out4081"	.09108	46	459	505
6	"6-out4082"	.08114	37	419	456
6	"6-out4083"	.05732	45	740	785
6	"6-out4084"	.02500	5	195	200
6	"6-out4085"	.22314	27	94	121
6	"6-out4086"	.12765	24	164	188
6	"6-out4087"	.10283	29	253	282
6	"6-out4089"	.05377	37	651	688
6	"6-out4090"	.04398	15	326	341
6	"6-out4091"	.09061	83	833	916
6	"6-out4092"	.21096	127	475	602
6	"6-out4093"	.19248	41	172	213
6	"6-out4094"	.07657	17	205	222
6	"6-out4095"	.06008	14	219	233
6	"6-out4096"	.42690	73	98	171
6	"6-out4097"	.18905	38	163	201
6	"6-out4098"	.05960	27	426	453
6	"6-out4099"	.07266	59	753	812
6	"6-out4100"	.05147	7	129	136
6	"6-out4101"	.04807	30	594	624
6	"6-out4102"	.32057	134	284	418
6	"6-out4103"	.42857	90	120	210
6	"6-out4104"	.07936	15	174	189
6	"6-out4105"	.09797	29	267	296
6	"6-out4106"	.20364	123	481	604
6	"6-out4107"	.13925	94	581	675
6	"6-out4108"	.69523	73	32	105
6	"6-out4109"	.36679	95	164	259
6	"6-out4110"	.28037	30	77	107
6	"6-out4111"	.06198	30	454	484
6	"6-out4112"	.27545	211	555	766
6	"6-out4113"	.07673	63	758	821
6	"6-out4114"	.03994	29	697	726
6	"6-out4115"	.07435	49	610	659
6	"6-out4116"	.18909	104	446	550
6	"6-out4117"	.16179	83	430	513
6	"6-out4118"	.05524	10	171	181
6	"6-out4119"	.40769	53	77	130
6	"6-out4120"	.05601	27	455	482
6	"6-out4121"	.32935	138	281	419
6	"6-out4122"	.12549	32	223	255
6	"6-out4123"	.04761	4	80	84
6	"6-out4124"	.10480	24	205	229
6	"6-out4125"	.28968	73	179	252
6	"6-out4126"	.58219	85	61	146
6	"6-out4127"	.07715	26	311	337
6	"6-out4128"	.12271	67	479	546
6	"6-out4129"	.14548	87	511	598
6	"6-out4130"	.13986	100	615	715
6	"6-out4131"	.42758	62	83	145
6	"6-out4132"	.04850	83	1628	1711
6	"6-out4133"	.08143	68	767	835
6	"6-out4134"	.07724	37	442	479
6	"6-out4135"	.07619	16	194	210
6	"6-out4136"	.04455	9	193	202
6	"6-out4137"	.11520	25	192	217
6	"6-out4138"	.08353	35	384	419
6	"6-out4139"	.04453	11	236	247
6	"6-out4140"	.69731	182	79	261
6	"6-out4141"	.13391	107	692	799
6	"6-out4142"	.20893	173	655	828
6	"6-out4143"	.14419	77	457	534
6	"6-out4144"	.12589	53	368	421
6	"6-out4145"	.12865	22	149	171
6	"6-out4146"	.05697	29	480	509
6	"6-out4147"	.44915	53	65	118
6	"6-out4148"	.50915	139	134	273
6	"6-out4149"	.09313	19	185	204
6	"6-out4150"	.24247	137	428	565
6	"6-out4151"	.03162	8	245	253
6	"6-out4152"	.04547	99	2078	2177
6	"6-out4153"	.01948	19	956	975
6	"6-out4154"	.52631	260	234	494
6	"6-out4155"	.09195	8	79	87
6	"6-out4156"	.37810	152	250	402
6	"6-out4157"	.18110	46	208	254
6	"6-out4158"	.05519	17	291	308
6	"6-out4159"	.14555	77	452	529
6	"6-out4160"	.09500	99	943	1042
6	"6-out4161"	.08972	83	842	925
6	"6-out4162"	.09633	50	469	519
6	"6-out4163"	.08436	156	1693	1849
6	"6-out4164"	.19211	78	328	406
6	"6-out4165"	.07597	74	900	974
6	"6-out4166"	.46028	226	265	491
6	"6-out4167"	.23239	33	109	142
6	"6-out4168"	.17802	81	374	455
6	"6-out4169"	.05424	23	401	424
6	"6-out4170"	.11886	46	341	387
6	"6-out4171"	.06377	25	367	392
6	"6-out4172"	.37030	197	335	532
6	"6-out4173"	.07916	87	1012	1099
6	"6-out4174"	.07828	31	365	396
6	"6-out4175"	.02919	4	133	137
6	"6-out4176"	.06024	15	234	249
6	"6-out4177"	.12670	65	448	513
6	"6-out4178"	.07615	299	3627	3926
6	"6-out4179"	.21702	51	184	235
6	"6-out4180"	.08438	20	217	237
6	"6-out4181"	.05931	64	1015	1079
6	"6-out4182"	.15384	30	165	195
6	"6-out4183"	.53469	262	228	490
6	"6-out4184"	.08498	30	323	353
6	"6-out4185"	.52941	99	88	187
6	"6-out4186"	.09059	440	4417	4857
6	"6-out4187"	.03361	12	345	357
6	"6-out4188"	.39552	159	243	402
6	"6-out4189"	.09051	62	623	685
6	"6-out4190"	.15547	44	239	283
6	"6-out4191"	.08695	16	168	184
6	"6-out4192"	.39625	508	774	1282
6	"6-out4193"	.16806	20	99	119
6	"6-out4194"	.50000	58	58	116
6	"6-out4195"	.43778	285	366	651
6	"6-out4196"	.12523	68	475	543
6	"6-out4197"	.09554	118	1117	1235
6	"6-out4198"	.07209	31	399	430
6	"6-out4199"	.06704	35	487	522
6	"6-out4200"	.18080	618	2800	3418
6	"6-out4201"	.12254	75	537	612
6	"6-out4202"	.06521	72	1032	1104
6	"6-out4203"	.14380	151	899	1050
6	"6-out4204"	.14470	157	928	1085
6	"6-out4205"	.56965	413	312	725
6	"6-out4206"	.45689	53	63	116
6	"6-out4207"	.28444	64	161	225
6	"6-out4208"	.42789	273	365	638
6	"6-out4209"	.19559	71	292	363
6	"6-out4210"	.53441	264	230	494
6	"6-out4211"	.09974	39	352	391
6	"6-out4212"	.20930	36	136	172
6	"6-out4213"	.13196	187	1230	1417
6	"6-out4214"	.06373	71	1043	1114
6	"6-out4215"	.22162	41	144	185
6	"6-out4216"	.04462	44	942	986
6	"6-out4217"	.11477	73	563	636
6	"6-out4218"	.14611	32	187	219
6	"6-out4219"	.14331	45	269	314
6	"6-out4220"	.10952	23	187	210
6	"6-out4221"	.31372	112	245	357
6	"6-out4222"	.04761	5	100	105
6	"6-out4223"	.41957	313	433	746
6	"6-out4224"	.07031	18	238	256
6	"6-out4225"	.20288	618	2428	3046
6	"6-out4226"	.52000	39	36	75
6	"6-out4227"	.08978	29	294	323
6	"6-out4228"	.21739	160	576	736
6	"6-out4229"	.20525	258	999	1257
6	"6-out4230"	.37353	223	374	597
6	"6-out4231"	.03888	7	173	180
6	"6-out4232"	.13880	44	273	317
6	"6-out4233"	.11210	25	198	223
6	"6-out4234"	.06153	60	915	975
6	"6-out4235"	.22200	111	389	500
6	"6-out4236"	.19665	94	384	478
6	"6-out4237"	.16292	29	149	178
6	"6-out4238"	.36800	46	79	125
6	"6-out4239"	.06670	106	1483	1589
6	"6-out4240"	.24085	79	249	328
6	"6-out4241"	.08610	44	467	511
6	"6-out4242"	.12287	65	464	529
6	"6-out4243"	.39122	214	333	547
6	"6-out4244"	.06875	11	149	160
6	"6-out4245"	.10705	167	1393	1560
6	"6-out4246"	.11309	57	447	504
6	"6-out4247"	.15668	34	183	217
6	"6-out4248"	.11729	59	444	503
6	"6-out4249"	.02427	5	201	206
6	"6-out4250"	.23148	25	83	108
6	"6-out4251"	.09246	27	265	292
6	"6-out4252"	.20585	239	922	1161
6	"6-out4253"	.08516	31	333	364
6	"6-out4254"	.12052	74	540	614
6	"6-out4255"	.09278	27	264	291
6	"6-out4256"	.13318	61	397	458
6	"6-out4257"	.09121	54	538	592
6	"6-out4258"	.46896	68	77	145
6	"6-out4259"	.05118	41	760	801
6	"6-out4260"	.02010	8	390	398
6	"6-out4261"	.04599	35	726	761
6	"6-out4262"	.07660	93	1121	1214
6	"6-out4263"	.11442	46	356	402
6	"6-out4264"	.11410	55	427	482
6	"6-out4265"	.12025	19	139	158
6	"6-out4266"	.09252	26	255	281
6	"6-out4267"	.07443	53	659	712
6	"6-out4268"	.42884	220	293	513
6	"6-out4269"	.52413	76	69	145
6	"6-out4270"	.05000	7	133	140
6	"6-out4271"	.15924	143	755	898
6	"6-out4272"	.15512	56	305	361
6	"6-out4273"	.12048	20	146	166
6	"6-out4274"	.07692	53	636	689
6	"6-out4275"	.04662	29	593	622
6	"6-out4276"	.08515	35	376	411
6	"6-out4277"	.14893	14	80	94
6	"6-out4278"	.04727	26	524	550
6	"6-out4279"	.59259	48	33	81
6	"6-out4280"	.13304	31	202	233
6	"6-out4281"	.15372	97	534	631
6	"6-out4282"	.15635	48	259	307
6	"6-out4283"	.23115	92	306	398
6	"6-out4284"	.13931	45	278	323
6	"6-out4285"	.10140	36	319	355
6	"6-out4286"	.14482	84	496	580
6	"6-out4287"	.12566	47	327	374
6	"6-out4288"	.05614	21	353	374
6	"6-out4289"	.05291	20	358	378
6	"6-out4290"	.08777	79	821	900
6	"6-out4291"	.07260	53	677	730
6	"6-out4292"	.58713	283	199	482
6	"6-out4293"	.43396	345	450	795
6	"6-out4294"	.08280	26	288	314
6	"6-out4295"	.44444	52	65	117
6	"6-out4296"	.12256	44	315	359
6	"6-out4297"	.32786	20	41	61
6	"6-out4298"	.10043	23	206	229
6	"6-out4299"	.14928	83	473	556
6	"6-out4300"	.29026	155	379	534
6	"6-out4301"	.19819	66	267	333
6	"6-out4302"	.14032	87	533	620
6	"6-out4303"	.04868	13	254	267
6	"6-out4304"	.05280	16	287	303
6	"6-out4305"	.13587	139	884	1023
6	"6-out4306"	.13206	173	1137	1310
6	"6-out4307"	.11873	45	334	379
6	"6-out4308"	.11224	33	261	294
6	"6-out4309"	.26190	33	93	126
6	"6-out4310"	.32352	33	69	102
6	"6-out4311"	.43155	227	299	526
6	"6-out4312"	.18596	461	2018	2479
6	"6-out4313"	.06183	29	440	469
6	"6-out4314"	.18173	203	914	1117
6	"6-out4315"	.12000	24	176	200
6	"6-out4316"	.03058	13	412	425
6	"6-out4317"	.27137	73	196	269
6	"6-out4318"	.31111	84	186	270
6	"6-out4319"	.12436	49	345	394
6	"6-out4320"	.05347	10	177	187
6	"6-out4321"	.05761	28	458	486
6	"6-out4322"	.21093	81	303	384
6	"6-out4323"	.10000	30	270	300
6	"6-out4324"	.04666	7	143	150
6	"6-out4325"	.29382	176	423	599
6	"6-out4326"	.14326	151	903	1054
6	"6-out4327"	.07130	40	521	561
6	"6-out4328"	.05202	45	820	865
6	"6-out4329"	.21912	165	588	753
6	"6-out4330"	.23507	63	205	268
6	"6-out4331"	.13362	62	402	464
6	"6-out4332"	.17228	46	221	267
6	"6-out4333"	.34563	103	195	298
6	"6-out4334"	.09114	69	688	757
6	"6-out4335"	.15577	93	504	597
6	"6-out4336"	.11976	20	147	167
6	"6-out4337"	.21863	122	436	558
6	"6-out4338"	.34615	45	85	130
6	"6-out4339"	.10857	38	312	350
6	"6-out4340"	.38745	105	166	271
6	"6-out4341"	.68644	81	37	118
6	"6-out4342"	.09049	59	593	652
6	"6-out4343"	.16942	41	201	242
6	"6-out4344"	.48684	37	39	76
6	"6-out4345"	.62903	117	69	186
6	"6-out4346"	.16535	21	106	127
6	"6-out4347"	.15714	22	118	140
6	"6-out4348"	.15264	283	1571	1854
6	"6-out4349"	.46636	104	119	223
6	"6-out4350"	.35582	1134	2053	3187
6	"6-out4351"	.12258	76	544	620
6	"6-out4352"	.20731	34	130	164
6	"6-out4353"	.12040	36	263	299
6	"6-out4354"	.14624	37	216	253
6	"6-out4355"	.10215	133	1169	1302
6	"6-out4356"	.29559	47	112	159
6	"6-out4357"	.03655	14	369	383
6	"6-out4358"	.09282	22	215	237
6	"6-out4359"	.17948	63	288	351
6	"6-out4360"	.23469	69	225	294
6	"6-out4361"	.11515	19	146	165
6	"6-out4362"	.07027	13	172	185
6	"6-out4363"	.19519	187	771	958
6	"6-out4364"	.45588	93	111	204
6	"6-out4365"	.09090	22	220	242
6	"6-out4366"	.08727	24	251	275
6	"6-out4367"	.16577	62	312	374
6	"6-out4368"	.19831	188	760	948
6	"6-out4369"	.13043	15	100	115
6	"6-out4370"	.18181	18	81	99
6	"6-out4371"	.12068	28	204	232
6	"6-out4372"	.12797	43	293	336
6	"6-out4373"	.06628	23	324	347
6	"6-out4374"	.40540	75	110	185
6	"6-out4375"	.08502	67	721	788
6	"6-out4376"	.37378	308	516	824
6	"6-out4377"	.05057	22	413	435
6	"6-out4378"	.07594	36	438	474
6	"6-out4379"	.24896	60	181	241
6	"6-out4380"	.09920	25	227	252
6	"6-out4381"	.08248	73	812	885
6	"6-out4382"	.30890	59	132	191
6	"6-out4383"	.04494	20	425	445
6	"6-out4384"	.41197	117	167	284
6	"6-out4385"	.23578	141	457	598
6	"6-out4386"	.08389	25	273	298
6	"6-out4387"	.11363	20	156	176
6	"6-out4388"	.46275	733	851	1584
6	"6-out4389"	.47308	167	186	353
6	"6-out4390"	.47085	105	118	223
6	"6-out4391"	.07118	21	274	295
6	"6-out4392"	.09766	188	1737	1925
6	"6-out4393"	.24017	226	715	941
6	"6-out4394"	.18769	61	264	325
6	"6-out4395"	.35162	205	378	583
6	"6-out4396"	.14473	22	130	152
6	"6-out4397"	.09798	34	313	347
6	"6-out4398"	.14625	43	251	294
6	"6-out4399"	.22727	35	119	154
6	"6-out4400"	.49732	93	94	187
6	"6-out4401"	.13476	69	443	512
6	"6-out4402"	.09007	49	495	544
6	"6-out4403"	.12400	62	438	500
6	"6-out4404"	.09623	235	2207	2442
6	"6-out4405"	.42774	222	297	519
6	"6-out4406"	.63529	216	124	340
6	"6-out4407"	.06239	37	556	593
6	"6-out4408"	.08383	14	153	167
6	"6-out4409"	.14035	16	98	114
6	"6-out4410"	.04011	28	670	698
6	"6-out4411"	.59302	51	35	86
6	"6-out4412"	.40883	74	107	181
6	"6-out4413"	.14890	102	583	685
6	"6-out4414"	.49629	67	68	135
6	"6-out4415"	.05752	26	426	452
6	"6-out4416"	.07288	100	1272	1372
6	"6-out4417"	.31046	86	191	277
6	"6-out4418"	.04751	22	441	463
6	"6-out4419"	.14836	50	287	337
6	"6-out4420"	.35258	116	213	329
6	"6-out4421"	.35897	140	250	390
6	"6-out4422"	.10106	76	676	752
6	"6-out4423"	.30357	170	390	560
6	"6-out4424"	.40776	168	244	412
6	"6-out4425"	.07323	29	367	396
6	"6-out4426"	.44527	179	223	402
6	"6-out4427"	.49557	56	57	113
6	"6-out4428"	.14726	43	249	292
6	"6-out4429"	.14074	19	116	135
6	"6-out4430"	.03600	9	241	250
6	"6-out4431"	.51533	84	79	163
6	"6-out4432"	.05405	30	525	555
6	"6-out4433"	.15778	77	411	488
6	"6-out4434"	.17321	163	778	941
6	"6-out4435"	.07563	9	110	119
6	"6-out4436"	.10392	45	388	433
6	"6-out4437"	.33898	100	195	295
6	"6-out4438"	.11337	39	305	344
6	"6-out4439"	.13840	40	249	289
6	"6-out4440"	.06488	51	735	786
6	"6-out4441"	.09577	34	321	355
6	"6-out4442"	.43933	344	439	783
6	"6-out4443"	.07905	20	233	253
6	"6-out4444"	.10422	116	997	1113
6	"6-out4445"	.42704	120	161	281
6	"6-out4446"	.13207	77	506	583
6	"6-out4447"	.04424	10	216	226
6	"6-out4448"	.11652	55	417	472
6	"6-out4449"	.10454	23	197	220
6	"6-out4450"	.22796	75	254	329
6	"6-out4451"	.19354	66	275	341
6	"6-out4452"	.10734	38	316	354
6	"6-out4453"	.07634	51	617	668
6	"6-out4454"	.14437	122	723	845
6	"6-out4455"	.19676	73	298	371
6	"6-out4456"	.10188	27	238	265
6	"6-out4457"	.06310	13	193	206
6	"6-out4458"	.15566	33	179	212
6	"6-out4459"	.08333	126	1386	1512
6	"6-out4460"	.12302	320	2281	2601
6	"6-out4461"	.20689	54	207	261
6	"6-out4462"	.12080	18	131	149
6	"6-out4463"	.12825	133	904	1037
6	"6-out4464"	.03448	4	112	116
6	"6-out4465"	.07396	52	651	703
6	"6-out4466"	.07413	43	537	580
6	"6-out4467"	.21472	140	512	652
6	"6-out4468"	.11160	25	199	224
6	"6-out4469"	.03902	8	197	205
6	"6-out4470"	.12030	80	585	665
6	"6-out4471"	.15337	25	138	163
6	"6-out4472"	.13103	190	1260	1450
6	"6-out4473"	.31351	58	127	185
6	"6-out4474"	.04035	9	214	223
6	"6-out4475"	.12921	69	465	534
6	"6-out4476"	.14615	38	222	260
6	"6-out4477"	.01030	2	192	194
6	"6-out4478"	.20565	80	309	389
6	"6-out4479"	.12688	42	289	331
6	"6-out4480"	.24000	24	76	100
6	"6-out4481"	.12550	31	216	247
6	"6-out4482"	.21782	44	158	202
6	"6-out4483"	.03888	14	346	360
6	"6-out4484"	.04761	15	300	315
6	"6-out4485"	.09183	9	89	98
6	"6-out4486"	.05135	17	314	331
6	"6-out4487"	.12666	19	131	150
6	"6-out4488"	.15862	69	366	435
6	"6-out4489"	.41397	154	218	372
6	"6-out4490"	.16512	125	632	757
6	"6-out4491"	.15909	56	296	352
6	"6-out4492"	.08677	63	663	726
6	"6-out4493"	.05072	14	262	276
6	"6-out4494"	.05940	12	190	202
6	"6-out4495"	.30219	110	254	364
6	"6-out4496"	.11607	39	297	336
6	"6-out4497"	.21400	110	404	514
6	"6-out4498"	.11083	136	1091	1227
6	"6-out4499"	.13076	34	226	260
6	"6-out4500"	.05252	26	469	495
6	"6-out4501"	.19088	67	284	351
6	"6-out4502"	.05245	16	289	305
6	"6-out4503"	.12948	65	437	502
6	"6-out4504"	.27653	99	259	358
6	"6-out4505"	.15942	22	116	138
6	"6-out4506"	.05431	17	296	313
6	"6-out4507"	.15544	30	163	193
6	"6-out4508"	.07731	136	1623	1759
6	"6-out4509"	.04796	20	397	417
6	"6-out4510"	.09692	41	382	423
6	"6-out4511"	.12536	173	1207	1380
6	"6-out4512"	.21748	97	349	446
6	"6-out4513"	.06843	62	844	906
6	"6-out4514"	.13705	81	510	591
6	"6-out4515"	.30075	160	372	532
6	"6-out4516"	.10948	30	244	274
6	"6-out4517"	.05228	8	145	153
6	"6-out4518"	.19371	37	154	191
6	"6-out4519"	.05577	14	237	251
6	"6-out4520"	.12906	123	830	953
6	"6-out4521"	.11280	37	291	328
6	"6-out4522"	.07096	65	851	916
6	"6-out4523"	.09629	26	244	270
6	"6-out4524"	.12658	40	276	316
6	"6-out4525"	.13054	53	353	406
6	"6-out4526"	.34586	92	174	266
6	"6-out4527"	.09375	21	203	224
6	"6-out4528"	.09523	46	437	483
6	"6-out4529"	.11337	50	391	441
6	"6-out4530"	.04477	6	128	134
6	"6-out4531"	.50458	55	54	109
6	"6-out4532"	.09953	43	389	432
6	"6-out4533"	.08287	30	332	362
6	"6-out4534"	.19856	277	1118	1395
6	"6-out4535"	.12692	66	454	520
6	"6-out4536"	.06000	21	329	350
6	"6-out4537"	.07166	22	285	307
6	"6-out4538"	.27804	57	148	205
6	"6-out4539"	.05994	22	345	367
6	"6-out4540"	.09663	23	215	238
6	"6-out4541"	.08230	20	223	243
6	"6-out4542"	.07692	14	168	182
6	"6-out4543"	.11135	51	407	458
6	"6-out4544"	.07894	18	210	228
6	"6-out4545"	.15298	41	227	268
6	"6-out4546"	.06752	58	801	859
6	"6-out4547"	.04878	8	156	164
6	"6-out4548"	.14646	29	169	198
6	"6-out4549"	.13015	60	401	461
6	"6-out4550"	.01190	2	166	168
6	"6-out4551"	.09262	49	480	529
6	"6-out4552"	.09164	136	1348	1484
6	"6-out4553"	.27793	97	252	349
6	"6-out4554"	.01449	2	136	138
6	"6-out4555"	.13664	110	695	805
6	"6-out4556"	.05314	27	481	508
6	"6-out4557"	.28985	40	98	138
6	"6-out4558"	.05679	166	2757	2923
6	"6-out4559"	.13106	27	179	206
6	"6-out4560"	.29801	45	106	151
6	"6-out4561"	.24857	306	925	1231
6	"6-out4562"	.11518	66	507	573
6	"6-out4563"	.07533	51	626	677
6	"6-out4564"	.58775	288	202	490
6	"6-out4565"	.46899	658	745	1403
6	"6-out4566"	.09803	15	138	153
6	"6-out4567"	.24647	35	107	142
6	"6-out4568"	.05940	12	190	202
6	"6-out4569"	.12529	54	377	431
6	"6-out4570"	.09744	61	565	626
6	"6-out4571"	.07899	82	956	1038
6	"6-out4572"	.08350	83	911	994
6	"6-out4573"	.22142	62	218	280
6	"6-out4574"	.05720	27	445	472
6	"6-out4575"	.07142	14	182	196
6	"6-out4576"	.25590	65	189	254
6	"6-out4577"	.05637	23	385	408
6	"6-out4578"	.05509	40	686	726
6	"6-out4579"	.08943	22	224	246
6	"6-out4580"	.10167	188	1661	1849
6	"6-out4581"	.30311	107	246	353
6	"6-out4582"	.46428	39	45	84
6	"6-out4583"	.19298	33	138	171
6	"6-out4584"	.29041	97	237	334
6	"6-out4585"	.08996	26	263	289
6	"6-out4586"	.15810	40	213	253
6	"6-out4587"	.43891	97	124	221
6	"6-out4588"	.37741	137	226	363
6	"6-out4589"	.18940	118	505	623
6	"6-out4590"	.11349	111	867	978
6	"6-out4591"	.19928	56	225	281
6	"6-out4592"	.54820	199	164	363
6	"6-out4593"	.05063	4	75	79
6	"6-out4594"	.08230	20	223	243
6	"6-out4595"	.16486	61	309	370
6	"6-out4596"	.11267	16	126	142
6	"6-out4597"	.04807	25	495	520
6	"6-out4598"	.08860	70	720	790
6	"6-out4599"	.10103	78	694	772
6	"6-out4600"	.06953	63	843	906
6	"6-out4601"	.12462	42	295	337
6	"6-out4602"	.05676	52	864	916
6	"6-out4603"	.14669	60	349	409
6	"6-out4604"	.22119	96	338	434
6	"6-out4605"	.08884	43	441	484
6	"6-out4606"	.12211	37	266	303
6	"6-out4607"	.13707	44	277	321
6	"6-out4608"	.13186	48	316	364
6	"6-out4609"	.09487	50	477	527
6	"6-out4610"	.12688	42	289	331
6	"6-out4611"	.43689	180	232	412
6	"6-out4612"	.08024	13	149	162
6	"6-out4613"	.23711	46	148	194
6	"6-out4614"	.15384	32	176	208
6	"6-out4615"	.09930	57	517	574
6	"6-out4616"	.59712	83	56	139
6	"6-out4617"	.13898	41	254	295
6	"6-out4618"	.12305	111	791	902
6	"6-out4619"	.04057	17	402	419
6	"6-out4620"	.13686	137	864	1001
6	"6-out4621"	.07355	37	466	503
6	"6-out4622"	.07407	12	150	162
6	"6-out4623"	.18905	38	163	201
6	"6-out4624"	.16180	61	316	377
6	"6-out4625"	.09933	30	272	302
6	"6-out4626"	.11645	109	827	936
6	"6-out4627"	.36986	108	184	292
6	"6-out4628"	.21705	56	202	258
6	"6-out4629"	.52861	157	140	297
6	"6-out4630"	.24275	134	418	552
6	"6-out4631"	.18685	162	705	867
6	"6-out4632"	.09047	19	191	210
6	"6-out4633"	.16643	119	596	715
6	"6-out4634"	.41578	158	222	380
6	"6-out4635"	.05786	32	521	553
6	"6-out4636"	.17694	66	307	373
6	"6-out4637"	.26953	138	374	512
6	"6-out4638"	.18461	48	212	260
6	"6-out4639"	.32049	183	388	571
6	"6-out4640"	.11458	11	85	96
6	"6-out4641"	.09278	9	88	97
6	"6-out4642"	.11811	15	112	127
6	"6-out4643"	.12367	35	248	283
6	"6-out4644"	.07046	26	343	369
6	"6-out4645"	.30526	29	66	95
6	"6-out4646"	.07575	5	61	66
6	"6-out4647"	.20603	41	158	199
6	"6-out4648"	.38215	167	270	437
6	"6-out4649"	.08018	53	608	661
6	"6-out4650"	.02916	7	233	240
6	"6-out4651"	.07031	9	119	128
6	"6-out4652"	.11111	29	232	261
6	"6-out4653"	.17417	58	275	333
6	"6-out4654"	.34501	256	486	742
6	"6-out4655"	.06432	11	160	171
6	"6-out4656"	.10212	24	211	235
6	"6-out4657"	.07572	34	415	449
6	"6-out4658"	.07537	45	552	597
6	"6-out4659"	.35233	68	125	193
6	"6-out4660"	.18269	38	170	208
6	"6-out4661"	.09177	48	475	523
6	"6-out4662"	.27071	637	1716	2353
6	"6-out4663"	.12370	275	1948	2223
6	"6-out4664"	.07843	36	423	459
6	"6-out4665"	.06191	20	303	323
6	"6-out4666"	.06666	29	406	435
6	"6-out4667"	.40625	52	76	128
6	"6-out4668"	.15555	49	266	315
6	"6-out4669"	.13529	23	147	170
6	"6-out4670"	.07990	128	1474	1602
6	"6-out4671"	.08906	57	583	640
6	"6-out4672"	.06929	95	1276	1371
6	"6-out4673"	.05299	31	554	585
6	"6-out4674"	.11372	29	226	255
6	"6-out4675"	.10855	52	427	479
6	"6-out4676"	.14181	39	236	275
6	"6-out4677"	.10033	30	269	299
6	"6-out4678"	.07421	80	998	1078
6	"6-out4679"	.57798	126	92	218
6	"6-out4680"	.11550	38	291	329
6	"6-out4681"	.38650	63	100	163
6	"6-out4682"	.08114	34	385	419
6	"6-out4683"	.06517	64	918	982
6	"6-out4684"	.06550	15	214	229
6	"6-out4685"	.05081	28	523	551
6	"6-out4686"	.05081	28	523	551
6	"6-out4687"	.09278	9	88	97
6	"6-out4688"	.15523	43	234	277
6	"6-out4689"	.11616	69	525	594
6	"6-out4690"	.11246	166	1310	1476
6	"6-out4691"	.54177	214	181	395
6	"6-out4692"	.15730	42	225	267
6	"6-out4693"	.17056	248	1206	1454
6	"6-out4694"	.30120	325	754	1079
6	"6-out4695"	.05251	23	415	438
6	"6-out4696"	.16129	15	78	93
6	"6-out4697"	.13805	37	231	268
6	"6-out4698"	.20404	111	433	544
6	"6-out4699"	.08921	48	490	538
6	"6-out4700"	.05653	48	801	849
6	"6-out4701"	.28705	122	303	425
6	"6-out4702"	.48351	44	47	91
6	"6-out4703"	.18901	148	635	783
6	"6-out4704"	.22281	84	293	377
6	"6-out4705"	.09516	63	599	662
6	"6-out4706"	.11221	34	269	303
6	"6-out4707"	.07235	28	359	387
6	"6-out4708"	.44755	128	158	286
6	"6-out4709"	.12906	119	803	922
6	"6-out4710"	.22155	74	260	334
6	"6-out4711"	.12345	20	142	162
6	"6-out4712"	.54629	59	49	108
6	"6-out4713"	.17094	20	97	117
6	"6-out4714"	.05191	46	840	886
6	"6-out4715"	.14843	19	109	128
6	"6-out4716"	.08752	101	1053	1154
6	"6-out4717"	.15820	106	564	670
6	"6-out4718"	.02222	4	176	180
6	"6-out4719"	.09461	58	555	613
6	"6-out4720"	.13876	184	1142	1326
6	"6-out4721"	.19255	212	889	1101
6	"6-out4722"	.33858	86	168	254
6	"6-out4723"	.24908	68	205	273
6	"6-out4724"	.20000	65	260	325
6	"6-out4725"	.13000	26	174	200
6	"6-out4726"	.09470	59	564	623
6	"6-out4727"	.21276	70	259	329
6	"6-out4728"	.20715	197	754	951
6	"6-out4729"	.38888	35	55	90
6	"6-out4730"	.40277	58	86	144
6	"6-out4731"	.45126	625	760	1385
6	"6-out4732"	.33695	31	61	92
6	"6-out4733"	.16666	16	80	96
6	"6-out4734"	.11052	21	169	190
6	"6-out4735"	.06162	22	335	357
6	"6-out4736"	.07526	35	430	465
6	"6-out4737"	.06111	22	338	360
6	"6-out4738"	.13550	50	319	369
6	"6-out4739"	.21287	86	318	404
6	"6-out4740"	.53629	133	115	248
6	"6-out4741"	.14915	44	251	295
6	"6-out4742"	.48476	175	186	361
6	"6-out4743"	.13702	198	1247	1445
6	"6-out4744"	.08759	24	250	274
6	"6-out4745"	.62365	58	35	93
6	"6-out4746"	.07926	13	151	164
6	"6-out4747"	.17808	39	180	219
6	"6-out4748"	.10270	38	332	370
6	"6-out4749"	.10169	24	212	236
6	"6-out4750"	.28306	107	271	378
6	"6-out4751"	.50828	184	178	362
6	"6-out4752"	.04580	6	125	131
6	"6-out4753"	.19161	32	135	167
6	"6-out4754"	.75781	97	31	128
6	"6-out4755"	.15444	120	657	777
6	"6-out4756"	.08548	169	1808	1977
6	"6-out4757"	.41639	127	178	305
6	"6-out4758"	.14880	118	675	793
6	"6-out4759"	.05757	38	622	660
6	"6-out4760"	.04896	19	369	388
6	"6-out4761"	.06896	24	324	348
6	"6-out4762"	.09186	113	1117	1230
6	"6-out4763"	.14214	57	344	401
6	"6-out4764"	.06582	47	667	714
6	"6-out4765"	.10764	69	572	641
6	"6-out4766"	.12389	28	198	226
6	"6-out4767"	.05892	35	559	594
6	"6-out4768"	.09118	30	299	329
6	"6-out4769"	.11528	46	353	399
6	"6-out4770"	.44055	126	160	286
6	"6-out4771"	.32000	48	102	150
6	"6-out4772"	.22137	29	102	131
6	"6-out4773"	.08771	20	208	228
6	"6-out4774"	.21686	36	130	166
6	"6-out4775"	.04941	21	404	425
6	"6-out4776"	.04988	21	400	421
6	"6-out4777"	.07035	75	991	1066
6	"6-out4778"	.12415	55	388	443
6	"6-out4779"	.06331	29	429	458
6	"6-out4780"	.13471	26	167	193
6	"6-out4781"	.06417	24	350	374
6	"6-out4782"	.08353	204	2238	2442
6	"6-out4783"	.10924	52	424	476
6	"6-out4784"	.12071	148	1078	1226
6	"6-out4785"	.04430	21	453	474
6	"6-out4786"	.30317	191	439	630
6	"6-out4787"	.51898	205	190	395
6	"6-out4788"	.67647	46	22	68
6	"6-out4789"	.10111	172	1529	1701
6	"6-out4790"	.25736	131	378	509
6	"6-out4791"	.09090	27	270	297
6	"6-out4792"	.39078	195	304	499
6	"6-out4793"	.05882	19	304	323
6	"6-out4794"	.07635	31	375	406
6	"6-out4795"	.13370	71	460	531
6	"6-out4796"	.05564	36	611	647
6	"6-out4797"	.04210	8	182	190
6	"6-out4798"	.10483	26	222	248
6	"6-out4799"	.53913	124	106	230
6	"6-out4800"	.14657	62	361	423
6	"6-out4801"	.25149	84	250	334
6	"6-out4802"	.46322	359	416	775
6	"6-out4803"	.12915	101	681	782
6	"6-out4804"	.03658	12	316	328
6	"6-out4805"	.11726	36	271	307
6	"6-out4806"	.48965	142	148	290
6	"6-out4807"	.04923	29	560	589
6	"6-out4808"	.05947	43	680	723
6	"6-out4809"	.07350	43	542	585
6	"6-out4810"	.08609	26	276	302
6	"6-out4811"	.09898	39	355	394
6	"6-out4812"	.08943	165	1680	1845
6	"6-out4813"	.21602	151	548	699
6	"6-out4814"	.16039	115	602	717
6	"6-out4815"	.07543	74	907	981
6	"6-out4816"	.16666	29	145	174
6	"6-out4817"	.09528	91	864	955
6	"6-out4818"	.13380	19	123	142
6	"6-out4819"	.57575	19	14	33
6	"6-out4820"	.07424	32	399	431
6	"6-out4821"	.14285	18	108	126
6	"6-out4822"	.03278	4	118	122
6	"6-out4823"	.48863	129	135	264
6	"6-out4824"	.28819	83	205	288
6	"6-out4825"	.21404	64	235	299
6	"6-out4826"	.22857	48	162	210
6	"6-out4827"	.15365	187	1030	1217
6	"6-out4828"	.21136	119	444	563
6	"6-out4829"	.11966	115	846	961
6	"6-out4830"	.07279	19	242	261
6	"6-out4831"	.08695	24	252	276
6	"6-out4832"	.41698	324	453	777
6	"6-out4833"	.17488	39	184	223
6	"6-out4834"	.42941	146	194	340
6	"6-out4835"	.13013	19	127	146
6	"6-out4836"	.16201	116	600	716
6	"6-out4837"	.02713	7	251	258
6	"6-out4838"	.35188	177	326	503
6	"6-out4839"	.19298	22	92	114
6	"6-out4840"	.15927	97	512	609
6	"6-out4841"	.40348	324	479	803
6	"6-out4842"	.12378	127	899	1026
6	"6-out4843"	.05973	31	488	519
6	"6-out4844"	.52329	1067	972	2039
6	"6-out4845"	.30448	95	217	312
6	"6-out4846"	.08466	37	400	437
6	"6-out4847"	.48786	201	211	412
6	"6-out4848"	.11899	52	385	437
6	"6-out4849"	.22795	106	359	465
6	"6-out4850"	.10714	21	175	196
6	"6-out4851"	.37356	65	109	174
6	"6-out4852"	.15934	29	153	182
6	"6-out4853"	.30693	31	70	101
6	"6-out4854"	.12085	51	371	422
6	"6-out4855"	.29713	145	343	488
6	"6-out4856"	.17451	352	1665	2017
6	"6-out4857"	.05263	16	288	304
6	"6-out4858"	.35191	101	186	287
6	"6-out4859"	.14723	101	585	686
6	"6-out4860"	.05800	29	471	500
6	"6-out4861"	.16161	80	415	495
6	"6-out4862"	.02766	7	246	253
6	"6-out4863"	.14214	57	344	401
6	"6-out4864"	.03468	6	167	173
6	"6-out4865"	.09868	15	137	152
6	"6-out4866"	.09322	11	107	118
6	"6-out4867"	.10256	12	105	117
6	"6-out4868"	.06267	22	329	351
6	"6-out4869"	.03827	8	201	209
6	"6-out4870"	.17054	22	107	129
6	"6-out4871"	.54545	108	90	198
6	"6-out4872"	.16176	22	114	136
6	"6-out4873"	.04462	22	471	493
6	"6-out4874"	.65686	67	35	102
6	"6-out4875"	.34975	291	541	832
6	"6-out4876"	.11879	67	497	564
6	"6-out4877"	.03468	6	167	173
6	"6-out4878"	.08593	22	234	256
6	"6-out4879"	.08122	45	509	554
6	"6-out4880"	.46082	100	117	217
6	"6-out4881"	.19444	28	116	144
6	"6-out4882"	.31202	122	269	391
6	"6-out4883"	.05939	85	1346	1431
6	"6-out4884"	.07986	96	1106	1202
6	"6-out4885"	.35549	139	252	391
6	"6-out4886"	.14035	40	245	285
6	"6-out4887"	.21181	104	387	491
6	"6-out4888"	.06134	20	306	326
6	"6-out4889"	.35260	122	224	346
6	"6-out4890"	.30722	51	115	166
6	"6-out4891"	.50185	271	269	540
6	"6-out4892"	.12765	24	164	188
6	"6-out4893"	.10416	10	86	96
6	"6-out4894"	.18246	256	1147	1403
6	"6-out4895"	.14102	77	469	546
6	"6-out4896"	.15453	121	662	783
6	"6-out4897"	.15844	212	1126	1338
6	"6-out4898"	.10668	75	628	703
6	"6-out4899"	.25153	41	122	163
6	"6-out4900"	.51219	105	100	205
6	"6-out4901"	.15000	57	323	380
6	"6-out4902"	.15135	252	1413	1665
6	"6-out4903"	.35000	84	156	240
6	"6-out4904"	.11587	27	206	233
6	"6-out4905"	.15346	31	171	202
6	"6-out4906"	.33939	56	109	165
6	"6-out4907"	.22421	50	173	223
6	"6-out4908"	.53465	54	47	101
6	"6-out4909"	.12569	68	473	541
6	"6-out4910"	.11358	46	359	405
6	"6-out4911"	.53260	49	43	92
6	"6-out4912"	.16532	41	207	248
6	"6-out4913"	.13247	31	203	234
6	"6-out4914"	.08968	20	203	223
6	"6-out4915"	.06936	12	161	173
6	"6-out4916"	.20394	31	121	152
6	"6-out4917"	.13813	46	287	333
6	"6-out4918"	.29299	92	222	314
6	"6-out4919"	.36666	33	57	90
6	"6-out4920"	.08771	5	52	57
6	"6-out4921"	.63937	328	185	513
6	"6-out4922"	.09345	90	873	963
6	"6-out4923"	.12204	62	446	508
6	"6-out4924"	.09493	15	143	158
6	"6-out4925"	.47307	246	274	520
6	"6-out4926"	.39436	196	301	497
6	"6-out4927"	.55578	274	219	493
6	"6-out4928"	.06653	34	477	511
6	"6-out4929"	.10380	90	777	867
6	"6-out4930"	.15612	79	427	506
6	"6-out4931"	.26242	132	371	503
6	"6-out4932"	.16844	79	390	469
6	"6-out4933"	.09649	55	515	570
6	"6-out4934"	.14181	39	236	275
6	"6-out4935"	.55714	39	31	70
6	"6-out4936"	.16030	63	330	393
6	"6-out4937"	.18791	28	121	149
6	"6-out4938"	.02234	20	875	895
6	"6-out4939"	.08988	96	972	1068
6	"6-out4940"	.14141	14	85	99
6	"6-out4941"	.25373	17	50	67
6	"6-out4942"	.12631	12	83	95
6	"6-out4943"	.19718	14	57	71
6	"6-out4944"	.35254	104	191	295
6	"6-out4945"	.14556	23	135	158
6	"6-out4946"	.06879	28	379	407
6	"6-out4947"	.07804	48	567	615
6	"6-out4948"	.19166	115	485	600
6	"6-out4949"	.36767	232	399	631
6	"6-out4950"	.09838	55	504	559
6	"6-out4951"	.08830	40	413	453
6	"6-out4952"	.05309	18	321	339
6	"6-out4953"	.22678	105	358	463
6	"6-out4954"	.05555	19	323	342
6	"6-out4955"	.15944	114	601	715
6	"6-out4956"	.12645	98	677	775
6	"6-out4957"	.23571	99	321	420
6	"6-out4958"	.02670	9	328	337
6	"6-out4959"	.28323	196	496	692
6	"6-out4960"	.29120	53	129	182
6	"6-out4961"	.02724	10	357	367
6	"6-out4962"	.32008	153	325	478
6	"6-out4963"	.34029	163	316	479
6	"6-out4964"	.02807	8	277	285
6	"6-out4965"	.03550	6	163	169
6	"6-out4966"	.26585	218	602	820
6	"6-out4967"	.09844	19	174	193
6	"6-out4968"	.08317	45	496	541
6	"6-out4969"	.04015	21	502	523
6	"6-out4970"	.10625	17	143	160
6	"6-out4971"	.12500	17	119	136
6	"6-out4972"	.54022	47	40	87
6	"6-out4973"	.08695	6	63	69
6	"6-out4974"	.02631	2	74	76
6	"6-out4975"	.60394	337	221	558
6	"6-out4976"	.03083	14	440	454
6	"6-out4977"	.10707	53	442	495
6	"6-out4978"	.07643	72	870	942
6	"6-out4979"	.06351	47	693	740
6	"6-out4980"	.08179	53	595	648
6	"6-out4981"	.10112	18	160	178
6	"6-out4982"	.10215	19	167	186
6	"6-out4983"	.15271	146	810	956
6	"6-out4984"	.09707	126	1172	1298
6	"6-out4985"	.05194	8	146	154
6	"6-out4986"	.51428	36	34	70
6	"6-out4987"	.24590	15	46	61
6	"6-out4988"	.22388	15	52	67
6	"6-out4989"	.06756	25	345	370
6	"6-out4990"	.13390	47	304	351
6	"6-out4991"	.22325	192	668	860
6	"6-out4992"	.47335	844	939	1783
6	"6-out4993"	.31974	204	434	638
6	"6-out4994"	.08762	51	531	582
6	"6-out4995"	.13230	43	282	325
6	"6-out4996"	.12000	36	264	300
6	"6-out4997"	.60106	226	150	376
6	"6-out4998"	.60000	39	26	65
6	"6-out4999"	.53957	409	349	758
6	"6-out5000"	.17486	32	151	183
6	"6-out5001"	.10843	45	370	415
6	"6-out5002"	.02941	3	99	102
6	"6-out5003"	.13008	16	107	123
6	"6-out5004"	.39393	26	40	66
6	"6-out5005"	.06410	5	73	78
6	"6-out5006"	.55769	87	69	156
6	"6-out5007"	.08108	9	102	111
6	"6-out5008"	.53378	79	69	148
6	"6-out5009"	.14177	56	339	395
6	"6-out5010"	.09742	53	491	544
6	"6-out5011"	.44044	196	249	445
6	"6-out5012"	.07384	24	301	325
6	"6-out5013"	.11222	67	530	597
6	"6-out5014"	.06481	14	202	216
6	"6-out5015"	.18076	94	426	520
6	"6-out5016"	.01298	3	228	231
6	"6-out5017"	.21964	331	1176	1507
6	"6-out5018"	.11764	56	420	476
6	"6-out5019"	.06634	96	1351	1447
6	"6-out5020"	.05891	38	607	645
6	"6-out5021"	.05405	14	245	259
6	"6-out5022"	.07035	28	370	398
6	"6-out5023"	.10204	10	88	98
6	"6-out5024"	.08146	91	1026	1117
6	"6-out5025"	.25153	41	122	163
6	"6-out5026"	.57024	138	104	242
6	"6-out5027"	.13385	51	330	381
6	"6-out5028"	.08287	45	498	543
6	"6-out5029"	.50476	212	208	420
6	"6-out5030"	.08843	52	536	588
6	"6-out5031"	.21428	60	220	280
6	"6-out5032"	.13274	15	98	113
6	"6-out5033"	.05540	41	699	740
6	"6-out5034"	.52419	390	354	744
6	"6-out5035"	.60905	296	190	486
6	"6-out5036"	.54576	316	263	579
6	"6-out5037"	.48071	324	350	674
6	"6-out5038"	.06744	29	401	430
6	"6-out5039"	.09300	133	1297	1430
6	"6-out5040"	.32258	210	441	651
6	"6-out5041"	.12931	45	303	348
6	"6-out5042"	.10406	41	353	394
6	"6-out5043"	.52820	103	92	195
6	"6-out5044"	.48293	184	197	381
6	"6-out5045"	.13370	48	311	359
6	"6-out5046"	.11764	74	555	629
6	"6-out5047"	.17699	20	93	113
6	"6-out5048"	.28220	46	117	163
6	"6-out5049"	.10129	78	692	770
6	"6-out5050"	.07750	31	369	400
6	"6-out5051"	.14355	146	871	1017
6	"6-out5052"	.37588	53	88	141
6	"6-out5053"	.17005	92	449	541
6	"6-out5054"	.44312	187	235	422
6	"6-out5055"	.05502	46	790	836
6	"6-out5056"	.33684	288	567	855
6	"6-out5057"	.55474	76	61	137
6	"6-out5058"	.10882	74	606	680
6	"6-out5059"	.08986	102	1033	1135
6	"6-out5060"	.10707	59	492	551
6	"6-out5061"	.15555	35	190	225
6	"6-out5062"	.08980	37	375	412
6	"6-out5063"	.13367	52	337	389
6	"6-out5064"	.37203	141	238	379
6	"6-out5065"	.05924	66	1048	1114
6	"6-out5066"	.16000	52	273	325
6	"6-out5067"	.24593	106	325	431
6	"6-out5068"	.13031	46	307	353
6	"6-out5069"	.08571	15	160	175
6	"6-out5070"	.24401	51	158	209
6	"6-out5071"	.15591	29	157	186
6	"6-out5072"	.05421	9	157	166
6	"6-out5073"	.56521	78	60	138
6	"6-out5074"	.15435	94	515	609
6	"6-out5075"	.16666	137	685	822
6	"6-out5076"	.03585	9	242	251
6	"6-out5077"	.06947	33	442	475
6	"6-out5078"	.14680	170	988	1158
6	"6-out5079"	.12689	92	633	725
6	"6-out5080"	.11546	53	406	459
6	"6-out5081"	.16599	41	206	247
6	"6-out5082"	.38095	192	312	504
6	"6-out5083"	.07766	16	190	206
6	"6-out5084"	.55454	183	147	330
6	"6-out5085"	.16129	130	676	806
6	"6-out5086"	.26345	142	397	539
6	"6-out5087"	.48713	568	598	1166
6	"6-out5088"	.06407	28	409	437
6	"6-out5089"	.11728	135	1016	1151
6	"6-out5090"	.07836	46	541	587
6	"6-out5091"	.18904	69	296	365
6	"6-out5092"	.13492	51	327	378
6	"6-out5093"	.07208	55	708	763
6	"6-out5094"	.39393	130	200	330
6	"6-out5095"	.04778	42	837	879
6	"6-out5096"	.12007	61	447	508
6	"6-out5097"	.08130	40	452	492
6	"6-out5098"	.08488	269	2900	3169
6	"6-out5099"	.10545	87	738	825
6	"6-out5100"	.14035	80	490	570
6	"6-out5101"	.10772	53	439	492
6	"6-out5102"	.02008	10	488	498
6	"6-out5103"	.11132	59	471	530
6	"6-out5104"	.38500	77	123	200
6	"6-out5105"	.12365	23	163	186
6	"6-out5106"	.09792	33	304	337
6	"6-out5107"	.07349	28	353	381
6	"6-out5108"	.49180	60	62	122
6	"6-out5109"	.09939	49	444	493
6	"6-out5110"	.18338	170	757	927
6	"6-out5111"	.18373	192	853	1045
6	"6-out5112"	.06847	43	585	628
6	"6-out5113"	.05063	36	675	711
6	"6-out5114"	.37234	70	118	188
6	"6-out5115"	.10869	40	328	368
6	"6-out5116"	.10434	48	412	460
6	"6-out5117"	.23732	103	331	434
6	"6-out5118"	.06000	18	282	300
6	"6-out5119"	.11515	38	292	330
6	"6-out5120"	.39884	138	208	346
6	"6-out5121"	.13527	51	326	377
6	"6-out5122"	.08272	68	754	822
6	"6-out5123"	.36082	70	124	194
6	"6-out5124"	.11189	158	1254	1412
6	"6-out5125"	.22404	41	142	183
6	"6-out5126"	.46766	94	107	201
6	"6-out5127"	.23337	558	1833	2391
6	"6-out5128"	.07710	33	395	428
6	"6-out5129"	.05585	21	355	376
6	"6-out5130"	.07366	54	679	733
6	"6-out5131"	.11549	208	1593	1801
6	"6-out5132"	.15950	52	274	326
6	"6-out5133"	.07628	46	557	603
6	"6-out5134"	.14794	54	311	365
6	"6-out5135"	.40551	206	302	508
6	"6-out5136"	.04684	23	468	491
6	"6-out5137"	.04545	17	357	374
6	"6-out5138"	.06902	201	2711	2912
6	"6-out5139"	.27204	182	487	669
6	"6-out5140"	.12017	109	798	907
6	"6-out5141"	.57439	332	246	578
6	"6-out5142"	.47275	269	300	569
6	"6-out5143"	.20231	35	138	173
6	"6-out5144"	.10089	68	606	674
6	"6-out5145"	.21084	35	131	166
6	"6-out5146"	.28173	91	232	323
6	"6-out5147"	.06747	161	2225	2386
6	"6-out5148"	.06250	31	465	496
6	"6-out5149"	.11643	34	258	292
6	"6-out5150"	.12213	32	230	262
6	"6-out5151"	.22805	278	941	1219
6	"6-out5152"	.43859	250	320	570
6	"6-out5153"	.28571	64	160	224
6	"6-out5154"	.39325	35	54	89
6	"6-out5155"	.04752	25	501	526
6	"6-out5156"	.26548	60	166	226
6	"6-out5157"	.29019	74	181	255
6	"6-out5158"	.50205	122	121	243
6	"6-out5159"	.06826	37	505	542
6	"6-out5160"	.10588	36	304	340
6	"6-out5161"	.09959	367	3318	3685
6	"6-out5162"	.07118	293	3823	4116
6	"6-out5163"	.09256	428	4196	4624
6	"6-out5164"	.05983	278	4368	4646
6	"6-out5165"	.07472	47	582	629
6	"6-out5166"	.21727	762	2745	3507
6	"6-out5167"	.04991	30	571	601
6	"6-out5168"	.12884	67	453	520
6	"6-out5169"	.06176	21	319	340
6	"6-out5170"	.21348	95	350	445
6	"6-out5171"	.07352	35	441	476
6	"6-out5172"	.35692	116	209	325
6	"6-out5173"	.28294	73	185	258
6	"6-out5174"	.07083	51	669	720
6	"6-out5175"	.07692	51	612	663
6	"6-out5176"	.35468	227	413	640
6	"6-out5177"	.13853	55	342	397
6	"6-out5178"	.22929	72	242	314
6	"6-out5179"	.12275	41	293	334
6	"6-out5180"	.08320	54	595	649
6	"6-out5181"	.18879	128	550	678
6	"6-out5182"	.07027	52	688	740
6	"6-out5183"	.56692	144	110	254
6	"6-out5184"	.16932	53	260	313
6	"6-out5185"	.11464	54	417	471
6	"6-out5186"	.12406	66	466	532
6	"6-out5187"	.09968	32	289	321
6	"6-out5188"	.06074	26	402	428
6	"6-out5189"	.33115	152	307	459
6	"6-out5190"	.17567	39	183	222
6	"6-out5191"	.10799	131	1082	1213
6	"6-out5192"	.10394	179	1543	1722
6	"6-out5193"	.04880	53	1033	1086
6	"6-out5194"	.08442	45	488	533
6	"6-out5195"	.47963	212	230	442
6	"6-out5196"	.05357	12	212	224
6	"6-out5197"	.12586	128	889	1017
6	"6-out5198"	.17097	172	834	1006
6	"6-out5199"	.12323	61	434	495
6	"6-out5200"	.16521	57	288	345
6	"6-out5201"	.42196	757	1037	1794
6	"6-out5202"	.07778	160	1897	2057
6	"6-out5203"	.09800	182	1675	1857
6	"6-out5204"	.30894	114	255	369
6	"6-out5205"	.10616	31	261	292
6	"6-out5206"	.06635	43	605	648
6	"6-out5207"	.07736	40	477	517
6	"6-out5208"	.55183	165	134	299
6	"6-out5209"	.08472	112	1210	1322
6	"6-out5210"	.13953	48	296	344
6	"6-out5211"	.23952	80	254	334
6	"6-out5212"	.12903	52	351	403
6	"6-out5213"	.09631	47	441	488
6	"6-out5214"	.11637	54	410	464
6	"6-out5215"	.13540	96	613	709
6	"6-out5216"	.58536	168	119	287
6	"6-out5217"	.06973	50	667	717
6	"6-out5218"	.11886	46	341	387
6	"6-out5219"	.12735	88	603	691
6	"6-out5220"	.03115	10	311	321
6	"6-out5221"	.07542	62	760	822
6	"6-out5222"	.10900	23	188	211
6	"6-out5223"	.12961	137	920	1057
6	"6-out5224"	.07161	28	363	391
6	"6-out5225"	.03201	13	393	406
6	"6-out5226"	.14592	34	199	233
6	"6-out5227"	.12244	18	129	147
6	"6-out5228"	.14516	27	159	186
6	"6-out5229"	.06113	28	430	458
6	"6-out5230"	.28943	189	464	653
6	"6-out5231"	.15705	49	263	312
6	"6-out5232"	.13392	30	194	224
6	"6-out5233"	.08243	23	256	279
6	"6-out5234"	.09584	83	783	866
6	"6-out5235"	.09264	92	901	993
6	"6-out5236"	.27061	384	1035	1419
6	"6-out5237"	.38292	139	224	363
6	"6-out5238"	.12025	76	556	632
6	"6-out5239"	.15495	75	409	484
6	"6-out5240"	.12500	26	182	208
6	"6-out5241"	.17847	63	290	353
6	"6-out5242"	.09138	70	696	766
6	"6-out5243"	.04076	17	400	417
6	"6-out5244"	.38164	79	128	207
6	"6-out5245"	.13807	33	206	239
6	"6-out5246"	.05985	17	267	284
6	"6-out5247"	.05769	12	196	208
6	"6-out5248"	.07064	58	763	821
6	"6-out5249"	.59090	195	135	330
6	"6-out5250"	.09536	109	1034	1143
6	"6-out5251"	.11479	52	401	453
6	"6-out5252"	.17162	75	362	437
6	"6-out5253"	.06666	33	462	495
6	"6-out5254"	.05279	67	1202	1269
6	"6-out5255"	.07079	8	105	113
6	"6-out5256"	.08492	40	431	471
6	"6-out5257"	.04489	29	617	646
6	"6-out5258"	.57062	101	76	177
6	"6-out5259"	.48299	71	76	147
6	"6-out5260"	.11297	54	424	478
6	"6-out5261"	.06040	45	700	745
6	"6-out5262"	.11728	95	715	810
6	"6-out5263"	.18099	40	181	221
6	"6-out5264"	.41666	45	63	108
6	"6-out5265"	.26911	88	239	327
6	"6-out5266"	.13665	63	398	461
6	"6-out5267"	.08450	12	130	142
6	"6-out5268"	.09398	50	482	532
6	"6-out5269"	.39325	35	54	89
6	"6-out5270"	.06031	62	966	1028
6	"6-out5271"	.11650	36	273	309
6	"6-out5272"	.31089	157	348	505
6	"6-out5273"	.08571	30	320	350
6	"6-out5274"	.18454	43	190	233
6	"6-out5275"	.30000	63	147	210
6	"6-out5276"	.35083	147	272	419
6	"6-out5277"	.23061	113	377	490
6	"6-out5278"	.35000	133	247	380
6	"6-out5279"	.21176	36	134	170
6	"6-out5280"	.06995	17	226	243
6	"6-out5281"	.11559	169	1293	1462
6	"6-out5282"	.25120	52	155	207
6	"6-out5283"	.12500	27	189	216
6	"6-out5284"	.08582	23	245	268
6	"6-out5285"	.04725	55	1109	1164
6	"6-out5286"	.20000	31	124	155
6	"6-out5287"	.12796	27	184	211
6	"6-out5288"	.10270	19	166	185
6	"6-out5289"	.05670	33	549	582
6	"6-out5290"	.25925	28	80	108
6	"6-out5291"	.04011	14	335	349
6	"6-out5292"	.05309	24	428	452
6	"6-out5293"	.39325	35	54	89
6	"6-out5294"	.06944	10	134	144
6	"6-out5295"	.47514	239	264	503
6	"6-out5296"	.25882	242	693	935
6	"6-out5297"	.07114	18	235	253
6	"6-out5298"	.04081	10	235	245
6	"6-out5299"	.05477	47	811	858
6	"6-out5300"	.17021	56	273	329
6	"6-out5301"	.10071	28	250	278
6	"6-out5302"	.03460	10	279	289
6	"6-out5303"	.21105	42	157	199
6	"6-out5305"	.03296	6	176	182
6	"6-out5306"	.50806	63	61	124
6	"6-out5307"	.22068	32	113	145
6	"6-out5308"	.12258	19	136	155
6	"6-out5309"	.45231	664	804	1468
6	"6-out5310"	.05147	14	258	272
6	"6-out5311"	.09832	47	431	478
6	"6-out5312"	.07389	15	188	203
6	"6-out5313"	.18715	469	2037	2506
6	"6-out5314"	.09090	20	200	220
6	"6-out5315"	.09020	211	2128	2339
6	"6-out5316"	.03544	28	762	790
6	"6-out5317"	.14634	54	315	369
6	"6-out5318"	.09589	21	198	219
6	"6-out5319"	.07259	58	741	799
6	"6-out5320"	.08547	70	749	819
6	"6-out5321"	.09744	61	565	626
6	"6-out5322"	.09269	33	323	356
6	"6-out5323"	.07012	23	305	328
6	"6-out5324"	.08192	29	325	354
6	"6-out5325"	.10256	32	280	312
6	"6-out5326"	.09090	28	280	308
6	"6-out5327"	.13259	24	157	181
6	"6-out5328"	.51822	199	185	384
6	"6-out5329"	.12080	18	131	149
6	"6-out5330"	.37684	179	296	475
6	"6-out5331"	.11486	34	262	296
6	"6-out5332"	.06716	36	500	536
6	"6-out5333"	.12627	37	256	293
6	"6-out5334"	.08554	29	310	339
6	"6-out5335"	.53164	42	37	79
6	"6-out5336"	.12284	64	457	521
6	"6-out5337"	.16337	91	466	557
6	"6-out5338"	.14285	41	246	287
6	"6-out5339"	.25825	86	247	333
6	"6-out5340"	.10169	48	424	472
6	"6-out5341"	.04641	22	452	474
6	"6-out5342"	.07801	11	130	141
6	"6-out5343"	.07089	38	498	536
6	"6-out5344"	.10580	51	431	482
6	"6-out5345"	.04896	26	505	531
6	"6-out5346"	.04921	25	483	508
6	"6-out5347"	.16990	105	513	618
6	"6-out5348"	.51824	213	198	411
6	"6-out5349"	.12269	40	286	326
6	"6-out5350"	.08418	41	446	487
6	"6-out5351"	.05027	63	1190	1253
6	"6-out5352"	.10501	44	375	419
6	"6-out5353"	.18181	24	108	132
6	"6-out5354"	.22317	104	362	466
6	"6-out5355"	.21682	116	419	535
6	"6-out5356"	.13227	50	328	378
6	"6-out5357"	.08996	104	1052	1156
6	"6-out5358"	.07150	68	883	951
6	"6-out5359"	.13025	31	207	238
6	"6-out5360"	.05981	39	613	652
6	"6-out5361"	.14227	35	211	246
6	"6-out5362"	.09126	23	229	252
6	"6-out5363"	.09445	46	441	487
6	"6-out5364"	.10308	167	1453	1620
6	"6-out5365"	.03805	43	1087	1130
6	"6-out5366"	.05682	62	1029	1091
6	"6-out5367"	.09900	10	91	101
6	"6-out5368"	.52307	102	93	195
6	"6-out5369"	.37440	79	132	211
6	"6-out5370"	.14067	120	733	853
6	"6-out5371"	.13294	23	150	173
6	"6-out5372"	.09523	84	798	882
6	"6-out5373"	.05784	194	3160	3354
6	"6-out5374"	.17713	79	367	446
6	"6-out5375"	.40068	234	350	584
6	"6-out5376"	.36708	58	100	158
6	"6-out5377"	.04761	6	120	126
6	"6-out5378"	.51111	161	154	315
6	"6-out5379"	.07740	74	882	956
6	"6-out5380"	.16815	94	465	559
6	"6-out5381"	.09263	73	715	788
6	"6-out5382"	.14886	46	263	309
6	"6-out5383"	.13968	44	271	315
6	"6-out5384"	.11832	31	231	262
6	"6-out5385"	.32432	264	550	814
6	"6-out5386"	.04046	14	332	346
6	"6-out5387"	.21041	97	364	461
6	"6-out5388"	.02195	11	490	501
6	"6-out5389"	.35308	441	808	1249
6	"6-out5390"	.07171	18	233	251
6	"6-out5391"	.43333	39	51	90
6	"6-out5392"	.34180	148	285	433
6	"6-out5393"	.16938	135	662	797
6	"6-out5394"	.35950	87	155	242
6	"6-out5395"	.07692	32	384	416
6	"6-out5396"	.06179	11	167	178
6	"6-out5397"	.23829	168	537	705
6	"6-out5398"	.06419	26	379	405
6	"6-out5399"	.11111	29	232	261
6	"6-out5400"	.10068	44	393	437
6	"6-out5401"	.15873	20	106	126
6	"6-out5402"	.41735	101	141	242
6	"6-out5403"	.12057	109	795	904
6	"6-out5404"	.06933	52	698	750
6	"6-out5405"	.14437	354	2098	2452
6	"6-out5406"	.07885	22	257	279
6	"6-out5407"	.19271	90	377	467
6	"6-out5408"	.24085	191	602	793
6	"6-out5409"	.07394	44	551	595
6	"6-out5410"	.11424	77	597	674
6	"6-out5411"	.36612	67	116	183
6	"6-out5412"	.05236	41	742	783
6	"6-out5413"	.37378	77	129	206
6	"6-out5414"	.08620	15	159	174
6	"6-out5415"	.50511	148	145	293
6	"6-out5416"	.04912	14	271	285
6	"6-out5417"	.19597	117	480	597
6	"6-out5418"	.42249	447	611	1058
6	"6-out5419"	.18181	22	99	121
6	"6-out5420"	.55208	53	43	96
6	"6-out5421"	.42857	54	72	126
6	"6-out5422"	.07423	17	212	229
6	"6-out5423"	.06003	38	595	633
6	"6-out5424"	.06554	43	613	656
6	"6-out5425"	.10130	225	1996	2221
6	"6-out5426"	.07932	66	766	832
6	"6-out5427"	.08816	70	724	794
6	"6-out5428"	.07840	65	764	829
6	"6-out5429"	.10000	70	630	700
6	"6-out5430"	.11403	78	606	684
6	"6-out5431"	.08943	121	1232	1353
6	"6-out5432"	.09878	114	1040	1154
6	"6-out5433"	.43421	99	129	228
6	"6-out5434"	.32425	131	273	404
6	"6-out5435"	.05494	10	172	182
6	"6-out5436"	.07761	26	309	335
6	"6-out5437"	.10158	77	681	758
6	"6-out5438"	.13782	47	294	341
6	"6-out5439"	.20063	190	757	947
6	"6-out5440"	.39658	209	318	527
6	"6-out5441"	.17162	75	362	437
6	"6-out5442"	.52950	655	582	1237
6	"6-out5443"	.18157	67	302	369
6	"6-out5444"	.18131	66	298	364
6	"6-out5445"	.09119	29	289	318
6	"6-out5446"	.09738	67	621	688
6	"6-out5447"	.17847	63	290	353
6	"6-out5448"	.03557	9	244	253
6	"6-out5449"	.18565	44	193	237
6	"6-out5450"	.21088	31	116	147
6	"6-out5451"	.18579	34	149	183
6	"6-out5452"	.11730	40	301	341
6	"6-out5453"	.11627	25	190	215
6	"6-out5454"	.08812	23	238	261
6	"6-out5455"	.07604	60	729	789
6	"6-out5456"	.09733	124	1150	1274
6	"6-out5457"	.09547	38	360	398
6	"6-out5458"	.05275	22	395	417
6	"6-out5459"	.08769	72	749	821
6	"6-out5460"	.08520	57	612	669
6	"6-out5461"	.07021	91	1205	1296
6	"6-out5462"	.18924	190	814	1004
6	"6-out5463"	.04460	57	1221	1278
6	"6-out5464"	.10294	49	427	476
6	"6-out5465"	.07088	75	983	1058
6	"6-out5466"	.27634	215	563	778
6	"6-out5467"	.10987	198	1604	1802
6	"6-out5468"	.37051	93	158	251
6	"6-out5469"	.21855	106	379	485
6	"6-out5470"	.13878	73	453	526
6	"6-out5471"	.44933	235	288	523
6	"6-out5472"	.49146	288	298	586
6	"6-out5473"	.18367	18	80	98
6	"6-out5474"	.48520	82	87	169
6	"6-out5475"	.57142	56	42	98
6	"6-out5476"	.15267	40	222	262
6	"6-out5477"	.54793	1086	896	1982
6	"6-out5478"	.14373	47	280	327
6	"6-out5479"	.11357	41	320	361
6	"6-out5480"	.13917	27	167	194
6	"6-out5481"	.07462	10	124	134
6	"6-out5482"	.44623	83	103	186
6	"6-out5483"	.10347	119	1031	1150
6	"6-out5484"	.09454	26	249	275
6	"6-out5485"	.09541	79	749	828
6	"6-out5486"	.05778	46	750	796
6	"6-out5487"	.49368	352	361	713
6	"6-out5488"	.10938	260	2117	2377
6	"6-out5489"	.17610	84	393	477
6	"6-out5490"	.12053	81	591	672
6	"6-out5491"	.07894	48	560	608
6	"6-out5492"	.10071	84	750	834
6	"6-out5493"	.08661	44	464	508
6	"6-out5494"	.04831	33	650	683
6	"6-out5495"	.21621	32	116	148
6	"6-out5496"	.09030	41	413	454
6	"6-out5497"	.05579	13	220	233
6	"6-out5498"	.10937	35	285	320
6	"6-out5499"	.05594	56	945	1001
6	"6-out5500"	.47151	149	167	316
6	"6-out5501"	.12307	32	228	260
6	"6-out5502"	.51857	740	687	1427
6	"6-out5503"	.48310	243	260	503
6	"6-out5504"	.60283	85	56	141
6	"6-out5505"	.10529	153	1300	1453
6	"6-out5506"	.08710	25	262	287
6	"6-out5507"	.50847	60	58	118
6	"6-out5508"	.07211	15	193	208
6	"6-out5509"	.30000	33	77	110
6	"6-out5510"	.11862	86	639	725
6	"6-out5511"	.04362	13	285	298
6	"6-out5512"	.14150	30	182	212
6	"6-out5513"	.11752	59	443	502
6	"6-out5514"	.41860	36	50	86
6	"6-out5515"	.07871	44	515	559
6	"6-out5516"	.11797	42	314	356
6	"6-out5517"	.15452	70	383	453
6	"6-out5518"	.10485	41	350	391
6	"6-out5519"	.29980	152	355	507
6	"6-out5520"	.10526	42	357	399
6	"6-out5521"	.09104	124	1238	1362
6	"6-out5522"	.09433	30	288	318
6	"6-out5523"	.12652	52	359	411
6	"6-out5524"	.06970	84	1121	1205
6	"6-out5525"	.18650	47	205	252
6	"6-out5526"	.18992	215	917	1132
6	"6-out5527"	.34105	162	313	475
6	"6-out5528"	.47447	158	175	333
6	"6-out5529"	.09795	24	221	245
6	"6-out5530"	.03603	8	214	222
6	"6-out5531"	.18439	130	575	705
6	"6-out5532"	.06896	20	270	290
6	"6-out5533"	.05952	35	553	588
6	"6-out5534"	.11655	69	523	592
6	"6-out5535"	.14181	329	1991	2320
6	"6-out5536"	.11808	220	1643	1863
6	"6-out5537"	.08877	68	698	766
6	"6-out5538"	.23809	125	400	525
6	"6-out5539"	.44835	204	251	455
6	"6-out5540"	.41580	121	170	291
6	"6-out5541"	.09090	46	460	506
6	"6-out5542"	.02749	8	283	291
6	"6-out5543"	.05729	22	362	384
6	"6-out5544"	.12639	68	470	538
6	"6-out5545"	.47447	158	175	333
6	"6-out5546"	.21252	190	704	894
6	"6-out5547"	.17577	74	347	421
6	"6-out5548"	.10919	76	620	696
6	"6-out5549"	.15172	357	1996	2353
6	"6-out5550"	.14100	141	859	1000
6	"6-out5551"	.09546	40	379	419
6	"6-out5552"	.08285	29	321	350
6	"6-out5553"	.08531	97	1040	1137
6	"6-out5554"	.09547	19	180	199
6	"6-out5555"	.31325	26	57	83
6	"6-out5556"	.07936	10	116	126
6	"6-out5557"	.32250	129	271	400
6	"6-out5558"	.15925	43	227	270
6	"6-out5559"	.39473	150	230	380
6	"6-out5560"	.09117	63	628	691
6	"6-out5561"	.10632	42	353	395
6	"6-out5562"	.09939	49	444	493
6	"6-out5563"	.07782	180	2133	2313
6	"6-out5564"	.12740	106	726	832
6	"6-out5565"	.06787	30	412	442
6	"6-out5566"	.11409	17	132	149
6	"6-out5567"	.12080	18	131	149
6	"6-out5568"	.10208	152	1337	1489
6	"6-out5569"	.16129	35	182	217
6	"6-out5570"	.15561	115	624	739
6	"6-out5571"	.07905	40	466	506
6	"6-out5572"	.11404	82	637	719
6	"6-out5573"	.13407	109	704	813
6	"6-out5574"	.13229	93	610	703
6	"6-out5575"	.10144	70	620	690
6	"6-out5576"	.07058	12	158	170
6	"6-out5577"	.11847	84	625	709
6	"6-out5578"	.10647	120	1007	1127
6	"6-out5579"	.13718	38	239	277
6	"6-out5580"	.08527	88	944	1032
6	"6-out5581"	.08239	51	568	619
6	"6-out5582"	.29078	82	200	282
6	"6-out5583"	.05099	36	670	706
6	"6-out5584"	.12790	33	225	258
6	"6-out5585"	.11290	42	330	372
6	"6-out5586"	.11916	74	547	621
6	"6-out5587"	.09935	62	562	624
6	"6-out5588"	.02602	7	262	269
6	"6-out5589"	.07407	18	225	243
6	"6-out5590"	.27642	34	89	123
6	"6-out5591"	.21843	64	229	293
6	"6-out5592"	.06122	6	92	98
6	"6-out5593"	.64000	80	45	125
6	"6-out5594"	.19444	35	145	180
6	"6-out5595"	.12389	14	99	113
6	"6-out5596"	.06846	152	2068	2220
6	"6-out5597"	.17679	195	908	1103
6	"6-out5598"	.06404	31	453	484
6	"6-out5599"	.33636	37	73	110
6	"6-out5600"	.03620	29	772	801
6	"6-out5601"	.04585	36	749	785
6	"6-out5602"	.06987	151	2010	2161
6	"6-out5603"	.14024	46	282	328
6	"6-out5604"	.04069	14	330	344
6	"6-out5605"	.08917	28	286	314
6	"6-out5606"	.13076	34	226	260
6	"6-out5607"	.04704	39	790	829
6	"6-out5608"	.17350	55	262	317
6	"6-out5609"	.06505	51	733	784
6	"6-out5610"	.15602	22	119	141
6	"6-out5611"	.08275	155	1718	1873
6	"6-out5612"	.14022	38	233	271
6	"6-out5613"	.04347	26	572	598
6	"6-out5614"	.06632	13	183	196
6	"6-out5615"	.01369	2	144	146
6	"6-out5616"	.31496	40	87	127
6	"6-out5617"	.13779	70	438	508
6	"6-out5618"	.06796	84	1152	1236
6	"6-out5619"	.40607	441	645	1086
6	"6-out5620"	.12231	57	409	466
6	"6-out5621"	.36450	152	265	417
6	"6-out5622"	.11483	48	370	418
6	"6-out5623"	.07704	101	1210	1311
6	"6-out5624"	.56896	66	50	116
6	"6-out5625"	.54700	64	53	117
6	"6-out5626"	.59759	398	268	666
6	"6-out5627"	.12008	113	828	941
6	"6-out5628"	.60510	403	263	666
6	"6-out5629"	.08750	14	146	160
6	"6-out5630"	.10691	17	142	159
6	"6-out5631"	.12208	68	489	557
6	"6-out5632"	.57738	97	71	168
6	"6-out5633"	.06011	41	641	682
6	"6-out5634"	.12058	246	1794	2040
6	"6-out5635"	.06953	144	1927	2071
6	"6-out5636"	.13750	66	414	480
6	"6-out5637"	.06331	29	429	458
6	"6-out5638"	.14569	66	387	453
6	"6-out5639"	.11974	57	419	476
6	"6-out5640"	.09583	23	217	240
6	"6-out5641"	.41935	65	90	155
6	"6-out5642"	.21599	181	657	838
6	"6-out5643"	.22318	77	268	345
6	"6-out5644"	.02460	11	436	447
6	"6-out5645"	.08944	50	509	559
6	"6-out5646"	.16836	33	163	196
6	"6-out5647"	.10330	25	217	242
6	"6-out5648"	.16426	57	290	347
6	"6-out5649"	.47008	55	62	117
6	"6-out5650"	.48571	17	18	35
6	"6-out5651"	.14754	36	208	244
6	"6-out5652"	.04186	26	595	621
6	"6-out5653"	.05849	21	338	359
6	"6-out5654"	.06807	29	397	426
6	"6-out5655"	.15418	70	384	454
6	"6-out5656"	.09139	51	507	558
6	"6-out5657"	.07547	24	294	318
6	"6-out5658"	.08139	98	1106	1204
6	"6-out5659"	.07233	137	1757	1894
6	"6-out5660"	.12820	30	204	234
6	"6-out5661"	.32547	69	143	212
6	"6-out5662"	.06172	20	304	324
6	"6-out5663"	.18444	102	451	553
6	"6-out5664"	.09736	37	343	380
6	"6-out5665"	.13533	54	345	399
6	"6-out5666"	.11968	45	331	376
6	"6-out5667"	.07205	49	631	680
6	"6-out5668"	.12544	35	244	279
6	"6-out5669"	.05899	61	973	1034
6	"6-out5670"	.39428	69	106	175
6	"6-out5671"	.19391	51	212	263
6	"6-out5672"	.30697	66	149	215
6	"6-out5673"	.12243	161	1154	1315
6	"6-out5674"	.13927	50	309	359
6	"6-out5675"	.12720	36	247	283
6	"6-out5676"	.47419	147	163	310
6	"6-out5677"	.07239	86	1102	1188
6	"6-out5678"	.49785	116	117	233
6	"6-out5679"	.10422	37	318	355
6	"6-out5680"	.07829	35	412	447
6	"6-out5681"	.15483	24	131	155
6	"6-out5682"	.04491	19	404	423
6	"6-out5683"	.06636	59	830	889
6	"6-out5684"	.13215	97	637	734
6	"6-out5685"	.43939	87	111	198
6	"6-out5686"	.08348	45	494	539
6	"6-out5687"	.17747	52	241	293
6	"6-out5688"	.09759	69	638	707
6	"6-out5689"	.06020	36	562	598
6	"6-out5690"	.08085	19	216	235
6	"6-out5691"	.47428	83	92	175
6	"6-out5692"	.05757	38	622	660
6	"6-out5693"	.05546	36	613	649
6	"6-out5694"	.14117	36	219	255
6	"6-out5695"	.04651	8	164	172
6	"6-out5696"	.14003	85	522	607
6	"6-out5697"	.20215	94	371	465
6	"6-out5698"	.37259	155	261	416
6	"6-out5699"	.19811	105	425	530
6	"6-out5700"	.09285	13	127	140
6	"6-out5701"	.14723	48	278	326
6	"6-out5702"	.54310	63	53	116
6	"6-out5703"	.55454	61	49	110
6	"6-out5704"	.08000	46	529	575
6	"6-out5705"	.08620	10	106	116
6	"6-out5706"	.54872	366	301	667
6	"6-out5707"	.12893	45	304	349
6	"6-out5708"	.08176	26	292	318
6	"6-out5709"	.44827	78	96	174
6	"6-out5710"	.09896	67	610	677
6	"6-out5711"	.11532	76	583	659
6	"6-out5712"	.11680	41	310	351
6	"6-out5713"	.06986	280	3728	4008
6	"6-out5714"	.63692	307	175	482
6	"6-out5715"	.18604	24	105	129
6	"6-out5716"	.06568	49	697	746
6	"6-out5717"	.16513	18	91	109
6	"6-out5718"	.48790	242	254	496
6	"6-out5719"	.06818	21	287	308
6	"6-out5720"	.39665	190	289	479
6	"6-out5721"	.03508	24	660	684
6	"6-out5722"	.12643	11	76	87
6	"6-out5723"	.50000	89	89	178
6	"6-out5724"	.23157	22	73	95
6	"6-out5725"	.08521	49	526	575
6	"6-out5726"	.15240	73	406	479
6	"6-out5727"	.12602	46	319	365
6	"6-out5728"	.59759	398	268	666
6	"6-out5729"	.44493	202	252	454
6	"6-out5730"	.11175	58	461	519
6	"6-out5731"	.13636	30	190	220
6	"6-out5732"	.16666	87	435	522
6	"6-out5733"	.06321	22	326	348
6	"6-out5734"	.14726	62	359	421
6	"6-out5735"	.38187	257	416	673
6	"6-out5736"	.16605	45	226	271
6	"6-out5737"	.18200	89	400	489
6	"6-out5738"	.35514	38	69	107
6	"6-out5739"	.17623	89	416	505
6	"6-out5740"	.45454	70	84	154
6	"6-out5741"	.31818	119	255	374
6	"6-out5742"	.46198	158	184	342
6	"6-out5743"	.10940	57	464	521
6	"6-out5744"	.10948	75	610	685
6	"6-out5745"	.13186	84	553	637
6	"6-out5746"	.09439	64	614	678
6	"6-out5747"	.07355	42	529	571
6	"6-out5748"	.11111	26	208	234
6	"6-out5749"	.13636	195	1235	1430
6	"6-out5750"	.08475	412	4449	4861
6	"6-out5751"	.27058	1308	3526	4834
6	"6-out5752"	.12030	64	468	532
6	"6-out5753"	.08636	95	1005	1100
6	"6-out5754"	.10270	57	498	555
6	"6-out5755"	.09015	108	1090	1198
6	"6-out5756"	.06645	41	576	617
6	"6-out5757"	.30714	129	291	420
6	"6-out5758"	.37585	165	274	439
6	"6-out5759"	.18015	118	537	655
6	"6-out5760"	.06993	40	532	572
6	"6-out5761"	.47619	90	99	189
6	"6-out5762"	.14835	108	620	728
6	"6-out5763"	.14746	64	370	434
6	"6-out5764"	.20810	149	567	716
6	"6-out5765"	.37259	155	261	416
6	"6-out5766"	.13552	95	606	701
6	"6-out5767"	.07865	7	82	89
6	"6-out5768"	.09225	100	984	1084
6	"6-out5769"	.06504	32	460	492
6	"6-out5770"	.08865	186	1912	2098
6	"6-out5771"	.07692	26	312	338
6	"6-out5772"	.19161	96	405	501
6	"6-out5773"	.48933	367	383	750
6	"6-out5774"	.22163	84	295	379
6	"6-out5775"	.20945	93	351	444
6	"6-out5776"	.10932	68	554	622
6	"6-out5777"	.16377	66	337	403
6	"6-out5778"	.10442	92	789	881
6	"6-out5779"	.09744	42	389	431
6	"6-out5780"	.44604	124	154	278
6	"6-out5781"	.45744	129	153	282
6	"6-out5782"	.44964	125	153	278
6	"6-out5783"	.45355	83	100	183
6	"6-out5784"	.07799	235	2778	3013
6	"6-out5785"	.10876	237	1942	2179
6	"6-out5786"	.22484	181	624	805
6	"6-out5787"	.08816	70	724	794
6	"6-out5788"	.21739	135	486	621
6	"6-out5789"	.07429	50	623	673
6	"6-out5790"	.09666	29	271	300
6	"6-out5791"	.37170	155	262	417
6	"6-out5792"	.30640	110	249	359
6	"6-out5793"	.60510	403	263	666
6	"6-out5794"	.03252	4	119	123
6	"6-out5795"	.03781	18	458	476
6	"6-out5796"	.09575	97	916	1013
6	"6-out5797"	.08660	128	1350	1478
6	"6-out5798"	.30015	193	450	643
6	"6-out5799"	.56656	183	140	323
6	"6-out5800"	.09833	53	486	539
6	"6-out5801"	.51806	545	507	1052
6	"6-out5802"	.10971	35	284	319
6	"6-out5803"	.03801	23	582	605
6	"6-out5804"	.14396	37	220	257
6	"6-out5805"	.12815	66	449	515
6	"6-out5806"	.08260	57	633	690
6	"6-out5807"	.04888	11	214	225
6	"6-out5808"	.20000	49	196	245
6	"6-out5809"	.27272	69	184	253
6	"6-out5810"	.31395	81	177	258
6	"6-out5811"	.02777	6	210	216
6	"6-out5812"	.09423	134	1288	1422
6	"6-out5813"	.41111	111	159	270
6	"6-out5814"	.09222	70	689	759
6	"6-out5815"	.09285	26	254	280
6	"6-out5816"	.23737	141	453	594
6	"6-out5817"	.04605	7	145	152
6	"6-out5818"	.08955	18	183	201
6	"6-out5819"	.14218	30	181	211
6	"6-out5820"	.08533	39	418	457
6	"6-out5821"	.23737	94	302	396
6	"6-out5822"	.10189	59	520	579
6	"6-out5823"	.13135	62	410	472
6	"6-out5824"	.35797	92	165	257
6	"6-out5825"	.03658	21	553	574
6	"6-out5826"	.39062	125	195	320
6	"6-out5827"	.07224	114	1464	1578
6	"6-out5828"	.15266	109	605	714
6	"6-out5829"	.07920	40	465	505
6	"6-out5830"	.11452	97	750	847
6	"6-out5831"	.05813	20	324	344
6	"6-out5832"	.19574	1352	5555	6907
6	"6-out5833"	.12396	30	212	242
6	"6-out5834"	.07608	49	595	644
6	"6-out5835"	.17717	59	274	333
6	"6-out5836"	.61669	399	248	647
6	"6-out5837"	.07234	45	577	622
6	"6-out5838"	.05847	20	322	342
6	"6-out5839"	.13436	52	335	387
6	"6-out5840"	.06930	7	94	101
6	"6-out5841"	.12075	32	233	265
6	"6-out5842"	.17222	31	149	180
6	"6-out5843"	.21714	38	137	175
6	"6-out5844"	.06592	65	921	986
6	"6-out5845"	.11026	58	468	526
6	"6-out5846"	.09343	111	1077	1188
6	"6-out5847"	.09339	75	728	803
6	"6-out5848"	.16574	30	151	181
6	"6-out5849"	.13043	24	160	184
6	"6-out5850"	.11720	94	708	802
6	"6-out5851"	.33615	119	235	354
6	"6-out5852"	.30964	61	136	197
6	"6-out5853"	.55932	99	78	177
6	"6-out5854"	.34402	193	368	561
6	"6-out5855"	.15831	199	1058	1257
6	"6-out5856"	.06866	32	434	466
6	"6-out5857"	.11764	56	420	476
6	"6-out5858"	.19889	108	435	543
6	"6-out5859"	.08588	42	447	489
6	"6-out5860"	.17305	158	755	913
6	"6-out5861"	.12087	110	800	910
6	"6-out5862"	.05540	42	716	758
6	"6-out5863"	.16007	85	446	531
6	"6-out5864"	.08482	71	766	837
6	"6-out5865"	.04388	14	305	319
6	"6-out5866"	.18526	347	1526	1873
6	"6-out5867"	.06451	18	261	279
6	"6-out5868"	.49176	956	988	1944
6	"6-out5869"	.07288	25	318	343
6	"6-out5870"	.08333	31	341	372
6	"6-out5871"	.15170	49	274	323
6	"6-out5872"	.46107	77	90	167
6	"6-out5873"	.08839	16	165	181
6	"6-out5874"	.13960	190	1171	1361
6	"6-out5875"	.10412	58	499	557
6	"6-out5876"	.08379	15	164	179
6	"6-out5877"	.25806	48	138	186
6	"6-out5878"	.14502	86	507	593
6	"6-out5879"	.16019	66	346	412
6	"6-out5880"	.12728	167	1145	1312
6	"6-out5881"	.05978	11	173	184
6	"6-out5882"	.10629	81	681	762
6	"6-out5883"	.15158	124	694	818
6	"6-out5884"	.27659	78	204	282
6	"6-out5885"	.13497	93	596	689
6	"6-out5886"	.13188	115	757	872
6	"6-out5887"	.45695	69	82	151
6	"6-out5888"	.03636	4	106	110
6	"6-out5889"	.08550	171	1829	2000
6	"6-out5890"	.05936	116	1838	1954
6	"6-out5891"	.07071	192	2523	2715
6	"6-out5892"	.10873	315	2582	2897
6	"6-out5893"	.06734	40	554	594
6	"6-out5894"	.14899	163	931	1094
6	"6-out5895"	.05639	41	686	727
6	"6-out5896"	.16711	62	309	371
6	"6-out5897"	.15706	30	161	191
6	"6-out5898"	.05809	61	989	1050
6	"6-out5899"	.04213	34	773	807
6	"6-out5900"	.16666	14	70	84
6	"6-out5901"	.05882	19	304	323
6	"6-out5902"	.03448	15	420	435
6	"6-out5903"	.06510	39	560	599
6	"6-out5904"	.12082	47	342	389
6	"6-out5905"	.07653	76	917	993
6	"6-out5906"	.09727	50	464	514
6	"6-out5907"	.36401	87	152	239
6	"6-out5908"	.37567	139	231	370
6	"6-out5909"	.06685	24	335	359
6	"6-out5910"	.14655	119	693	812
6	"6-out5911"	.32069	110	233	343
6	"6-out5912"	.07352	25	315	340
6	"6-out5913"	.14186	123	744	867
6	"6-out5914"	.16666	93	465	558
6	"6-out5915"	.20560	22	85	107
6	"6-out5916"	.15192	67	374	441
6	"6-out5917"	.16949	20	98	118
6	"6-out5918"	.12982	222	1488	1710
6	"6-out5919"	.07374	221	2776	2997
6	"6-out5920"	.06754	51	704	755
6	"6-out5921"	.11154	509	4054	4563
6	"6-out5922"	.07894	21	245	266
6	"6-out5923"	.49221	158	163	321
6	"6-out5924"	.03454	18	503	521
6	"6-out5925"	.11049	20	161	181
6	"6-out5926"	.13559	48	306	354
6	"6-out5927"	.17207	53	255	308
6	"6-out5928"	.10370	70	605	675
6	"6-out5929"	.13513	105	672	777
6	"6-out5930"	.06780	103	1416	1519
6	"6-out5931"	.08557	51	545	596
6	"6-out5932"	.06066	89	1378	1467
6	"6-out5933"	.14974	205	1164	1369
6	"6-out5934"	.14285	26	156	182
6	"6-out5935"	.11135	249	1987	2236
6	"6-out5936"	.44000	88	112	200
6	"6-out5937"	.49197	92	95	187
6	"6-out5938"	.11136	97	774	871
6	"6-out5939"	.09852	40	366	406
6	"6-out5940"	.06802	87	1192	1279
6	"6-out5941"	.37536	259	431	690
6	"6-out5942"	.45209	722	875	1597
6	"6-out5943"	.22149	202	710	912
6	"6-out5944"	.08354	129	1415	1544
6	"6-out5945"	.07015	59	782	841
6	"6-out5946"	.37883	136	223	359
6	"6-out5947"	.48036	159	172	331
6	"6-out5948"	.02551	5	191	196
6	"6-out5949"	.21568	44	160	204
6	"6-out5950"	.19553	35	144	179
6	"6-out5951"	.25152	124	369	493
6	"6-out5952"	.06228	37	557	594
6	"6-out5953"	.09459	21	201	222
6	"6-out5954"	.40977	109	157	266
6	"6-out5955"	.32044	116	246	362
6	"6-out5956"	.31767	115	247	362
6	"6-out5957"	.04580	18	375	393
6	"6-out5958"	.37808	138	227	365
6	"6-out5959"	.14000	42	258	300
6	"6-out5960"	.08101	70	794	864
6	"6-out5961"	.11229	63	498	561
6	"6-out5962"	.49331	406	417	823
6	"6-out5963"	.13031	46	307	353
6	"6-out5964"	.38105	173	281	454
6	"6-out5965"	.06666	18	252	270
6	"6-out5966"	.03987	13	313	326
6	"6-out5967"	.07643	36	435	471
6	"6-out5968"	.11774	148	1109	1257
6	"6-out5969"	.16913	57	280	337
6	"6-out5970"	.13052	65	433	498
6	"6-out5971"	.09702	49	456	505
6	"6-out5972"	.46191	467	544	1011
6	"6-out5973"	.20883	52	197	249
6	"6-out5974"	.11702	55	415	470
6	"6-out5975"	.17611	87	407	494
6	"6-out5976"	.50378	133	131	264
6	"6-out5977"	.03299	13	381	394
6	"6-out5978"	.04930	46	887	933
6	"6-out5979"	.38118	231	375	606
6	"6-out5980"	.33128	54	109	163
6	"6-out5981"	.09006	29	293	322
6	"6-out5982"	.12577	61	424	485
6	"6-out5983"	.44057	152	193	345
6	"6-out5984"	.11912	38	281	319
6	"6-out5985"	.15428	81	444	525
6	"6-out5986"	.07910	39	454	493
6	"6-out5987"	.09603	63	593	656
6	"6-out5988"	.46374	793	917	1710
6	"6-out5989"	.07237	71	910	981
6	"6-out5990"	.14388	60	357	417
6	"6-out5991"	.14659	140	815	955
6	"6-out5992"	.05980	25	393	418
6	"6-out5993"	.11346	59	461	520
6	"6-out5994"	.03960	4	97	101
6	"6-out5995"	.14485	62	366	428
6	"6-out5996"	.05586	81	1369	1450
6	"6-out5997"	.51033	247	237	484
6	"6-out5998"	.14646	145	845	990
6	"6-out5999"	.45148	228	277	505
6	"6-out6000"	.12440	52	366	418
6	"6-out6001"	.05000	18	342	360
6	"6-out6002"	.11057	138	1110	1248
6	"6-out6003"	.11023	28	226	254
6	"6-out6004"	.04563	45	941	986
6	"6-out6005"	.06508	55	790	845
6	"6-out6006"	.08274	35	388	423
6	"6-out6007"	.08894	37	379	416
6	"6-out6008"	.34715	67	126	193
6	"6-out6009"	.41221	216	308	524
6	"6-out6010"	.46202	73	85	158
6	"6-out6011"	.34939	29	54	83
6	"6-out6012"	.03145	24	739	763
6	"6-out6013"	.31870	138	295	433
6	"6-out6014"	.11370	39	304	343
6	"6-out6015"	.08914	46	470	516
6	"6-out6016"	.48116	396	427	823
6	"6-out6017"	.09797	63	580	643
6	"6-out6018"	.08208	22	246	268
6	"6-out6019"	.13378	59	382	441
6	"6-out6020"	.08118	63	713	776
6	"6-out6021"	.08122	61	690	751
6	"6-out6022"	.09248	32	314	346
6	"6-out6023"	.52931	334	297	631
6	"6-out6024"	.09954	44	398	442
6	"6-out6025"	.08450	12	130	142
6	"6-out6026"	.10486	28	239	267
6	"6-out6027"	.36610	108	187	295
6	"6-out6028"	.40776	84	122	206
6	"6-out6029"	.05521	18	308	326
6	"6-out6030"	.23780	117	375	492
6	"6-out6031"	.08942	82	835	917
6	"6-out6032"	.16666	72	360	432
6	"6-out6033"	.06957	51	682	733
6	"6-out6034"	.16385	97	495	592
6	"6-out6035"	.11293	62	487	549
6	"6-out6036"	.12562	75	522	597
6	"6-out6037"	.10359	72	623	695
6	"6-out6038"	.10814	81	668	749
6	"6-out6039"	.08687	47	494	541
6	"6-out6040"	.06868	25	339	364
6	"6-out6041"	.49572	58	59	117
6	"6-out6042"	.54700	64	53	117
6	"6-out6043"	.03246	5	149	154
6	"6-out6044"	.08040	48	549	597
6	"6-out6045"	.07077	62	814	876
6	"6-out6046"	.08971	82	832	914
6	"6-out6047"	.06926	32	430	462
6	"6-out6048"	.12969	76	510	586
6	"6-out6049"	.12500	9	63	72
6	"6-out6050"	.34782	24	45	69
6	"6-out6051"	.16918	56	275	331
6	"6-out6052"	.12010	184	1348	1532
6	"6-out6053"	.09623	46	432	478
6	"6-out6054"	.06633	27	380	407
6	"6-out6055"	.13636	42	266	308
6	"6-out6056"	.21774	81	291	372
6	"6-out6057"	.08857	38	391	429
6	"6-out6058"	.02472	9	355	364
6	"6-out6059"	.07600	19	231	250
6	"6-out6060"	.07784	39	462	501
6	"6-out6061"	.11648	53	402	455
6	"6-out6062"	.14888	67	383	450
6	"6-out6063"	.05706	42	694	736
6	"6-out6064"	.08172	38	427	465
6	"6-out6065"	.46654	265	303	568
6	"6-out6066"	.60000	87	58	145
6	"6-out6067"	.57241	83	62	145
6	"6-out6068"	.46007	121	142	263
6	"6-out6069"	.47908	126	137	263
6	"6-out6070"	.50190	132	131	263
6	"6-out6071"	.65094	69	37	106
6	"6-out6072"	.66037	70	36	106
6	"6-out6073"	.52450	107	97	204
6	"6-out6074"	.08264	70	777	847
6	"6-out6075"	.46017	52	61	113
6	"6-out6076"	.44761	47	58	105
6	"6-out6077"	.10732	85	707	792
6	"6-out6078"	.12765	48	328	376
6	"6-out6079"	.17692	161	749	910
6	"6-out6080"	.41304	38	54	92
6	"6-out6081"	.09000	18	182	200
6	"6-out6082"	.32579	72	149	221
6	"6-out6083"	.35467	72	131	203
6	"6-out6084"	.09417	21	202	223
6	"6-out6085"	.03720	8	207	215
6	"6-out6086"	.07142	34	442	476
6	"6-out6087"	.08212	17	190	207
6	"6-out6088"	.16735	122	607	729
6	"6-out6089"	.82352	42	9	51
6	"6-out6090"	.48009	205	222	427
6	"6-out6091"	.17176	146	704	850
6	"6-out6092"	.45563	380	454	834
6	"6-out6093"	.15879	37	196	233
6	"6-out6094"	.03485	13	360	373
6	"6-out6095"	.04123	8	186	194
6	"6-out6096"	.17507	125	589	714
6	"6-out6097"	.10407	23	198	221
6	"6-out6098"	.03797	9	228	237
6	"6-out6099"	.15668	34	183	217
6	"6-out6100"	.35211	75	138	213
6	"6-out6101"	.39130	99	154	253
6	"6-out6102"	.09693	79	736	815
6	"6-out6103"	.30812	110	247	357
6	"6-out6104"	.13235	63	413	476
6	"6-out6105"	.04100	18	421	439
6	"6-out6106"	.38320	251	404	655
6	"6-out6107"	.42365	394	536	930
6	"6-out6108"	.16431	35	178	213
6	"6-out6109"	.13268	41	268	309
6	"6-out6110"	.18426	171	757	928
6	"6-out6111"	.00985	2	201	203
6	"6-out6112"	.07421	19	237	256
6	"6-out6113"	.61290	57	36	93
6	"6-out6114"	.08408	28	305	333
6	"6-out6115"	.01388	3	213	216
6	"6-out6116"	.06635	14	197	211
6	"6-out6117"	.07731	15	179	194
6	"6-out6118"	.05022	11	208	219
6	"6-out6119"	.12621	26	180	206
6	"6-out6120"	.05769	12	196	208
6	"6-out6121"	.31889	81	173	254
6	"6-out6122"	.34251	87	167	254
6	"6-out6123"	.28855	58	143	201
6	"6-out6124"	.50251	100	99	199
6	"6-out6125"	.09666	55	514	569
6	"6-out6126"	.07291	14	178	192
6	"6-out6127"	.32171	203	428	631
6	"6-out6128"	.13737	68	427	495
6	"6-out6129"	.16920	222	1090	1312
6	"6-out6130"	.06559	49	698	747
6	"6-out6131"	.16431	70	356	426
6	"6-out6132"	.40446	163	240	403
6	"6-out6133"	.09150	28	278	306
6	"6-out6134"	.07502	143	1763	1906
6	"6-out6135"	.07231	41	526	567
6	"6-out6136"	.20388	42	164	206
6	"6-out6137"	.22282	41	143	184
6	"6-out6138"	.08185	23	258	281
6	"6-out6139"	.44333	356	447	803
6	"6-out6140"	.12462	126	885	1011
6	"6-out6141"	.10096	21	187	208
6	"6-out6142"	.12269	40	286	326
6	"6-out6143"	.06542	21	300	321
6	"6-out6144"	.11455	48	371	419
6	"6-out6145"	.11797	126	942	1068
6	"6-out6146"	.11130	125	998	1123
6	"6-out6147"	.03750	18	462	480
6	"6-out6148"	.02201	7	311	318
6	"6-out6149"	.17303	86	411	497
6	"6-out6150"	.55208	106	86	192
6	"6-out6151"	.10776	161	1333	1494
6	"6-out6152"	.10942	101	822	923
6	"6-out6153"	.09069	156	1564	1720
6	"6-out6154"	.08295	55	608	663
6	"6-out6155"	.06060	4	62	66
6	"6-out6156"	.52166	313	287	600
6	"6-out6157"	.13114	40	265	305
6	"6-out6158"	.12500	42	294	336
6	"6-out6159"	.09609	32	301	333
6	"6-out6160"	.13202	47	309	356
6	"6-out6161"	.06400	24	351	375
6	"6-out6162"	.13421	51	329	380
6	"6-out6163"	.29526	106	253	359
6	"6-out6164"	.12562	50	348	398
6	"6-out6165"	.07074	37	486	523
6	"6-out6166"	.09574	27	255	282
6	"6-out6167"	.08950	29	295	324
6	"6-out6168"	.14498	39	230	269
6	"6-out6169"	.08517	27	290	317
6	"6-out6170"	.04735	17	342	359
6	"6-out6171"	.16009	65	341	406
6	"6-out6172"	.16635	88	441	529
6	"6-out6173"	.15466	58	317	375
6	"6-out6174"	.11722	49	369	418
6	"6-out6175"	.06610	55	777	832
6	"6-out6176"	.29226	204	494	698
6	"6-out6177"	.32436	193	402	595
6	"6-out6178"	.51010	202	194	396
6	"6-out6179"	.34634	142	268	410
6	"6-out6180"	.09137	18	179	197
6	"6-out6181"	.39564	218	333	551
6	"6-out6182"	.20770	97	370	467
6	"6-out6183"	.12388	97	686	783
6	"6-out6184"	.44747	115	142	257
6	"6-out6185"	.06309	20	297	317
6	"6-out6186"	.26315	30	84	114
6	"6-out6187"	.11094	76	609	685
6	"6-out6188"	.11803	36	269	305
6	"6-out6189"	.38541	74	118	192
6	"6-out6190"	.07517	63	775	838
6	"6-out6191"	.08196	60	672	732
6	"6-out6192"	.04081	6	141	147
6	"6-out6193"	.16161	48	249	297
6	"6-out6194"	.07258	27	345	372
6	"6-out6195"	.05405	8	140	148
6	"6-out6196"	.57342	164	122	286
6	"6-out6197"	.09293	50	488	538
6	"6-out6198"	.10429	17	146	163
6	"6-out6199"	.08347	98	1076	1174
6	"6-out6200"	.53043	61	54	115
6	"6-out6201"	.17322	22	105	127
6	"6-out6202"	.16322	87	446	533
6	"6-out6203"	.13505	94	602	696
6	"6-out6204"	.21662	86	311	397
6	"6-out6205"	.06447	47	682	729
6	"6-out6206"	.44680	84	104	188
6	"6-out6207"	.16095	47	245	292
6	"6-out6208"	.13483	24	154	178
6	"6-out6209"	.04687	6	122	128
6	"6-out6210"	.01781	7	386	393
6	"6-out6211"	.07105	27	353	380
6	"6-out6212"	.16554	49	247	296
6	"6-out6213"	.30975	127	283	410
6	"6-out6214"	.07368	42	528	570
6	"6-out6215"	.08283	55	609	664
6	"6-out6216"	.09714	34	316	350
6	"6-out6217"	.23076	36	120	156
6	"6-out6218"	.14623	68	397	465
6	"6-out6219"	.05426	14	244	258
6	"6-out6220"	.35714	150	270	420
6	"6-out6221"	.27173	50	134	184
6	"6-out6222"	.08730	11	115	126
6	"6-out6223"	.11747	41	308	349
6	"6-out6224"	.12341	39	277	316
6	"6-out6225"	.41414	82	116	198
6	"6-out6226"	.08243	23	256	279
6	"6-out6227"	.12531	49	342	391
6	"6-out6228"	.14540	57	335	392
6	"6-out6229"	.07799	28	331	359
6	"6-out6230"	.16047	95	497	592
6	"6-out6231"	.04453	11	236	247
6	"6-out6232"	.66666	102	51	153
6	"6-out6233"	.07291	14	178	192
6	"6-out6234"	.40253	254	377	631
6	"6-out6235"	.48979	120	125	245
6	"6-out6236"	.22127	52	183	235
6	"6-out6237"	.14778	30	173	203
6	"6-out6238"	.19565	45	185	230
6	"6-out6239"	.07952	54	625	679
6	"6-out6240"	.11814	28	209	237
6	"6-out6241"	.11363	25	195	220
6	"6-out6242"	.14010	80	491	571
6	"6-out6243"	.63157	96	56	152
6	"6-out6244"	.56764	193	147	340
6	"6-out6245"	.16666	44	220	264
6	"6-out6246"	.37795	144	237	381
6	"6-out6247"	.00668	2	297	299
6	"6-out6248"	.43218	188	247	435
6	"6-out6249"	.10185	22	194	216
6	"6-out6250"	.31640	81	175	256
6	"6-out6251"	.06741	36	498	534
6	"6-out6252"	.06043	84	1306	1390
6	"6-out6253"	.09072	136	1363	1499
6	"6-out6254"	.09022	12	121	133
6	"6-out6255"	.07968	111	1282	1393
6	"6-out6256"	.10958	80	650	730
6	"6-out6257"	.48431	494	526	1020
6	"6-out6258"	.39655	138	210	348
6	"6-out6259"	.04065	5	118	123
6	"6-out6260"	.40849	125	181	306
6	"6-out6261"	.32038	33	70	103
6	"6-out6262"	.16406	21	107	128
6	"6-out6263"	.07951	26	301	327
6	"6-out6264"	.13592	28	178	206
6	"6-out6265"	.20487	42	163	205
6	"6-out6266"	.15048	31	175	206
6	"6-out6267"	.14627	55	321	376
6	"6-out6268"	.06685	47	656	703
6	"6-out6269"	.11864	84	624	708
6	"6-out6270"	.29508	90	215	305
6	"6-out6271"	.12210	58	417	475
6	"6-out6272"	.09632	97	910	1007
6	"6-out6273"	.10764	38	315	353
6	"6-out6274"	.39910	89	134	223
6	"6-out6275"	.23648	35	113	148
6	"6-out6276"	.08501	59	635	694
6	"6-out6277"	.17818	49	226	275
6	"6-out6278"	.06557	28	399	427
6	"6-out6279"	.60122	98	65	163
6	"6-out6280"	.12614	55	381	436
6	"6-out6281"	.04568	27	564	591
6	"6-out6282"	.10853	145	1191	1336
6	"6-out6283"	.31603	67	145	212
6	"6-out6284"	.13787	79	494	573
6	"6-out6285"	.06393	50	732	782
6	"6-out6286"	.10330	75	651	726
6	"6-out6287"	.09333	14	136	150
6	"6-out6288"	.26842	51	139	190
6	"6-out6289"	.10243	21	184	205
6	"6-out6290"	.08045	21	240	261
6	"6-out6291"	.31304	36	79	115
6	"6-out6292"	.11564	17	130	147
6	"6-out6293"	.19862	144	581	725
6	"6-out6294"	.41397	154	218	372
6	"6-out6295"	.40094	85	127	212
6	"6-out6296"	.48275	28	30	58
6	"6-out6297"	.54782	63	52	115
6	"6-out6298"	.24371	97	301	398
6	"6-out6299"	.66393	81	41	122
6	"6-out6300"	.58571	123	87	210
6	"6-out6301"	.19024	39	166	205
6	"6-out6302"	.20819	127	483	610
6	"6-out6303"	.09615	30	282	312
6	"6-out6304"	.09132	20	199	219
6	"6-out6305"	.07834	17	200	217
6	"6-out6306"	.51152	111	106	217
6	"6-out6307"	.54482	79	66	145
6	"6-out6308"	.55474	76	61	137
6	"6-out6309"	.52542	31	28	59
6	"6-out6310"	.59469	157	107	264
6	"6-out6311"	.48559	118	125	243
6	"6-out6312"	.53571	105	91	196
6	"6-out6313"	.08955	12	122	134
6	"6-out6314"	.10289	89	776	865
6	"6-out6315"	.07889	37	432	469
6	"6-out6316"	.48833	293	307	600
6	"6-out6317"	.32357	221	462	683
6	"6-out6318"	.04319	53	1174	1227
6	"6-out6319"	.36746	61	105	166
6	"6-out6320"	.08559	104	1111	1215
6	"6-out6321"	.09887	44	401	445
6	"6-out6322"	.30798	81	182	263
6	"6-out6323"	.48780	100	105	205
6	"6-out6324"	.12173	14	101	115
6	"6-out6325"	.07161	27	350	377
6	"6-out6326"	.04890	29	564	593
6	"6-out6327"	.10055	18	161	179
6	"6-out6328"	.07385	87	1091	1178
6	"6-out6329"	.20618	20	77	97
6	"6-out6330"	.54233	269	227	496
6	"6-out6331"	.11890	39	289	328
6	"6-out6332"	.14358	28	167	195
6	"6-out6333"	.07914	63	733	796
6	"6-out6334"	.03831	10	251	261
6	"6-out6335"	.09926	27	245	272
6	"6-out6336"	.07683	130	1562	1692
6	"6-out6337"	.04926	20	386	406
6	"6-out6338"	.32133	125	264	389
6	"6-out6339"	.41395	89	126	215
6	"6-out6340"	.36170	68	120	188
6	"6-out6341"	.36764	50	86	136
6	"6-out6342"	.06319	17	252	269
6	"6-out6343"	.43925	94	120	214
6	"6-out6344"	.42857	87	116	203
6	"6-out6345"	.71538	93	37	130
6	"6-out6346"	.45147	214	260	474
6	"6-out6347"	.44514	211	263	474
6	"6-out6348"	.42226	201	275	476
6	"6-out6349"	.44725	212	262	474
6	"6-out6350"	.13283	89	581	670
6	"6-out6351"	.33709	508	999	1507
6	"6-out6352"	.39819	88	133	221
6	"6-out6353"	.39819	88	133	221
6	"6-out6354"	.23798	99	317	416
6	"6-out6355"	.34627	107	202	309
6	"6-out6356"	.22435	315	1089	1404
6	"6-out6357"	.07990	64	737	801
6	"6-out6358"	.29464	66	158	224
6	"6-out6359"	.47802	87	95	182
6	"6-out6360"	.05419	51	890	941
6	"6-out6361"	.37681	52	86	138
6	"6-out6362"	.21076	141	528	669
6	"6-out6363"	.48744	233	245	478
6	"6-out6364"	.03554	15	407	422
6	"6-out6365"	.08874	93	955	1048
6	"6-out6366"	.15806	49	261	310
6	"6-out6367"	.57386	101	75	176
6	"6-out6368"	.39701	133	202	335
6	"6-out6369"	.44131	188	238	426
6	"6-out6370"	.13130	242	1601	1843
6	"6-out6371"	.30857	108	242	350
6	"6-out6372"	.16666	44	220	264
6	"6-out6373"	.06504	8	115	123
6	"6-out6374"	.20078	154	613	767
6	"6-out6375"	.18233	64	287	351
6	"6-out6376"	.09979	48	433	481
6	"6-out6377"	.09494	47	448	495
6	"6-out6378"	.09738	41	380	421
6	"6-out6379"	.07325	83	1050	1133
6	"6-out6380"	.05031	16	302	318
6	"6-out6381"	.43269	45	59	104
6	"6-out6382"	.08592	47	500	547
6	"6-out6383"	.42857	45	60	105
6	"6-out6384"	.08333	55	605	660
6	"6-out6385"	.07583	43	524	567
6	"6-out6386"	.47368	180	200	380
6	"6-out6387"	.11603	131	998	1129
6	"6-out6388"	.11235	50	395	445
6	"6-out6389"	.06273	17	254	271
6	"6-out6390"	.06008	28	438	466
6	"6-out6391"	.09505	73	695	768
6	"6-out6392"	.03076	12	378	390
6	"6-out6393"	.06435	50	727	777
6	"6-out6394"	.15311	32	177	209
6	"6-out6395"	.10723	83	691	774
6	"6-out6396"	.39682	150	228	378
6	"6-out6397"	.19387	95	395	490
6	"6-out6398"	.31221	202	445	647
6	"6-out6399"	.04761	42	840	882
6	"6-out6400"	.06870	18	244	262
6	"6-out6401"	.46587	819	939	1758
6	"6-out6402"	.10977	64	519	583
6	"6-out6403"	.22012	35	124	159
6	"6-out6404"	.07823	32	377	409
6	"6-out6405"	.20598	62	239	301
6	"6-out6406"	.33952	256	498	754
6	"6-out6407"	.18012	29	132	161
6	"6-out6408"	.09615	5	47	52
6	"6-out6409"	.07515	36	443	479
6	"6-out6410"	.06776	41	564	605
6	"6-out6411"	.08476	64	691	755
6	"6-out6412"	.06387	29	425	454
6	"6-out6413"	.12790	55	375	430
6	"6-out6414"	.15591	58	314	372
6	"6-out6415"	.14078	97	592	689
6	"6-out6416"	.31431	281	613	894
6	"6-out6417"	.50104	240	239	479
6	"6-out6418"	.08628	61	646	707
6	"6-out6419"	.41846	213	296	509
6	"6-out6420"	.11764	122	915	1037
6	"6-out6421"	.47907	229	249	478
6	"6-out6422"	.19191	38	160	198
6	"6-out6423"	.11145	179	1427	1606
6	"6-out6424"	.20634	39	150	189
6	"6-out6425"	.51283	2117	2011	4128
6	"6-out6426"	.20000	123	492	615
6	"6-out6427"	.04845	11	216	227
6	"6-out6428"	.26595	25	69	94
6	"6-out6429"	.09836	66	605	671
6	"6-out6430"	.11481	62	478	540
6	"6-out6431"	.06201	8	121	129
6	"6-out6432"	.14533	67	394	461
6	"6-out6433"	.08931	51	520	571
6	"6-out6434"	.08055	29	331	360
6	"6-out6435"	.09897	29	264	293
6	"6-out6436"	.41263	111	158	269
6	"6-out6437"	.41860	144	200	344
6	"6-out6438"	.39887	142	214	356
6	"6-out6439"	.38409	169	271	440
6	"6-out6440"	.07382	22	276	298
6	"6-out6441"	.09584	53	500	553
6	"6-out6442"	.09873	39	356	395
6	"6-out6443"	.32006	193	410	603
6	"6-out6444"	.12033	29	212	241
6	"6-out6445"	.08510	20	215	235
6	"6-out6446"	.09304	107	1043	1150
6	"6-out6447"	.07521	71	873	944
6	"6-out6448"	.09171	72	713	785
6	"6-out6449"	.14436	41	243	284
6	"6-out6450"	.21263	138	511	649
6	"6-out6451"	.27822	69	179	248
6	"6-out6452"	.06766	86	1185	1271
6	"6-out6453"	.09489	13	124	137
6	"6-out6454"	.07752	59	702	761
6	"6-out6455"	.13270	28	183	211
6	"6-out6456"	.11244	28	221	249
6	"6-out6457"	.09342	91	883	974
6	"6-out6458"	.10841	116	954	1070
6	"6-out6459"	.11877	62	460	522
6	"6-out6460"	.05251	49	884	933
6	"6-out6461"	.19186	33	139	172
6	"6-out6462"	.43298	84	110	194
6	"6-out6463"	.12765	150	1025	1175
6	"6-out6464"	.10079	51	455	506
6	"6-out6465"	.07446	28	348	376
6	"6-out6466"	.12682	26	179	205
6	"6-out6467"	.06880	30	406	436
6	"6-out6468"	.15665	60	323	383
6	"6-out6469"	.06239	38	571	609
6	"6-out6470"	.63157	612	357	969
6	"6-out6471"	.60221	489	323	812
6	"6-out6472"	.61274	894	565	1459
6	"6-out6473"	.05933	41	650	691
6	"6-out6474"	.05172	36	660	696
6	"6-out6475"	.17647	108	504	612
6	"6-out6476"	.05361	46	812	858
6	"6-out6477"	.04605	7	145	152
6	"6-out6478"	.06875	44	596	640
6	"6-out6479"	.42727	47	63	110
6	"6-out6480"	.16853	45	222	267
6	"6-out6481"	.21576	52	189	241
6	"6-out6482"	.51155	155	148	303
6	"6-out6483"	.04751	21	421	442
6	"6-out6484"	.44814	121	149	270
6	"6-out6485"	.09929	28	254	282
6	"6-out6486"	.47098	828	930	1758
6	"6-out6487"	.13840	40	249	289
6	"6-out6488"	.20317	294	1153	1447
6	"6-out6489"	.05651	23	384	407
6	"6-out6490"	.13043	75	500	575
6	"6-out6491"	.08588	28	298	326
6	"6-out6492"	.14553	93	546	639
6	"6-out6493"	.17307	18	86	104
6	"6-out6494"	.14878	43	246	289
6	"6-out6495"	.16205	41	212	253
6	"6-out6496"	.09677	33	308	341
6	"6-out6497"	.55468	71	57	128
6	"6-out6498"	.07553	42	514	556
6	"6-out6499"	.16053	48	251	299
6	"6-out6500"	.05900	58	925	983
6	"6-out6501"	.09939	181	1640	1821
6	"6-out6502"	.07196	29	374	403
6	"6-out6503"	.07476	56	693	749
6	"6-out6504"	.08859	122	1255	1377
6	"6-out6505"	.47272	208	232	440
6	"6-out6506"	.51178	152	145	297
6	"6-out6507"	.07436	76	946	1022
6	"6-out6508"	.05476	27	466	493
6	"6-out6509"	.27008	121	327	448
6	"6-out6510"	.02513	14	543	557
6	"6-out6511"	.30325	121	278	399
6	"6-out6512"	.28346	180	455	635
6	"6-out6513"	.50980	104	100	204
6	"6-out6514"	.05665	20	333	353
6	"6-out6515"	.10492	49	418	467
6	"6-out6516"	.25714	54	156	210
6	"6-out6517"	.57553	80	59	139
6	"6-out6518"	.06804	23	315	338
6	"6-out6519"	.09774	26	240	266
6	"6-out6520"	.51965	304	281	585
6	"6-out6521"	.39763	101	153	254
6	"6-out6522"	.08172	89	1000	1089
6	"6-out6523"	.09259	40	392	432
6	"6-out6524"	.10000	84	756	840
6	"6-out6525"	.31707	26	56	82
6	"6-out6526"	.06060	20	310	330
6	"6-out6527"	.18469	70	309	379
6	"6-out6528"	.11760	499	3744	4243
6	"6-out6529"	.40462	210	309	519
6	"6-out6530"	.48081	188	203	391
6	"6-out6531"	.08345	340	3734	4074
6	"6-out6532"	.36000	63	112	175
6	"6-out6533"	.13291	21	137	158
6	"6-out6534"	.04978	69	1317	1386
6	"6-out6535"	.16878	53	261	314
6	"6-out6536"	.20521	181	701	882
6	"6-out6537"	.08730	22	230	252
6	"6-out6538"	.04761	36	720	756
6	"6-out6539"	.13029	40	267	307
6	"6-out6540"	.05940	6	95	101
6	"6-out6541"	.05263	13	234	247
6	"6-out6542"	.14401	71	422	493
6	"6-out6543"	.04149	10	231	241
6	"6-out6544"	.04608	43	890	933
6	"6-out6545"	.07872	37	433	470
6	"6-out6546"	.28497	55	138	193
6	"6-out6547"	.04171	38	873	911
6	"6-out6548"	.08950	393	3998	4391
6	"6-out6549"	.07588	192	2338	2530
6	"6-out6550"	.13907	84	520	604
6	"6-out6551"	.16786	70	347	417
6	"6-out6552"	.08266	31	344	375
6	"6-out6553"	.09034	29	292	321
6	"6-out6554"	.10247	29	254	283
6	"6-out6555"	.08994	34	344	378
6	"6-out6556"	.13938	172	1062	1234
6	"6-out6557"	.12095	56	407	463
6	"6-out6558"	.24067	129	407	536
6	"6-out6559"	.07722	20	239	259
6	"6-out6560"	.42261	71	97	168
6	"6-out6561"	.45077	87	106	193
6	"6-out6562"	.16666	41	205	246
6	"6-out6563"	.05543	26	443	469
6	"6-out6564"	.09911	45	409	454
6	"6-out6565"	.08479	58	626	684
6	"6-out6566"	.07019	81	1073	1154
6	"6-out6567"	.09790	70	645	715
6	"6-out6568"	.02362	6	248	254
6	"6-out6569"	.05342	32	567	599
6	"6-out6570"	.12755	25	171	196
6	"6-out6571"	.13004	29	194	223
6	"6-out6572"	.30000	39	91	130
6	"6-out6573"	.08550	141	1508	1649
6	"6-out6574"	.07611	58	704	762
6	"6-out6575"	.28834	47	116	163
6	"6-out6576"	.05726	13	214	227
6	"6-out6577"	.18112	71	321	392
6	"6-out6578"	.13127	374	2475	2849
6	"6-out6579"	.09405	38	366	404
6	"6-out6580"	.09331	74	719	793
6	"6-out6581"	.11819	76	567	643
6	"6-out6582"	.10266	81	708	789
6	"6-out6583"	.07979	47	542	589
6	"6-out6584"	.09317	71	691	762
6	"6-out6585"	.10608	129	1087	1216
6	"6-out6586"	.14812	201	1156	1357
6	"6-out6587"	.42805	119	159	278
6	"6-out6588"	.07000	35	465	500
6	"6-out6589"	.46739	43	49	92
6	"6-out6590"	.04000	12	288	300
6	"6-out6591"	.11970	48	353	401
6	"6-out6592"	.01574	2	125	127
6	"6-out6593"	.14520	53	312	365
6	"6-out6594"	.44888	101	124	225
6	"6-out6595"	.05769	6	98	104
6	"6-out6596"	.09554	30	284	314
6	"6-out6597"	.08247	24	267	291
6	"6-out6598"	.55600	963	769	1732
6	"6-out6599"	.09243	138	1355	1493
6	"6-out6600"	.10927	33	269	302
6	"6-out6601"	.16107	24	125	149
6	"6-out6602"	.22072	49	173	222
6	"6-out6603"	.09565	119	1125	1244
6	"6-out6604"	.09710	131	1218	1349
6	"6-out6605"	.07653	106	1279	1385
6	"6-out6606"	.10559	85	720	805
6	"6-out6607"	.20192	126	498	624
6	"6-out6608"	.08117	72	815	887
6	"6-out6609"	.09345	30	291	321
6	"6-out6610"	.05967	33	520	553
6	"6-out6611"	.14638	89	519	608
6	"6-out6612"	.10126	120	1065	1185
6	"6-out6613"	.13387	66	427	493
6	"6-out6614"	.29259	237	573	810
6	"6-out6615"	.06324	80	1185	1265
6	"6-out6616"	.10805	153	1263	1416
6	"6-out6617"	.36932	691	1180	1871
6	"6-out6618"	.32871	190	388	578
6	"6-out6619"	.25888	102	292	394
6	"6-out6620"	.15105	50	281	331
6	"6-out6621"	.13600	17	108	125
6	"6-out6622"	.08039	98	1121	1219
6	"6-out6623"	.09620	76	714	790
6	"6-out6624"	.11529	49	376	425
6	"6-out6625"	.14784	165	951	1116
6	"6-out6626"	.09939	33	299	332
6	"6-out6627"	.44318	468	588	1056
6	"6-out6628"	.26285	46	129	175
6	"6-out6629"	.10569	91	770	861
6	"6-out6630"	.16017	74	388	462
6	"6-out6631"	.15038	157	887	1044
6	"6-out6632"	.08192	58	650	708
6	"6-out6633"	.35254	1517	2786	4303
6	"6-out6634"	.30810	57	128	185
6	"6-out6635"	.09154	13	129	142
6	"6-out6636"	.18077	79	358	437
6	"6-out6637"	.06682	29	405	434
6	"6-out6638"	.09010	203	2050	2253
6	"6-out6639"	.11632	57	433	490
6	"6-out6640"	.18956	69	295	364
6	"6-out6641"	.07364	95	1195	1290
6	"6-out6642"	.09509	161	1532	1693
6	"6-out6643"	.08036	88	1007	1095
6	"6-out6644"	.09760	110	1017	1127
6	"6-out6645"	.51702	167	156	323
6	"6-out6646"	.04590	14	291	305
6	"6-out6647"	.05639	41	686	727
6	"6-out6648"	.16282	120	617	737
6	"6-out6649"	.06233	46	692	738
6	"6-out6650"	.08069	153	1743	1896
6	"6-out6651"	.48666	73	77	150
6	"6-out6652"	.11629	222	1687	1909
6	"6-out6653"	.09948	156	1412	1568
6	"6-out6654"	.50400	881	867	1748
6	"6-out6655"	.31040	167	371	538
6	"6-out6656"	.49405	872	893	1765
6	"6-out6657"	.15028	26	147	173
6	"6-out6658"	.39473	45	69	114
6	"6-out6659"	.05476	23	397	420
6	"6-out6660"	.07022	54	715	769
6	"6-out6661"	.38853	617	971	1588
6	"6-out6662"	.05752	65	1065	1130
6	"6-out6663"	.08040	16	183	199
6	"6-out6664"	.09956	23	208	231
6	"6-out6665"	.05611	83	1396	1479
6	"6-out6666"	.09960	125	1130	1255
6	"6-out6667"	.05617	40	672	712
6	"6-out6668"	.33544	265	525	790
6	"6-out6669"	.15819	84	447	531
6	"6-out6670"	.08527	11	118	129
6	"6-out6671"	.08196	25	280	305
6	"6-out6672"	.07525	59	725	784
6	"6-out6673"	.11734	23	173	196
6	"6-out6674"	.12958	53	356	409
6	"6-out6675"	.07136	85	1106	1191
6	"6-out6676"	.11676	124	938	1062
6	"6-out6677"	.16494	48	243	291
6	"6-out6678"	.06598	90	1274	1364
6	"6-out6679"	.45000	135	165	300
6	"6-out6680"	.22593	176	603	779
6	"6-out6681"	.08117	91	1030	1121
6	"6-out6682"	.14482	42	248	290
6	"6-out6683"	.08557	35	374	409
6	"6-out6684"	.04081	20	470	490
6	"6-out6685"	.14007	302	1854	2156
6	"6-out6686"	.11834	40	298	338
6	"6-out6687"	.07799	84	993	1077
6	"6-out6688"	.14349	32	191	223
6	"6-out6689"	.06632	13	183	196
6	"6-out6690"	.12839	123	835	958
6	"6-out6691"	.11084	47	377	424
6	"6-out6692"	.06433	125	1818	1943
6	"6-out6693"	.08098	66	749	815
6	"6-out6694"	.16413	119	606	725
6	"6-out6695"	.40000	206	309	515
6	"6-out6696"	.43617	123	159	282
6	"6-out6697"	.15072	52	293	345
6	"6-out6698"	.21481	58	212	270
6	"6-out6699"	.20426	182	709	891
6	"6-out6700"	.04166	29	667	696
6	"6-out6701"	.03905	33	812	845
6	"6-out6702"	.12487	122	855	977
6	"6-out6703"	.10991	92	745	837
6	"6-out6704"	.04175	40	918	958
6	"6-out6705"	.11055	88	708	796
6	"6-out6706"	.08995	137	1386	1523
6	"6-out6707"	.12330	82	583	665
6	"6-out6708"	.14901	76	434	510
6	"6-out6709"	.05000	24	456	480
6	"6-out6710"	.09349	46	446	492
6	"6-out6711"	.09652	25	234	259
6	"6-out6712"	.16040	47	246	293
6	"6-out6713"	.09976	43	388	431
6	"6-out6714"	.15204	52	290	342
6	"6-out6715"	.15830	41	218	259
6	"6-out6716"	.08000	38	437	475
6	"6-out6717"	.10792	98	810	908
6	"6-out6718"	.08908	111	1135	1246
6	"6-out6719"	.53797	85	73	158
6	"6-out6720"	.13989	135	830	965
6	"6-out6721"	.44785	73	90	163
6	"6-out6722"	.12829	107	727	834
6	"6-out6723"	.10150	81	717	798
6	"6-out6724"	.13253	77	504	581
6	"6-out6725"	.22684	267	910	1177
6	"6-out6726"	.08656	29	306	335
6	"6-out6727"	.11445	38	294	332
6	"6-out6728"	.33333	44	88	132
6	"6-out6729"	.08802	50	518	568
6	"6-out6730"	.11531	67	514	581
6	"6-out6731"	.16143	36	187	223
6	"6-out6732"	.16896	98	482	580
6	"6-out6733"	.13372	23	149	172
6	"6-out6734"	.26143	160	452	612
6	"6-out6735"	.49122	112	116	228
6	"6-out6736"	.04437	28	603	631
6	"6-out6737"	.09913	69	627	696
6	"6-out6738"	.43571	122	158	280
6	"6-out6739"	.47878	79	86	165
6	"6-out6740"	.07723	19	227	246
6	"6-out6741"	.20055	72	287	359
6	"6-out6742"	.09236	23	226	249
6	"6-out6743"	.60695	227	147	374
6	"6-out6744"	.22185	67	235	302
6	"6-out6745"	.06117	23	353	376
6	"6-out6746"	.10157	84	743	827
6	"6-out6747"	.21377	149	548	697
6	"6-out6748"	.15243	50	278	328
6	"6-out6749"	.37629	181	300	481
6	"6-out6750"	.12388	97	686	783
6	"6-out6751"	.07127	66	860	926
6	"6-out6752"	.32051	25	53	78
6	"6-out6753"	.11956	11	81	92
6	"6-out6754"	.16483	15	76	91
6	"6-out6755"	.07441	57	709	766
6	"6-out6756"	.29230	38	92	130
6	"6-out6757"	.43157	41	54	95
6	"6-out6758"	.65454	36	19	55
6	"6-out6759"	.09295	62	605	667
6	"6-out6760"	.22033	13	46	59
6	"6-out6761"	.69014	49	22	71
6	"6-out6762"	.38834	40	63	103
6	"6-out6763"	.46212	61	71	132
6	"6-out6764"	.49411	42	43	85
6	"6-out6765"	.33333	31	62	93
6	"6-out6766"	.11877	62	460	522
6	"6-out6767"	.06015	24	375	399
6	"6-out6768"	.07500	30	370	400
6	"6-out6769"	.36764	75	129	204
6	"6-out6770"	.25229	55	163	218
6	"6-out6771"	.37786	99	163	262
6	"6-out6772"	.07632	99	1198	1297
6	"6-out6773"	.37185	148	250	398
6	"6-out6774"	.51136	90	86	176
6	"6-out6775"	.07696	144	1727	1871
6	"6-out6776"	.37864	39	64	103
6	"6-out6777"	.13377	61	395	456
6	"6-out6778"	.11395	89	692	781
6	"6-out6779"	.14117	36	219	255
6	"6-out6780"	.38016	46	75	121
6	"6-out6781"	.15776	65	347	412
6	"6-out6782"	.10584	38	321	359
6	"6-out6783"	.07911	25	291	316
6	"6-out6784"	.09661	80	748	828
6	"6-out6785"	.20309	92	361	453
6	"6-out6786"	.26853	134	365	499
6	"6-out6787"	.23326	108	355	463
6	"6-out6788"	.07948	105	1216	1321
6	"6-out6789"	.14009	29	178	207
6	"6-out6790"	.08676	40	421	461
6	"6-out6791"	.17567	13	61	74
6	"6-out6792"	.19642	11	45	56
6	"6-out6793"	.09904	31	282	313
6	"6-out6794"	.10962	41	333	374
6	"6-out6795"	.10526	134	1139	1273
6	"6-out6796"	.07745	90	1072	1162
6	"6-out6797"	.03503	11	303	314
6	"6-out6798"	.19032	59	251	310
6	"6-out6799"	.10985	39	316	355
6	"6-out6800"	.14539	41	241	282
6	"6-out6801"	.45775	298	353	651
6	"6-out6802"	.12690	25	172	197
6	"6-out6803"	.45736	177	210	387
6	"6-out6804"	.15068	55	310	365
6	"6-out6805"	.06855	109	1481	1590
6	"6-out6806"	.09245	38	373	411
6	"6-out6807"	.13546	199	1270	1469
6	"6-out6808"	.07085	35	459	494
6	"6-out6809"	.12878	17	115	132
6	"6-out6810"	.36774	57	98	155
6	"6-out6811"	.19603	99	406	505
6	"6-out6812"	.07291	123	1564	1687
6	"6-out6813"	.09007	127	1283	1410
6	"6-out6814"	.14890	116	663	779
6	"6-out6815"	.10386	86	742	828
6	"6-out6816"	.35785	321	576	897
6	"6-out6817"	.10565	43	364	407
6	"6-out6818"	.01515	2	130	132
6	"6-out6819"	.09574	99	935	1034
6	"6-out6820"	.14505	85	501	586
6	"6-out6821"	.04128	68	1579	1647
6	"6-out6822"	.07446	21	261	282
6	"6-out6823"	.08148	44	496	540
6	"6-out6824"	.36904	31	53	84
6	"6-out6825"	.14572	29	170	199
6	"6-out6826"	.08262	29	322	351
6	"6-out6827"	.07456	17	211	228
6	"6-out6828"	.08695	20	210	230
6	"6-out6829"	.08384	95	1038	1133
6	"6-out6830"	.11166	268	2132	2400
6	"6-out6831"	.06255	71	1064	1135
6	"6-out6832"	.18137	37	167	204
6	"6-out6833"	.03757	13	333	346
6	"6-out6834"	.29577	42	100	142
6	"6-out6835"	.04451	45	966	1011
6	"6-out6836"	.14803	237	1364	1601
6	"6-out6837"	.08164	105	1181	1286
6	"6-out6838"	.15238	48	267	315
6	"6-out6839"	.11293	62	487	549
6	"6-out6840"	.12500	53	371	424
6	"6-out6841"	.14024	69	423	492
6	"6-out6842"	.41708	166	232	398
6	"6-out6843"	.04989	23	438	461
6	"6-out6844"	.47634	151	166	317
6	"6-out6845"	.19211	78	328	406
6	"6-out6846"	.10225	59	518	577
6	"6-out6847"	.12780	74	505	579
6	"6-out6848"	.10505	52	443	495
6	"6-out6849"	.03428	6	169	175
6	"6-out6850"	.08132	27	305	332
6	"6-out6851"	.01785	2	110	112
6	"6-out6852"	.13043	18	120	138
6	"6-out6853"	.44720	72	89	161
6	"6-out6854"	.08523	56	601	657
6	"6-out6855"	.13541	104	664	768
6	"6-out6856"	.15327	82	453	535
6	"6-out6857"	.10115	35	311	346
6	"6-out6858"	.04593	26	540	566
6	"6-out6859"	.31914	105	224	329
6	"6-out6860"	.30608	191	433	624
6	"6-out6861"	.39029	185	289	474
6	"6-out6862"	.05446	25	434	459
6	"6-out6863"	.05504	12	206	218
6	"6-out6864"	.08666	13	137	150
6	"6-out6865"	.50438	115	113	228
6	"6-out6866"	.28959	64	157	221
6	"6-out6867"	.03102	13	406	419
6	"6-out6868"	.05362	17	300	317
6	"6-out6869"	.11138	92	734	826
6	"6-out6870"	.22670	73	249	322
6	"6-out6871"	.07184	99	1279	1378
6	"6-out6872"	.12319	171	1217	1388
6	"6-out6873"	.05500	77	1323	1400
6	"6-out6874"	.36792	78	134	212
6	"6-out6875"	.52991	62	55	117
6	"6-out6876"	.05970	4	63	67
6	"6-out6877"	.18421	77	341	418
6	"6-out6878"	.07615	130	1577	1707
6	"6-out6879"	.08646	170	1796	1966
6	"6-out6880"	.40731	501	729	1230
6	"6-out6881"	.08056	46	525	571
6	"6-out6882"	.03906	10	246	256
6	"6-out6883"	.19480	30	124	154
6	"6-out6884"	.17995	937	4270	5207
6	"6-out6885"	.38333	69	111	180
6	"6-out6886"	.18910	59	253	312
6	"6-out6887"	.08815	32	331	363
6	"6-out6888"	.03484	10	277	287
6	"6-out6889"	.21385	71	261	332
6	"6-out6890"	.14624	37	216	253
6	"6-out6891"	.18551	105	461	566
6	"6-out6892"	.04545	8	168	176
6	"6-out6893"	.11695	40	302	342
6	"6-out6894"	.14640	59	344	403
6	"6-out6895"	.06354	53	781	834
6	"6-out6896"	.05660	18	300	318
6	"6-out6897"	.12437	25	176	201
6	"6-out6898"	.45747	199	236	435
6	"6-out6899"	.28871	151	372	523
6	"6-out6900"	.11682	25	189	214
6	"6-out6901"	.42904	130	173	303
6	"6-out6902"	.11920	18	133	151
6	"6-out6903"	.20437	28	109	137
6	"6-out6904"	.07608	28	340	368
6	"6-out6905"	.12628	49	339	388
6	"6-out6906"	.38571	54	86	140
6	"6-out6907"	.17241	20	96	116
6	"6-out6908"	.05426	7	122	129
6	"6-out6909"	.14320	59	353	412
6	"6-out6910"	.07571	29	354	383
6	"6-out6911"	.09893	28	255	283
6	"6-out6912"	.25056	110	329	439
6	"6-out6913"	.11954	52	383	435
6	"6-out6914"	.30833	148	332	480
6	"6-out6915"	.56862	116	88	204
6	"6-out6916"	.13763	64	401	465
6	"6-out6917"	.05212	27	491	518
6	"6-out6918"	.03448	18	504	522
6	"6-out6919"	.05780	20	326	346
6	"6-out6920"	.23248	209	690	899
6	"6-out6921"	.17307	45	215	260
6	"6-out6922"	.07346	18	227	245
6	"6-out6923"	.19661	58	237	295
6	"6-out6924"	.10900	46	376	422
6	"6-out6925"	.14676	59	343	402
6	"6-out6926"	.34961	136	253	389
6	"6-out6927"	.11721	32	241	273
6	"6-out6928"	.32300	73	153	226
6	"6-out6929"	.30701	35	79	114
6	"6-out6930"	.12026	127	929	1056
6	"6-out6931"	.06250	64	960	1024
6	"6-out6932"	.06095	47	724	771
6	"6-out6933"	.32972	61	124	185
6	"6-out6934"	.09810	83	763	846
6	"6-out6935"	.17175	45	217	262
6	"6-out6936"	.11127	75	599	674
6	"6-out6937"	.09042	17	171	188
6	"6-out6938"	.08757	43	448	491
6	"6-out6939"	.48148	26	28	54
6	"6-out6940"	.48780	240	252	492
6	"6-out6941"	.08605	121	1285	1406
6	"6-out6942"	.05338	78	1383	1461
6	"6-out6943"	.05172	66	1210	1276
6	"6-out6944"	.38709	120	190	310
6	"6-out6945"	.06444	139	2018	2157
6	"6-out6946"	.07030	58	767	825
6	"6-out6947"	.06591	41	581	622
6	"6-out6948"	.19565	108	444	552
6	"6-out6949"	.42901	275	366	641
6	"6-out6950"	.09966	59	533	592
6	"6-out6951"	.06750	27	373	400
6	"6-out6952"	.15019	38	215	253
6	"6-out6953"	.15068	33	186	219
6	"6-out6954"	.51466	193	182	375
6	"6-out6955"	.13719	45	283	328
6	"6-out6956"	.40229	35	52	87
6	"6-out6957"	.40575	127	186	313
6	"6-out6958"	.25404	110	323	433
6	"6-out6959"	.29642	83	197	280
6	"6-out6960"	.10411	43	370	413
6	"6-out6961"	.07668	25	301	326
6	"6-out6962"	.11576	47	359	406
6	"6-out6963"	.14285	49	294	343
6	"6-out6964"	.17328	48	229	277
6	"6-out6965"	.10912	55	449	504
6	"6-out6966"	.28414	258	650	908
6	"6-out6967"	.40585	97	142	239
6	"6-out6968"	.10545	58	492	550
6	"6-out6969"	.23423	26	85	111
6	"6-out6970"	.06862	7	95	102
6	"6-out6971"	.14379	22	131	153
6	"6-out6972"	.08533	71	761	832
6	"6-out6973"	.11693	29	219	248
6	"6-out6974"	.46745	316	360	676
6	"6-out6975"	.17968	23	105	128
6	"6-out6976"	.20430	275	1071	1346
6	"6-out6977"	.28506	63	158	221
6	"6-out6978"	.11415	25	194	219
6	"6-out6979"	.09150	28	278	306
6	"6-out6980"	.53181	117	103	220
6	"6-out6981"	.05397	19	333	352
6	"6-out6982"	.24218	62	194	256
6	"6-out6983"	.03409	9	255	264
6	"6-out6984"	.07031	18	238	256
6	"6-out6985"	.40811	171	248	419
6	"6-out6986"	.09137	18	179	197
6	"6-out6987"	.10236	26	228	254
6	"6-out6988"	.10543	33	280	313
6	"6-out6989"	.46570	129	148	277
6	"6-out6990"	.27380	92	244	336
6	"6-out6991"	.06941	32	429	461
6	"6-out6992"	.18571	104	456	560
6	"6-out6993"	.13294	69	450	519
6	"6-out6994"	.52142	73	67	140
6	"6-out6995"	.06012	30	469	499
6	"6-out6996"	.07058	24	316	340
6	"6-out6997"	.36477	116	202	318
6	"6-out6998"	.30576	281	638	919
6	"6-out6999"	.01369	3	216	219
6	"6-out7000"	.32675	149	307	456
6	"6-out7001"	.06241	46	691	737
6	"6-out7002"	.16489	31	157	188
6	"6-out7003"	.18248	50	224	274
6	"6-out7004"	.50675	75	73	148
6	"6-out7005"	.09230	54	531	585
6	"6-out7006"	.08300	21	232	253
6	"6-out7007"	.06937	29	389	418
6	"6-out7008"	.38066	126	205	331
6	"6-out7009"	.07053	17	224	241
6	"6-out7010"	.60326	111	73	184
6	"6-out7011"	.51329	193	183	376
6	"6-out7012"	.10185	22	194	216
6	"6-out7013"	.38028	162	264	426
6	"6-out7014"	.37345	121	203	324
6	"6-out7015"	.13492	85	545	630
6	"6-out7016"	.44979	215	263	478
6	"6-out7017"	.14211	136	821	957
6	"6-out7018"	.44725	212	262	474
6	"6-out7019"	.45530	163	195	358
6	"6-out7020"	.46118	101	118	219
6	"6-out7021"	.08838	70	722	792
6	"6-out7022"	.09566	117	1106	1223
6	"6-out7023"	.52873	92	82	174
6	"6-out7024"	.11949	38	280	318
6	"6-out7025"	.07586	22	268	290
6	"6-out7026"	.12333	37	263	300
6	"6-out7027"	.04602	11	228	239
6	"6-out7028"	.09057	25	251	276
6	"6-out7029"	.10756	64	531	595
6	"6-out7030"	.36538	114	198	312
6	"6-out7031"	.43892	212	271	483
6	"6-out7032"	.49060	235	244	479
6	"6-out7033"	.44303	210	264	474
6	"6-out7034"	.42647	203	273	476
6	"6-out7035"	.08638	33	349	382
6	"6-out7036"	.43723	209	269	478
6	"6-out7037"	.47682	72	79	151
6	"6-out7038"	.39819	88	133	221
6	"6-out7039"	.39819	88	133	221
6	"6-out7040"	.45263	215	260	475
6	"6-out7041"	.21621	48	174	222
6	"6-out7042"	.10768	185	1533	1718
6	"6-out7043"	.07380	20	251	271
6	"6-out7044"	.14485	31	183	214
6	"6-out7045"	.06549	67	956	1023
6	"6-out7046"	.07073	66	867	933
6	"6-out7047"	.13118	61	404	465
6	"6-out7048"	.14084	80	488	568
6	"6-out7049"	.13953	18	111	129
6	"6-out7050"	.08056	17	194	211
6	"6-out7051"	.04016	38	908	946
6	"6-out7052"	.12953	75	504	579
6	"6-out7053"	.11111	21	168	189
6	"6-out7054"	.30798	81	182	263
6	"6-out7055"	.26048	118	335	453
6	"6-out7056"	.08128	251	2837	3088
6	"6-out7057"	.14545	16	94	110
6	"6-out7058"	.11864	28	208	236
6	"6-out7059"	.17598	85	398	483
6	"6-out7060"	.09210	21	207	228
6	"6-out7061"	.33268	172	345	517
6	"6-out7062"	.07363	69	868	937
6	"6-out7063"	.04559	43	900	943
6	"6-out7064"	.07265	38	485	523
6	"6-out7065"	.05957	28	442	470
6	"6-out7066"	.06756	35	483	518
6	"6-out7067"	.39440	127	195	322
6	"6-out7068"	.04838	30	590	620
6	"6-out7069"	.31457	123	268	391
6	"6-out7070"	.09289	17	166	183
6	"6-out7071"	.51428	54	51	105
6	"6-out7072"	.42857	45	60	105
6	"6-out7073"	.07826	76	895	971
6	"6-out7074"	.08502	63	678	741
6	"6-out7075"	.08254	61	678	739
6	"6-out7076"	.33931	189	368	557
6	"6-out7077"	.08457	17	184	201
6	"6-out7078"	.00793	2	250	252
6	"6-out7079"	.09019	23	232	255
6	"6-out7080"	.09727	25	232	257
6	"6-out7081"	.06878	13	176	189
6	"6-out7082"	.42180	89	122	211
6	"6-out7083"	.54216	90	76	166
6	"6-out7084"	.46385	77	89	166
6	"6-out7085"	.10551	132	1119	1251
6	"6-out7086"	.15047	471	2659	3130
6	"6-out7087"	.50522	145	142	287
6	"6-out7088"	.25605	148	430	578
6	"6-out7089"	.03581	13	350	363
6	"6-out7090"	.10515	49	417	466
6	"6-out7091"	.46687	148	169	317
6	"6-out7092"	.05924	58	921	979
6	"6-out7093"	.44479	141	176	317
6	"6-out7094"	.09954	65	588	653
6	"6-out7095"	.09757	133	1230	1363
6	"6-out7096"	.39719	85	129	214
6	"6-out7097"	.18644	77	336	413
6	"6-out7098"	.18173	191	860	1051
6	"6-out7099"	.20879	76	288	364
6	"6-out7100"	.14981	163	925	1088
6	"6-out7101"	.08974	14	142	156
6	"6-out7102"	.45019	235	287	522
6	"6-out7103"	.04149	10	231	241
6	"6-out7104"	.22738	93	316	409
6	"6-out7105"	.07808	93	1098	1191
6	"6-out7106"	.12933	41	276	317
6	"6-out7107"	.52380	55	50	105
6	"6-out7108"	.16915	34	167	201
6	"6-out7109"	.08583	297	3163	3460
6	"6-out7110"	.05194	32	584	616
6	"6-out7111"	.50318	79	78	157
6	"6-out7112"	.11773	75	562	637
6	"6-out7113"	.15277	33	183	216
6	"6-out7114"	.09015	108	1090	1198
6	"6-out7115"	.07276	35	446	481
6	"6-out7116"	.11759	276	2071	2347
6	"6-out7117"	.10187	125	1102	1227
6	"6-out7118"	.26702	98	269	367
6	"6-out7119"	.10041	24	215	239
6	"6-out7120"	.50813	125	121	246
6	"6-out7121"	.09308	35	341	376
6	"6-out7122"	.12316	42	299	341
6	"6-out7123"	.12707	199	1367	1566
6	"6-out7124"	.11299	40	314	354
6	"6-out7125"	.13686	173	1091	1264
6	"6-out7126"	.49128	141	146	287
6	"6-out7127"	.15097	85	478	563
6	"6-out7128"	.09260	99	970	1069
6	"6-out7129"	.11414	159	1234	1393
6	"6-out7130"	.09493	15	143	158
6	"6-out7131"	.15670	76	409	485
6	"6-out7132"	.14500	77	454	531
6	"6-out7133"	.06611	24	339	363
6	"6-out7134"	.14500	29	171	200
6	"6-out7135"	.37190	45	76	121
6	"6-out7136"	.07058	24	316	340
6	"6-out7137"	.11925	153	1130	1283
6	"6-out7138"	.07804	59	697	756
6	"6-out7139"	.11742	93	699	792
6	"6-out7140"	.15555	21	114	135
6	"6-out7141"	.22000	77	273	350
6	"6-out7142"	.27611	37	97	134
6	"6-out7143"	.07207	8	103	111
6	"6-out7144"	.07809	87	1027	1114
6	"6-out7145"	.09823	39	358	397
6	"6-out7146"	.14895	171	977	1148
6	"6-out7147"	.11132	57	455	512
6	"6-out7148"	.09251	68	667	735
6	"6-out7149"	.04444	20	430	450
6	"6-out7150"	.07276	31	395	426
6	"6-out7151"	.22054	73	258	331
6	"6-out7152"	.18426	260	1151	1411
6	"6-out7153"	.12987	40	268	308
6	"6-out7154"	.04460	12	257	269
6	"6-out7155"	.13026	102	681	783
6	"6-out7156"	.07486	67	828	895
6	"6-out7157"	.08730	86	899	985
6	"6-out7158"	.21367	75	276	351
6	"6-out7159"	.09955	45	407	452
6	"6-out7160"	.50000	89	89	178
6	"6-out7161"	.48815	103	108	211
6	"6-out7162"	.17399	91	432	523
6	"6-out7163"	.43202	143	188	331
6	"6-out7164"	.45774	130	154	284
6	"6-out7165"	.34152	417	804	1221
6	"6-out7166"	.07635	31	375	406
6	"6-out7167"	.29620	125	297	422
6	"6-out7168"	.06201	48	726	774
6	"6-out7169"	.18771	110	476	586
6	"6-out7170"	.06538	17	243	260
6	"6-out7171"	.05703	15	248	263
6	"6-out7172"	.07607	55	668	723
6	"6-out7173"	.31962	202	430	632
6	"6-out7174"	.08766	54	562	616
6	"6-out7175"	.08466	37	400	437
6	"6-out7176"	.09913	92	836	928
6	"6-out7177"	.13170	27	178	205
6	"6-out7178"	.19889	36	145	181
6	"6-out7179"	.05932	28	444	472
6	"6-out7180"	.12525	62	433	495
6	"6-out7181"	.06666	12	168	180
6	"6-out7182"	.05839	8	129	137
6	"6-out7183"	.07309	25	317	342
6	"6-out7184"	.14051	60	367	427
6	"6-out7185"	.09950	20	181	201
6	"6-out7186"	.53422	281	245	526
6	"6-out7187"	.40000	108	162	270
6	"6-out7188"	.15168	54	302	356
6	"6-out7189"	.05285	25	448	473
6	"6-out7190"	.08539	31	332	363
6	"6-out7191"	.13144	51	337	388
6	"6-out7192"	.18421	28	124	152
6	"6-out7193"	.13270	28	183	211
6	"6-out7194"	.06008	45	704	749
6	"6-out7195"	.09057	49	492	541
6	"6-out7196"	.41121	44	63	107
6	"6-out7197"	.15328	21	116	137
6	"6-out7198"	.36448	78	136	214
6	"6-out7199"	.42494	201	272	473
6	"6-out7200"	.50877	116	112	228
6	"6-out7201"	.51315	117	111	228
6	"6-out7202"	.06726	45	624	669
6	"6-out7203"	.14210	27	163	190
6	"6-out7204"	.05729	55	905	960
6	"6-out7205"	.27298	98	261	359
6	"6-out7206"	.14116	119	724	843
6	"6-out7207"	.09831	99	908	1007
6	"6-out7208"	.21698	115	415	530
6	"6-out7209"	.12182	24	173	197
6	"6-out7210"	.32743	37	76	113
6	"6-out7211"	.53830	267	229	496
6	"6-out7212"	.06109	19	292	311
6	"6-out7213"	.53629	266	230	496
6	"6-out7214"	.53225	264	232	496
6	"6-out7215"	.01898	6	310	316
6	"6-out7216"	.42857	45	60	105
6	"6-out7217"	.26956	31	84	115
6	"6-out7218"	.12871	39	264	303
6	"6-out7219"	.10714	21	175	196
6	"6-out7220"	.08208	11	123	134
6	"6-out7221"	.07944	46	533	579
6	"6-out7222"	.11019	134	1082	1216
6	"6-out7223"	.08053	24	274	298
6	"6-out7224"	.16037	204	1068	1272
6	"6-out7225"	.09944	54	489	543
6	"6-out7226"	.32758	57	117	174
6	"6-out7227"	.28078	114	292	406
6	"6-out7228"	.06576	39	554	593
6	"6-out7229"	.06779	16	220	236
6	"6-out7230"	.09447	77	738	815
6	"6-out7231"	.44791	129	159	288
6	"6-out7232"	.10671	81	678	759
6	"6-out7233"	.12393	145	1025	1170
6	"6-out7234"	.18861	53	228	281
6	"6-out7235"	.09334	87	845	932
6	"6-out7236"	.10991	41	332	373
6	"6-out7237"	.18518	20	88	108
6	"6-out7238"	.53830	267	229	496
6	"6-out7239"	.17522	58	273	331
6	"6-out7240"	.19051	209	888	1097
6	"6-out7241"	.39705	189	287	476
6	"6-out7242"	.06030	12	187	199
6	"6-out7244"	.11177	56	445	501
6	"6-out7245"	.09014	64	646	710
6	"6-out7246"	.46060	76	89	165
6	"6-out7247"	.46056	146	171	317
6	"6-out7248"	.08333	38	418	456
6	"6-out7249"	.27083	52	140	192
6	"6-out7250"	.29530	44	105	149
6	"6-out7251"	.45222	71	86	157
6	"6-out7252"	.62500	155	93	248
6	"6-out7253"	.56756	84	64	148
6	"6-out7254"	.56603	90	69	159
6	"6-out7255"	.09846	32	293	325
6	"6-out7256"	.19016	58	247	305
6	"6-out7257"	.09737	26	241	267
6	"6-out7258"	.04137	6	139	145
6	"6-out7259"	.10059	51	456	507
6	"6-out7260"	.29255	55	133	188
6	"6-out7261"	.05786	32	521	553
6	"6-out7262"	.14967	69	392	461
6	"6-out7263"	.08371	110	1204	1314
6	"6-out7264"	.06808	32	438	470
6	"6-out7265"	.13308	142	925	1067
6	"6-out7266"	.13414	44	284	328
6	"6-out7267"	.18081	98	444	542
6	"6-out7268"	.49006	74	77	151
6	"6-out7269"	.15308	293	1621	1914
6	"6-out7270"	.03240	7	209	216
6	"6-out7271"	.31800	83	178	261
6	"6-out7272"	.30400	76	174	250
6	"6-out7273"	.07602	39	474	513
6	"6-out7274"	.29175	131	318	449
6	"6-out7275"	.18709	29	126	155
6	"6-out7276"	.06521	6	86	92
6	"6-out7277"	.31282	122	268	390
6	"6-out7278"	.42253	60	82	142
6	"6-out7279"	.04729	7	141	148
6	"6-out7280"	.20257	63	248	311
6	"6-out7281"	.13645	67	424	491
6	"6-out7282"	.06603	35	495	530
6	"6-out7283"	.26035	88	250	338
6	"6-out7284"	.05577	14	237	251
6	"6-out7285"	.29260	91	220	311
6	"6-out7286"	.10764	107	887	994
6	"6-out7287"	.04109	18	420	438
6	"6-out7288"	.44081	108	137	245
6	"6-out7289"	.22986	254	851	1105
6	"6-out7290"	.32467	50	104	154
6	"6-out7291"	.01282	2	154	156
6	"6-out7292"	.14751	190	1098	1288
6	"6-out7293"	.13947	59	364	423
6	"6-out7294"	.06578	15	213	228
6	"6-out7295"	.09210	28	276	304
6	"6-out7296"	.15040	94	531	625
6	"6-out7297"	.21897	30	107	137
6	"6-out7298"	.04487	7	149	156
6	"6-out7299"	.07957	30	347	377
6	"6-out7300"	.07929	18	209	227
6	"6-out7301"	.35879	155	277	432
6	"6-out7302"	.09615	15	141	156
6	"6-out7303"	.13973	192	1182	1374
6	"6-out7304"	.20847	123	467	590
6	"6-out7305"	.10097	52	463	515
6	"6-out7306"	.03233	14	419	433
6	"6-out7307"	.22761	244	828	1072
6	"6-out7308"	.25789	49	141	190
6	"6-out7309"	.07882	35	409	444
6	"6-out7310"	.08369	116	1270	1386
6	"6-out7311"	.47744	127	139	266
6	"6-out7312"	.37000	148	252	400
6	"6-out7313"	.14265	101	607	708
6	"6-out7314"	.10327	60	521	581
6	"6-out7315"	.09456	47	450	497
6	"6-out7316"	.36363	28	49	77
6	"6-out7317"	.05581	12	203	215
6	"6-out7318"	.10769	7	58	65
6	"6-out7319"	.42232	280	383	663
6	"6-out7320"	.63354	102	59	161
6	"6-out7321"	.25301	63	186	249
6	"6-out7322"	.08771	65	676	741
6	"6-out7323"	.10166	55	486	541
6	"6-out7324"	.09617	78	733	811
6	"6-out7325"	.17436	283	1340	1623
6	"6-out7326"	.06465	15	217	232
6	"6-out7327"	.03524	8	219	227
6	"6-out7328"	.02459	6	238	244
6	"6-out7329"	.11574	50	382	432
6	"6-out7330"	.26861	184	501	685
6	"6-out7331"	.17938	87	398	485
6	"6-out7332"	.19512	32	132	164
6	"6-out7333"	.10421	42	361	403
6	"6-out7334"	.11666	21	159	180
6	"6-out7335"	.16867	28	138	166
6	"6-out7336"	.35443	56	102	158
6	"6-out7337"	.36734	54	93	147
6	"6-out7338"	.14331	45	269	314
6	"6-out7339"	.05172	12	220	232
6	"6-out7340"	.07943	34	394	428
6	"6-out7341"	.32026	49	104	153
6	"6-out7342"	.04500	18	382	400
6	"6-out7343"	.14120	61	371	432
6	"6-out7344"	.16974	147	719	866
6	"6-out7345"	.09148	58	576	634
6	"6-out7346"	.14088	51	311	362
6	"6-out7347"	.06641	52	731	783
6	"6-out7348"	.09677	12	112	124
6	"6-out7350"	.07035	14	185	199
6	"6-out7351"	.10909	24	196	220
6	"6-out7352"	.15671	42	226	268
6	"6-out7353"	.13427	38	245	283
6	"6-out7354"	.23966	87	276	363
6	"6-out7355"	.12179	38	274	312
6	"6-out7356"	.06134	20	306	326
6	"6-out7357"	.08418	123	1338	1461
6	"6-out7358"	.26666	32	88	120
6	"6-out7359"	.01834	2	107	109
6	"6-out7360"	.28571	224	560	784
6	"6-out7361"	.03970	53	1282	1335
6	"6-out7362"	.15079	38	214	252
6	"6-out7363"	.23049	127	424	551
6	"6-out7364"	.54233	269	227	496
6	"6-out7365"	.14195	45	272	317
6	"6-out7366"	.60606	120	78	198
6	"6-out7367"	.08035	27	309	336
6	"6-out7368"	.45714	48	57	105
6	"6-out7369"	.13157	35	231	266
6	"6-out7370"	.05453	68	1179	1247
6	"6-out7371"	.13247	82	537	619
6	"6-out7372"	.09718	38	353	391
6	"6-out7373"	.20370	22	86	108
6	"6-out7374"	.08529	29	311	340
6	"6-out7375"	.07916	57	663	720
6	"6-out7376"	.03478	4	111	115
6	"6-out7377"	.06666	11	154	165
6	"6-out7378"	.08099	52	590	642
6	"6-out7379"	.38461	175	280	455
6	"6-out7380"	.49056	260	270	530
6	"6-out7381"	.19343	106	442	548
6	"6-out7382"	.08641	21	222	243
6	"6-out7383"	.03783	7	178	185
6	"6-out7384"	.22500	72	248	320
6	"6-out7385"	.05747	30	492	522
6	"6-out7386"	.49358	231	237	468
6	"6-out7387"	.14201	72	435	507
6	"6-out7388"	.06549	67	956	1023
6	"6-out7389"	.02919	8	266	274
6	"6-out7390"	.27335	79	210	289
6	"6-out7391"	.25936	90	257	347
6	"6-out7392"	.12759	43	294	337
6	"6-out7393"	.15705	49	263	312
6	"6-out7394"	.18878	165	709	874
6	"6-out7395"	.05714	8	132	140
6	"6-out7396"	.36989	462	787	1249
6	"6-out7397"	.38729	323	511	834
6	"6-out7398"	.36940	454	775	1229
6	"6-out7399"	.15068	44	248	292
6	"6-out7400"	.10810	32	264	296
6	"6-out7401"	.09034	44	443	487
6	"6-out7402"	.06991	132	1756	1888
6	"6-out7403"	.26237	53	149	202
6	"6-out7404"	.10025	40	359	399
6	"6-out7405"	.09823	39	358	397
6	"6-out7406"	.09004	38	384	422
6	"6-out7407"	.18823	112	483	595
6	"6-out7408"	.05570	21	356	377
6	"6-out7409"	.06487	106	1528	1634
6	"6-out7410"	.10365	34	294	328
6	"6-out7411"	.39832	143	216	359
6	"6-out7412"	.11899	57	422	479
6	"6-out7413"	.16008	77	404	481
6	"6-out7414"	.06542	35	500	535
6	"6-out7415"	.03187	16	486	502
6	"6-out7416"	.16206	135	698	833
6	"6-out7417"	.10218	28	246	274
6	"6-out7418"	.51081	425	407	832
6	"6-out7419"	.07169	57	738	795
6	"6-out7420"	.10412	48	413	461
6	"6-out7421"	.15094	96	540	636
6	"6-out7422"	.05396	32	561	593
6	"6-out7423"	.13437	43	277	320
6	"6-out7424"	.10268	84	734	818
6	"6-out7425"	.42746	221	296	517
6	"6-out7426"	.07656	65	784	849
6	"6-out7427"	.17901	29	133	162
6	"6-out7428"	.44512	73	91	164
6	"6-out7429"	.42682	70	94	164
6	"6-out7430"	.50000	82	82	164
6	"6-out7431"	.50609	83	81	164
6	"6-out7432"	.26635	228	628	856
6	"6-out7433"	.14710	99	574	673
6	"6-out7434"	.09437	52	499	551
6	"6-out7435"	.04444	32	688	720
6	"6-out7436"	.08818	106	1096	1202
6	"6-out7437"	.45098	138	168	306
6	"6-out7438"	.32051	25	53	78
6	"6-out7439"	.13253	11	72	83
6	"6-out7440"	.50549	46	45	91
6	"6-out7441"	.11111	11	88	99
6	"6-out7442"	.61864	73	45	118
6	"6-out7443"	.58947	56	39	95
6	"6-out7444"	.11940	8	59	67
6	"6-out7445"	.43703	59	76	135
6	"6-out7446"	.47093	81	91	172
6	"6-out7447"	.41447	63	89	152
6	"6-out7448"	.55882	57	45	102
6	"6-out7449"	.31182	29	64	93
6	"6-out7450"	.33944	296	576	872
6	"6-out7451"	.36764	25	43	68
6	"6-out7452"	.08253	86	956	1042
6	"6-out7453"	.07500	30	370	400
6	"6-out7454"	.10026	76	682	758
6	"6-out7455"	.08571	15	160	175
6	"6-out7456"	.14084	40	244	284
6	"6-out7457"	.12371	36	255	291
6	"6-out7458"	.10240	34	298	332
6	"6-out7459"	.21650	160	579	739
6	"6-out7460"	.16812	115	569	684
6	"6-out7461"	.06868	50	678	728
6	"6-out7462"	.32667	327	674	1001
6	"6-out7463"	.07266	59	753	812
6	"6-out7464"	.11160	100	796	896
6	"6-out7465"	.07473	50	619	669
6	"6-out7466"	.13023	84	561	645
6	"6-out7467"	.12104	65	472	537
6	"6-out7468"	.18772	211	913	1124
6	"6-out7469"	.09253	31	304	335
6	"6-out7470"	.05263	15	270	285
6	"6-out7471"	.13148	38	251	289
6	"6-out7472"	.12318	34	242	276
6	"6-out7473"	.04980	13	248	261
6	"6-out7474"	.15879	168	890	1058
6	"6-out7475"	.07586	116	1413	1529
6	"6-out7476"	.12145	150	1085	1235
6	"6-out7477"	.43951	396	505	901
6	"6-out7478"	.44117	255	323	578
6	"6-out7479"	.10855	99	813	912
6	"6-out7480"	.04210	36	819	855
6	"6-out7481"	.19341	47	196	243
6	"6-out7482"	.07202	26	335	361
6	"6-out7483"	.09400	58	559	617
6	"6-out7484"	.08374	17	186	203
6	"6-out7485"	.08870	22	226	248
6	"6-out7486"	.09977	45	406	451
6	"6-out7487"	.03488	9	249	258
6	"6-out7488"	.09018	34	343	377
6	"6-out7489"	.50000	71	71	142
6	"6-out7491"	.11545	62	475	537
6	"6-out7492"	.13169	59	389	448
6	"6-out7493"	.43625	219	283	502
6	"6-out7494"	.13071	20	133	153
6	"6-out7495"	.11337	39	305	344
6	"6-out7496"	.12658	20	138	158
6	"6-out7497"	.67213	123	60	183
6	"6-out7498"	.16243	32	165	197
6	"6-out7499"	.06940	27	362	389
6	"6-out7500"	.25675	19	55	74
6	"6-out7501"	.47040	453	510	963
6	"6-out7502"	.31081	115	255	370
6	"6-out7503"	.13157	50	330	380
6	"6-out7504"	.07658	70	844	914
6	"6-out7505"	.12977	340	2280	2620
6	"6-out7506"	.13362	122	791	913
6	"6-out7507"	.11783	111	831	942
6	"6-out7508"	.16339	133	681	814
6	"6-out7509"	.06238	65	977	1042
6	"6-out7510"	.09593	66	622	688
6	"6-out7511"	.12022	211	1544	1755
6	"6-out7512"	.07764	33	392	425
6	"6-out7513"	.14370	73	435	508
6	"6-out7514"	.13292	65	424	489
6	"6-out7515"	.34775	209	392	601
6	"6-out7516"	.05384	28	492	520
6	"6-out7517"	.29343	76	183	259
6	"6-out7518"	.12693	41	282	323
6	"6-out7519"	.04693	13	264	277
6	"6-out7520"	.51232	1309	1246	2555
6	"6-out7521"	.05206	24	437	461
6	"6-out7522"	.12068	49	357	406
6	"6-out7523"	.18191	175	787	962
6	"6-out7524"	.05685	39	647	686
6	"6-out7525"	.10147	124	1098	1222
6	"6-out7526"	.35096	73	135	208
6	"6-out7527"	.33185	150	302	452
6	"6-out7528"	.46623	145	166	311
6	"6-out7529"	.30794	186	418	604
6	"6-out7530"	.26428	37	103	140
6	"6-out7531"	.37704	69	114	183
6	"6-out7532"	.48387	45	48	93
6	"6-out7533"	.33986	52	101	153
6	"6-out7534"	.46625	76	87	163
6	"6-out7535"	.47085	105	118	223
6	"6-out7536"	.35930	83	148	231
6	"6-out7537"	.34177	27	52	79
6	"6-out7538"	.57181	211	158	369
6	"6-out7539"	.48920	68	71	139
6	"6-out7540"	.09069	115	1153	1268
6	"6-out7541"	.08494	57	614	671
6	"6-out7542"	.07134	59	768	827
6	"6-out7543"	.22030	115	407	522
6	"6-out7544"	.59033	232	161	393
6	"6-out7545"	.44144	98	124	222
6	"6-out7546"	.14285	21	126	147
6	"6-out7547"	.33519	60	119	179
6	"6-out7548"	.36228	317	558	875
6	"6-out7549"	.11449	124	959	1083
6	"6-out7550"	.15587	77	417	494
6	"6-out7551"	.04778	27	538	565
6	"6-out7552"	.02975	18	587	605
6	"6-out7553"	.08136	110	1242	1352
6	"6-out7554"	.34289	550	1054	1604
6	"6-out7555"	.08170	88	989	1077
6	"6-out7556"	.09135	93	925	1018
6	"6-out7557"	.13381	184	1191	1375
6	"6-out7558"	.13236	137	898	1035
6	"6-out7559"	.08307	80	883	963
6	"6-out7560"	.08003	87	1000	1087
6	"6-out7561"	.16216	174	899	1073
6	"6-out7562"	.07808	67	791	858
6	"6-out7563"	.06656	44	617	661
6	"6-out7564"	.30448	190	434	624
6	"6-out7565"	.10105	48	427	475
6	"6-out7566"	.01532	4	257	261
6	"6-out7567"	.13538	44	281	325
6	"6-out7568"	.42756	121	162	283
6	"6-out7569"	.12318	17	121	138
6	"6-out7570"	.18726	100	434	534
6	"6-out7571"	.17741	22	102	124
6	"6-out7572"	.10559	17	144	161
6	"6-out7573"	.05863	18	289	307
6	"6-out7574"	.11464	54	417	471
6	"6-out7575"	.09580	16	151	167
6	"6-out7576"	.12090	96	698	794
6	"6-out7577"	.16490	250	1266	1516
6	"6-out7578"	.43518	141	183	324
6	"6-out7579"	.10139	58	514	572
6	"6-out7580"	.08040	16	183	199
6	"6-out7581"	.71578	68	27	95
6	"6-out7582"	.10000	10	90	100
6	"6-out7583"	.14184	20	121	141
6	"6-out7584"	.04135	22	510	532
6	"6-out7585"	.60454	133	87	220
6	"6-out7586"	.71014	49	20	69
6	"6-out7587"	.03913	20	491	511
6	"6-out7588"	.02439	5	200	205
6	"6-out7589"	.32508	92	191	283
6	"6-out7590"	.15774	592	3161	3753
6	"6-out7591"	.62820	98	58	156
6	"6-out7592"	.09724	60	557	617
6	"6-out7593"	.59533	153	104	257
6	"6-out7594"	.09977	45	406	451
6	"6-out7595"	.07727	17	203	220
6	"6-out7596"	.08333	34	374	408
6	"6-out7597"	.07407	24	300	324
6	"6-out7598"	.01923	4	204	208
6	"6-out7599"	.12500	28	196	224
6	"6-out7600"	.41065	131	188	319
6	"6-out7601"	.19469	66	273	339
6	"6-out7602"	.10185	33	291	324
6	"6-out7603"	.28484	47	118	165
6	"6-out7604"	.03846	8	200	208
6	"6-out7605"	.12413	54	381	435
6	"6-out7606"	.06837	24	327	351
6	"6-out7607"	.12227	28	201	229
6	"6-out7608"	.20155	26	103	129
6	"6-out7609"	.07807	52	614	666
6	"6-out7610"	.19649	101	413	514
6	"6-out7611"	.07352	10	126	136
6	"6-out7612"	.12114	51	370	421
6	"6-out7613"	.16666	27	135	162
6	"6-out7614"	.09824	56	514	570
6	"6-out7615"	.10416	25	215	240
6	"6-out7616"	.14414	80	475	555
6	"6-out7617"	.09655	14	131	145
6	"6-out7618"	.19097	55	233	288
6	"6-out7619"	.49753	101	102	203
6	"6-out7620"	.09283	35	342	377
6	"6-out7621"	.12500	42	294	336
6	"6-out7622"	.10256	16	140	156
6	"6-out7623"	.50607	125	122	247
6	"6-out7624"	.24309	44	137	181
6	"6-out7625"	.21937	197	701	898
6	"6-out7626"	.07469	67	830	897
6	"6-out7627"	.05247	18	325	343
6	"6-out7628"	.14035	40	245	285
6	"6-out7629"	.02362	6	248	254
6	"6-out7630"	.14492	40	236	276
6	"6-out7631"	.05484	60	1034	1094
6	"6-out7632"	.10538	88	747	835
6	"6-out7633"	.08145	47	530	577
6	"6-out7634"	.10784	55	455	510
6	"6-out7635"	.12500	76	532	608
6	"6-out7636"	.12153	127	918	1045
6	"6-out7637"	.05494	55	946	1001
6	"6-out7638"	.06451	12	174	186
6	"6-out7639"	.28824	179	442	621
6	"6-out7640"	.21568	165	600	765
6	"6-out7641"	.70000	98	42	140
6	"6-out7642"	.07182	13	168	181
6	"6-out7643"	.08569	169	1803	1972
6	"6-out7644"	.64285	90	50	140
6	"6-out7645"	.14912	214	1221	1435
6	"6-out7646"	.06473	29	419	448
6	"6-out7647"	.58237	304	218	522
6	"6-out7648"	.05923	68	1080	1148
6	"6-out7649"	.59428	104	71	175
6	"6-out7650"	.22538	87	299	386
6	"6-out7651"	.09594	52	490	542
6	"6-out7652"	.51785	58	54	112
6	"6-out7653"	.39449	43	66	109
6	"6-out7654"	.41071	46	66	112
6	"6-out7655"	.46017	52	61	113
6	"6-out7656"	.48214	54	58	112
6	"6-out7657"	.47368	54	60	114
6	"6-out7658"	.51428	54	51	105
6	"6-out7659"	.59821	67	45	112
6	"6-out7660"	.55045	60	49	109
6	"6-out7661"	.40366	44	65	109
6	"6-out7662"	.52941	63	56	119
6	"6-out7663"	.32743	37	76	113
6	"6-out7664"	.44247	50	63	113
6	"6-out7665"	.52631	60	54	114
6	"6-out7666"	.39823	45	68	113
6	"6-out7667"	.44642	50	62	112
6	"6-out7668"	.57017	65	49	114
6	"6-out7669"	.43478	50	65	115
6	"6-out7670"	.46788	51	58	109
6	"6-out7671"	.59677	74	50	124
6	"6-out7672"	.46086	53	62	115
6	"6-out7673"	.49549	55	56	111
6	"6-out7674"	.42608	49	66	115
6	"6-out7675"	.57017	65	49	114
6	"6-out7676"	.53913	62	53	115
6	"6-out7677"	.43243	48	63	111
6	"6-out7678"	.50000	57	57	114
6	"6-out7679"	.42982	49	65	114
6	"6-out7680"	.47368	54	60	114
6	"6-out7681"	.47368	54	60	114
6	"6-out7682"	.39473	45	69	114
6	"6-out7683"	.18589	58	254	312
6	"6-out7684"	.17346	102	486	588
6	"6-out7685"	.08918	61	623	684
6	"6-out7686"	.30225	94	217	311
6	"6-out7687"	.45918	135	159	294
6	"6-out7688"	.38195	199	322	521
6	"6-out7689"	.14975	31	176	207
6	"6-out7690"	.02666	14	511	525
6	"6-out7691"	.16403	52	265	317
6	"6-out7692"	.08112	92	1042	1134
6	"6-out7693"	.07762	34	404	438
6	"6-out7694"	.10588	18	152	170
6	"6-out7695"	.05787	18	293	311
6	"6-out7696"	.06857	36	489	525
6	"6-out7697"	.49113	194	201	395
6	"6-out7698"	.03891	20	494	514
6	"6-out7699"	.60784	217	140	357
6	"6-out7700"	.42315	212	289	501
6	"6-out7701"	.17928	45	206	251
6	"6-out7702"	.10357	87	753	840
6	"6-out7703"	.60897	95	61	156
6	"6-out7704"	.09803	20	184	204
6	"6-out7705"	.12795	65	443	508
6	"6-out7706"	.21935	34	121	155
6	"6-out7707"	.45378	54	65	119
6	"6-out7708"	.39906	85	128	213
6	"6-out7709"	.16551	48	242	290
6	"6-out7710"	.20396	72	281	353
6	"6-out7711"	.52475	53	48	101
6	"6-out7712"	.13846	72	448	520
6	"6-out7713"	.22935	75	252	327
6	"6-out7714"	.05964	17	268	285
6	"6-out7715"	.58974	92	64	156
6	"6-out7716"	.62179	97	59	156
6	"6-out7717"	.19298	55	230	285
6	"6-out7718"	.14417	78	463	541
6	"6-out7719"	.21030	98	368	466
6	"6-out7720"	.16314	85	436	521
6	"6-out7721"	.53140	110	97	207
6	"6-out7722"	.07239	16	205	221
6	"6-out7723"	.10745	49	407	456
6	"6-out7724"	.05960	72	1136	1208
6	"6-out7725"	.05714	58	957	1015
6	"6-out7726"	.09152	68	675	743
6	"6-out7727"	.04533	35	737	772
6	"6-out7728"	.30939	237	529	766
6	"6-out7729"	.14354	60	358	418
6	"6-out7730"	.10066	91	813	904
6	"6-out7731"	.06976	15	200	215
6	"6-out7732"	.45614	52	62	114
6	"6-out7733"	.10400	13	112	125
6	"6-out7734"	.09793	19	175	194
6	"6-out7735"	.47619	50	55	105
6	"6-out7736"	.09473	36	344	380
6	"6-out7737"	.20640	58	223	281
6	"6-out7738"	.12595	33	229	262
6	"6-out7739"	.15789	42	224	266
6	"6-out7740"	.31963	70	149	219
6	"6-out7741"	.10057	35	313	348
6	"6-out7742"	.10276	26	227	253
6	"6-out7743"	.12074	39	284	323
6	"6-out7744"	.51776	306	285	591
6	"6-out7745"	.38006	244	398	642
6	"6-out7746"	.05530	25	427	452
6	"6-out7747"	.12528	55	384	439
6	"6-out7748"	.15183	290	1620	1910
6	"6-out7749"	.05426	7	122	129
6	"6-out7750"	.05687	12	199	211
6	"6-out7751"	.05360	61	1077	1138
6	"6-out7752"	.17156	105	507	612
6	"6-out7753"	.12285	129	921	1050
6	"6-out7754"	.14160	81	491	572
6	"6-out7755"	.44217	195	246	441
6	"6-out7756"	.07396	25	313	338
6	"6-out7757"	.13967	69	425	494
6	"6-out7758"	.20715	168	643	811
6	"6-out7759"	.21755	171	615	786
6	"6-out7760"	.19515	153	631	784
6	"6-out7761"	.03830	19	477	496
6	"6-out7762"	.13178	17	112	129
6	"6-out7763"	.50591	214	209	423
6	"6-out7764"	.20091	88	350	438
6	"6-out7765"	.18125	29	131	160
6	"6-out7766"	.13486	94	603	697
6	"6-out7767"	.09714	34	316	350
6	"6-out7768"	.03030	3	96	99
6	"6-out7769"	.19101	34	144	178
6	"6-out7770"	.16455	52	264	316
6	"6-out7771"	.09248	16	157	173
6	"6-out7772"	.05347	30	531	561
6	"6-out7773"	.09668	35	327	362
6	"6-out7774"	.56170	132	103	235
6	"6-out7775"	.12500	37	259	296
6	"6-out7776"	.17333	52	248	300
6	"6-out7777"	.20259	78	307	385
6	"6-out7778"	.07453	12	149	161
6	"6-out7779"	.07679	47	565	612
6	"6-out7780"	.14492	30	177	207
6	"6-out7781"	.11721	32	241	273
6	"6-out7782"	.10619	24	202	226
6	"6-out7783"	.04672	5	102	107
6	"6-out7784"	.08026	61	699	760
6	"6-out7785"	.14909	41	234	275
6	"6-out7786"	.10636	117	983	1100
6	"6-out7787"	.13273	88	575	663
6	"6-out7788"	.12030	16	117	133
6	"6-out7789"	.15085	97	546	643
6	"6-out7790"	.12601	62	430	492
6	"6-out7791"	.02597	6	225	231
6	"6-out7792"	.09292	21	205	226
6	"6-out7793"	.16309	38	195	233
6	"6-out7794"	.06504	16	230	246
6	"6-out7795"	.19496	31	128	159
6	"6-out7796"	.10491	32	273	305
6	"6-out7797"	.15714	22	118	140
6	"6-out7798"	.09119	58	578	636
6	"6-out7799"	.14029	47	288	335
6	"6-out7800"	.44137	64	81	145
6	"6-out7801"	.11038	169	1362	1531
6	"6-out7802"	.08196	40	448	488
6	"6-out7803"	.09293	117	1142	1259
6	"6-out7804"	.45306	111	134	245
6	"6-out7805"	.04705	8	162	170
6	"6-out7806"	.10915	31	253	284
6	"6-out7807"	.09230	48	472	520
6	"6-out7808"	.11085	49	393	442
6	"6-out7809"	.55263	63	51	114
6	"6-out7810"	.42982	49	65	114
6	"6-out7811"	.55263	63	51	114
6	"6-out7812"	.51460	511	482	993
6	"6-out7813"	.13709	17	107	124
6	"6-out7814"	.10714	21	175	196
6	"6-out7815"	.08626	27	286	313
6	"6-out7816"	.68309	97	45	142
6	"6-out7817"	.12848	106	719	825
6	"6-out7818"	.10162	25	221	246
6	"6-out7819"	.19166	46	194	240
6	"6-out7820"	.09179	47	465	512
6	"6-out7821"	.38554	32	51	83
6	"6-out7822"	.10091	44	392	436
6	"6-out7823"	.30000	30	70	100
6	"6-out7824"	.07826	9	106	115
6	"6-out7825"	.04694	10	203	213
6	"6-out7826"	.03703	7	182	189
6	"6-out7827"	.04526	11	232	243
6	"6-out7828"	.08486	60	647	707
6	"6-out7829"	.50420	60	59	119
6	"6-out7830"	.32203	38	80	118
6	"6-out7831"	.10156	13	115	128
6	"6-out7832"	.01944	7	353	360
6	"6-out7833"	.44785	73	90	163
6	"6-out7834"	.10588	18	152	170
6	"6-out7835"	.21951	36	128	164
6	"6-out7836"	.10698	49	409	458
6	"6-out7837"	.04545	14	294	308
6	"6-out7838"	.34375	22	42	64
6	"6-out7839"	.12018	106	776	882
6	"6-out7840"	.08492	71	765	836
6	"6-out7841"	.10550	23	195	218
6	"6-out7842"	.10591	34	287	321
6	"6-out7843"	.35687	96	173	269
6	"6-out7844"	.12000	57	418	475
6	"6-out7845"	.08540	24	257	281
6	"6-out7846"	.08040	16	183	199
6	"6-out7847"	.04687	9	183	192
6	"6-out7848"	.04666	14	286	300
6	"6-out7849"	.17156	35	169	204
6	"6-out7850"	.05952	25	395	420
6	"6-out7851"	.04109	9	210	219
6	"6-out7852"	.02325	4	168	172
6	"6-out7853"	.04026	6	143	149
6	"6-out7854"	.03409	18	510	528
6	"6-out7855"	.10690	65	543	608
6	"6-out7856"	.22159	117	411	528
6	"6-out7857"	.43362	98	128	226
6	"6-out7858"	.17886	22	101	123
6	"6-out7859"	.15992	83	436	519
6	"6-out7860"	.60000	45	30	75
6	"6-out7861"	.51948	80	74	154
6	"6-out7862"	.40000	58	87	145
6	"6-out7863"	.05430	58	1010	1068
6	"6-out7864"	.11290	28	220	248
6	"6-out7865"	.38205	115	186	301
6	"6-out7866"	.39655	46	70	116
6	"6-out7867"	.04123	8	186	194
6	"6-out7868"	.38860	300	472	772
6	"6-out7869"	.11162	24	191	215
6	"6-out7870"	.11298	87	683	770
6	"6-out7871"	.09469	25	239	264
6	"6-out7872"	.13270	28	183	211
6	"6-out7873"	.08333	18	198	216
6	"6-out7874"	.09729	18	167	185
6	"6-out7875"	.07079	8	105	113
6	"6-out7876"	.14089	41	250	291
6	"6-out7877"	.06930	14	188	202
6	"6-out7878"	.12969	114	765	879
6	"6-out7879"	.10173	41	362	403
6	"6-out7880"	.47945	105	114	219
6	"6-out7881"	.29113	92	224	316
6	"6-out7882"	.47482	66	73	139
6	"6-out7883"	.22869	51	172	223
6	"6-out7884"	.10599	23	194	217
6	"6-out7885"	.12844	14	95	109
6	"6-out7886"	.11891	66	489	555
6	"6-out7887"	.04680	11	224	235
6	"6-out7888"	.26751	42	115	157
6	"6-out7889"	.23599	139	450	589
6	"6-out7890"	.07721	61	729	790
6	"6-out7891"	.13861	28	174	202
6	"6-out7892"	.33333	70	140	210
6	"6-out7893"	.14004	64	393	457
6	"6-out7894"	.07786	19	225	244
6	"6-out7895"	.16403	52	265	317
6	"6-out7896"	.51418	145	137	282
6	"6-out7897"	.06010	11	172	183
6	"6-out7898"	.30714	86	194	280
6	"6-out7899"	.33966	143	278	421
6	"6-out7900"	.10795	19	157	176
6	"6-out7901"	.10830	30	247	277
6	"6-out7902"	.11627	30	228	258
6	"6-out7903"	.47292	131	146	277
6	"6-out7904"	.09401	22	212	234
6	"6-out7905"	.10911	200	1633	1833
6	"6-out7906"	.31950	77	164	241
6	"6-out7907"	.08115	28	317	345
6	"6-out7908"	.10109	46	409	455
6	"6-out7909"	.05422	25	436	461
6	"6-out7910"	.10196	26	229	255
6	"6-out7911"	.13429	56	361	417
6	"6-out7912"	.22972	17	57	74
6	"6-out7913"	.05177	16	293	309
6	"6-out7914"	.45429	164	197	361
6	"6-out7915"	.25490	208	608	816
6	"6-out7916"	.02678	6	218	224
6	"6-out7917"	.34131	57	110	167
6	"6-out7918"	.12758	37	253	290
6	"6-out7919"	.16551	24	121	145
6	"6-out7920"	.10664	252	2111	2363
6	"6-out7921"	.17338	43	205	248
6	"6-out7922"	.11392	81	630	711
6	"6-out7923"	.12315	92	655	747
6	"6-out7924"	.22393	58	201	259
6	"6-out7925"	.50980	78	75	153
6	"6-out7926"	.11574	50	382	432
6	"6-out7927"	.06060	20	310	330
6	"6-out7928"	.30708	39	88	127
6	"6-out7929"	.34090	15	29	44
6	"6-out7930"	.32824	43	88	131
6	"6-out7931"	.08849	10	103	113
6	"6-out7932"	.20210	96	379	475
6	"6-out7933"	.19166	46	194	240
6	"6-out7934"	.06299	24	357	381
6	"6-out7935"	.19895	152	612	764
6	"6-out7936"	.15118	70	393	463
6	"6-out7937"	.06172	25	380	405
6	"6-out7938"	.28971	93	228	321
6	"6-out7939"	.11000	22	178	200
6	"6-out7940"	.37254	38	64	102
6	"6-out7941"	.09814	53	487	540
6	"6-out7942"	.23076	27	90	117
6	"6-out7943"	.41401	65	92	157
6	"6-out7944"	.15517	27	147	174
6	"6-out7945"	.41095	30	43	73
6	"6-out7946"	.08421	111	1207	1318
6	"6-out7947"	.08201	93	1041	1134
6	"6-out7948"	.06604	57	806	863
6	"6-out7949"	.11581	156	1191	1347
6	"6-out7950"	.18216	143	642	785
6	"6-out7951"	.37092	296	502	798
6	"6-out7952"	.11926	117	864	981
6	"6-out7953"	.13649	144	911	1055
6	"6-out7954"	.51612	192	180	372
6	"6-out7955"	.12380	439	3107	3546
6	"6-out7956"	.08081	107	1217	1324
6	"6-out7957"	.14533	134	788	922
6	"6-out7958"	.23036	88	294	382
6	"6-out7959"	.14285	20	120	140
6	"6-out7960"	.02222	4	176	180
6	"6-out7961"	.54347	75	63	138
6	"6-out7962"	.26886	196	533	729
6	"6-out7963"	.15145	249	1395	1644
6	"6-out7964"	.07124	84	1095	1179
6	"6-out7965"	.58536	120	85	205
6	"6-out7966"	.52631	60	54	114
6	"6-out7967"	.52777	57	51	108
6	"6-out7968"	.62264	66	40	106
6	"6-out7969"	.47321	53	59	112
6	"6-out7970"	.59821	67	45	112
6	"6-out7971"	.39655	46	70	116
6	"6-out7972"	.55357	62	50	112
6	"6-out7973"	.45454	50	60	110
6	"6-out7974"	.44954	49	60	109
6	"6-out7975"	.53787	71	61	132
6	"6-out7976"	.44247	50	63	113
6	"6-out7977"	.53097	60	53	113
6	"6-out7978"	.39130	45	70	115
6	"6-out7979"	.42857	48	64	112
6	"6-out7980"	.44642	50	62	112
6	"6-out7981"	.57391	66	49	115
6	"6-out7982"	.63392	71	41	112
6	"6-out7983"	.50442	57	56	113
6	"6-out7984"	.50458	55	54	109
6	"6-out7985"	.56521	65	50	115
6	"6-out7986"	.52173	60	55	115
6	"6-out7987"	.73043	84	31	115
6	"6-out7988"	.57391	66	49	115
6	"6-out7989"	.60000	69	46	115
6	"6-out7990"	.50877	58	56	114
6	"6-out7991"	.54054	60	51	111
6	"6-out7992"	.56140	64	50	114
6	"6-out7993"	.46491	53	61	114
6	"6-out7994"	.43859	50	64	114
6	"6-out7995"	.58771	67	47	114
6	"6-out7996"	.56162	401	313	714
6	"6-out7997"	.11854	78	580	658
6	"6-out7998"	.47727	21	23	44
6	"6-out7999"	.16574	60	302	362
6	"6-out8000"	.14134	80	486	566
6	"6-out16001"	.07803	27	319	346
6	"6-out16002"	.24218	62	194	256
6	"6-out16003"	.22240	139	486	625
6	"6-out16004"	.06214	22	332	354
6	"6-out16005"	.06065	37	573	610
6	"6-out16006"	.11811	45	336	381
6	"6-out16007"	.09604	34	320	354
6	"6-out16008"	.53012	44	39	83
6	"6-out16009"	.09577	34	321	355
6	"6-out16010"	.05198	17	310	327
6	"6-out16011"	.38013	111	181	292
6	"6-out16012"	.08876	49	503	552
6	"6-out16013"	.13729	127	798	925
6	"6-out16014"	.44620	282	350	632
6	"6-out16015"	.44936	284	348	632
6	"6-out16016"	.21897	30	107	137
6	"6-out16017"	.39519	181	277	458
6	"6-out16018"	.13551	58	370	428
6	"6-out16019"	.04635	28	576	604
6	"6-out16020"	.35402	154	281	435
6	"6-out16021"	.11590	51	389	440
6	"6-out16022"	.07377	72	904	976
6	"6-out16023"	.42334	185	252	437
6	"6-out16024"	.13763	79	495	574
6	"6-out16025"	.05741	24	394	418
6	"6-out16026"	.20630	72	277	349
6	"6-out16027"	.08986	39	395	434
6	"6-out16028"	.13903	52	322	374
6	"6-out16029"	.19298	88	368	456
6	"6-out16030"	.22410	106	367	473
6	"6-out16031"	.23591	67	217	284
6	"6-out16032"	.11034	64	516	580
6	"6-out16033"	.09070	82	822	904
6	"6-out16034"	.09157	25	248	273
6	"6-out16035"	.20689	54	207	261
6	"6-out16036"	.04504	25	530	555
6	"6-out16037"	.07019	65	861	926
6	"6-out16038"	.15178	34	190	224
6	"6-out16039"	.05882	61	976	1037
6	"6-out16040"	.07818	81	955	1036
6	"6-out16041"	.06132	13	199	212
6	"6-out16042"	.12606	178	1234	1412
6	"6-out16043"	.24489	36	111	147
6	"6-out16044"	.08707	31	325	356
6	"6-out16045"	.08574	71	757	828
6	"6-out16046"	.07586	22	268	290
6	"6-out16047"	.40125	319	476	795
6	"6-out16048"	.19683	137	559	696
6	"6-out16049"	.15328	84	464	548
6	"6-out16050"	.42857	45	60	105
6	"6-out16051"	.06647	23	323	346
6	"6-out16052"	.14906	72	411	483
6	"6-out16053"	.06962	33	441	474
6	"6-out16054"	.09263	44	431	475
6	"6-out16055"	.17094	80	388	468
6	"6-out16056"	.20034	116	463	579
6	"6-out16057"	.11349	53	414	467
6	"6-out16058"	.04714	19	384	403
6	"6-out16059"	.04761	21	420	441
6	"6-out16060"	.14794	137	789	926
6	"6-out16061"	.11083	45	361	406
6	"6-out16062"	.27803	295	766	1061
6	"6-out16063"	.15839	67	356	423
6	"6-out16064"	.02309	10	423	433
6	"6-out16065"	.61425	293	184	477
6	"6-out16066"	.10788	78	645	723
6	"6-out16067"	.16037	51	267	318
6	"6-out16068"	.19282	43	180	223
6	"6-out16069"	.06521	12	172	184
6	"6-out16070"	.31967	273	581	854
6	"6-out16071"	.39639	88	134	222
6	"6-out16072"	.11596	69	526	595
6	"6-out16073"	.03438	12	337	349
6	"6-out16074"	.10683	61	510	571
6	"6-out16075"	.28869	166	409	575
6	"6-out16076"	.08865	25	257	282
6	"6-out16077"	.03804	42	1062	1104
6	"6-out16078"	.13246	122	799	921
6	"6-out16079"	.04288	38	848	886
6	"6-out16080"	.29697	275	651	926
6	"6-out16081"	.62711	37	22	59
6	"6-out16082"	.62711	37	22	59
6	"6-out16083"	.52542	31	28	59
6	"6-out16084"	.15915	53	280	333
6	"6-out16085"	.08265	51	566	617
6	"6-out16086"	.43333	39	51	90
6	"6-out16087"	.13779	35	219	254
6	"6-out16088"	.06122	27	414	441
6	"6-out16089"	.19954	88	353	441
6	"6-out16090"	.07373	16	201	217
6	"6-out16091"	.20000	33	132	165
6	"6-out16092"	.18080	81	367	448
6	"6-out16093"	.05528	23	393	416
6	"6-out16094"	.14250	58	349	407
6	"6-out16095"	.07645	38	459	497
6	"6-out16096"	.12995	59	395	454
6	"6-out16097"	.08864	107	1100	1207
6	"6-out16098"	.06380	46	675	721
6	"6-out16099"	.04909	19	368	387
6	"6-out16100"	.18119	106	479	585
6	"6-out16101"	.09208	57	562	619
6	"6-out16102"	.02964	11	360	371
6	"6-out16103"	.16187	45	233	278
6	"6-out16104"	.11609	44	335	379
6	"6-out16105"	.07248	44	563	607
6	"6-out16106"	.10436	55	472	527
6	"6-out16107"	.06441	42	610	652
6	"6-out16108"	.07453	24	298	322
6	"6-out16109"	.19387	57	237	294
6	"6-out16110"	.12324	184	1309	1493
6	"6-out16111"	.13636	54	342	396
6	"6-out16112"	.08333	109	1199	1308
6	"6-out16113"	.07009	15	199	214
6	"6-out16114"	.05944	34	538	572
6	"6-out16115"	.50220	114	113	227
6	"6-out16116"	.31995	271	576	847
6	"6-out16117"	.15211	108	602	710
6	"6-out16118"	.12266	46	329	375
6	"6-out16119"	.16298	140	719	859
6	"6-out16120"	.10035	56	502	558
6	"6-out16121"	.14940	137	780	917
6	"6-out16122"	.05581	12	203	215
6	"6-out16123"	.07177	75	970	1045
6	"6-out16124"	.07454	342	4246	4588
6	"6-out16125"	.06283	313	4668	4981
6	"6-out16126"	.12394	44	311	355
6	"6-out16127"	.07262	26	332	358
6	"6-out16128"	.12320	43	306	349
6	"6-out16129"	.12471	54	379	433
6	"6-out16130"	.08208	93	1040	1133
6	"6-out16131"	.16500	116	587	703
6	"6-out16132"	.07601	90	1094	1184
6	"6-out16133"	.04288	19	424	443
6	"6-out16134"	.09968	32	289	321
6	"6-out16135"	.07432	22	274	296
6	"6-out16136"	.14124	100	608	708
6	"6-out16137"	.50357	141	139	280
6	"6-out16138"	.07194	30	387	417
6	"6-out16139"	.19767	17	69	86
6	"6-out16140"	.34708	143	269	412
6	"6-out16141"	.10600	60	506	566
6	"6-out16142"	.06870	193	2616	2809
6	"6-out16143"	.12857	18	122	140
6	"6-out16144"	.12066	73	532	605
6	"6-out16145"	.09728	61	566	627
6	"6-out16146"	.07058	6	79	85
6	"6-out16147"	.35351	362	662	1024
6	"6-out16148"	.08593	11	117	128
6	"6-out16149"	.29545	39	93	132
6	"6-out16150"	.13636	18	114	132
6	"6-out16151"	.07344	13	164	177
6	"6-out16152"	.11666	21	159	180
6	"6-out16153"	.10024	41	368	409
6	"6-out16154"	.02507	8	311	319
6	"6-out16155"	.34269	122	234	356
6	"6-out16156"	.53753	179	154	333
6	"6-out16157"	.06605	29	410	439
6	"6-out16158"	.08108	45	510	555
6	"6-out16159"	.16621	61	306	367
6	"6-out16160"	.48264	153	164	317
6	"6-out16161"	.06334	28	414	442
6	"6-out16162"	.06020	18	281	299
6	"6-out16163"	.07314	64	811	875
6	"6-out16164"	.15636	43	232	275
6	"6-out16165"	.12155	75	542	617
6	"6-out16166"	.06539	24	343	367
6	"6-out16167"	.10209	39	343	382
6	"6-out16168"	.20168	48	190	238
6	"6-out16169"	.09183	36	356	392
6	"6-out16170"	.06451	62	899	961
6	"6-out16171"	.07328	48	607	655
6	"6-out16172"	.19318	17	71	88
6	"6-out16173"	.10762	24	199	223
6	"6-out16174"	.34375	99	189	288
6	"6-out16175"	.11153	59	470	529
6	"6-out16176"	.10666	112	938	1050
6	"6-out16177"	.39334	402	620	1022
6	"6-out16178"	.06318	23	341	364
6	"6-out16179"	.14052	69	422	491
6	"6-out16180"	.11428	32	248	280
6	"6-out16181"	.02403	5	203	208
6	"6-out16182"	.06109	49	753	802
6	"6-out16183"	.11872	26	193	219
6	"6-out16184"	.08133	17	192	209
6	"6-out16185"	.39546	1606	2455	4061
6	"6-out16186"	.12984	57	382	439
6	"6-out16187"	.40845	58	84	142
6	"6-out16188"	.04779	13	259	272
6	"6-out16189"	.13076	51	339	390
6	"6-out16190"	.17714	31	144	175
6	"6-out16191"	.62025	49	30	79
6	"6-out16192"	.13691	102	643	745
6	"6-out16193"	.36263	66	116	182
6	"6-out16194"	.63768	88	50	138
6	"6-out16195"	.54545	72	60	132
6	"6-out16196"	.11891	22	163	185
6	"6-out16197"	.26341	54	151	205
6	"6-out16198"	.16766	84	417	501
6	"6-out16199"	.17721	14	65	79
6	"6-out16200"	.15510	38	207	245
6	"6-out16201"	.06342	43	635	678
6	"6-out16202"	.07259	49	626	675
6	"6-out16203"	.14705	10	58	68
6	"6-out16204"	.06947	33	442	475
6	"6-out16205"	.19642	22	90	112
6	"6-out16206"	.08260	57	633	690
6	"6-out16207"	.06024	40	624	664
6	"6-out16208"	.12316	319	2271	2590
6	"6-out16209"	.16331	130	666	796
6	"6-out16210"	.04674	23	469	492
6	"6-out16211"	.21981	162	575	737
6	"6-out16212"	.14751	113	653	766
6	"6-out16213"	.11213	97	768	865
6	"6-out16214"	.08017	72	826	898
6	"6-out16215"	.07531	65	798	863
6	"6-out16216"	.45973	137	161	298
6	"6-out16217"	.42767	68	91	159
6	"6-out16218"	.24342	74	230	304
6	"6-out16219"	.22413	26	90	116
6	"6-out16220"	.36649	70	121	191
6	"6-out16221"	.30120	125	290	415
6	"6-out16222"	.07090	29	380	409
6	"6-out16223"	.49494	49	50	99
6	"6-out16224"	.11707	120	905	1025
6	"6-out16225"	.04020	23	549	572
6	"6-out16226"	.01923	11	561	572
6	"6-out16227"	.02807	16	554	570
6	"6-out16228"	.27622	158	414	572
6	"6-out16229"	.06560	37	527	564
6	"6-out16230"	.35714	95	171	266
6	"6-out16231"	.43609	116	150	266
6	"6-out16232"	.43984	117	149	266
6	"6-out16233"	.16258	73	376	449
6	"6-out16234"	.10218	84	738	822
6	"6-out16235"	.10000	74	666	740
6	"6-out16236"	.15909	77	407	484
6	"6-out16237"	.05736	30	493	523
6	"6-out16238"	.09205	44	434	478
6	"6-out16239"	.10179	51	450	501
6	"6-out16240"	.12108	89	646	735
6	"6-out16241"	.09038	79	795	874
6	"6-out16242"	.21561	58	211	269
6	"6-out16243"	.10158	45	398	443
6	"6-out16244"	.06726	30	416	446
6	"6-out16245"	.04514	20	423	443
6	"6-out16246"	.08250	33	367	400
6	"6-out16247"	.16274	76	391	467
6	"6-out16248"	.35639	170	307	477
6	"6-out16249"	.08936	58	591	649
6	"6-out16250"	.34059	125	242	367
6	"6-out16251"	.04395	16	348	364
6	"6-out16252"	.15209	40	223	263
6	"6-out16253"	.21397	49	180	229
6	"6-out16254"	.02153	7	318	325
6	"6-out16255"	.21153	66	246	312
6	"6-out16256"	.37765	71	117	188
6	"6-out16258"	.63157	84	49	133
6	"6-out16259"	.88235	30	4	34
6	"6-out16260"	.09116	32	319	351
6	"6-out16261"	.30978	57	127	184
6	"6-out16262"	.22666	34	116	150
6	"6-out16264"	.10103	117	1041	1158
6	"6-out16265"	.20454	36	140	176
6	"6-out16266"	.31746	20	43	63
6	"6-out16267"	.07099	35	458	493
6	"6-out16268"	.39855	110	166	276
6	"6-out16269"	.07804	32	378	410
6	"6-out16270"	.15233	487	2710	3197
6	"6-out16271"	.22388	30	104	134
6	"6-out16272"	.05851	33	531	564
6	"6-out16273"	.05174	40	733	773
6	"6-out16274"	.05263	13	234	247
6	"6-out16275"	.37773	190	313	503
6	"6-out16276"	.78947	60	16	76
6	"6-out16277"	.38317	82	132	214
6	"6-out16278"	.38536	79	126	205
6	"6-out16279"	.11978	66	485	551
6	"6-out16280"	.24954	413	1242	1655
6	"6-out16281"	.07008	26	345	371
6	"6-out16282"	.15282	46	255	301
6	"6-out16283"	.05940	18	285	303
6	"6-out16284"	.04599	50	1037	1087
6	"6-out16285"	.06410	10	146	156
6	"6-out16286"	.33333	37	74	111
6	"6-out16287"	.05484	43	741	784
6	"6-out16288"	.11805	17	127	144
6	"6-out16289"	.10170	143	1263	1406
6	"6-out16290"	.04000	7	168	175
6	"6-out16291"	.09044	53	533	586
6	"6-out16292"	.39385	141	217	358
6	"6-out16293"	.55963	61	48	109
6	"6-out16294"	.12176	80	577	657
6	"6-out16295"	.12261	45	322	367
6	"6-out16296"	.14679	133	773	906
6	"6-out16297"	.07323	52	658	710
6	"6-out16298"	.17948	161	736	897
6	"6-out16299"	.11246	74	584	658
6	"6-out16300"	.13316	53	345	398
6	"6-out16301"	.06060	16	248	264
6	"6-out16302"	.07992	162	1865	2027
6	"6-out16303"	.41216	61	87	148
6	"6-out16304"	.05771	55	898	953
6	"6-out16305"	.10512	82	698	780
6	"6-out16306"	.01123	2	176	178
6	"6-out16307"	.06530	80	1145	1225
6	"6-out16308"	.09952	169	1529	1698
6	"6-out16309"	.50655	116	113	229
6	"6-out16310"	.11058	47	378	425
6	"6-out16311"	.49656	217	220	437
6	"6-out16312"	.12121	104	754	858
6	"6-out16313"	.09448	12	115	127
6	"6-out16314"	.14723	24	139	163
6	"6-out16315"	.15384	88	484	572
6	"6-out16316"	.32887	320	653	973
6	"6-out16317"	.16565	82	413	495
6	"6-out16318"	.50342	294	290	584
6	"6-out16319"	.48956	258	269	527
6	"6-out16320"	.17794	71	328	399
6	"6-out16321"	.13924	55	340	395
6	"6-out16322"	.18009	38	173	211
6	"6-out16323"	.09574	9	85	94
6	"6-out16324"	.16927	54	265	319
6	"6-out16325"	.18282	115	514	629
6	"6-out16326"	.06329	5	74	79
6	"6-out16327"	.44383	162	203	365
6	"6-out16328"	.41884	160	222	382
6	"6-out16329"	.43816	124	159	283
6	"6-out16330"	.07894	9	105	114
6	"6-out16331"	.12500	16	112	128
6	"6-out16332"	.08722	28	293	321
6	"6-out16333"	.14942	65	370	435
6	"6-out16334"	.18640	96	419	515
6	"6-out16335"	.08522	30	322	352
6	"6-out16336"	.06565	13	185	198
6	"6-out16337"	.35074	47	87	134
6	"6-out16338"	.50877	116	112	228
6	"6-out16339"	.40000	208	312	520
6	"6-out16340"	.10438	119	1021	1140
6	"6-out16341"	.17165	86	415	501
6	"6-out16342"	.17080	1293	6277	7570
6	"6-out16343"	.61584	311	194	505
6	"6-out16344"	.10691	82	685	767
6	"6-out16345"	.07493	55	679	734
6	"6-out16346"	.30647	194	439	633
6	"6-out16347"	.28486	143	359	502
6	"6-out16348"	.54385	31	26	57
6	"6-out16349"	.19045	359	1526	1885
6	"6-out16350"	.04403	24	521	545
6	"6-out16351"	.09465	69	660	729
6	"6-out16352"	.04761	12	240	252
6	"6-out16353"	.07307	38	482	520
6	"6-out16354"	.20607	95	366	461
6	"6-out16355"	.07928	31	360	391
6	"6-out16356"	.06780	95	1306	1401
6	"6-out16357"	.04566	29	606	635
6	"6-out16358"	.13089	86	571	657
6	"6-out16359"	.11764	138	1035	1173
6	"6-out16360"	.07266	42	536	578
6	"6-out16361"	.10300	96	836	932
6	"6-out16362"	.14874	166	950	1116
6	"6-out16363"	.16193	154	797	951
6	"6-out16364"	.12079	140	1019	1159
6	"6-out16365"	.07500	15	185	200
6	"6-out16366"	.11041	53	427	480
6	"6-out16367"	.28540	133	333	466
6	"6-out16368"	.08839	147	1516	1663
6	"6-out16369"	.16509	35	177	212
6	"6-out16370"	.09264	68	666	734
6	"6-out16371"	.50359	70	69	139
6	"6-out16372"	.37254	57	96	153
6	"6-out16373"	.40845	58	84	142
6	"6-out16374"	.12195	10	72	82
6	"6-out16375"	.12686	179	1232	1411
6	"6-out16376"	.31972	141	300	441
6	"6-out16377"	.07029	40	529	569
6	"6-out16378"	.06476	25	361	386
6	"6-out16379"	.54545	252	210	462
6	"6-out16380"	.19201	149	627	776
6	"6-out16381"	.09733	245	2272	2517
6	"6-out16382"	.09967	91	822	913
6	"6-out16383"	.11355	31	242	273
6	"6-out16384"	.04054	6	142	148
6	"6-out16385"	.24503	37	114	151
6	"6-out16386"	.53529	91	79	170
6	"6-out16387"	.23943	34	108	142
6	"6-out16388"	.34262	86	165	251
6	"6-out16389"	.34875	98	183	281
6	"6-out16390"	.16740	152	756	908
6	"6-out16391"	.43030	142	188	330
6	"6-out16392"	.05241	38	687	725
6	"6-out16393"	.13135	62	410	472
6	"6-out16394"	.67088	53	26	79
6	"6-out16395"	.52531	83	75	158
6	"6-out16396"	.54430	86	72	158
6	"6-out16397"	.49305	71	73	144
6	"6-out16398"	.17766	35	162	197
6	"6-out16399"	.15886	95	503	598
6	"6-out16400"	.58469	107	76	183
6	"6-out16401"	.32558	28	58	86
6	"6-out16402"	.32803	165	338	503
6	"6-out16403"	.72727	64	24	88
6	"6-out16404"	.15285	83	460	543
6	"6-out16405"	.08849	20	206	226
6	"6-out16406"	.12312	41	292	333
6	"6-out16407"	.10902	29	237	266
6	"6-out16408"	.11355	31	242	273
6	"6-out16409"	.12290	44	314	358
6	"6-out16410"	.16858	44	217	261
6	"6-out16411"	.28673	80	199	279
6	"6-out16412"	.05511	14	240	254
6	"6-out16413"	.09408	35	337	372
6	"6-out16414"	.08366	21	230	251
6	"6-out16415"	.12937	37	249	286
6	"6-out16416"	.05882	11	176	187
6	"6-out16417"	.11164	93	740	833
6	"6-out16418"	.08125	52	588	640
6	"6-out16419"	.29107	326	794	1120
6	"6-out16420"	.20274	59	232	291
6	"6-out16421"	.13432	27	174	201
6	"6-out16422"	.39017	135	211	346
6	"6-out16423"	.06606	22	311	333
6	"6-out16424"	.17352	59	281	340
6	"6-out16425"	.07990	97	1117	1214
6	"6-out16426"	.46184	587	684	1271
6	"6-out16427"	.13015	41	274	315
6	"6-out16428"	.08219	24	268	292
6	"6-out16429"	.07307	19	241	260
6	"6-out16430"	.11065	27	217	244
6	"6-out16431"	.11186	99	786	885
6	"6-out16432"	.22279	305	1064	1369
6	"6-out16433"	.30872	46	103	149
6	"6-out16434"	.20266	76	299	375
6	"6-out16435"	.07894	21	245	266
6	"6-out16436"	.07007	48	637	685
6	"6-out16437"	.06968	20	267	287
6	"6-out16438"	.03428	6	169	175
6	"6-out16439"	.09090	89	890	979
6	"6-out16440"	.26805	219	598	817
6	"6-out16441"	.16784	142	704	846
6	"6-out16442"	.07712	148	1771	1919
6	"6-out16443"	.18815	108	466	574
6	"6-out16444"	.05885	251	4014	4265
6	"6-out16445"	.09293	25	244	269
6	"6-out16446"	.07208	55	708	763
6	"6-out16447"	.12560	541	3766	4307
6	"6-out16448"	.09543	431	4085	4516
6	"6-out16449"	.49197	92	95	187
6	"6-out16450"	.16046	716	3746	4462
6	"6-out16451"	.04421	26	562	588
6	"6-out16452"	.09600	89	838	927
6	"6-out16453"	.09381	44	425	469
6	"6-out16454"	.03235	11	329	340
6	"6-out16455"	.06091	53	817	870
6	"6-out16456"	.07941	27	313	340
6	"6-out16457"	.04142	36	833	869
6	"6-out16458"	.07777	42	498	540
6	"6-out16459"	.07680	48	577	625
6	"6-out16460"	.11238	49	387	436
6	"6-out16461"	.07905	40	466	506
6	"6-out16462"	.04268	114	2557	2671
6	"6-out16463"	.11915	51	377	428
6	"6-out16464"	.10502	46	392	438
6	"6-out16465"	.14790	67	386	453
6	"6-out16466"	.28372	122	308	430
6	"6-out16467"	.46195	170	198	368
6	"6-out16468"	.08647	78	824	902
6	"6-out16469"	.10915	99	808	907
6	"6-out16470"	.09895	66	601	667
6	"6-out16471"	.15625	160	864	1024
6	"6-out16472"	.07765	41	487	528
6	"6-out16473"	.07256	132	1687	1819
6	"6-out16474"	.17374	135	642	777
6	"6-out16475"	.18539	33	145	178
6	"6-out16476"	.48431	494	526	1020
6	"6-out16477"	.11662	47	356	403
6	"6-out16478"	.10434	72	618	690
6	"6-out16479"	.10928	80	652	732
6	"6-out16480"	.08723	54	565	619
6	"6-out16481"	.29335	181	436	617
6	"6-out16482"	.47046	231	260	491
6	"6-out16483"	.14901	83	474	557
6	"6-out16484"	.10759	17	141	158
6	"6-out16485"	.18750	30	130	160
6	"6-out16486"	.16334	41	210	251
6	"6-out16487"	.22026	50	177	227
6	"6-out16488"	.13025	62	414	476
6	"6-out16489"	.52759	325	291	616
6	"6-out16490"	.03720	8	207	215
6	"6-out16491"	.10454	23	197	220
6	"6-out16492"	.07648	27	326	353
6	"6-out16493"	.11363	45	351	396
6	"6-out16494"	.05326	22	391	413
6	"6-out16495"	.05231	26	471	497
6	"6-out16496"	.30542	135	307	442
6	"6-out16497"	.15114	125	702	827
6	"6-out16498"	.41558	288	405	693
6	"6-out16499"	.11450	45	348	393
6	"6-out16500"	.13953	30	185	215
6	"6-out16501"	.06872	29	393	422
6	"6-out16502"	.07865	14	164	178
6	"6-out16503"	.57692	60	44	104
6	"6-out16504"	.38709	72	114	186
6	"6-out16505"	.44144	98	124	222
6	"6-out16506"	.52179	383	351	734
6	"6-out16507"	.09225	50	492	542
6	"6-out16508"	.09541	77	730	807
6	"6-out16509"	.13032	104	694	798
6	"6-out16510"	.09351	49	475	524
6	"6-out16511"	.10447	28	240	268
6	"6-out16512"	.56500	226	174	400
6	"6-out16513"	.05314	11	196	207
6	"6-out16514"	.08285	29	321	350
6	"6-out16515"	.09503	88	838	926
6	"6-out16516"	.02666	12	438	450
6	"6-out16517"	.23702	105	338	443
6	"6-out16518"	.55737	204	162	366
6	"6-out16519"	.08562	28	299	327
6	"6-out16520"	.06909	19	256	275
6	"6-out16521"	.09469	25	239	264
6	"6-out16522"	.47087	97	109	206
6	"6-out16523"	.08951	304	3092	3396
6	"6-out16524"	.30569	59	134	193
6	"6-out16525"	.09278	18	176	194
6	"6-out16526"	.08928	55	561	616
6	"6-out16527"	.18367	27	120	147
6	"6-out16528"	.32075	51	108	159
6	"6-out16529"	.20261	31	122	153
6	"6-out16530"	.45876	89	105	194
6	"6-out16531"	.37566	71	118	189
6	"6-out16532"	.51851	98	91	189
6	"6-out16533"	.49735	94	95	189
6	"6-out16534"	.49735	94	95	189
6	"6-out16535"	.49735	94	95	189
6	"6-out16536"	.51851	98	91	189
6	"6-out16537"	.53439	101	88	189
6	"6-out16538"	.63125	101	59	160
6	"6-out16539"	.17177	157	757	914
6	"6-out16540"	.09653	64	599	663
6	"6-out16541"	.19669	143	584	727
6	"6-out16542"	.33483	149	296	445
6	"6-out16543"	.41610	310	435	745
6	"6-out16544"	.51898	82	76	158
6	"6-out16545"	.42084	327	450	777
6	"6-out16546"	.21890	44	157	201
6	"6-out16547"	.05133	23	425	448
6	"6-out16548"	.09188	60	593	653
6	"6-out16549"	.05405	34	595	629
6	"6-out16550"	.08723	54	565	619
6	"6-out16551"	.09328	25	243	268
6	"6-out16552"	.55084	260	212	472
6	"6-out16553"	.14536	116	682	798
6	"6-out16554"	.13793	48	300	348
6	"6-out16555"	.10485	54	461	515
6	"6-out16556"	.04132	40	928	968
6	"6-out16557"	.09836	42	385	427
6	"6-out16558"	.20987	17	64	81
6	"6-out16559"	.62857	88	52	140
6	"6-out16560"	.35135	26	48	74
6	"6-out16561"	.07239	32	410	442
6	"6-out16562"	.45454	75	90	165
6	"6-out16563"	.47350	143	159	302
6	"6-out16564"	.24013	870	2753	3623
6	"6-out16565"	.55844	258	204	462
6	"6-out16566"	.11149	32	255	287
6	"6-out16567"	.56155	260	203	463
6	"6-out16568"	.12214	91	654	745
6	"6-out16569"	.07821	14	165	179
6	"6-out16570"	.06908	59	795	854
6	"6-out16571"	.15555	56	304	360
6	"6-out16572"	.20761	289	1103	1392
6	"6-out16573"	.05676	13	216	229
6	"6-out16574"	.20666	31	119	150
6	"6-out16575"	.07356	64	806	870
6	"6-out16576"	.28125	27	69	96
6	"6-out16577"	.15984	82	431	513
6	"6-out16578"	.57727	127	93	220
6	"6-out16579"	.27083	52	140	192
6	"6-out16580"	.11710	89	671	760
6	"6-out16581"	.16383	106	541	647
6	"6-out16582"	.10275	41	358	399
6	"6-out16583"	.14736	28	162	190
6	"6-out16584"	.11428	12	93	105
6	"6-out16585"	.09583	46	434	480
6	"6-out16586"	.18639	74	323	397
6	"6-out16587"	.46176	157	183	340
6	"6-out16588"	.28965	42	103	145
6	"6-out16589"	.16504	51	258	309
6	"6-out16590"	.10119	51	453	504
6	"6-out16591"	.45955	125	147	272
6	"6-out16592"	.40157	102	152	254
6	"6-out16593"	.50196	128	127	255
6	"6-out16594"	.05439	39	678	717
6	"6-out16595"	.04255	18	405	423
6	"6-out16596"	.45226	180	218	398
6	"6-out16597"	.05800	25	406	431
6	"6-out16598"	.08403	20	218	238
6	"6-out16599"	.09909	22	200	222
6	"6-out16600"	.09842	25	229	254
6	"6-out16601"	.04149	10	231	241
6	"6-out16602"	.07706	43	515	558
6	"6-out16603"	.06051	21	326	347
6	"6-out16604"	.15384	58	319	377
6	"6-out16605"	.11111	22	176	198
6	"6-out16606"	.10075	67	598	665
6	"6-out16607"	.05722	21	346	367
6	"6-out16608"	.39037	146	228	374
6	"6-out16609"	.13114	56	371	427
6	"6-out16610"	.22400	28	97	125
6	"6-out16611"	.12130	82	594	676
6	"6-out16612"	.06865	308	4178	4486
6	"6-out16613"	.14499	97	572	669
6	"6-out16614"	.14583	126	738	864
6	"6-out16615"	.11111	79	632	711
6	"6-out16616"	.06467	13	188	201
6	"6-out16617"	.07827	40	471	511
6	"6-out16618"	.03090	17	533	550
6	"6-out16619"	.43373	108	141	249
6	"6-out16620"	.10655	52	436	488
6	"6-out16621"	.05684	22	365	387
6	"6-out16622"	.07581	79	963	1042
6	"6-out16623"	.10606	42	354	396
6	"6-out16624"	.07588	28	341	369
6	"6-out16625"	.07427	28	349	377
6	"6-out16626"	.06070	19	294	313
6	"6-out16627"	.07523	24	295	319
6	"6-out16628"	.11127	76	607	683
6	"6-out16629"	.11946	27	199	226
6	"6-out16630"	.09543	69	654	723
6	"6-out16631"	.10598	186	1569	1755
6	"6-out16632"	.09685	37	345	382
6	"6-out16633"	.10626	112	942	1054
6	"6-out16634"	.07066	33	434	467
6	"6-out16635"	.11603	123	937	1060
6	"6-out16636"	.11898	84	622	706
6	"6-out16637"	.10240	81	710	791
6	"6-out16638"	.11285	108	849	957
6	"6-out16639"	.44372	276	346	622
6	"6-out16640"	.11756	87	653	740
6	"6-out16641"	.07754	48	571	619
6	"6-out16642"	.07272	16	204	220
6	"6-out16643"	.10165	49	433	482
6	"6-out16644"	.11764	40	300	340
6	"6-out16645"	.23728	70	225	295
6	"6-out16646"	.26267	57	160	217
6	"6-out16647"	.15887	68	360	428
6	"6-out16648"	.10606	42	354	396
6	"6-out16649"	.34803	71	133	204
6	"6-out16650"	.02422	7	282	289
6	"6-out16651"	.12056	34	248	282
6	"6-out16652"	.33950	110	214	324
6	"6-out16653"	.15727	53	284	337
6	"6-out16654"	.08333	29	319	348
6	"6-out16655"	.30061	98	228	326
6	"6-out16656"	.05172	12	220	232
6	"6-out16657"	.22869	51	172	223
6	"6-out16658"	.23188	144	477	621
6	"6-out16659"	.07676	37	445	482
6	"6-out16660"	.01960	8	400	408
6	"6-out16661"	.38507	129	206	335
6	"6-out16662"	.10982	57	462	519
6	"6-out16663"	.42911	112	149	261
6	"6-out16664"	.34701	93	175	268
6	"6-out16665"	.41281	116	165	281
6	"6-out16666"	.33043	76	154	230
6	"6-out16667"	.06709	21	292	313
6	"6-out16668"	.07407	36	450	486
6	"6-out16669"	.09774	26	240	266
6	"6-out16670"	.18911	66	283	349
6	"6-out16671"	.13802	49	306	355
6	"6-out16672"	.04046	14	332	346
6	"6-out16673"	.06442	23	334	357
6	"6-out16674"	.59417	306	209	515
6	"6-out16675"	.07220	20	257	277
6	"6-out16676"	.08609	26	276	302
6	"6-out16677"	.09157	176	1746	1922
6	"6-out16678"	.08112	55	623	678
6	"6-out16679"	.07788	93	1101	1194
6	"6-out16680"	.11731	42	316	358
6	"6-out16681"	.08482	19	205	224
6	"6-out16682"	.03137	8	247	255
6	"6-out16683"	.15736	93	498	591
6	"6-out16684"	.41359	292	414	706
6	"6-out16685"	.11618	28	213	241
6	"6-out16686"	.06652	32	449	481
6	"6-out16687"	.28571	72	180	252
6	"6-out16688"	.53529	91	79	170
6	"6-out16689"	.54314	107	90	197
6	"6-out16690"	.06983	50	666	716
6	"6-out16691"	.32089	215	455	670
6	"6-out16692"	.61764	21	13	34
6	"6-out16693"	.59159	394	272	666
6	"6-out16694"	.12922	88	593	681
6	"6-out16695"	.10795	95	785	880
6	"6-out16696"	.14553	101	593	694
6	"6-out16697"	.08933	62	632	694
6	"6-out16698"	.47909	275	299	574
6	"6-out16699"	.06844	303	4124	4427
6	"6-out16700"	.10289	462	4028	4490
6	"6-out16701"	.13483	12	77	89
6	"6-out16702"	.39823	45	68	113
6	"6-out16703"	.10475	86	735	821
6	"6-out16704"	.15463	15	82	97
6	"6-out16705"	.13271	86	562	648
6	"6-out16706"	.01405	6	421	427
6	"6-out16707"	.15055	95	536	631
6	"6-out16708"	.04794	14	278	292
6	"6-out16709"	.13066	49	326	375
6	"6-out16710"	.08986	258	2613	2871
6	"6-out16711"	.45000	99	121	220
6	"6-out16712"	.08091	64	727	791
6	"6-out16713"	.06000	18	282	300
6	"6-out16714"	.15555	42	228	270
6	"6-out16715"	.32733	91	187	278
6	"6-out16716"	.08513	118	1268	1386
6	"6-out16717"	.11111	22	176	198
6	"6-out16718"	.04455	70	1501	1571
6	"6-out16719"	.06466	28	405	433
6	"6-out16720"	.12401	189	1335	1524
6	"6-out16721"	.07155	40	519	559
6	"6-out16722"	.13508	303	1940	2243
6	"6-out16723"	.04960	19	364	383
6	"6-out16724"	.03861	10	249	259
6	"6-out16725"	.11585	38	290	328
6	"6-out16726"	.15564	40	217	257
6	"6-out16727"	.06166	23	350	373
6	"6-out16728"	.59803	61	41	102
6	"6-out16729"	.13026	34	227	261
6	"6-out16730"	.12812	389	2647	3036
6	"6-out16731"	.08133	122	1378	1500
6	"6-out16732"	.07385	37	464	501
6	"6-out16733"	.05711	59	974	1033
6	"6-out16734"	.08206	54	604	658
6	"6-out16735"	.49384	281	288	569
6	"6-out16736"	.11070	61	490	551
6	"6-out16737"	.47706	52	57	109
6	"6-out16738"	.09750	168	1555	1723
6	"6-out16739"	.39057	1160	1810	2970
6	"6-out16740"	.18274	36	161	197
6	"6-out16741"	.12365	138	978	1116
6	"6-out16742"	.06634	55	774	829
6	"6-out16743"	.14141	14	85	99
6	"6-out16744"	.14137	41	249	290
6	"6-out16745"	.16428	69	351	420
6	"6-out16746"	.12666	57	393	450
6	"6-out16747"	.13053	56	373	429
6	"6-out16748"	.08294	53	586	639
6	"6-out16749"	.08272	34	377	411
6	"6-out16750"	.09248	32	314	346
6	"6-out16751"	.39501	111	170	281
6	"6-out16752"	.12643	22	152	174
6	"6-out16753"	.04347	14	308	322
6	"6-out16754"	.08783	91	945	1036
6	"6-out16755"	.09876	24	219	243
6	"6-out16756"	.57142	212	159	371
6	"6-out16757"	.03703	47	1222	1269
6	"6-out16758"	.04313	38	843	881
6	"6-out16759"	.07661	77	928	1005
6	"6-out16760"	.12278	90	643	733
6	"6-out16761"	.12888	116	784	900
6	"6-out16762"	.53363	238	208	446
6	"6-out16763"	.11607	26	198	224
6	"6-out16764"	.11906	153	1132	1285
6	"6-out16765"	.13333	16	104	120
6	"6-out16766"	.09801	79	727	806
6	"6-out16767"	.67948	53	25	78
6	"6-out16768"	.59842	76	51	127
6	"6-out16769"	.05923	34	540	574
6	"6-out16770"	.52941	81	72	153
6	"6-out16771"	.06428	36	524	560
6	"6-out16772"	.07912	282	3282	3564
6	"6-out16773"	.06223	217	3270	3487
6	"6-out16774"	.09819	364	3343	3707
6	"6-out16775"	.12091	37	269	306
6	"6-out16776"	.34449	72	137	209
6	"6-out16777"	.07017	4	53	57
6	"6-out16778"	.07922	61	709	770
6	"6-out16779"	.10727	87	724	811
6	"6-out16780"	.14808	186	1070	1256
6	"6-out16781"	.34600	264	499	763
6	"6-out16782"	.25738	122	352	474
6	"6-out16783"	.05136	15	277	292
6	"6-out16784"	.16501	50	253	303
6	"6-out16785"	.07918	43	500	543
6	"6-out16786"	.04663	9	184	193
6	"6-out16787"	.05545	32	545	577
6	"6-out16788"	.28965	42	103	145
6	"6-out16789"	.12672	46	317	363
6	"6-out16790"	.08472	81	875	956
6	"6-out16791"	.07633	20	242	262
6	"6-out16792"	.06666	11	154	165
6	"6-out16793"	.30201	45	104	149
6	"6-out16794"	.50000	51	51	102
6	"6-out16795"	.10535	124	1053	1177
6	"6-out16796"	.14876	18	103	121
6	"6-out16797"	.30555	55	125	180
6	"6-out16798"	.56756	42	32	74
6	"6-out16799"	.43886	341	436	777
6	"6-out16800"	.43629	339	438	777
6	"6-out16801"	.45610	239	285	524
6	"6-out16802"	.15987	102	536	638
6	"6-out16803"	.02419	9	363	372
6	"6-out16804"	.17241	25	120	145
6	"6-out16805"	.19685	25	102	127
6	"6-out16806"	.08972	83	842	925
6	"6-out16807"	.19685	188	767	955
6	"6-out16808"	.11111	14	112	126
6	"6-out16809"	.10339	143	1240	1383
6	"6-out16810"	.11956	22	162	184
6	"6-out16811"	.17472	47	222	269
6	"6-out16812"	.36397	99	173	272
6	"6-out16813"	.36585	105	182	287
6	"6-out16814"	.08571	12	128	140
6	"6-out16815"	.07692	37	444	481
6	"6-out16816"	.10555	19	161	180
6	"6-out16817"	.07421	101	1260	1361
6	"6-out16818"	.13808	430	2684	3114
6	"6-out16819"	.25506	63	184	247
6	"6-out16820"	.26200	131	369	500
6	"6-out16821"	.25446	271	794	1065
6	"6-out16822"	.04069	7	165	172
6	"6-out16823"	.16417	77	392	469
6	"6-out16824"	.08900	17	174	191
6	"6-out16825"	.10158	32	283	315
6	"6-out16826"	.11836	78	581	659
6	"6-out16827"	.13207	91	598	689
6	"6-out16828"	.51562	66	62	128
6	"6-out16829"	.17118	120	581	701
6	"6-out16830"	.08910	9	92	101
6	"6-out16831"	.21671	83	300	383
6	"6-out16832"	.13793	40	250	290
6	"6-out16833"	.11433	63	488	551
6	"6-out16834"	.12890	33	223	256
6	"6-out16835"	.07454	65	807	872
6	"6-out16836"	.55555	50	40	90
6	"6-out16837"	.31901	52	111	163
6	"6-out16838"	.08305	25	276	301
6	"6-out16839"	.13243	196	1284	1480
6	"6-out16840"	.36274	37	65	102
6	"6-out16841"	.12085	51	371	422
6	"6-out16842"	.05769	30	490	520
6	"6-out16843"	.13157	10	66	76
6	"6-out16844"	.12075	32	233	265
6	"6-out16845"	.39310	57	88	145
6	"6-out16846"	.03470	11	306	317
6	"6-out16847"	.10199	41	361	402
6	"6-out16848"	.05303	7	125	132
6	"6-out16849"	.07201	44	567	611
6	"6-out16850"	.56530	277	213	490
6	"6-out16851"	.55714	273	217	490
6	"6-out16852"	.47420	239	265	504
6	"6-out16853"	.45992	241	283	524
6	"6-out16854"	.49508	252	257	509
6	"6-out16855"	.08651	43	454	497
6	"6-out16856"	.16759	30	149	179
6	"6-out16857"	.26086	36	102	138
6	"6-out16858"	.07284	11	140	151
6	"6-out16859"	.08759	12	125	137
6	"6-out16860"	.36734	54	93	147
6	"6-out16861"	.20000	10	40	50
6	"6-out16862"	.05633	36	603	639
6	"6-out16863"	.50264	95	94	189
6	"6-out16864"	.49735	94	95	189
6	"6-out16865"	.51851	98	91	189
6	"6-out16866"	.27941	38	98	136
6	"6-out16867"	.46341	95	110	205
6	"6-out16868"	.31322	135	296	431
6	"6-out16869"	.13053	118	786	904
6	"6-out16870"	.11363	50	390	440
6	"6-out16871"	.11070	30	241	271
6	"6-out16872"	.09538	93	882	975
6	"6-out16873"	.43371	337	440	777
6	"6-out16874"	.14326	50	299	349
6	"6-out16875"	.15813	34	181	215
6	"6-out16876"	.04674	33	673	706
6	"6-out16877"	.11934	29	214	243
6	"6-out16878"	.10200	61	537	598
6	"6-out16879"	.11265	81	638	719
6	"6-out16880"	.11811	60	448	508
6	"6-out16881"	.55900	90	71	161
6	"6-out16882"	.31558	83	180	263
6	"6-out16883"	.33460	88	175	263
6	"6-out16884"	.50000	265	265	530
6	"6-out16885"	.09162	82	813	895
6	"6-out16886"	.08194	64	717	781
6	"6-out16887"	.15546	37	201	238
6	"6-out16888"	.02469	2	79	81
6	"6-out16889"	.67901	55	26	81
6	"6-out16890"	.09259	10	98	108
6	"6-out16891"	.12111	39	283	322
6	"6-out16892"	.05022	11	208	219
6	"6-out16893"	.26470	54	150	204
6	"6-out16894"	.42307	22	30	52
6	"6-out16895"	.57936	73	53	126
6	"6-out16896"	.57812	37	27	64
6	"6-out16897"	.48051	37	40	77
6	"6-out16898"	.54237	32	27	59
6	"6-out16899"	.40000	22	33	55
6	"6-out16900"	.11631	144	1094	1238
6	"6-out16901"	.15885	122	646	768
6	"6-out16902"	.14615	114	666	780
6	"6-out16903"	.29333	66	159	225
6	"6-out16904"	.27625	121	317	438
6	"6-out16905"	.59677	37	25	62
6	"6-out16906"	.10859	163	1338	1501
6	"6-out16907"	.39200	49	76	125
6	"6-out16908"	.48832	251	263	514
6	"6-out16909"	.50458	55	54	109
6	"6-out16910"	.41891	93	129	222
6	"6-out16911"	.32989	32	65	97
6	"6-out16912"	.40662	135	197	332
6	"6-out16913"	.37037	40	68	108
6	"6-out16914"	.37037	40	68	108
6	"6-out16915"	.43103	75	99	174
6	"6-out16916"	.05209	46	837	883
6	"6-out16917"	.13573	49	312	361
6	"6-out16918"	.13521	48	307	355
6	"6-out16919"	.31325	26	57	83
6	"6-out16920"	.45679	37	44	81
6	"6-out16921"	.12280	14	100	114
6	"6-out16922"	.12573	43	299	342
6	"6-out16923"	.19428	68	282	350
6	"6-out16924"	.12556	28	195	223
6	"6-out16925"	.24299	26	81	107
6	"6-out16926"	.23008	26	87	113
6	"6-out16927"	.10105	96	854	950
6	"6-out16928"	.11196	73	579	652
6	"6-out16929"	.12658	60	414	474
6	"6-out16930"	.18042	59	268	327
6	"6-out16931"	.15636	43	232	275
6	"6-out16932"	.08644	37	391	428
6	"6-out16933"	.07657	34	410	444
6	"6-out16934"	.06451	6	87	93
6	"6-out16935"	.10833	13	107	120
6	"6-out16936"	.10679	33	276	309
6	"6-out16937"	.10000	27	243	270
6	"6-out16938"	.50872	175	169	344
6	"6-out16939"	.09970	34	307	341
6	"6-out16940"	.09917	84	763	847
6	"6-out16941"	.04000	15	360	375
6	"6-out16942"	.36250	29	51	80
6	"6-out16943"	.11000	33	267	300
6	"6-out16944"	.17525	68	320	388
6	"6-out16945"	.10357	58	502	560
6	"6-out16946"	.29702	120	284	404
6	"6-out16947"	.50000	105	105	210
6	"6-out16948"	.35209	294	541	835
6	"6-out16949"	.15577	31	168	199
6	"6-out16950"	.10922	58	473	531
6	"6-out16951"	.10627	61	513	574
6	"6-out16952"	.09859	21	192	213
6	"6-out16953"	.12121	36	261	297
6	"6-out16954"	.40957	77	111	188
6	"6-out16955"	.31395	81	177	258
6	"6-out16956"	.06007	34	532	566
6	"6-out16957"	.03743	7	180	187
6	"6-out16958"	.05928	30	476	506
6	"6-out16959"	.15202	90	502	592
6	"6-out16960"	.18947	324	1386	1710
6	"6-out16961"	.03825	57	1433	1490
6	"6-out16962"	.13836	22	137	159
6	"6-out16963"	.08172	38	427	465
6	"6-out16964"	.07488	34	420	454
6	"6-out16965"	.27137	73	196	269
6	"6-out16966"	.06250	5	75	80
6	"6-out16967"	.13687	49	309	358
6	"6-out16968"	.18604	48	210	258
6	"6-out16969"	.17441	60	284	344
6	"6-out16970"	.53523	319	277	596
6	"6-out16971"	.45733	134	159	293
6	"6-out16972"	.09754	294	2720	3014
6	"6-out16973"	.23303	79	260	339
6	"6-out16974"	.13666	41	259	300
6	"6-out16975"	.17993	486	2215	2701
6	"6-out16976"	.04545	4	84	88
6	"6-out16977"	.06510	25	359	384
6	"6-out16978"	.16129	10	52	62
6	"6-out16979"	.37979	109	178	287
6	"6-out16980"	.11195	133	1055	1188
6	"6-out16981"	.11065	27	217	244
6	"6-out16982"	.15946	48	253	301
6	"6-out16983"	.13981	46	283	329
6	"6-out16984"	.10269	118	1031	1149
6	"6-out16985"	.07187	23	297	320
6	"6-out16986"	.10204	40	352	392
6	"6-out16987"	.15273	95	527	622
6	"6-out16988"	.12117	329	2386	2715
6	"6-out16989"	.17857	95	437	532
6	"6-out16990"	.53843	1667	1429	3096
6	"6-out16991"	.26956	31	84	115
6	"6-out16992"	.10080	113	1008	1121
6	"6-out16993"	.09090	28	280	308
6	"6-out16994"	.60784	62	40	102
6	"6-out16995"	.28782	156	386	542
6	"6-out16996"	.45000	45	55	100
6	"6-out16997"	.17796	105	485	590
6	"6-out16998"	.05649	10	167	177
6	"6-out16999"	.38524	94	150	244
6	"6-out17000"	.54320	44	37	81
6	"6-out17001"	.10951	76	618	694
6	"6-out17002"	.07130	41	534	575
6	"6-out17003"	.08026	48	550	598
6	"6-out17004"	.21770	241	866	1107
6	"6-out17005"	.46055	216	253	469
6	"6-out17006"	.10300	48	418	466
6	"6-out17007"	.05607	6	101	107
6	"6-out17008"	.06692	153	2133	2286
6	"6-out17009"	.14421	76	451	527
6	"6-out17010"	.10884	16	131	147
6	"6-out17011"	.09401	11	106	117
6	"6-out17012"	.07667	95	1144	1239
6	"6-out17013"	.11340	55	430	485
6	"6-out17014"	.10533	154	1308	1462
6	"6-out17015"	.14328	48	287	335
6	"6-out17016"	.06086	35	540	575
6	"6-out17017"	.16801	83	411	494
6	"6-out17018"	.15000	135	765	900
6	"6-out17019"	.10223	55	483	538
6	"6-out17020"	.35795	567	1017	1584
6	"6-out17021"	.67088	53	26	79
6	"6-out17022"	.48550	268	284	552
6	"6-out17023"	.39692	129	196	325
6	"6-out17024"	.24539	160	492	652
6	"6-out17025"	.18611	67	293	360
6	"6-out17026"	.10674	19	159	178
6	"6-out17027"	.16711	123	613	736
6	"6-out17028"	.11842	108	804	912
6	"6-out17029"	.06682	57	796	853
6	"6-out17030"	.10880	42	344	386
6	"6-out17031"	.07545	119	1458	1577
6	"6-out17032"	.07363	119	1497	1616
6	"6-out17033"	.06105	29	446	475
6	"6-out17034"	.18390	32	142	174
6	"6-out17035"	.05555	20	340	360
6	"6-out17036"	.09418	34	327	361
6	"6-out17037"	.22185	67	235	302
6	"6-out17038"	.13712	41	258	299
6	"6-out17039"	.07213	22	283	305
6	"6-out17040"	.13200	33	217	250
6	"6-out17041"	.12820	35	238	273
6	"6-out17042"	.11619	254	1932	2186
6	"6-out17043"	.31210	647	1426	2073
6	"6-out17044"	.03750	15	385	400
6	"6-out17045"	.29854	123	289	412
6	"6-out17046"	.08900	166	1699	1865
6	"6-out17047"	.07431	136	1694	1830
6	"6-out17048"	.05172	105	1925	2030
6	"6-out17049"	.11190	220	1746	1966
6	"6-out17050"	.08235	154	1716	1870
6	"6-out17051"	.05715	117	1930	2047
6	"6-out17052"	.09626	206	1934	2140
6	"6-out17053"	.08003	168	1931	2099
6	"6-out17054"	.08748	181	1888	2069
6	"6-out17055"	.09602	29	273	302
6	"6-out17056"	.24324	117	364	481
6	"6-out17057"	.08009	33	379	412
6	"6-out17058"	.09879	49	447	496
6	"6-out17059"	.08895	29	297	326
6	"6-out17060"	.06862	21	285	306
6	"6-out17061"	.06042	20	311	331
6	"6-out17062"	.10119	51	453	504
6	"6-out17063"	.06505	35	503	538
6	"6-out17064"	.22438	127	439	566
6	"6-out17065"	.09979	246	2219	2465
6	"6-out17066"	.08703	200	2098	2298
6	"6-out17067"	.53389	63	55	118
6	"6-out17068"	.07455	46	571	617
6	"6-out17070"	.06636	102	1435	1537
6	"6-out17071"	.08746	30	313	343
6	"6-out17072"	.04062	13	307	320
6	"6-out17073"	.11706	83	626	709
6	"6-out17074"	.10692	71	593	664
6	"6-out17075"	.47967	59	64	123
6	"6-out17076"	.15769	41	219	260
6	"6-out17077"	.26356	68	190	258
6	"6-out17078"	.27325	47	125	172
6	"6-out17079"	.03940	8	195	203
6	"6-out17080"	.47688	196	215	411
6	"6-out17081"	.09876	48	438	486
6	"6-out17082"	.07581	37	451	488
6	"6-out17083"	.14473	55	325	380
6	"6-out17084"	.12169	46	332	378
6	"6-out17085"	.07223	32	411	443
6	"6-out17086"	.21676	106	383	489
6	"6-out17087"	.33333	26	52	78
6	"6-out17088"	.24390	20	62	82
6	"6-out17089"	.17543	50	235	285
6	"6-out17090"	.07490	20	247	267
6	"6-out17091"	.21238	96	356	452
6	"6-out17092"	.20384	53	207	260
6	"6-out17093"	.11904	10	74	84
6	"6-out17094"	.13043	12	80	92
6	"6-out17095"	.03153	7	215	222
6	"6-out17096"	.06785	19	261	280
6	"6-out17097"	.20224	18	71	89
6	"6-out17098"	.24107	27	85	112
6	"6-out17099"	.02898	6	201	207
6	"6-out17100"	.23577	29	94	123
6	"6-out17101"	.22198	103	361	464
6	"6-out17102"	.07918	35	407	442
6	"6-out17103"	.09523	14	133	147
6	"6-out17104"	.37500	81	135	216
6	"6-out17105"	.45038	118	144	262
6	"6-out17106"	.22540	55	189	244
6	"6-out17107"	.30484	214	488	702
6	"6-out17108"	.13333	62	403	465
6	"6-out17109"	.07774	29	344	373
6	"6-out17110"	.11778	49	367	416
6	"6-out17111"	.17818	49	226	275
6	"6-out17112"	.31349	237	519	756
6	"6-out17113"	.02469	2	79	81
6	"6-out17114"	.08771	5	52	57
6	"6-out17115"	.08346	54	593	647
6	"6-out17116"	.13846	72	448	520
6	"6-out17117"	.09941	34	308	342
6	"6-out17118"	.11942	91	671	762
6	"6-out17119"	.11167	44	350	394
6	"6-out17120"	.11864	91	676	767
6	"6-out17121"	.17977	48	219	267
6	"6-out17122"	.15904	73	386	459
6	"6-out17123"	.13035	67	447	514
6	"6-out17124"	.08507	65	699	764
6	"6-out17125"	.04663	9	184	193
6	"6-out17126"	.53030	70	62	132
6	"6-out17127"	.40611	93	136	229
6	"6-out17128"	.11790	27	202	229
6	"6-out17129"	.53478	123	107	230
6	"6-out17130"	.30410	111	254	365
6	"6-out17131"	.37967	71	116	187
6	"6-out17132"	.32121	53	112	165
6	"6-out17133"	.05988	10	157	167
6	"6-out17134"	.64102	75	42	117
6	"6-out17135"	.06650	28	393	421
6	"6-out17136"	.12886	25	169	194
6	"6-out17137"	.35977	127	226	353
6	"6-out17138"	.06919	51	686	737
6	"6-out17139"	.08773	417	4336	4753
6	"6-out17140"	.15577	31	168	199
6	"6-out17141"	.05820	11	178	189
6	"6-out17142"	.38287	152	245	397
6	"6-out17143"	.07038	29	383	412
6	"6-out17144"	.16666	33	165	198
6	"6-out17145"	.20445	101	393	494
6	"6-out17146"	.45059	114	139	253
6	"6-out17147"	.34230	89	171	260
6	"6-out17148"	.06202	57	862	919
6	"6-out17149"	.05351	54	955	1009
6	"6-out17150"	.17672	161	750	911
6	"6-out17151"	.02366	4	165	169
6	"6-out17152"	.12087	22	160	182
6	"6-out17153"	.06010	11	172	183
6	"6-out17154"	.08084	100	1137	1237
6	"6-out17155"	.29585	50	119	169
6	"6-out17156"	.08541	41	439	480
6	"6-out17157"	.14009	29	178	207
6	"6-out17158"	.56164	82	64	146
6	"6-out17159"	.10263	39	341	380
6	"6-out17160"	.13425	29	187	216
6	"6-out17161"	.10022	45	404	449
6	"6-out17162"	.09827	57	523	580
6	"6-out17163"	.50574	44	43	87
6	"6-out17164"	.12080	108	786	894
6	"6-out17165"	.14539	131	770	901
6	"6-out17166"	.12611	113	783	896
6	"6-out17167"	.05616	113	1899	2012
6	"6-out17168"	.06770	139	1914	2053
6	"6-out17169"	.13131	39	258	297
6	"6-out17170"	.41525	49	69	118
6	"6-out17171"	.11578	22	168	190
6	"6-out17172"	.38144	37	60	97
6	"6-out17173"	.55033	82	67	149
6	"6-out17174"	.11138	135	1077	1212
6	"6-out17175"	.35386	339	619	958
6	"6-out17176"	.08484	89	960	1049
6	"6-out17177"	.11091	124	994	1118
6	"6-out17178"	.08408	84	915	999
6	"6-out17179"	.07884	82	958	1040
6	"6-out17180"	.13483	48	308	356
6	"6-out17181"	.06072	79	1222	1301
6	"6-out17182"	.09053	111	1115	1226
6	"6-out17183"	.03827	8	201	209
6	"6-out17184"	.21428	36	132	168
6	"6-out17185"	.13956	109	672	781
6	"6-out17186"	.11369	83	647	730
6	"6-out17187"	.05787	43	700	743
6	"6-out17188"	.05901	37	590	627
6	"6-out17189"	.46052	140	164	304
6	"6-out17190"	.33892	101	197	298
6	"6-out17191"	.10806	67	553	620
6	"6-out17192"	.36792	156	268	424
6	"6-out17193"	.36792	156	268	424
6	"6-out17194"	.37203	157	265	422
6	"6-out17195"	.36792	156	268	424
6	"6-out17196"	.36792	156	268	424
6	"6-out17197"	.36792	156	268	424
6	"6-out17198"	.21276	330	1221	1551
6	"6-out17199"	.27971	433	1115	1548
6	"6-out17200"	.08421	16	174	190
6	"6-out17201"	.58490	62	44	106
6	"6-out17202"	.21670	96	347	443
6	"6-out17203"	.08000	52	598	650
6	"6-out17204"	.08108	15	170	185
6	"6-out17205"	.18296	58	259	317
6	"6-out17206"	.07106	28	366	394
6	"6-out17207"	.06824	26	355	381
6	"6-out17208"	.22656	87	297	384
6	"6-out17209"	.30909	85	190	275
6	"6-out17210"	.16022	87	456	543
6	"6-out17211"	.13372	69	447	516
6	"6-out17212"	.20115	243	965	1208
6	"6-out17213"	.25249	76	225	301
6	"6-out17214"	.07076	38	499	537
6	"6-out17215"	.23284	336	1107	1443
6	"6-out17216"	.06463	36	521	557
6	"6-out17217"	.07275	55	701	756
6	"6-out17218"	.15254	18	100	118
6	"6-out17219"	.22272	49	171	220
6	"6-out17220"	.22524	91	313	404
6	"6-out17221"	.08163	16	180	196
6	"6-out17222"	.06807	45	616	661
6	"6-out17223"	.08168	62	697	759
6	"6-out17224"	.06378	96	1409	1505
6	"6-out17225"	.10699	159	1327	1486
6	"6-out17226"	.08072	49	558	607
6	"6-out17227"	.15625	25	135	160
6	"6-out17228"	.13448	39	251	290
6	"6-out17229"	.13168	32	211	243
6	"6-out17230"	.43609	58	75	133
6	"6-out17231"	.34234	38	73	111
6	"6-out17232"	.08970	27	274	301
6	"6-out17233"	.17165	258	1245	1503
6	"6-out17234"	.13600	17	108	125
6	"6-out17235"	.19727	58	236	294
6	"6-out17236"	.11351	42	328	370
6	"6-out17237"	.66829	137	68	205
6	"6-out17238"	.19861	86	347	433
6	"6-out17239"	.27102	29	78	107
6	"6-out17240"	.06521	24	344	368
6	"6-out17241"	.11224	11	87	98
6	"6-out17242"	.15717	69	370	439
6	"6-out17243"	.15957	15	79	94
6	"6-out17244"	.08256	9	100	109
6	"6-out17245"	.09909	11	100	111
6	"6-out17246"	.24369	29	90	119
6	"6-out17247"	.04115	27	629	656
6	"6-out17248"	.08947	51	519	570
6	"6-out17249"	.33684	64	126	190
6	"6-out17250"	.06750	27	373	400
6	"6-out17251"	.07182	26	336	362
6	"6-out17252"	.08191	24	269	293
6	"6-out17253"	.12101	19	138	157
6	"6-out17254"	.11464	36	278	314
6	"6-out17255"	.05474	30	518	548
6	"6-out17256"	.55303	146	118	264
6	"6-out17257"	.48453	47	50	97
6	"6-out17258"	.18644	44	192	236
6	"6-out17259"	.06347	49	723	772
6	"6-out17260"	.35407	239	436	675
6	"6-out17261"	.12895	57	385	442
6	"6-out17262"	.08354	33	362	395
6	"6-out17263"	.10000	12	108	120
6	"6-out17264"	.29365	185	445	630
6	"6-out17265"	.13953	42	259	301
6	"6-out17266"	.17888	61	280	341
6	"6-out17267"	.20921	345	1304	1649
6	"6-out17268"	.08115	28	317	345
6	"6-out17269"	.08070	41	467	508
6	"6-out17270"	.09909	44	400	444
6	"6-out17271"	.24000	42	133	175
6	"6-out17272"	.20114	35	139	174
6	"6-out17273"	.11855	108	803	911
6	"6-out17274"	.11303	98	769	867
6	"6-out17275"	.59740	46	31	77
6	"6-out17276"	.36538	76	132	208
6	"6-out17277"	.12903	28	189	217
6	"6-out17278"	.18072	45	204	249
6	"6-out17279"	.06530	16	229	245
6	"6-out17280"	.11792	100	748	848
6	"6-out17281"	.15299	97	537	634
6	"6-out17282"	.06785	42	577	619
6	"6-out17283"	.03344	10	289	299
6	"6-out17284"	.13636	18	114	132
6	"6-out17285"	.39726	261	396	657
6	"6-out17286"	.13323	89	579	668
6	"6-out17287"	.10031	32	287	319
6	"6-out17288"	.08598	27	287	314
6	"6-out17289"	.05902	35	558	593
6	"6-out17290"	.06584	64	908	972
6	"6-out17291"	.11923	31	229	260
6	"6-out17292"	.47004	102	115	217
6	"6-out17293"	.10765	90	746	836
6	"6-out17294"	.21989	42	149	191
6	"6-out17295"	.44594	99	123	222
6	"6-out17296"	.06666	16	224	240
6	"6-out17297"	.10232	22	193	215
6	"6-out17298"	.18181	24	108	132
6	"6-out17299"	.17279	47	225	272
6	"6-out17300"	.07142	29	377	406
6	"6-out17301"	.26485	615	1707	2322
6	"6-out17302"	.06713	38	528	566
6	"6-out17303"	.16149	104	540	644
6	"6-out17304"	.08253	69	767	836
6	"6-out17305"	.13591	109	693	802
6	"6-out17306"	.47393	100	111	211
6	"6-out17307"	.04145	24	555	579
6	"6-out17308"	.25342	37	109	146
6	"6-out17309"	.11111	40	320	360
6	"6-out17310"	.52925	398	354	752
6	"6-out17311"	.41618	144	202	346
6	"6-out17312"	.17038	84	409	493
6	"6-out17313"	.07534	110	1350	1460
6	"6-out17314"	.08924	88	898	986
6	"6-out17315"	.32848	113	231	344
6	"6-out17316"	.09895	142	1293	1435
6	"6-out17317"	.18840	65	280	345
6	"6-out17318"	.23420	63	206	269
6	"6-out17319"	.44939	111	136	247
6	"6-out17320"	.29120	364	886	1250
6	"6-out17321"	.20881	109	413	522
6	"6-out17322"	.12030	64	468	532
6	"6-out17323"	.10344	33	286	319
6	"6-out17324"	.44720	72	89	161
6	"6-out17325"	.06018	13	203	216
6	"6-out17326"	.19680	123	502	625
6	"6-out17327"	.09041	84	845	929
6	"6-out17328"	.56028	79	62	141
6	"6-out17329"	.18045	24	109	133
6	"6-out17330"	.08482	19	205	224
6	"6-out17331"	.15163	79	442	521
6	"6-out17332"	.13121	66	437	503
6	"6-out17333"	.14229	144	868	1012
6	"6-out17334"	.10389	48	414	462
6	"6-out17335"	.11357	123	960	1083
6	"6-out17336"	.47368	234	260	494
6	"6-out17337"	.34351	180	344	524
6	"6-out17338"	.07403	154	1926	2080
6	"6-out17339"	.40970	211	304	515
6	"6-out17340"	.12975	75	503	578
6	"6-out17341"	.09308	70	682	752
6	"6-out17342"	.07006	33	438	471
6	"6-out17343"	.23144	131	435	566
6	"6-out17344"	.08894	37	379	416
6	"6-out17345"	.40192	209	311	520
6	"6-out17346"	.17226	41	197	238
6	"6-out17347"	.26810	137	374	511
6	"6-out17348"	.08454	29	314	343
6	"6-out17349"	.10674	57	477	534
6	"6-out17350"	.11217	47	372	419
6	"6-out17351"	.10833	13	107	120
6	"6-out17352"	.19612	81	332	413
6	"6-out17353"	.18373	61	271	332
6	"6-out17354"	.22777	82	278	360
6	"6-out17355"	.08445	25	271	296
6	"6-out17356"	.03640	17	450	467
6	"6-out17357"	.29411	230	552	782
6	"6-out17358"	.34615	72	136	208
6	"6-out17359"	.58713	283	199	482
6	"6-out17360"	.06134	110	1683	1793
6	"6-out17361"	.53191	50	44	94
6	"6-out17362"	.11175	58	461	519
6	"6-out17363"	.15053	28	158	186
6	"6-out17364"	.31858	36	77	113
6	"6-out17365"	.09090	35	350	385
6	"6-out17366"	.07291	21	267	288
6	"6-out17367"	.06049	17	264	281
6	"6-out17368"	.35323	71	130	201
6	"6-out17369"	.06885	44	595	639
6	"6-out17370"	.18835	55	237	292
6	"6-out17371"	.16556	25	126	151
6	"6-out17372"	.23101	73	243	316
6	"6-out17373"	.29487	46	110	156
6	"6-out17374"	.27329	44	117	161
6	"6-out17375"	.12061	306	2231	2537
6	"6-out17376"	.15652	18	97	115
6	"6-out17377"	.32936	83	169	252
6	"6-out17378"	.09232	101	993	1094
6	"6-out17379"	.10715	334	2783	3117
6	"6-out17380"	.26415	70	195	265
6	"6-out17381"	.46739	215	245	460
6	"6-out17382"	.33703	91	179	270
6	"6-out17383"	.13131	169	1118	1287
6	"6-out17384"	.09670	47	439	486
6	"6-out17385"	.22818	34	115	149
6	"6-out17386"	.36397	99	173	272
6	"6-out17387"	.08454	280	3032	3312
6	"6-out17388"	.27272	114	304	418
6	"6-out17389"	.15897	62	328	390
6	"6-out17390"	.37704	46	76	122
6	"6-out17391"	.04761	14	280	294
6	"6-out17392"	.13554	45	287	332
6	"6-out17393"	.16666	64	320	384
6	"6-out17394"	.16229	68	351	419
6	"6-out17395"	.44915	53	65	118
6	"6-out17396"	.12405	49	346	395
6	"6-out17397"	.15384	28	154	182
6	"6-out17398"	.10166	116	1025	1141
6	"6-out17399"	.40476	51	75	126
6	"6-out17400"	.11553	58	444	502
6	"6-out17401"	.22178	114	400	514
6	"6-out17402"	.08097	43	488	531
6	"6-out17403"	.06530	32	458	490
6	"6-out17404"	.10857	57	468	525
6	"6-out17405"	.49903	259	260	519
6	"6-out17406"	.49502	249	254	503
6	"6-out17407"	.13299	104	678	782
6	"6-out17408"	.22388	30	104	134
6	"6-out17409"	.20689	36	138	174
6	"6-out17410"	.39366	87	134	221
6	"6-out17411"	.57446	81	60	141
6	"6-out17412"	.11567	31	237	268
6	"6-out17413"	.16049	39	204	243
6	"6-out17414"	.11688	18	136	154
6	"6-out17415"	.65263	62	33	95
6	"6-out17416"	.42857	48	64	112
6	"6-out17417"	.12267	33	236	269
6	"6-out17418"	.06635	14	197	211
6	"6-out17419"	.24187	67	210	277
6	"6-out17420"	.08783	109	1132	1241
6	"6-out17421"	.07916	19	221	240
6	"6-out17422"	.27295	107	285	392
6	"6-out17423"	.07111	16	209	225
6	"6-out17424"	.06363	7	103	110
6	"6-out17425"	.11471	106	818	924
6	"6-out17426"	.08482	38	410	448
6	"6-out17427"	.08768	42	437	479
6	"6-out17428"	.09273	37	362	399
6	"6-out17429"	.12322	87	619	706
6	"6-out17430"	.09580	16	151	167
6	"6-out17431"	.04651	4	82	86
6	"6-out17432"	.12969	138	926	1064
6	"6-out17433"	.14893	14	80	94
6	"6-out17434"	.12519	161	1125	1286
6	"6-out17435"	.16455	13	66	79
6	"6-out17436"	.20238	17	67	84
6	"6-out17437"	.08836	41	423	464
6	"6-out17438"	.44675	172	213	385
6	"6-out17439"	.53409	47	41	88
6	"6-out17440"	.12920	123	829	952
6	"6-out17441"	.12725	106	727	833
6	"6-out17442"	.11929	34	251	285
6	"6-out17443"	.05164	69	1267	1336
6	"6-out17444"	.04574	57	1189	1246
6	"6-out17445"	.07692	31	372	403
6	"6-out17446"	.07854	26	305	331
6	"6-out17447"	.47151	149	167	316
6	"6-out17448"	.04610	16	331	347
6	"6-out17449"	.52525	52	47	99
6	"6-out17450"	.11351	194	1515	1709
6	"6-out17451"	.14511	147	866	1013
6	"6-out17452"	.13112	91	603	694
6	"6-out17453"	.07787	126	1492	1618
6	"6-out17454"	.07247	134	1715	1849
6	"6-out17455"	.15741	275	1472	1747
6	"6-out17456"	.12016	143	1047	1190
6	"6-out17457"	.07534	44	540	584
6	"6-out17458"	.13091	94	624	718
6	"6-out17459"	.05668	28	466	494
6	"6-out17460"	.08871	444	4561	5005
6	"6-out17461"	.24250	97	303	400
6	"6-out17462"	.22621	107	366	473
6	"6-out17463"	.08254	35	389	424
6	"6-out17464"	.25000	108	324	432
6	"6-out17465"	.09111	41	409	450
6	"6-out17466"	.36511	157	273	430
6	"6-out17467"	.18085	102	462	564
6	"6-out17468"	.18794	106	458	564
6	"6-out17469"	.26355	311	869	1180
6	"6-out17470"	.09980	51	460	511
6	"6-out17471"	.08450	54	585	639
6	"6-out17472"	.11909	63	466	529
6	"6-out17473"	.09472	61	583	644
6	"6-out17474"	.29399	142	341	483
6	"6-out17475"	.10772	113	936	1049
6	"6-out17476"	.23190	173	573	746
6	"6-out17477"	.11412	80	621	701
6	"6-out17478"	.12865	44	298	342
6	"6-out17479"	.14957	35	199	234
6	"6-out17480"	.09677	36	336	372
6	"6-out17481"	.07920	32	372	404
6	"6-out17482"	.09473	18	172	190
6	"6-out17483"	.12568	46	320	366
6	"6-out17484"	.11774	71	532	603
6	"6-out17485"	.09795	24	221	245
6	"6-out17486"	.55026	208	170	378
6	"6-out17487"	.54497	206	172	378
6	"6-out17488"	.23360	57	187	244
6	"6-out17489"	.06557	16	228	244
6	"6-out17490"	.09367	37	358	395
6	"6-out17491"	.19746	78	317	395
6	"6-out17492"	.13953	18	111	129
6	"6-out17493"	.09207	36	355	391
6	"6-out17494"	.44897	704	864	1568
6	"6-out17495"	.45783	76	90	166
6	"6-out17496"	.03773	4	102	106
6	"6-out17497"	.14218	60	362	422
6	"6-out17498"	.18250	121	542	663
6	"6-out17499"	.06967	17	227	244
6	"6-out17500"	.13636	57	361	418
6	"6-out17501"	.03621	13	346	359
6	"6-out17502"	.39215	20	31	51
6	"6-out17503"	.10073	41	366	407
6	"6-out17504"	.01704	6	346	352
6	"6-out17505"	.09505	25	238	263
6	"6-out17506"	.06000	21	329	350
6	"6-out17507"	.41925	270	374	644
6	"6-out17508"	.11764	60	450	510
6	"6-out17509"	.06060	28	434	462
6	"6-out17510"	.06903	72	971	1043
6	"6-out17511"	.11776	61	457	518
6	"6-out17512"	.08835	85	877	962
6	"6-out17513"	.26724	31	85	116
6	"6-out17514"	.04669	41	837	878
6	"6-out17515"	.14285	39	234	273
6	"6-out17516"	.15476	52	284	336
6	"6-out17517"	.20055	72	287	359
6	"6-out17518"	.04739	10	201	211
6	"6-out17519"	.08376	80	875	955
6	"6-out17520"	.10042	95	851	946
6	"6-out17521"	.07906	54	629	683
6	"6-out17522"	.11003	57	461	518
6	"6-out17523"	.07981	34	392	426
6	"6-out17524"	.05046	27	508	535
6	"6-out17525"	.20512	16	62	78
6	"6-out17526"	.43421	33	43	76
6	"6-out17527"	.46634	194	222	416
6	"6-out17528"	.15076	147	828	975
6	"6-out17529"	.11630	112	851	963
6	"6-out17530"	.06660	72	1009	1081
6	"6-out17531"	.35645	370	668	1038
6	"6-out17532"	.12246	127	910	1037
6	"6-out17533"	.43414	89	116	205
6	"6-out17534"	.40000	82	123	205
6	"6-out17535"	.20570	101	390	491
6	"6-out17536"	.03473	19	528	547
6	"6-out17537"	.09852	40	366	406
6	"6-out17538"	.17964	60	274	334
6	"6-out17539"	.38754	112	177	289
6	"6-out17540"	.47066	385	433	818
6	"6-out17541"	.04460	31	664	695
6	"6-out17542"	.07804	16	189	205
6	"6-out17543"	.17073	28	136	164
6	"6-out17544"	.07142	11	143	154
6	"6-out17545"	.23648	35	113	148
6	"6-out17546"	.12950	133	894	1027
6	"6-out17547"	.65868	330	171	501
6	"6-out17548"	.08983	106	1074	1180
6	"6-out17549"	.15059	178	1004	1182
6	"6-out17550"	.07302	121	1536	1657
6	"6-out17551"	.07970	130	1501	1631
6	"6-out17552"	.08880	50	513	563
6	"6-out17553"	.14791	117	674	791
6	"6-out17554"	.08389	50	546	596
6	"6-out17555"	.03384	11	314	325
6	"6-out17556"	.12876	124	839	963
6	"6-out17557"	.06034	42	654	696
6	"6-out17558"	.08309	57	629	686
6	"6-out17559"	.09098	113	1129	1242
6	"6-out17560"	.09715	130	1208	1338
6	"6-out17561"	.32824	129	264	393
6	"6-out17562"	.11428	56	434	490
6	"6-out17563"	.11764	10	75	85
6	"6-out17564"	.15463	15	82	97
6	"6-out17565"	.19767	17	69	86
6	"6-out17566"	.08077	29	330	359
6	"6-out17567"	.05906	44	701	745
6	"6-out17568"	.04205	18	410	428
6	"6-out17569"	.13309	76	495	571
6	"6-out17570"	.10067	30	268	298
6	"6-out17571"	.09729	54	501	555
6	"6-out17572"	.12758	37	253	290
6	"6-out17573"	.44444	52	65	117
6	"6-out17574"	.26956	62	168	230
6	"6-out17575"	.04882	27	526	553
6	"6-out17576"	.09620	33	310	343
6	"6-out17577"	.14792	100	576	676
6	"6-out17578"	.51282	60	57	117
6	"6-out17579"	.42148	51	70	121
6	"6-out17580"	.40833	49	71	120
6	"6-out17581"	.04924	13	251	264
6	"6-out17582"	.12380	52	368	420
6	"6-out17583"	.12177	52	375	427
6	"6-out17584"	.45299	53	64	117
6	"6-out17585"	.04332	25	552	577
6	"6-out17586"	.35726	214	385	599
6	"6-out17587"	.20729	108	413	521
6	"6-out17588"	.08445	44	477	521
6	"6-out17589"	.27821	143	371	514
6	"6-out17590"	.06725	84	1165	1249
6	"6-out17591"	.14314	70	419	489
6	"6-out17592"	.06824	23	314	337
6	"6-out17593"	.07142	33	429	462
6	"6-out17594"	.52000	312	288	600
6	"6-out17595"	.14792	75	432	507
6	"6-out17596"	.07479	46	569	615
6	"6-out17597"	.10935	90	733	823
6	"6-out17598"	.06746	45	622	667
6	"6-out17599"	.17673	79	368	447
6	"6-out17600"	.11538	57	437	494
6	"6-out17601"	.12580	39	271	310
6	"6-out17602"	.08492	98	1056	1154
6	"6-out17603"	.10406	41	353	394
6	"6-out17604"	.23706	165	531	696
6	"6-out17605"	.11363	85	663	748
6	"6-out17606"	.10093	119	1060	1179
6	"6-out17607"	.11111	130	1040	1170
6	"6-out17608"	.05475	19	328	347
6	"6-out17609"	.13288	297	1938	2235
6	"6-out17610"	.22681	181	617	798
6	"6-out17611"	.09065	97	973	1070
6	"6-out17612"	.17201	177	852	1029
6	"6-out17613"	.10192	53	467	520
6	"6-out17614"	.09750	117	1083	1200
6	"6-out17615"	.48484	128	136	264
6	"6-out17616"	.11842	54	402	456
6	"6-out17617"	.17907	101	463	564
6	"6-out17618"	.16252	85	438	523
6	"6-out17619"	.24038	100	316	416
6	"6-out17620"	.10936	230	1873	2103
6	"6-out17621"	.11296	61	479	540
6	"6-out17622"	.14013	81	497	578
6	"6-out17623"	.30277	142	327	469
6	"6-out17624"	.06299	16	238	254
6	"6-out17625"	.04560	14	293	307
6	"6-out17626"	.12280	56	400	456
6	"6-out17627"	.05244	45	813	858
6	"6-out17628"	.04093	21	492	513
6	"6-out17629"	.06200	31	469	500
6	"6-out17630"	.11575	205	1566	1771
6	"6-out17631"	.26086	132	374	506
6	"6-out17632"	.06331	107	1583	1690
6	"6-out17633"	.08413	35	381	416
6	"6-out17634"	.25000	118	354	472
6	"6-out17635"	.52631	110	99	209
6	"6-out17636"	.16981	54	264	318
6	"6-out17637"	.12397	136	961	1097
6	"6-out17638"	.07108	74	967	1041
6	"6-out17639"	.43902	90	115	205
6	"6-out17640"	.54950	111	91	202
6	"6-out17641"	.10445	61	523	584
6	"6-out17642"	.16956	78	382	460
6	"6-out17643"	.07736	27	322	349
6	"6-out17644"	.08203	37	414	451
6	"6-out17645"	.05823	29	469	498
6	"6-out17646"	.15734	76	407	483
6	"6-out17647"	.45736	59	70	129
6	"6-out17648"	.05128	6	111	117
6	"6-out17649"	.09797	213	1961	2174
6	"6-out17650"	.07547	16	196	212
6	"6-out17651"	.25694	37	107	144
6	"6-out17652"	.02000	4	196	200
6	"6-out17653"	.08698	119	1249	1368
6	"6-out17654"	.09328	25	243	268
6	"6-out17655"	.05479	8	138	146
6	"6-out17656"	.09643	46	431	477
6	"6-out17657"	.52861	157	140	297
6	"6-out17658"	.37463	130	217	347
6	"6-out17659"	.48920	272	284	556
6	"6-out17660"	.14950	135	768	903
6	"6-out17661"	.28909	244	600	844
6	"6-out17662"	.07023	21	278	299
6	"6-out17663"	.10738	32	266	298
6	"6-out17664"	.13367	104	674	778
6	"6-out17665"	.09503	44	419	463
6	"6-out17666"	.06914	13	175	188
6	"6-out17667"	.15533	16	87	103
6	"6-out17668"	.06217	36	543	579
6	"6-out17669"	.07079	72	945	1017
6	"6-out17670"	.07793	77	911	988
6	"6-out17671"	.09959	99	895	994
6	"6-out17672"	.07088	56	734	790
6	"6-out17673"	.08148	66	744	810
6	"6-out17674"	.33602	416	822	1238
6	"6-out17675"	.09815	16	147	163
6	"6-out17676"	.13869	157	975	1132
6	"6-out17677"	.14441	119	705	824
6	"6-out17678"	.10606	28	236	264
6	"6-out17679"	.17993	113	515	628
6	"6-out17680"	.08421	16	174	190
6	"6-out17681"	.11612	162	1233	1395
6	"6-out17682"	.08488	91	981	1072
6	"6-out17683"	.16464	95	482	577
6	"6-out17684"	.05794	113	1837	1950
6	"6-out17685"	.07978	103	1188	1291
6	"6-out17686"	.57941	456	331	787
6	"6-out17687"	.38482	695	1111	1806
6	"6-out17688"	.13135	168	1111	1279
6	"6-out17689"	.26256	188	528	716
6	"6-out17690"	.13461	63	405	468
6	"6-out17691"	.10560	49	415	464
6	"6-out17692"	.06496	28	403	431
6	"6-out17693"	.05939	37	586	623
6	"6-out17694"	.39747	252	382	634
6	"6-out17695"	.09375	42	406	448
6	"6-out17696"	.15517	99	539	638
6	"6-out17697"	.11433	63	488	551
6	"6-out17698"	.09038	47	473	520
6	"6-out17699"	.10841	58	477	535
6	"6-out17700"	.08504	29	312	341
6	"6-out17701"	.11464	72	556	628
6	"6-out17702"	.09925	53	481	534
6	"6-out17703"	.08552	26	278	304
6	"6-out17704"	.07414	37	462	499
6	"6-out17705"	.06709	21	292	313
6	"6-out17706"	.08088	22	250	272
6	"6-out17707"	.10396	55	474	529
6	"6-out17708"	.25680	66	191	257
6	"6-out17709"	.04357	19	417	436
6	"6-out17710"	.48788	141	148	289
6	"6-out17711"	.06880	60	812	872
6	"6-out17712"	.05276	21	377	398
6	"6-out17713"	.07637	32	387	419
6	"6-out17714"	.12676	108	744	852
6	"6-out17715"	.07102	75	981	1056
6	"6-out17716"	.11377	152	1184	1336
6	"6-out17717"	.07253	112	1432	1544
6	"6-out17718"	.23269	363	1197	1560
6	"6-out17719"	.06938	114	1529	1643
6	"6-out17720"	.19243	56	235	291
6	"6-out17721"	.37542	110	183	293
6	"6-out17722"	.08920	124	1266	1390
6	"6-out17723"	.02811	16	553	569
6	"6-out17724"	.32213	163	343	506
6	"6-out17725"	.10478	46	393	439
6	"6-out17726"	.30904	229	512	741
6	"6-out17727"	.07191	21	271	292
6	"6-out17728"	.06593	24	340	364
6	"6-out17729"	.13254	101	661	762
6	"6-out17730"	.43697	52	67	119
6	"6-out17731"	.09688	56	522	578
6	"6-out17732"	.08108	81	918	999
6	"6-out17733"	.38983	46	72	118
6	"6-out17734"	.42016	50	69	119
6	"6-out17735"	.02572	8	303	311
6	"6-out17736"	.15053	56	316	372
6	"6-out17737"	.06284	23	343	366
6	"6-out17738"	.08762	17	177	194
6	"6-out17739"	.05714	22	363	385
6	"6-out17740"	.29710	123	291	414
6	"6-out17741"	.26086	42	119	161
6	"6-out17742"	.08520	19	204	223
6	"6-out17743"	.49272	271	279	550
6	"6-out17744"	.11944	78	575	653
6	"6-out17745"	.07692	12	144	156
6	"6-out17746"	.16438	204	1037	1241
6	"6-out17747"	.39826	92	139	231
6	"6-out17748"	.07200	9	116	125
6	"6-out17749"	.26829	66	180	246
6	"6-out17750"	.28917	227	558	785
6	"6-out17751"	.16891	25	123	148
6	"6-out17752"	.55855	186	147	333
6	"6-out17753"	.11428	36	279	315
6	"6-out17754"	.22222	34	119	153
6	"6-out17755"	.23877	133	424	557
6	"6-out17756"	.07291	14	178	192
6	"6-out17757"	.05357	15	265	280
6	"6-out17758"	.12676	18	124	142
6	"6-out17759"	.05220	13	236	249
6	"6-out17760"	.03703	5	130	135
6	"6-out17761"	.15163	37	207	244
6	"6-out17762"	.13861	42	261	303
6	"6-out17763"	.11607	122	929	1051
6	"6-out17764"	.07070	84	1104	1188
6	"6-out17765"	.12309	97	691	788
6	"6-out17766"	.11327	128	1002	1130
6	"6-out17767"	.13167	69	455	524
6	"6-out17768"	.14561	68	399	467
6	"6-out17769"	.09741	49	454	503
6	"6-out17770"	.07746	33	393	426
6	"6-out17771"	.10833	52	428	480
6	"6-out17772"	.07900	38	443	481
6	"6-out17773"	.05524	10	171	181
6	"6-out17774"	.03049	19	604	623
6	"6-out17775"	.06278	28	418	446
6	"6-out17776"	.29870	46	108	154
6	"6-out17777"	.12423	61	430	491
6	"6-out17778"	.10328	578	5018	5596
6	"6-out17779"	.18750	15	65	80
6	"6-out17780"	.49696	82	83	165
6	"6-out17781"	.01104	2	179	181
6	"6-out17782"	.06303	22	327	349
6	"6-out17783"	.12031	154	1126	1280
6	"6-out17784"	.42268	41	56	97
6	"6-out17785"	.30714	43	97	140
6	"6-out17786"	.37560	77	128	205
6	"6-out17787"	.15964	72	379	451
6	"6-out17788"	.53418	125	109	234
6	"6-out17789"	.34306	94	180	274
6	"6-out17790"	.30446	109	249	358
6	"6-out17791"	.05945	11	174	185
6	"6-out17792"	.05630	21	352	373
6	"6-out17793"	.43638	950	1227	2177
6	"6-out17794"	.42895	160	213	373
6	"6-out17795"	.29185	129	313	442
6	"6-out17796"	.28000	105	270	375
6	"6-out17797"	.07066	46	605	651
6	"6-out17798"	.09333	56	544	600
6	"6-out17799"	.07957	67	775	842
6	"6-out17800"	.09770	119	1099	1218
6	"6-out17801"	.13346	339	2201	2540
6	"6-out17802"	.09565	99	936	1035
6	"6-out17803"	.28596	332	829	1161
6	"6-out17804"	.20779	32	122	154
6	"6-out17805"	.09982	115	1037	1152
6	"6-out17806"	.07919	83	965	1048
6	"6-out17807"	.20289	28	110	138
6	"6-out17808"	.66800	167	83	250
6	"6-out17809"	.09459	91	871	962
6	"6-out17810"	.13447	55	354	409
6	"6-out17811"	.13659	53	335	388
6	"6-out17812"	.39316	46	71	117
6	"6-out17813"	.41525	49	69	118
6	"6-out17814"	.11855	23	171	194
6	"6-out17815"	.48000	72	78	150
6	"6-out17816"	.19090	21	89	110
6	"6-out17817"	.58119	68	49	117
6	"6-out17818"	.39285	55	85	140
6	"6-out17819"	.06060	10	155	165
6	"6-out17820"	.07034	65	859	924
6	"6-out17821"	.23206	55	182	237
6	"6-out17822"	.11145	73	582	655
6	"6-out17823"	.15578	353	1913	2266
6	"6-out17824"	.36150	355	627	982
6	"6-out17825"	.17475	36	170	206
6	"6-out17826"	.13738	140	879	1019
6	"6-out17827"	.05882	7	112	119
6	"6-out17828"	.31896	37	79	116
6	"6-out17829"	.40528	92	135	227
6	"6-out17830"	.17180	39	188	227
6	"6-out17831"	.21182	154	573	727
6	"6-out17832"	.31088	180	399	579
6	"6-out17833"	.09782	18	166	184
6	"6-out17834"	.12038	62	453	515
6	"6-out17835"	.07455	116	1440	1556
6	"6-out17836"	.07950	45	521	566
6	"6-out17837"	.20610	27	104	131
6	"6-out17838"	.18705	26	113	139
6	"6-out17839"	.37500	60	100	160
6	"6-out17840"	.08510	56	602	658
6	"6-out17841"	.36552	352	611	963
6	"6-out17842"	.05691	58	961	1019
6	"6-out17843"	.11571	109	833	942
6	"6-out17844"	.07323	78	987	1065
6	"6-out17845"	.10349	222	1923	2145
6	"6-out17846"	.11142	80	638	718
6	"6-out17847"	.46341	95	110	205
6	"6-out17848"	.27424	164	434	598
6	"6-out17849"	.10515	49	417	466
6	"6-out17850"	.04672	5	102	107
6	"6-out17851"	.12578	20	139	159
6	"6-out17852"	.12543	36	251	287
6	"6-out17853"	.06334	61	902	963
6	"6-out17854"	.17473	260	1228	1488
6	"6-out17855"	.08888	140	1435	1575
6	"6-out17856"	.12195	10	72	82
6	"6-out17857"	.40168	286	426	712
6	"6-out17858"	.07520	47	578	625
6	"6-out17859"	.09844	57	522	579
6	"6-out17860"	.05474	71	1226	1297
6	"6-out17861"	.05716	79	1303	1382
6	"6-out17862"	.11851	16	119	135
6	"6-out17863"	.18309	39	174	213
6	"6-out17864"	.11877	143	1061	1204
6	"6-out17865"	.06484	142	2048	2190
6	"6-out17866"	.24273	142	443	585
6	"6-out17867"	.11211	112	887	999
6	"6-out17868"	.41988	76	105	181
6	"6-out17869"	.11646	29	220	249
6	"6-out17870"	.06250	19	285	304
6	"6-out17871"	.12250	43	308	351
6	"6-out17872"	.08959	198	2012	2210
6	"6-out17873"	.51288	219	208	427
6	"6-out17874"	.09341	44	427	471
6	"6-out17875"	.10342	130	1127	1257
6	"6-out17876"	.14570	73	428	501
6	"6-out17877"	.17919	93	426	519
6	"6-out17878"	.15266	109	605	714
6	"6-out17879"	.10487	129	1101	1230
6	"6-out17880"	.10082	49	437	486
6	"6-out17881"	.06144	40	611	651
6	"6-out17882"	.02884	6	202	208
6	"6-out17883"	.05945	94	1487	1581
6	"6-out17884"	.12820	50	340	390
6	"6-out17885"	.06470	22	318	340
6	"6-out17886"	.09300	105	1024	1129
6	"6-out17887"	.10451	81	694	775
6	"6-out17888"	.42403	307	417	724
6	"6-out17889"	.22464	144	497	641
6	"6-out17890"	.32296	135	283	418
6	"6-out17891"	.07006	33	438	471
6	"6-out17892"	.44537	53	66	119
6	"6-out17893"	.38461	45	72	117
6	"6-out17894"	.42735	50	67	117
6	"6-out17895"	.04651	14	287	301
6	"6-out17896"	.40170	47	70	117
6	"6-out17897"	.10303	34	296	330
6	"6-out17898"	.10553	61	517	578
6	"6-out17899"	.04516	7	148	155
6	"6-out17900"	.14516	36	212	248
6	"6-out17901"	.25212	89	264	353
6	"6-out17902"	.40000	50	75	125
6	"6-out17903"	.30827	41	92	133
6	"6-out17904"	.15332	90	497	587
6	"6-out17905"	.32780	158	324	482
6	"6-out17906"	.15808	43	229	272
6	"6-out17907"	.13937	240	1482	1722
6	"6-out17908"	.09745	69	639	708
6	"6-out17909"	.09500	38	362	400
6	"6-out17910"	.19063	57	242	299
6	"6-out17911"	.07907	48	559	607
6	"6-out17912"	.16507	52	263	315
6	"6-out17913"	.07894	18	210	228
6	"6-out17914"	.40740	77	112	189
6	"6-out17915"	.46031	87	102	189
6	"6-out17916"	.53968	102	87	189
6	"6-out17917"	.14973	28	159	187
6	"6-out17918"	.18855	112	482	594
6	"6-out17919"	.34000	68	132	200
6	"6-out17920"	.34693	68	128	196
6	"6-out17921"	.34078	61	118	179
6	"6-out17922"	.16877	80	394	474
6	"6-out17923"	.06944	10	134	144
6	"6-out17924"	.06879	56	758	814
6	"6-out17925"	.03877	53	1314	1367
6	"6-out17926"	.57258	71	53	124
6	"6-out17927"	.07114	89	1162	1251
6	"6-out17928"	.44270	170	214	384
6	"6-out17929"	.13207	21	138	159
6	"6-out17930"	.38679	41	65	106
6	"6-out17931"	.31924	68	145	213
6	"6-out17932"	.49597	185	188	373
6	"6-out17933"	.09634	87	816	903
6	"6-out17934"	.11979	23	169	192
6	"6-out17935"	.08907	119	1217	1336
6	"6-out17936"	.31993	382	812	1194
6	"6-out17937"	.16461	67	340	407
6	"6-out17938"	.45283	216	261	477
6	"6-out17939"	.12727	105	720	825
6	"6-out17940"	.11764	18	135	153
6	"6-out17941"	.11111	20	160	180
6	"6-out17942"	.11481	62	478	540
6	"6-out17943"	.06146	26	397	423
6	"6-out17944"	.07070	42	552	594
6	"6-out17945"	.09895	38	346	384
6	"6-out17946"	.17408	43	204	247
6	"6-out17947"	.06329	25	370	395
6	"6-out17948"	.43750	63	81	144
6	"6-out17949"	.07857	44	516	560
6	"6-out17950"	.08500	17	183	200
6	"6-out17951"	.12705	85	584	669
6	"6-out17952"	.19736	60	244	304
6	"6-out17953"	.46296	50	58	108
6	"6-out17954"	.08961	63	640	703
6	"6-out17955"	.05670	11	183	194
6	"6-out17956"	.06787	15	206	221
6	"6-out17957"	.02654	6	220	226
6	"6-out17958"	.54700	64	53	117
6	"6-out17959"	.57264	67	50	117
6	"6-out17960"	.13461	42	270	312
6	"6-out17961"	.52762	382	342	724
6	"6-out17962"	.24566	85	261	346
6	"6-out17963"	.39591	97	148	245
6	"6-out17964"	.19607	30	123	153
6	"6-out17965"	.07187	114	1472	1586
6	"6-out17966"	.05639	15	251	266
6	"6-out17967"	.06774	42	578	620
6	"6-out17968"	.18400	23	102	125
6	"6-out17969"	.51840	169	157	326
6	"6-out17970"	.32537	109	226	335
6	"6-out17971"	.11392	18	140	158
6	"6-out17972"	.62195	102	62	164
6	"6-out17973"	.40566	43	63	106
6	"6-out17974"	.56878	215	163	378
6	"6-out17975"	.06156	37	564	601
6	"6-out17976"	.08809	37	383	420
6	"6-out17977"	.32244	296	622	918
6	"6-out17978"	.06286	32	477	509
6	"6-out17979"	.07625	35	424	459
6	"6-out17980"	.13131	13	86	99
6	"6-out17981"	.11805	17	127	144
6	"6-out17982"	.08241	45	501	546
6	"6-out17983"	.09233	59	580	639
6	"6-out17984"	.09693	38	354	392
6	"6-out17985"	.31988	111	236	347
6	"6-out17986"	.15731	115	616	731
6	"6-out17987"	.15000	90	510	600
6	"6-out17988"	.12183	106	764	870
6	"6-out17989"	.35223	118	217	335
6	"6-out17990"	.05526	21	359	380
6	"6-out17991"	.13991	170	1045	1215
6	"6-out17992"	.14979	74	420	494
6	"6-out17993"	.11898	42	311	353
6	"6-out17994"	.31952	108	230	338
6	"6-out17995"	.16831	68	336	404
6	"6-out17996"	.09909	33	300	333
6	"6-out17997"	.19971	142	569	711
6	"6-out17998"	.07110	31	405	436
6	"6-out17999"	.19803	101	409	510
6	"6-out18000"	.05296	50	894	944
6	"6-out18001"	.07780	68	806	874
6	"6-out18002"	.03194	10	303	313
6	"6-out18003"	.17675	73	340	413
6	"6-out18004"	.16304	60	308	368
6	"6-out18005"	.05714	4	66	70
6	"6-out18006"	.31418	186	406	592
6	"6-out18007"	.25000	160	480	640
6	"6-out18008"	.05298	24	429	453
6	"6-out18009"	.13432	9	58	67
6	"6-out18010"	.03508	16	440	456
6	"6-out18011"	.07812	40	472	512
6	"6-out18012"	.28028	472	1212	1684
6	"6-out18013"	.14970	50	284	334
6	"6-out18014"	.19597	39	160	199
6	"6-out18015"	.09782	18	166	184
6	"6-out18016"	.05027	9	170	179
6	"6-out18017"	.10679	22	184	206
6	"6-out18018"	.07344	13	164	177
6	"6-out18019"	.16593	38	191	229
6	"6-out18020"	.08752	40	417	457
6	"6-out18021"	.29585	50	119	169
6	"6-out18022"	.42105	88	121	209
6	"6-out18023"	.10256	48	420	468
6	"6-out18024"	.51439	268	253	521
6	"6-out18025"	.15303	58	321	379
6	"6-out18026"	.05309	24	428	452
6	"6-out18027"	.59532	331	225	556
6	"6-out18028"	.06608	38	537	575
6	"6-out18029"	.19124	83	351	434
6	"6-out18030"	.05709	31	512	543
6	"6-out18031"	.08656	29	306	335
6	"6-out18032"	.39299	516	797	1313
6	"6-out18033"	.12011	43	315	358
6	"6-out18034"	.07309	50	634	684
6	"6-out18035"	.05000	8	152	160
6	"6-out18036"	.07024	17	225	242
6	"6-out18037"	.12096	30	218	248
6	"6-out18038"	.14003	262	1609	1871
6	"6-out18039"	.35398	120	219	339
6	"6-out18040"	.07605	47	571	618
6	"6-out18041"	.20312	117	459	576
6	"6-out18042"	.14933	181	1031	1212
6	"6-out18043"	.10266	54	472	526
6	"6-out18044"	.10374	72	622	694
6	"6-out18045"	.58558	390	276	666
6	"6-out18046"	.02238	6	262	268
6	"6-out18047"	.10064	47	420	467
6	"6-out18048"	.08045	28	320	348
6	"6-out18049"	.08000	6	69	75
6	"6-out18050"	.06783	27	371	398
6	"6-out18051"	.02727	9	321	330
6	"6-out18052"	.09468	98	937	1035
6	"6-out18053"	.04643	15	308	323
6	"6-out18054"	.06981	37	493	530
6	"6-out18055"	.14974	59	335	394
6	"6-out18056"	.07142	6	78	84
6	"6-out18057"	.11572	39	298	337
6	"6-out18058"	.39449	43	66	109
6	"6-out18059"	.54790	366	302	668
6	"6-out18060"	.08687	131	1377	1508
6	"6-out18061"	.12993	56	375	431
6	"6-out18062"	.10389	32	276	308
6	"6-out18063"	.56875	91	69	160
6	"6-out18064"	.09489	39	372	411
6	"6-out18065"	.15824	94	500	594
6	"6-out18066"	.03023	14	449	463
6	"6-out18067"	.08832	28	289	317
6	"6-out18068"	.05108	26	483	509
6	"6-out18069"	.29648	59	140	199
6	"6-out18070"	.10502	23	196	219
6	"6-out18071"	.09756	32	296	328
6	"6-out18072"	.19753	32	130	162
6	"6-out18073"	.01290	2	153	155
6	"6-out18074"	.12435	24	169	193
6	"6-out18075"	.05649	10	167	177
6	"6-out18076"	.14035	80	490	570
6	"6-out18077"	.07011	19	252	271
6	"6-out18078"	.21880	121	432	553
6	"6-out18079"	.16257	86	443	529
6	"6-out18080"	.09293	25	244	269
6	"6-out18081"	.09868	15	137	152
6	"6-out18082"	.14938	85	484	569
6	"6-out18083"	.11864	21	156	177
6	"6-out18084"	.05681	10	166	176
6	"6-out18085"	.07992	43	495	538
6	"6-out18086"	.25730	44	127	171
6	"6-out18087"	.13602	37	235	272
6	"6-out18088"	.36493	204	355	559
6	"6-out18089"	.56910	210	159	369
6	"6-out18090"	.07432	22	274	296
6	"6-out18091"	.30831	189	424	613
6	"6-out18092"	.11755	75	563	638
6	"6-out18093"	.06153	24	366	390
6	"6-out18094"	.21747	107	385	492
6	"6-out18095"	.36842	84	144	228
6	"6-out18096"	.40909	54	78	132
6	"6-out18097"	.41798	79	110	189
6	"6-out18098"	.48677	92	97	189
6	"6-out18099"	.47619	90	99	189
6	"6-out18100"	.07881	32	374	406
6	"6-out18101"	.18072	30	136	166
6	"6-out18102"	.38000	76	124	200
6	"6-out18103"	.08869	40	411	451
6	"6-out18104"	.11513	35	269	304
6	"6-out18105"	.18195	123	553	676
6	"6-out18106"	.17435	34	161	195
6	"6-out18107"	.25555	46	134	180
6	"6-out18108"	.11830	42	313	355
6	"6-out18109"	.30654	103	233	336
6	"6-out18110"	.10859	24	197	221
6	"6-out18111"	.12413	36	254	290
6	"6-out18112"	.24796	61	185	246
6	"6-out18113"	.05254	31	559	590
6	"6-out18114"	.10784	99	819	918
6	"6-out18115"	.33990	69	134	203
6	"6-out18116"	.07881	48	561	609
6	"6-out18117"	.31111	70	155	225
6	"6-out18118"	.09291	97	947	1044
6	"6-out18119"	.11156	192	1529	1721
6	"6-out18120"	.09641	43	403	446
6	"6-out18121"	.16510	141	713	854
6	"6-out18122"	.11042	18	145	163
6	"6-out18123"	.37500	54	90	144
6	"6-out18124"	.03278	12	354	366
6	"6-out18125"	.08086	30	341	371
6	"6-out18126"	.18199	95	427	522
6	"6-out18127"	.06044	46	715	761
6	"6-out18128"	.25000	74	222	296
6	"6-out18129"	.18644	33	144	177
6	"6-out18130"	.27692	108	282	390
6	"6-out18131"	.04250	38	856	894
6	"6-out18133"	.29897	670	1571	2241
6	"6-out18134"	.23188	32	106	138
6	"6-out18135"	.05489	23	396	419
6	"6-out18136"	.08723	41	429	470
6	"6-out18137"	.45275	230	278	508
6	"6-out18138"	.11165	68	541	609
6	"6-out18139"	.09582	78	736	814
6	"6-out18140"	.09876	8	73	81
6	"6-out18141"	.06557	20	285	305
6	"6-out18142"	.09956	46	416	462
6	"6-out18143"	.04158	22	507	529
6	"6-out18144"	.06802	40	548	588
6	"6-out18145"	.06586	60	851	911
6	"6-out18146"	.39429	373	573	946
6	"6-out18147"	.08764	78	812	890
6	"6-out18148"	.07634	71	859	930
6	"6-out18149"	.08353	35	384	419
6	"6-out18150"	.04972	18	344	362
6	"6-out18151"	.04354	27	593	620
6	"6-out18152"	.19345	65	271	336
6	"6-out18153"	.30031	94	219	313
6	"6-out18154"	.44067	52	66	118
6	"6-out18155"	.05751	31	508	539
6	"6-out18156"	.09565	33	312	345
6	"6-out18157"	.47275	269	300	569
6	"6-out18158"	.27857	78	202	280
6	"6-out18159"	.08421	56	609	665
6	"6-out18160"	.46082	100	117	217
6	"6-out18161"	.11377	19	148	167
6	"6-out18162"	.32644	79	163	242
6	"6-out18163"	.17477	79	373	452
6	"6-out18164"	.11882	65	482	547
6	"6-out18165"	.05660	3	50	53
6	"6-out18166"	.41509	44	62	106
6	"6-out18167"	.14005	143	878	1021
6	"6-out18168"	.11618	28	213	241
6	"6-out18169"	.05752	26	426	452
6	"6-out18170"	.07926	13	151	164
6	"6-out18171"	.07434	31	386	417
6	"6-out18172"	.09504	23	219	242
6	"6-out18173"	.09417	63	606	669
6	"6-out18174"	.16494	48	243	291
6	"6-out18175"	.10071	56	500	556
6	"6-out18176"	.06655	41	575	616
6	"6-out18177"	.14673	81	471	552
6	"6-out18178"	.03598	19	509	528
6	"6-out18179"	.05660	12	200	212
6	"6-out18180"	.09917	36	327	363
6	"6-out18181"	.38062	220	358	578
6	"6-out18182"	.05925	40	635	675
6	"6-out18183"	.07878	26	304	330
6	"6-out18184"	.11450	30	232	262
6	"6-out18185"	.04323	23	509	532
6	"6-out18186"	.06541	59	843	902
6	"6-out18187"	.07352	30	378	408
6	"6-out18188"	.05263	53	954	1007
6	"6-out18189"	.05915	52	827	879
6	"6-out18190"	.05646	45	752	797
6	"6-out18191"	.06400	40	585	625
6	"6-out18192"	.06043	53	824	877
6	"6-out18193"	.39673	146	222	368
6	"6-out18194"	.04461	41	878	919
6	"6-out18195"	.12114	110	798	908
6	"6-out18196"	.14121	135	821	956
6	"6-out18197"	.09677	21	196	217
6	"6-out18198"	.07857	77	903	980
6	"6-out18199"	.31958	217	462	679
6	"6-out18200"	.08774	237	2464	2701
6	"6-out18201"	.34011	117	227	344
6	"6-out18202"	.13750	66	414	480
6	"6-out18203"	.11904	40	296	336
6	"6-out18204"	.11255	191	1506	1697
6	"6-out18205"	.10652	160	1342	1502
6	"6-out18206"	.06060	16	248	264
6	"6-out18207"	.07224	63	809	872
6	"6-out18208"	.07987	50	576	626
6	"6-out18209"	.05960	54	852	906
6	"6-out18210"	.10019	101	907	1008
6	"6-out18211"	.07432	11	137	148
6	"6-out18212"	.44027	129	164	293
6	"6-out18213"	.03521	15	411	426
6	"6-out18214"	.27804	57	148	205
6	"6-out18215"	.10116	26	231	257
6	"6-out18216"	.07661	38	458	496
6	"6-out18217"	.11023	56	452	508
6	"6-out18218"	.24586	119	365	484
6	"6-out18219"	.51464	123	116	239
6	"6-out18220"	.10775	25	207	232
6	"6-out18221"	.10601	37	312	349
6	"6-out18222"	.14598	40	234	274
6	"6-out18223"	.10518	67	570	637
6	"6-out18224"	.35135	78	144	222
6	"6-out18225"	.09469	25	239	264
6	"6-out18226"	.46330	101	117	218
6	"6-out18227"	.52581	499	450	949
6	"6-out18228"	.08803	53	549	602
6	"6-out18229"	.08298	60	663	723
6	"6-out18230"	.01307	2	151	153
6	"6-out18231"	.09350	36	349	385
6	"6-out18232"	.08519	42	451	493
6	"6-out18233"	.40978	134	193	327
6	"6-out18234"	.16333	49	251	300
6	"6-out18235"	.04861	21	411	432
6	"6-out18236"	.21531	45	164	209
6	"6-out18237"	.26060	86	244	330
6	"6-out18238"	.07479	54	668	722
6	"6-out18239"	.23780	39	125	164
6	"6-out18240"	.06034	28	436	464
6	"6-out18241"	.08623	52	551	603
6	"6-out18242"	.04651	28	574	602
6	"6-out18243"	.07917	46	535	581
6	"6-out18244"	.11424	73	566	639
6	"6-out18245"	.13544	60	383	443
6	"6-out18246"	.12709	76	522	598
6	"6-out18247"	.13432	18	116	134
6	"6-out18248"	.30581	100	227	327
6	"6-out18249"	.12080	18	131	149
6	"6-out18250"	.11578	22	168	190
6	"6-out18251"	.02139	4	183	187
6	"6-out18252"	.06313	25	371	396
6	"6-out18253"	.07177	15	194	209
6	"6-out18254"	.32223	271	570	841
6	"6-out18255"	.21524	96	350	446
6	"6-out18256"	.36491	104	181	285
6	"6-out18257"	.10074	122	1089	1211
6	"6-out18258"	.06711	60	834	894
6	"6-out18259"	.11299	40	314	354
6	"6-out18260"	.45193	456	553	1009
6	"6-out18261"	.09861	57	521	578
6	"6-out18262"	.08499	47	506	553
6	"6-out18263"	.17987	59	269	328
6	"6-out18264"	.27102	29	78	107
6	"6-out18265"	.09134	115	1144	1259
6	"6-out18266"	.16183	67	347	414
6	"6-out18267"	.07505	207	2551	2758
6	"6-out18268"	.05353	143	2528	2671
6	"6-out18269"	.02083	8	376	384
6	"6-out18270"	.12592	17	118	135
6	"6-out18271"	.27716	227	592	819
6	"6-out18272"	.09975	41	370	411
6	"6-out18273"	.33195	80	161	241
6	"6-out18274"	.06329	30	444	474
6	"6-out18275"	.09053	22	221	243
6	"6-out18276"	.10791	15	124	139
6	"6-out18277"	.44689	446	552	998
6	"6-out18278"	.12162	9	65	74
6	"6-out18279"	.53827	436	374	810
6	"6-out18280"	.10068	59	527	586
6	"6-out18281"	.44144	49	62	111
6	"6-out18282"	.10666	32	268	300
6	"6-out18283"	.15686	24	129	153
6	"6-out18284"	.48618	88	93	181
6	"6-out18285"	.44963	183	224	407
6	"6-out18286"	.07191	115	1484	1599
6	"6-out18287"	.11735	186	1399	1585
6	"6-out18288"	.13824	30	187	217
6	"6-out18289"	.06607	60	848	908
6	"6-out18290"	.09739	86	797	883
6	"6-out18291"	.15008	89	504	593
6	"6-out18292"	.06281	75	1119	1194
6	"6-out18293"	.46311	113	131	244
6	"6-out18294"	.11382	56	436	492
6	"6-out18295"	.10563	30	254	284
6	"6-out18296"	.09821	11	101	112
6	"6-out18297"	.09452	19	182	201
6	"6-out18298"	.14583	35	205	240
6	"6-out18299"	.10134	68	603	671
6	"6-out18300"	.09080	237	2373	2610
6	"6-out18301"	.03735	60	1546	1606
6	"6-out18302"	.06297	99	1473	1572
6	"6-out18303"	.45723	540	641	1181
6	"6-out18304"	.09992	138	1243	1381
6	"6-out18305"	.12171	102	736	838
6	"6-out18306"	.14634	30	175	205
6	"6-out18307"	.08517	50	537	587
6	"6-out18308"	.14663	61	355	416
6	"6-out18309"	.13615	148	939	1087
6	"6-out18310"	.14684	79	459	538
6	"6-out18311"	.18092	55	249	304
6	"6-out18312"	.26730	112	307	419
6	"6-out18313"	.10950	68	553	621
6	"6-out18314"	.02094	4	187	191
6	"6-out18315"	.37833	255	419	674
6	"6-out18316"	.23684	162	522	684
6	"6-out18317"	.15789	57	304	361
6	"6-out18318"	.28783	97	240	337
6	"6-out18319"	.30267	102	235	337
6	"6-out18320"	.07469	31	384	415
6	"6-out18321"	.06730	28	388	416
6	"6-out18322"	.07582	32	390	422
6	"6-out18323"	.23614	98	317	415
6	"6-out18324"	.06263	28	419	447
6	"6-out18325"	.08414	43	468	511
6	"6-out18326"	.09546	40	379	419
6	"6-out18327"	.09729	36	334	370
6	"6-out18328"	.03636	14	371	385
6	"6-out18329"	.07563	36	440	476
6	"6-out18330"	.07547	20	245	265
6	"6-out18331"	.05603	13	219	232
6	"6-out18332"	.07242	31	397	428
6	"6-out18333"	.09546	40	379	419
6	"6-out18334"	.07048	16	211	227
6	"6-out18335"	.08148	22	248	270
6	"6-out18336"	.06332	24	355	379
6	"6-out18337"	.06666	26	364	390
6	"6-out18338"	.20000	47	188	235
6	"6-out18339"	.35483	99	180	279
6	"6-out18340"	.12529	53	370	423
6	"6-out18341"	.12030	16	117	133
6	"6-out18342"	.07396	25	313	338
6	"6-out18343"	.05627	26	436	462
6	"6-out18344"	.13095	11	73	84
6	"6-out18345"	.25846	84	241	325
6	"6-out18346"	.14068	37	226	263
6	"6-out18347"	.13157	35	231	266
6	"6-out18348"	.13857	37	230	267
6	"6-out18349"	.02976	5	163	168
6	"6-out18350"	.06004	29	454	483
6	"6-out18351"	.03736	25	644	669
6	"6-out18352"	.56081	83	65	148
6	"6-out18353"	.38911	193	303	496
6	"6-out18354"	.09274	46	450	496
6	"6-out18355"	.39207	89	138	227
6	"6-out18356"	.50672	113	110	223
6	"6-out18357"	.24098	167	526	693
6	"6-out18358"	.17204	16	77	93
6	"6-out18359"	.23731	145	466	611
6	"6-out18360"	.10869	20	164	184
6	"6-out18361"	.04633	12	247	259
6	"6-out18362"	.03187	8	243	251
6	"6-out18363"	.07325	89	1126	1215
6	"6-out18364"	.05882	56	896	952
6	"6-out18365"	.07433	64	797	861
6	"6-out18366"	.07121	72	939	1011
6	"6-out18367"	.46491	265	305	570
6	"6-out18368"	.02116	4	185	189
6	"6-out18369"	.08677	21	221	242
6	"6-out18370"	.08750	56	584	640
6	"6-out18371"	.10816	53	437	490
6	"6-out18372"	.05855	39	627	666
6	"6-out18373"	.04008	20	479	499
6	"6-out18374"	.04480	25	533	558
6	"6-out18375"	.08722	28	293	321
6	"6-out18376"	.11032	47	379	426
6	"6-out18377"	.03232	16	479	495
6	"6-out18378"	.08173	47	528	575
6	"6-out18379"	.06212	31	468	499
6	"6-out18380"	.07121	24	313	337
6	"6-out18381"	.11487	61	470	531
6	"6-out18382"	.56591	352	270	622
6	"6-out18383"	.08775	114	1185	1299
6	"6-out18384"	.26805	167	456	623
6	"6-out18385"	.05200	13	237	250
6	"6-out18386"	.04255	14	315	329
6	"6-out18387"	.07277	77	981	1058
6	"6-out18388"	.38833	353	556	909
6	"6-out18389"	.31707	182	392	574
6	"6-out18390"	.10122	66	586	652
6	"6-out18391"	.14285	119	714	833
6	"6-out18392"	.09592	40	377	417
6	"6-out18393"	.61818	68	42	110
6	"6-out18394"	.65546	78	41	119
6	"6-out18395"	.35977	127	226	353
6	"6-out18396"	.38529	131	209	340
6	"6-out18397"	.50928	192	185	377
6	"6-out18398"	.48123	218	235	453
6	"6-out18399"	.43396	46	60	106
6	"6-out18400"	.07280	34	433	467
6	"6-out18401"	.10543	33	280	313
6	"6-out18402"	.05831	27	436	463
6	"6-out18403"	.13019	72	481	553
6	"6-out18404"	.08771	25	260	285
6	"6-out18405"	.24666	37	113	150
6	"6-out18406"	.43956	40	51	91
6	"6-out18407"	.04775	17	339	356
6	"6-out18408"	.10543	33	280	313
6	"6-out18409"	.03660	19	500	519
6	"6-out18410"	.06463	34	492	526
6	"6-out18411"	.05468	7	121	128
6	"6-out18412"	.04786	28	557	585
6	"6-out18413"	.09069	38	381	419
6	"6-out18414"	.19101	34	144	178
6	"6-out18415"	.44871	35	43	78
6	"6-out18416"	.09589	14	132	146
6	"6-out18417"	.05855	78	1254	1332
6	"6-out18418"	.13333	24	156	180
6	"6-out18419"	.08629	17	180	197
6	"6-out18420"	.17821	36	166	202
6	"6-out18421"	.09202	15	148	163
6	"6-out18422"	.17005	92	449	541
6	"6-out18423"	.35985	199	354	553
6	"6-out18424"	.13316	53	345	398
6	"6-out18425"	.14838	23	132	155
6	"6-out18426"	.06878	13	176	189
6	"6-out18427"	.14785	93	536	629
6	"6-out18428"	.39094	95	148	243
6	"6-out18429"	.11433	63	488	551
6	"6-out18430"	.11764	18	135	153
6	"6-out18431"	.24203	38	119	157
6	"6-out18432"	.09972	73	659	732
6	"6-out18433"	.44871	105	129	234
6	"6-out18434"	.15185	41	229	270
6	"6-out18435"	.09657	48	449	497
6	"6-out18436"	.63302	138	80	218
6	"6-out18437"	.08472	76	821	897
6	"6-out18438"	.11842	18	134	152
6	"6-out18439"	.14716	39	226	265
6	"6-out18440"	.12664	77	531	608
6	"6-out18441"	.07706	43	515	558
6	"6-out18442"	.13344	81	526	607
6	"6-out18443"	.10037	53	475	528
6	"6-out18444"	.07428	39	486	525
6	"6-out18445"	.15185	82	458	540
6	"6-out18446"	.06604	127	1796	1923
6	"6-out18447"	.04147	9	208	217
6	"6-out18448"	.14432	28	166	194
6	"6-out18449"	.07901	154	1795	1949
6	"6-out18450"	.32214	336	707	1043
6	"6-out18451"	.12500	54	378	432
6	"6-out18452"	.07608	14	170	184
6	"6-out18453"	.41891	93	129	222
6	"6-out18454"	.43243	96	126	222
6	"6-out18455"	.46311	113	131	244
6	"6-out18456"	.18095	38	172	210
6	"6-out18457"	.11280	133	1046	1179
6	"6-out18458"	.23357	224	735	959
6	"6-out18459"	.47916	115	125	240
6	"6-out18460"	.51949	493	456	949
6	"6-out18461"	.07877	49	573	622
6	"6-out18462"	.07083	51	669	720
6	"6-out18463"	.43604	225	291	516
6	"6-out18464"	.15489	296	1615	1911
6	"6-out18465"	.11233	51	403	454
6	"6-out18466"	.43216	258	339	597
6	"6-out18467"	.30656	126	285	411
6	"6-out18468"	.14960	38	216	254
6	"6-out18469"	.11864	49	364	413
6	"6-out18470"	.05761	28	458	486
6	"6-out18471"	.09310	193	1880	2073
6	"6-out18472"	.05979	40	629	669
6	"6-out18473"	.10865	59	484	543
6	"6-out18474"	.08401	41	447	488
6	"6-out18475"	.10610	40	337	377
6	"6-out18476"	.14432	112	664	776
6	"6-out18477"	.13233	257	1685	1942
6	"6-out18478"	.14441	159	942	1101
6	"6-out18479"	.08874	41	421	462
6	"6-out18480"	.16666	22	110	132
6	"6-out18481"	.03937	15	366	381
6	"6-out18482"	.48663	346	365	711
6	"6-out18483"	.25000	21	63	84
6	"6-out18484"	.24888	56	169	225
6	"6-out18485"	.49082	107	111	218
6	"6-out18486"	.08130	40	452	492
6	"6-out18487"	.11463	123	950	1073
6	"6-out18488"	.17703	37	172	209
6	"6-out18489"	.11384	37	288	325
6	"6-out18490"	.11372	29	226	255
6	"6-out18491"	.05811	29	470	499
6	"6-out18492"	.09890	72	656	728
6	"6-out18493"	.04876	59	1151	1210
6	"6-out18494"	.11561	57	436	493
6	"6-out18495"	.06194	63	954	1017
6	"6-out18496"	.10176	23	203	226
6	"6-out18497"	.10862	68	558	626
6	"6-out18498"	.09915	59	536	595
6	"6-out18499"	.06701	13	181	194
6	"6-out18500"	.41153	214	306	520
6	"6-out18501"	.10262	47	411	458
6	"6-out18502"	.06106	32	492	524
6	"6-out18503"	.12574	21	146	167
6	"6-out18504"	.05730	31	510	541
6	"6-out18505"	.04444	24	516	540
6	"6-out18506"	.11387	64	498	562
6	"6-out18507"	.07933	38	441	479
6	"6-out18508"	.54269	197	166	363
6	"6-out18509"	.05363	14	247	261
6	"6-out18510"	.09662	86	804	890
6	"6-out18511"	.08056	34	388	422
6	"6-out18512"	.06586	132	1872	2004
6	"6-out18513"	.14317	65	389	454
6	"6-out18514"	.06131	29	444	473
6	"6-out18515"	.01315	4	300	304
6	"6-out18516"	.12141	89	644	733
6	"6-out18517"	.48453	47	50	97
6	"6-out18518"	.50000	53	53	106
6	"6-out18519"	.08295	55	608	663
6	"6-out18520"	.06060	14	217	231
6	"6-out18521"	.07449	26	323	349
6	"6-out18522"	.06554	70	998	1068
6	"6-out18523"	.09200	23	227	250
6	"6-out18524"	.25635	111	322	433
6	"6-out18525"	.07777	28	332	360
6	"6-out18526"	.05963	26	410	436
6	"6-out18527"	.04533	17	358	375
6	"6-out18528"	.07894	33	385	418
6	"6-out18529"	.26327	114	319	433
6	"6-out18530"	.11165	138	1098	1236
6	"6-out18531"	.08900	17	174	191
6	"6-out18532"	.03809	8	202	210
6	"6-out18533"	.13231	52	341	393
6	"6-out18534"	.05292	19	340	359
6	"6-out18535"	.29824	34	80	114
6	"6-out18536"	.12226	95	682	777
6	"6-out18537"	.11411	59	458	517
6	"6-out18538"	.54314	107	90	197
6	"6-out18539"	.07975	13	150	163
6	"6-out18540"	.11011	37	299	336
6	"6-out18541"	.03030	4	128	132
6	"6-out18542"	.07857	55	645	700
6	"6-out18543"	.06493	40	576	616
6	"6-out18544"	.53676	73	63	136
6	"6-out18545"	.61690	219	136	355
6	"6-out18546"	.10465	18	154	172
6	"6-out18547"	.05482	29	500	529
6	"6-out18548"	.40566	43	63	106
6	"6-out18549"	.46031	58	68	126
6	"6-out18550"	.30446	109	249	358
6	"6-out18551"	.41618	144	202	346
6	"6-out18552"	.40532	137	201	338
6	"6-out18553"	.35082	127	235	362
6	"6-out18554"	.08438	40	434	474
6	"6-out18555"	.36585	15	26	41
6	"6-out18556"	.20833	5	19	24
6	"6-out18557"	.14814	4	23	27
6	"6-out18558"	.03169	20	611	631
6	"6-out18559"	.12795	92	627	719
6	"6-out18560"	.06615	26	367	393
6	"6-out18561"	.45689	159	189	348
6	"6-out18562"	.04946	14	269	283
6	"6-out18563"	.07883	73	853	926
6	"6-out18564"	.08846	23	237	260
6	"6-out18565"	.11148	33	263	296
6	"6-out18566"	.14024	46	282	328
6	"6-out18567"	.10611	59	497	556
6	"6-out18568"	.12801	53	361	414
6	"6-out18569"	.09090	9	90	99
6	"6-out18570"	.16183	106	549	655
6	"6-out18571"	.03338	40	1158	1198
6	"6-out18572"	.63764	227	129	356
6	"6-out18573"	.50877	29	28	57
6	"6-out18574"	.04945	9	173	182
6	"6-out18575"	.43137	22	29	51
6	"6-out18576"	.37852	430	706	1136
6	"6-out18577"	.20146	55	218	273
6	"6-out18578"	.14465	46	272	318
6	"6-out18579"	.17298	73	349	422
6	"6-out18580"	.15666	47	253	300
6	"6-out18581"	.54700	64	53	117
6	"6-out18582"	.54700	64	53	117
6	"6-out18583"	.54700	64	53	117
6	"6-out18584"	.13773	96	601	697
6	"6-out18585"	.13387	49	317	366
6	"6-out18586"	.20754	132	504	636
6	"6-out18587"	.47044	191	215	406
6	"6-out18588"	.12293	52	371	423
6	"6-out18589"	.46666	105	120	225
6	"6-out18590"	.51376	112	106	218
6	"6-out18591"	.06733	47	651	698
6	"6-out18592"	.53333	176	154	330
6	"6-out18593"	.51070	167	160	327
6	"6-out18594"	.38679	41	65	106
6	"6-out18595"	.10828	102	840	942
6	"6-out18596"	.28015	72	185	257
6	"6-out18597"	.09189	34	336	370
6	"6-out18598"	.10407	23	198	221
6	"6-out18599"	.60995	147	94	241
6	"6-out18600"	.40090	89	133	222
6	"6-out18601"	.48255	83	89	172
6	"6-out18602"	.09932	44	399	443
6	"6-out18603"	.10466	92	787	879
6	"6-out18604"	.08819	65	672	737
6	"6-out18605"	.09230	12	118	130
6	"6-out18606"	.06153	8	122	130
6	"6-out18607"	.07031	9	119	128
6	"6-out18608"	.05426	7	122	129
6	"6-out18609"	.09230	12	118	130
6	"6-out18610"	.33043	38	77	115
6	"6-out18611"	.08602	32	340	372
6	"6-out18612"	.31250	40	88	128
6	"6-out18613"	.10317	13	113	126
6	"6-out18614"	.12698	16	110	126
6	"6-out18615"	.11111	14	112	126
6	"6-out18616"	.14285	18	108	126
6	"6-out18617"	.11904	15	111	126
6	"6-out18618"	.13492	17	109	126
6	"6-out18619"	.17460	22	104	126
6	"6-out18620"	.01470	2	134	136
6	"6-out18621"	.05882	8	128	136
6	"6-out18622"	.02941	4	132	136
6	"6-out18623"	.23448	68	222	290
6	"6-out18624"	.08746	104	1085	1189
6	"6-out18625"	.06216	23	347	370
6	"6-out18626"	.20055	72	287	359
6	"6-out18627"	.05163	19	349	368
6	"6-out18628"	.09756	40	370	410
6	"6-out18629"	.35915	51	91	142
6	"6-out18630"	.48591	69	73	142
6	"6-out18631"	.46543	101	116	217
6	"6-out18632"	.07865	35	410	445
6	"6-out18633"	.18339	53	236	289
6	"6-out18634"	.07313	89	1128	1217
6	"6-out18635"	.05428	19	331	350
6	"6-out18636"	.07692	17	204	221
6	"6-out18637"	.28662	135	336	471
6	"6-out18638"	.06904	29	391	420
6	"6-out18639"	.08846	56	577	633
6	"6-out18640"	.52752	115	103	218
6	"6-out18641"	.58088	79	57	136
6	"6-out18642"	.15762	61	326	387
6	"6-out18643"	.09181	46	455	501
6	"6-out18644"	.06969	43	574	617
6	"6-out18645"	.07337	35	442	477
6	"6-out18646"	.05711	63	1040	1103
6	"6-out18647"	.10833	26	214	240
6	"6-out18648"	.51181	130	124	254
6	"6-out18649"	.37272	164	276	440
6	"6-out18650"	.09845	70	641	711
6	"6-out18651"	.00930	2	213	215
6	"6-out18652"	.05633	12	201	213
6	"6-out18653"	.02739	6	213	219
6	"6-out18654"	.05882	15	240	255
6	"6-out18655"	.69072	67	30	97
6	"6-out18656"	.06122	24	368	392
6	"6-out18657"	.08396	11	120	131
6	"6-out18658"	.09230	12	118	130
6	"6-out18659"	.06153	8	122	130
6	"6-out18660"	.06250	8	120	128
6	"6-out18661"	.02307	3	127	130
6	"6-out18662"	.03496	5	138	143
6	"6-out18663"	.08661	11	116	127
6	"6-out18664"	.40932	79	114	193
6	"6-out18665"	.33536	55	109	164
6	"6-out18666"	.11111	14	112	126
6	"6-out18667"	.11111	14	112	126
6	"6-out18668"	.18253	23	103	126
6	"6-out18669"	.12698	16	110	126
6	"6-out18670"	.18093	131	593	724
6	"6-out18671"	.27438	782	2068	2850
6	"6-out18672"	.32142	9	19	28
6	"6-out18673"	.49645	210	213	423
6	"6-out18674"	.51351	171	162	333
6	"6-out18675"	.52369	210	191	401
6	"6-out18676"	.06818	24	328	352
6	"6-out18677"	.45762	54	64	118
6	"6-out18678"	.05111	16	297	313
6	"6-out18679"	.41880	49	68	117
6	"6-out18680"	.09722	42	390	432
6	"6-out18681"	.19780	54	219	273
6	"6-out18682"	.26086	30	85	115
6	"6-out18683"	.12280	21	150	171
6	"6-out18684"	.43881	104	133	237
6	"6-out18685"	.18987	45	192	237
6	"6-out18686"	.01639	2	120	122
6	"6-out18687"	.41101	194	278	472
6	"6-out18688"	.07068	27	355	382
6	"6-out18689"	.15433	73	400	473
6	"6-out18690"	.05932	7	111	118
6	"6-out18691"	.09495	32	305	337
6	"6-out18692"	.18805	63	272	335
6	"6-out18693"	.06730	35	485	520
6	"6-out18694"	.12650	42	290	332
6	"6-out18695"	.31716	85	183	268
6	"6-out18696"	.03669	12	315	327
6	"6-out18697"	.27758	78	203	281
6	"6-out18698"	.20723	361	1381	1742
6	"6-out18699"	.08304	24	265	289
6	"6-out18700"	.18699	46	200	246
6	"6-out18701"	.03557	9	244	253
6	"6-out18702"	.07560	31	379	410
6	"6-out18703"	.16187	45	233	278
6	"6-out18704"	.06923	63	847	910
6	"6-out18705"	.07812	55	649	704
6	"6-out18706"	.15463	45	246	291
6	"6-out18707"	.07514	26	320	346
6	"6-out18708"	.12623	102	706	808
6	"6-out18709"	.16666	67	335	402
6	"6-out18710"	.05031	40	755	795
6	"6-out18711"	.15482	122	666	788
6	"6-out18712"	.04382	33	720	753
6	"6-out18713"	.07446	56	696	752
6	"6-out18714"	.09259	35	343	378
6	"6-out18715"	.25608	179	520	699
6	"6-out18716"	.11078	76	610	686
6	"6-out18717"	.09490	149	1421	1570
6	"6-out18718"	.11902	214	1584	1798
6	"6-out18719"	.04965	65	1244	1309
6	"6-out18720"	.05947	156	2467	2623
6	"6-out18721"	.08915	37	378	415
6	"6-out18722"	.09401	22	212	234
6	"6-out18723"	.05846	19	306	325
6	"6-out18724"	.15533	48	261	309
6	"6-out18725"	.05089	17	317	334
6	"6-out18726"	.09072	46	461	507
6	"6-out18727"	.05292	19	340	359
6	"6-out18728"	.05292	19	340	359
6	"6-out18729"	.34745	41	77	118
6	"6-out18730"	.51219	63	60	123
6	"6-out18731"	.41600	52	73	125
6	"6-out18732"	.14440	40	237	277
6	"6-out18733"	.10216	52	457	509
6	"6-out18734"	.15719	47	252	299
6	"6-out18735"	.08933	36	367	403
6	"6-out18736"	.05785	14	228	242
6	"6-out18737"	.06067	25	387	412
6	"6-out18738"	.45299	53	64	117
6	"6-out18739"	.09090	27	270	297
6	"6-out18740"	.17184	83	400	483
6	"6-out18741"	.41221	54	77	131
6	"6-out18742"	.09600	48	452	500
6	"6-out18743"	.10361	86	744	830
6	"6-out18744"	.52777	19	17	36
6	"6-out18745"	.04580	18	375	393
6	"6-out18746"	.47826	110	120	230
6	"6-out18747"	.07092	10	131	141
6	"6-out18748"	.48611	70	74	144
6	"6-out18749"	.05780	20	326	346
6	"6-out18750"	.09561	24	227	251
6	"6-out18751"	.07387	108	1354	1462
6	"6-out18752"	.26136	23	65	88
6	"6-out18753"	.16152	110	571	681
6	"6-out18754"	.10467	56	479	535
6	"6-out18755"	.04379	12	262	274
6	"6-out18756"	.15414	322	1767	2089
6	"6-out18757"	.52380	99	90	189
6	"6-out18758"	.15853	39	207	246
6	"6-out18759"	.09756	24	222	246
6	"6-out18760"	.12147	56	405	461
6	"6-out18761"	.13389	128	828	956
6	"6-out18762"	.04535	20	421	441
6	"6-out18763"	.06341	26	384	410
6	"6-out18764"	.09369	52	503	555
6	"6-out18765"	.06578	5	71	76
6	"6-out18766"	.08333	2	22	24
6	"6-out18767"	.25000	6	18	24
6	"6-out18768"	.26476	139	386	525
6	"6-out18769"	.05357	9	159	168
6	"6-out18770"	.04560	14	293	307
6	"6-out18771"	.34326	288	551	839
6	"6-out18772"	.04268	7	157	164
6	"6-out18773"	.48377	164	175	339
6	"6-out18774"	.07373	16	201	217
6	"6-out18775"	.25925	70	200	270
6	"6-out18776"	.13352	47	305	352
6	"6-out18777"	.07761	26	309	335
6	"6-out18778"	.26517	83	230	313
6	"6-out18779"	.06553	31	442	473
6	"6-out18780"	.48717	57	60	117
6	"6-out18781"	.14392	96	571	667
6	"6-out18782"	.34782	40	75	115
6	"6-out18783"	.23193	61	202	263
6	"6-out18784"	.10173	445	3929	4374
6	"6-out18785"	.04623	27	557	584
6	"6-out18786"	.47863	56	61	117
6	"6-out18787"	.09066	67	672	739
6	"6-out18788"	.21129	101	377	478
6	"6-out18789"	.14230	37	223	260
6	"6-out18790"	.08854	102	1050	1152
6	"6-out18791"	.14760	120	693	813
6	"6-out18792"	.08811	66	683	749
6	"6-out18793"	.28593	185	462	647
6	"6-out18794"	.12750	51	349	400
6	"6-out18795"	.46610	55	63	118
6	"6-out18796"	.04367	19	416	435
6	"6-out18797"	.38983	46	72	118
6	"6-out18798"	.51845	2655	2466	5121
6	"6-out18799"	.35042	41	76	117
6	"6-out18800"	.43103	50	66	116
6	"6-out18801"	.05714	26	429	455
6	"6-out18802"	.40336	48	71	119
6	"6-out18803"	.05689	45	746	791
6	"6-out18804"	.47863	56	61	117
6	"6-out18805"	.10156	13	115	128
6	"6-out18806"	.08992	25	253	278
6	"6-out18807"	.16875	27	133	160
6	"6-out18808"	.11659	111	841	952
6	"6-out18809"	.09610	42	395	437
6	"6-out18810"	.05161	8	147	155
6	"6-out18811"	.12695	65	447	512
6	"6-out18812"	.10071	42	375	417
6	"6-out18813"	.25076	82	245	327
6	"6-out18814"	.38461	80	128	208
6	"6-out18815"	.37019	77	131	208
6	"6-out18816"	.37980	79	129	208
6	"6-out18817"	.40453	214	315	529
6	"6-out18818"	.06877	37	501	538
6	"6-out18819"	.07649	41	495	536
6	"6-out18820"	.14857	26	149	175
6	"6-out18821"	.12640	45	311	356
6	"6-out18822"	.04810	14	277	291
6	"6-out18823"	.15181	121	676	797
6	"6-out18824"	.05119	47	871	918
6	"6-out18825"	.08303	23	254	277
6	"6-out18826"	.06000	12	188	200
6	"6-out18827"	.09278	9	88	97
6	"6-out18828"	.11690	83	627	710
6	"6-out18829"	.06484	19	274	293
6	"6-out18830"	.09044	89	895	984
6	"6-out18831"	.12891	111	750	861
6	"6-out18832"	.37091	329	558	887
6	"6-out18833"	.11758	117	878	995
6	"6-out18834"	.23170	95	315	410
6	"6-out18835"	.08146	29	327	356
6	"6-out18836"	.08776	33	343	376
6	"6-out18837"	.30232	39	90	129
6	"6-out18838"	.17977	16	73	89
6	"6-out18839"	.12371	36	255	291
6	"6-out18840"	.28776	80	198	278
6	"6-out18841"	.08391	48	524	572
6	"6-out18842"	.12800	64	436	500
6	"6-out18843"	.14173	54	327	381
6	"6-out18844"	.09610	69	649	718
6	"6-out18845"	.41714	146	204	350
6	"6-out18846"	.13691	102	643	745
6	"6-out18847"	.04761	36	720	756
6	"6-out18848"	.10195	73	643	716
6	"6-out18849"	.05379	34	598	632
6	"6-out18850"	.06289	30	447	477
6	"6-out18851"	.04029	11	262	273
6	"6-out18852"	.15047	48	271	319
6	"6-out18853"	.06629	24	338	362
6	"6-out18854"	.37980	79	129	208
6	"6-out18855"	.04123	12	279	291
6	"6-out18856"	.14244	49	295	344
6	"6-out18857"	.09885	43	392	435
6	"6-out18858"	.09650	47	440	487
6	"6-out18859"	.24364	115	357	472
6	"6-out18860"	.05367	19	335	354
6	"6-out18861"	.13157	40	264	304
6	"6-out18862"	.15161	94	526	620
6	"6-out18863"	.08038	66	755	821
6	"6-out18864"	.04867	35	684	719
6	"6-out18865"	.15476	130	710	840
6	"6-out18866"	.10673	122	1021	1143
6	"6-out18867"	.05597	30	506	536
6	"6-out18868"	.21124	109	407	516
6	"6-out18869"	.39622	21	32	53
6	"6-out18870"	.10071	14	125	139
6	"6-out18871"	.14285	4	24	28
6	"6-out18872"	.14689	52	302	354
6	"6-out18873"	.09454	52	498	550
6	"6-out18874"	.09052	65	653	718
6	"6-out18875"	.06658	57	799	856
6	"6-out18876"	.41176	126	180	306
6	"6-out18877"	.08755	19	198	217
6	"6-out18878"	.15878	131	694	825
6	"6-out18879"	.27397	20	53	73
6	"6-out18880"	.51008	177	170	347
6	"6-out18881"	.43842	178	228	406
6	"6-out18882"	.35897	42	75	117
6	"6-out18883"	.36752	43	74	117
6	"6-out18884"	.05882	20	320	340
6	"6-out18885"	.39316	46	71	117
6	"6-out18886"	.09561	24	227	251
6	"6-out18887"	.26470	72	200	272
6	"6-out18888"	.38938	44	69	113
6	"6-out18889"	.07692	9	108	117
6	"6-out18890"	.08677	21	221	242
6	"6-out18891"	.05193	43	785	828
6	"6-out18892"	.20849	54	205	259
6	"6-out18893"	.34188	40	77	117
6	"6-out18894"	.14016	171	1049	1220
6	"6-out18895"	.29452	172	412	584
6	"6-out18896"	.13907	84	520	604
6	"6-out18897"	.11185	50	397	447
6	"6-out18898"	.13917	27	167	194
6	"6-out18899"	.37745	77	127	204
6	"6-out18900"	.07831	104	1224	1328
6	"6-out18901"	.21186	50	186	236
6	"6-out18902"	.07218	130	1671	1801
6	"6-out18903"	.06597	19	269	288
6	"6-out18904"	.11502	49	377	426
6	"6-out18905"	.07115	37	483	520
6	"6-out18906"	.07017	20	265	285
6	"6-out18907"	.12121	36	261	297
6	"6-out18908"	.50537	282	276	558
6	"6-out18909"	.07471	73	904	977
6	"6-out18910"	.08615	28	297	325
6	"6-out18911"	.10602	44	371	415
6	"6-out18912"	.33333	8	16	24
6	"6-out18913"	.10657	107	897	1004
6	"6-out18914"	.08123	58	656	714
6	"6-out18915"	.06796	7	96	103
6	"6-out18916"	.07200	9	116	125
6	"6-out18917"	.47058	56	63	119
6	"6-out18918"	.36134	43	76	119
6	"6-out18919"	.31034	36	80	116
6	"6-out18920"	.32478	38	79	117
6	"6-out18921"	.11031	46	371	417
6	"6-out18922"	.03216	11	331	342
6	"6-out18923"	.12641	56	387	443
6	"6-out18924"	.08932	77	785	862
6	"6-out18925"	.13745	69	433	502
6	"6-out18926"	.50427	59	58	117
6	"6-out18927"	.52991	62	55	117
6	"6-out18928"	.09170	73	723	796
6	"6-out18929"	.10465	27	231	258
6	"6-out18930"	.09454	26	249	275
6	"6-out18931"	.08856	24	247	271
6	"6-out18932"	.07083	17	223	240
6	"6-out18933"	.19364	262	1091	1353
6	"6-out18934"	.54255	102	86	188
6	"6-out18935"	.06390	34	498	532
6	"6-out18936"	.06291	19	283	302
6	"6-out18937"	.29850	40	94	134
6	"6-out18938"	.08490	18	194	212
6	"6-out18939"	.20000	56	224	280
6	"6-out18940"	.37606	44	73	117
6	"6-out18941"	.08550	92	984	1076
6	"6-out18942"	.41880	49	68	117
6	"6-out18943"	.04089	11	258	269
6	"6-out18944"	.35897	42	75	117
6	"6-out18945"	.10820	58	478	536
6	"6-out18946"	.19375	62	258	320
6	"6-out18947"	.03829	9	226	235
6	"6-out18948"	.05384	7	123	130
6	"6-out18949"	.06042	60	933	993
6	"6-out18950"	.24595	213	653	866
6	"6-out18951"	.27371	251	666	917
6	"6-out18952"	.09335	59	573	632
6	"6-out18953"	.20987	34	128	162
6	"6-out18954"	.07446	21	261	282
6	"6-out18955"	.08802	25	259	284
6	"6-out18956"	.11639	71	539	610
6	"6-out18957"	.09547	19	180	199
6	"6-out18958"	.07454	41	509	550
6	"6-out18959"	.15831	60	319	379
6	"6-out18960"	.08185	37	415	452
6	"6-out18961"	.25000	101	303	404
6	"6-out18962"	.14728	38	220	258
6	"6-out18963"	.47222	68	76	144
6	"6-out18964"	.09965	58	524	582
6	"6-out18965"	.07261	127	1622	1749
6	"6-out18966"	.35164	32	59	91
6	"6-out18967"	.24038	25	79	104
6	"6-out18968"	.26923	21	57	78
6	"6-out18969"	.42584	201	271	472
6	"6-out18970"	.08000	6	69	75
6	"6-out18971"	.08137	52	587	639
6	"6-out18972"	.38138	127	206	333
6	"6-out18973"	.46455	249	287	536
6	"6-out18974"	.11570	56	428	484
6	"6-out18975"	.17753	49	227	276
6	"6-out18976"	.49391	203	208	411
6	"6-out18977"	.36693	91	157	248
6	"6-out18978"	.24675	38	116	154
6	"6-out18979"	.16122	79	411	490
6	"6-out18980"	.08091	39	443	482
6	"6-out18981"	.10576	22	186	208
6	"6-out18982"	.19806	41	166	207
6	"6-out18983"	.39487	77	118	195
6	"6-out18984"	.06250	13	195	208
6	"6-out18985"	.18500	111	489	600
6	"6-out18986"	.19047	32	136	168
6	"6-out18987"	.64601	73	40	113
6	"6-out18988"	.38938	132	207	339
6	"6-out18989"	.09120	114	1136	1250
6	"6-out18990"	.47663	51	56	107
6	"6-out18991"	.33177	71	143	214
6	"6-out18992"	.12199	320	2303	2623
6	"6-out18993"	.13057	41	273	314
6	"6-out18994"	.16037	51	267	318
6	"6-out18995"	.31081	46	102	148
6	"6-out18996"	.13935	91	562	653
6	"6-out18997"	.29007	38	93	131
6	"6-out18998"	.17967	99	452	551
6	"6-out18999"	.50222	113	112	225
6	"6-out19000"	.06118	32	491	523
6	"6-out19001"	.19196	43	181	224
6	"6-out19002"	.05949	94	1486	1580
6	"6-out19003"	.24825	107	324	431
6	"6-out19004"	.11627	65	494	559
6	"6-out19005"	.11025	57	460	517
6	"6-out19006"	.65648	86	45	131
6	"6-out19007"	.05737	7	115	122
6	"6-out19008"	.05384	7	123	130
6	"6-out19009"	.18731	192	833	1025
6	"6-out19010"	.10381	49	423	472
6	"6-out19011"	.62400	78	47	125
6	"6-out19012"	.59848	79	53	132
6	"6-out19013"	.63909	85	48	133
6	"6-out19014"	.46031	87	102	189
6	"6-out19015"	.52910	100	89	189
6	"6-out19016"	.42857	81	108	189
6	"6-out19017"	.44148	83	105	188
6	"6-out19018"	.47089	89	100	189
6	"6-out19019"	.05928	30	476	506
6	"6-out19020"	.30303	40	92	132
6	"6-out19021"	.15675	29	156	185
6	"6-out19022"	.09677	18	168	186
6	"6-out19023"	.10526	46	391	437
6	"6-out19024"	.11552	64	490	554
6	"6-out19025"	.11421	49	380	429
6	"6-out19026"	.29729	231	546	777
6	"6-out19027"	.04126	13	302	315
6	"6-out19028"	.31533	146	317	463
6	"6-out19029"	.07876	23	269	292
6	"6-out19030"	.05533	42	717	759
6	"6-out19031"	.67000	67	33	100
6	"6-out19032"	.14586	90	527	617
6	"6-out19033"	.36333	222	389	611
6	"6-out19034"	.14672	103	599	702
6	"6-out19035"	.51612	112	105	217
6	"6-out19036"	.07758	9	107	116
6	"6-out19037"	.07061	37	487	524
6	"6-out19038"	.47663	204	224	428
6	"6-out19039"	.40566	43	63	106
6	"6-out19040"	.07830	48	565	613
6	"6-out19041"	.37234	35	59	94
6	"6-out19042"	.33795	122	239	361
6	"6-out19043"	.35049	143	265	408
6	"6-out19044"	.05440	29	504	533
6	"6-out19045"	.50427	59	58	117
6	"6-out19046"	.14691	93	540	633
6	"6-out19047"	.33658	69	136	205
6	"6-out19048"	.04945	9	173	182
6	"6-out19049"	.06000	9	141	150
6	"6-out19050"	.15294	26	144	170
6	"6-out19051"	.05917	110	1749	1859
6	"6-out19052"	.22058	15	53	68
6	"6-out19053"	.05285	25	448	473
6	"6-out19054"	.36764	25	43	68
6	"6-out19055"	.06637	30	422	452
6	"6-out19056"	.09247	43	422	465
6	"6-out19057"	.47976	83	90	173
6	"6-out19058"	.06437	45	654	699
6	"6-out19059"	.07289	57	725	782
6	"6-out19060"	.05947	43	680	723
6	"6-out19061"	.08600	43	457	500
6	"6-out19062"	.07006	11	146	157
6	"6-out19063"	.09741	64	593	657
6	"6-out19064"	.29237	69	167	236
6	"6-out19065"	.23051	139	464	603
6	"6-out19066"	.08525	63	676	739
6	"6-out19067"	.29103	406	989	1395
6	"6-out19068"	.08125	39	441	480
6	"6-out19069"	.37121	196	332	528
6	"6-out19070"	.32425	119	248	367
6	"6-out19071"	.11764	68	510	578
6	"6-out19072"	.16911	23	113	136
6	"6-out19073"	.10638	45	378	423
6	"6-out19074"	.05000	17	323	340
6	"6-out19075"	.27536	19	50	69
6	"6-out19076"	.31506	23	50	73
6	"6-out19077"	.10643	48	403	451
6	"6-out19078"	.52941	9	8	17
6	"6-out19079"	.13404	50	323	373
6	"6-out19080"	.10561	79	669	748
6	"6-out19081"	.08313	70	772	842
6	"6-out19082"	.19277	112	469	581
6	"6-out19083"	.12515	98	685	783
6	"6-out19084"	.08592	127	1351	1478
6	"6-out19085"	.56034	65	51	116
6	"6-out19086"	.54700	64	53	117
6	"6-out19087"	.08888	176	1804	1980
6	"6-out19088"	.26728	58	159	217
6	"6-out19089"	.09762	37	342	379
6	"6-out19090"	.08060	32	365	397
6	"6-out19091"	.12050	77	562	639
6	"6-out19092"	.10252	61	534	595
6	"6-out19093"	.10256	12	105	117
6	"6-out19094"	.48657	308	325	633
6	"6-out19095"	.20400	51	199	250
6	"6-out19096"	.06849	30	408	438
6	"6-out19097"	.10654	70	587	657
6	"6-out19098"	.10278	48	419	467
6	"6-out19099"	.05131	35	647	682
6	"6-out19100"	.45869	261	308	569
6	"6-out19101"	.10649	41	344	385
6	"6-out19102"	.27127	51	137	188
6	"6-out19103"	.53448	62	54	116
6	"6-out19104"	.07099	47	615	662
6	"6-out19105"	.32603	149	308	457
6	"6-out19106"	.20689	66	253	319
6	"6-out19107"	.16285	57	293	350
6	"6-out19108"	.04895	35	680	715
6	"6-out19109"	.07575	50	610	660
6	"6-out19110"	.17041	53	258	311
6	"6-out19111"	.51162	132	126	258
6	"6-out19112"	.27370	127	337	464
6	"6-out19113"	.06438	194	2819	3013
6	"6-out19114"	.05967	62	977	1039
6	"6-out19115"	.08134	174	1965	2139
6	"6-out19116"	.20244	265	1044	1309
6	"6-out19117"	.42430	768	1042	1810
6	"6-out19118"	.35294	174	319	493
6	"6-out19119"	.08842	55	567	622
6	"6-out19120"	.07594	30	365	395
6	"6-out19121"	.55405	41	33	74
6	"6-out19122"	.53379	229	200	429
6	"6-out19123"	.59459	396	270	666
6	"6-out19124"	.13763	64	401	465
6	"6-out19125"	.09290	72	703	775
6	"6-out19126"	.12548	98	683	781
6	"6-out19127"	.16274	76	391	467
6	"6-out19128"	.09821	44	404	448
6	"6-out19129"	.49739	478	483	961
6	"6-out19130"	.05588	28	473	501
6	"6-out19131"	.58408	389	277	666
6	"6-out19132"	.02238	6	262	268
6	"6-out19133"	.08577	38	405	443
6	"6-out19134"	.15384	68	374	442
6	"6-out19135"	.09761	82	758	840
6	"6-out19136"	.22291	144	502	646
6	"6-out19137"	.13359	68	441	509
6	"6-out19138"	.12340	116	824	940
6	"6-out19139"	.02941	2	66	68
6	"6-out19140"	.33333	39	78	117
6	"6-out19141"	.05415	30	524	554
6	"6-out19142"	.24369	145	450	595
6	"6-out19143"	.07954	35	405	440
6	"6-out19144"	.09968	63	569	632
6	"6-out19145"	.06118	29	445	474
6	"6-out19146"	.04225	3	68	71
6	"6-out19147"	.38194	165	267	432
6	"6-out19148"	.34865	182	340	522
6	"6-out19149"	.35454	195	355	550
6	"6-out19150"	.09477	29	277	306
6	"6-out19151"	.18750	87	377	464
6	"6-out19152"	.20991	127	478	605
6	"6-out19153"	.45945	238	280	518
6	"6-out19154"	.52136	61	56	117
6	"6-out19155"	.12446	58	408	466
6	"6-out19156"	.22149	68	239	307
6	"6-out19157"	.15759	55	294	349
6	"6-out19158"	.17889	117	537	654
6	"6-out19159"	.13675	16	101	117
6	"6-out19160"	.29787	14	33	47
6	"6-out19161"	.56008	508	399	907
6	"6-out19162"	.28571	44	110	154
6	"6-out19163"	.06962	77	1029	1106
6	"6-out19164"	.11702	44	332	376
6	"6-out19165"	.08645	67	708	775
6	"6-out19166"	.03265	8	237	245
6	"6-out19167"	.08391	12	131	143
6	"6-out19168"	.11036	49	395	444
6	"6-out19169"	.25941	124	354	478
6	"6-out19170"	.42857	81	108	189
6	"6-out19171"	.21865	75	268	343
6	"6-out19172"	.10706	50	417	467
6	"6-out19173"	.29959	74	173	247
6	"6-out19174"	.08373	35	383	418
6	"6-out19175"	.08847	43	443	486
6	"6-out19176"	.09310	50	487	537
6	"6-out19177"	.31250	25	55	80
6	"6-out19178"	.56115	78	61	139
6	"6-out19179"	.04846	19	373	392
6	"6-out19180"	.07641	35	423	458
6	"6-out19181"	.05333	4	71	75
6	"6-out19182"	.36717	217	374	591
6	"6-out19183"	.13361	64	415	479
6	"6-out19184"	.45924	293	345	638
6	"6-out19185"	.43589	51	66	117
6	"6-out19186"	.08539	31	332	363
6	"6-out19187"	.06504	32	460	492
6	"6-out19188"	.16007	81	425	506
6	"6-out19189"	.12334	112	796	908
6	"6-out19190"	.17665	56	261	317
6	"6-out19191"	.63202	225	131	356
6	"6-out19192"	.07989	31	357	388
6	"6-out19193"	.20057	208	829	1037
6	"6-out19194"	.36054	1824	3235	5059
6	"6-out19195"	.07094	63	825	888
6	"6-out19196"	.25952	109	311	420
6	"6-out19197"	.19178	140	590	730
6	"6-out19198"	.10128	55	488	543
6	"6-out19199"	.04794	7	139	146
6	"6-out19200"	.09790	84	774	858
6	"6-out19201"	.04087	15	352	367
6	"6-out19202"	.43169	316	416	732
6	"6-out19203"	.13030	43	287	330
6	"6-out19204"	.15432	75	411	486
6	"6-out19205"	.10786	48	397	445
6	"6-out19206"	.10569	65	550	615
6	"6-out19207"	.64788	92	50	142
6	"6-out19208"	.34615	135	255	390
6	"6-out19209"	.09267	62	607	669
6	"6-out19210"	.34455	133	253	386
6	"6-out19211"	.07078	86	1129	1215
6	"6-out19212"	.03405	11	312	323
6	"6-out19213"	.03978	15	362	377
6	"6-out19214"	.06349	4	59	63
6	"6-out19215"	.06340	22	325	347
6	"6-out19216"	.07133	402	5233	5635
6	"6-out19217"	.15384	80	440	520
6	"6-out19218"	.13775	54	338	392
6	"6-out19219"	.46236	43	50	93
6	"6-out19220"	.11188	32	254	286
6	"6-out19221"	.06979	55	733	788
6	"6-out19222"	.17826	41	189	230
6	"6-out19223"	.42455	332	450	782
6	"6-out19224"	.27900	202	522	724
6	"6-out19225"	.10400	26	224	250
6	"6-out19226"	.08812	49	507	556
6	"6-out19227"	.18334	185	824	1009
6	"6-out19228"	.06428	27	393	420
6	"6-out19229"	.11864	42	312	354
6	"6-out19230"	.13793	48	300	348
6	"6-out19231"	.11764	48	360	408
6	"6-out19232"	.09462	44	421	465
6	"6-out19233"	.16666	4	20	24
6	"6-out19234"	.27777	25	65	90
6	"6-out19235"	.11675	85	643	728
6	"6-out19236"	.08652	52	549	601
6	"6-out19237"	.07601	45	547	592
6	"6-out19238"	.03975	13	314	327
6	"6-out19239"	.11400	35	272	307
6	"6-out19240"	.48380	224	239	463
6	"6-out19241"	.23049	65	217	282
6	"6-out19242"	.18930	85	364	449
6	"6-out19243"	.16972	37	181	218
6	"6-out19244"	.12820	50	340	390
6	"6-out19245"	.29012	47	115	162
6	"6-out19246"	.11585	19	145	164
6	"6-out19247"	.27027	20	54	74
6	"6-out19248"	.17872	42	193	235
6	"6-out19249"	.07303	26	330	356
6	"6-out19250"	.10863	39	320	359
6	"6-out19251"	.08988	40	405	445
6	"6-out19252"	.32462	174	362	536
6	"6-out19253"	.04878	24	468	492
6	"6-out19255"	.12692	33	227	260
6	"6-out19256"	.09200	23	227	250
6	"6-out19257"	.41880	49	68	117
6	"6-out19258"	.06884	38	514	552
6	"6-out19259"	.38655	46	73	119
6	"6-out19260"	.05185	14	256	270
6	"6-out19261"	.12195	40	288	328
6	"6-out19262"	.47863	56	61	117
6	"6-out19263"	.08510	24	258	282
6	"6-out19264"	.37391	43	72	115
6	"6-out19265"	.08180	49	550	599
6	"6-out19266"	.12559	53	369	422
6	"6-out19267"	.16037	102	534	636
6	"6-out19268"	.09538	31	294	325
6	"6-out19269"	.03656	20	527	547
6	"6-out19270"	.39855	55	83	138
6	"6-out19271"	.10094	32	285	317
6	"6-out19272"	.03740	19	489	508
6	"6-out19273"	.11411	38	295	333
6	"6-out19274"	.24788	88	267	355
6	"6-out19275"	.08627	44	466	510
6	"6-out19276"	.02083	6	282	288
6	"6-out19277"	.33137	113	228	341
6	"6-out19278"	.16789	91	451	542
6	"6-out19279"	.08333	30	330	360
6	"6-out19280"	.34065	31	60	91
6	"6-out19281"	.08888	60	615	675
6	"6-out19282"	.05102	35	651	686
6	"6-out19283"	.41399	142	201	343
6	"6-out19284"	.08114	37	419	456
6	"6-out19285"	.13333	18	117	135
6	"6-out19286"	.07991	39	449	488
6	"6-out19287"	.09243	33	324	357
6	"6-out19288"	.29166	7	17	24
6	"6-out19289"	.20833	5	19	24
6	"6-out19290"	.37500	9	15	24
6	"6-out19291"	.33333	33	66	99
6	"6-out19292"	.44482	262	327	589
6	"6-out19293"	.28089	175	448	623
6	"6-out19294"	.10144	14	124	138
6	"6-out19295"	.34763	81	152	233
6	"6-out19296"	.17455	59	279	338
6	"6-out19297"	.47863	56	61	117
6	"6-out19298"	.38135	45	73	118
6	"6-out19299"	.06696	15	209	224
6	"6-out19300"	.07839	45	529	574
6	"6-out19301"	.07207	16	206	222
6	"6-out19302"	.14285	79	474	553
6	"6-out19303"	.27678	93	243	336
6	"6-out19304"	.55555	65	52	117
6	"6-out19305"	.17816	62	286	348
6	"6-out19306"	.19790	284	1151	1435
6	"6-out19307"	.33175	70	141	211
6	"6-out19308"	.07518	30	369	399
6	"6-out19309"	.10048	83	743	826
6	"6-out19310"	.54225	77	65	142
6	"6-out19311"	.08181	27	303	330
6	"6-out19312"	.46626	235	269	504
6	"6-out19313"	.07407	10	125	135
6	"6-out19314"	.14444	39	231	270
6	"6-out19315"	.18367	18	80	98
6	"6-out19316"	.09152	27	268	295
6	"6-out19317"	.15135	56	314	370
6	"6-out19318"	.11864	42	312	354
6	"6-out19319"	.08955	36	366	402
6	"6-out19320"	.29166	7	17	24
6	"6-out19322"	.08561	25	267	292
6	"6-out19323"	.38566	113	180	293
6	"6-out19324"	.38566	113	180	293
6	"6-out19325"	.06962	22	294	316
6	"6-out19326"	.13263	204	1334	1538
6	"6-out19327"	.09232	107	1052	1159
6	"6-out19328"	.08860	49	504	553
6	"6-out19329"	.03672	13	341	354
6	"6-out19330"	.13142	92	608	700
6	"6-out19331"	.46113	534	624	1158
6	"6-out19332"	.33043	38	77	115
6	"6-out19333"	.14039	106	649	755
6	"6-out19334"	.12500	12	84	96
6	"6-out19335"	.02290	3	128	131
6	"6-out19336"	.09154	39	387	426
6	"6-out19337"	.04929	14	270	284
6	"6-out19338"	.34453	41	78	119
6	"6-out19339"	.41176	49	70	119
6	"6-out19340"	.14450	50	296	346
6	"6-out19341"	.36206	21	37	58
6	"6-out19342"	.33333	39	78	117
6	"6-out19343"	.37288	44	74	118
6	"6-out19344"	.09383	35	338	373
6	"6-out19345"	.07236	22	282	304
6	"6-out19346"	.27000	27	73	100
6	"6-out19347"	.05817	21	340	361
6	"6-out19348"	.23333	21	69	90
6	"6-out19349"	.06104	34	523	557
6	"6-out19350"	.06291	47	700	747
6	"6-out19351"	.05929	22	349	371
6	"6-out19352"	.32233	127	267	394
6	"6-out19353"	.41907	145	201	346
6	"6-out19354"	.07253	14	179	193
6	"6-out19355"	.16080	32	167	199
6	"6-out19356"	.32735	73	150	223
6	"6-out19357"	.12903	36	243	279
6	"6-out19358"	.49700	166	168	334
6	"6-out19359"	.11293	55	432	487
6	"6-out19360"	.27179	106	284	390
6	"6-out19361"	.22464	144	497	641
6	"6-out19362"	.14196	91	550	641
6	"6-out19363"	.42105	32	44	76
6	"6-out19364"	.13610	72	457	529
6	"6-out19365"	.03892	13	321	334
6	"6-out19366"	.52852	176	157	333
6	"6-out19367"	.36177	106	187	293
6	"6-out19368"	.39249	115	178	293
6	"6-out19369"	.21158	95	354	449
6	"6-out19370"	.10693	37	309	346
6	"6-out19371"	.12205	57	410	467
6	"6-out19372"	.21011	133	500	633
6	"6-out19373"	.40389	145	214	359
6	"6-out19374"	.02094	4	187	191
6	"6-out19375"	.04145	8	185	193
6	"6-out19376"	.09604	68	640	708
6	"6-out19377"	.48325	202	216	418
6	"6-out19378"	.13005	45	301	346
6	"6-out19379"	.23684	81	261	342
6	"6-out19380"	.33990	138	268	406
6	"6-out19381"	.09899	59	537	596
6	"6-out19382"	.37500	9	15	24
6	"6-out19383"	.28750	23	57	80
6	"6-out19384"	.08992	25	253	278
6	"6-out19385"	.13571	38	242	280
6	"6-out19386"	.38135	45	73	118
6	"6-out19387"	.41880	49	68	117
6	"6-out19388"	.04705	12	243	255
6	"6-out19389"	.13435	70	451	521
6	"6-out19390"	.05525	51	872	923
6	"6-out19391"	.04489	11	234	245
6	"6-out19392"	.13662	141	891	1032
6	"6-out19393"	.09001	164	1658	1822
6	"6-out19394"	.05227	61	1106	1167
6	"6-out19395"	.09386	75	724	799
6	"6-out19396"	.06015	48	750	798
6	"6-out19397"	.08373	87	952	1039
6	"6-out19398"	.09386	124	1197	1321
6	"6-out19399"	.10928	20	163	183
6	"6-out19400"	.08502	84	904	988
6	"6-out19401"	.05686	53	879	932
6	"6-out19402"	.06877	37	501	538
6	"6-out19403"	.10407	23	198	221
6	"6-out19404"	.14519	62	365	427
6	"6-out19405"	.13740	54	339	393
6	"6-out19406"	.08440	46	499	545
6	"6-out19407"	.04862	23	450	473
6	"6-out19408"	.05672	154	2561	2715
6	"6-out19409"	.17267	848	4063	4911
6	"6-out19410"	.06718	372	5165	5537
6	"6-out19411"	.32314	148	310	458
6	"6-out19412"	.11578	143	1092	1235
6	"6-out19413"	.08482	57	615	672
6	"6-out19414"	.03934	29	708	737
6	"6-out19415"	.04155	16	369	385
6	"6-out19416"	.36534	194	337	531
6	"6-out19417"	.41875	67	93	160
6	"6-out19418"	.10218	14	123	137
6	"6-out19419"	.02469	2	79	81
6	"6-out19420"	.07142	6	78	84
6	"6-out19421"	.30158	19	44	63
6	"6-out19422"	.19858	56	226	282
6	"6-out19423"	.17647	45	210	255
6	"6-out19424"	.23529	52	169	221
6	"6-out19425"	.35384	69	126	195
6	"6-out19426"	.29353	59	142	201
6	"6-out19427"	.24257	49	153	202
6	"6-out19428"	.35256	55	101	156
6	"6-out19429"	.28627	73	182	255
6	"6-out19430"	.26553	47	130	177
6	"6-out19431"	.18750	18	78	96
6	"6-out19432"	.21428	24	88	112
6	"6-out19433"	.31976	55	117	172
6	"6-out19434"	.53061	52	46	98
6	"6-out19435"	.55102	54	44	98
6	"6-out19436"	.22794	31	105	136
6	"6-out19437"	.22051	43	152	195
6	"6-out19438"	.29518	49	117	166
6	"6-out19439"	.35911	65	116	181
6	"6-out19440"	.25853	53	152	205
6	"6-out19441"	.34761	73	137	210
6	"6-out19442"	.38918	72	113	185
6	"6-out19443"	.33809	71	139	210
6	"6-out19444"	.14028	39	239	278
6	"6-out19445"	.22362	53	184	237
6	"6-out19446"	.21705	28	101	129
6	"6-out19447"	.30303	50	115	165
6	"6-out19448"	.29411	55	132	187
6	"6-out19449"	.36686	62	107	169
6	"6-out19450"	.11267	8	63	71
6	"6-out19451"	.32258	20	42	62
6	"6-out19452"	.32038	33	70	103
6	"6-out19453"	.25200	63	187	250
6	"6-out19454"	.32183	56	118	174
6	"6-out19455"	.28301	45	114	159
6	"6-out19456"	.37662	58	96	154
6	"6-out19457"	.33125	53	107	160
6	"6-out19458"	.29585	50	119	169
6	"6-out19459"	.36477	58	101	159
6	"6-out19460"	.04016	19	454	473
6	"6-out19461"	.12718	131	899	1030
6	"6-out19462"	.08593	11	117	128
6	"6-out19463"	.39181	67	104	171
6	"6-out19464"	.15164	69	386	455
6	"6-out19465"	.31403	141	308	449
6	"6-out19466"	.27412	125	331	456
6	"6-out19467"	.25760	127	366	493
6	"6-out19468"	.04638	34	699	733
6	"6-out19469"	.48104	444	479	923
6	"6-out19470"	.11684	111	839	950
6	"6-out19471"	.05186	25	457	482
6	"6-out19472"	.08536	91	975	1066
6	"6-out19473"	.20000	82	328	410
6	"6-out19474"	.29207	118	286	404
6	"6-out19475"	.15441	21	115	136
6	"6-out19476"	.41509	22	31	53
6	"6-out19477"	.47328	62	69	131
6	"6-out19478"	.44027	446	567	1013
6	"6-out19479"	.55128	43	35	78
6	"6-out19480"	.34801	79	148	227
6	"6-out19481"	.06227	70	1054	1124
6	"6-out19482"	.48825	187	196	383
6	"6-out19483"	.11344	54	422	476
6	"6-out19484"	.20000	106	424	530
6	"6-out19485"	.18803	88	380	468
6	"6-out19486"	.44922	376	461	837
6	"6-out19487"	.14867	73	418	491
6	"6-out19488"	.08266	133	1476	1609
6	"6-out19489"	.13174	232	1529	1761
6	"6-out19490"	.05867	70	1123	1193
6	"6-out19491"	.08190	129	1446	1575
6	"6-out19492"	.19285	81	339	420
6	"6-out19493"	.29968	95	222	317
6	"6-out19494"	.39237	288	446	734
6	"6-out19495"	.09911	112	1018	1130
6	"6-out19496"	.10687	28	234	262
6	"6-out19497"	.48529	198	210	408
6	"6-out19498"	.12912	90	607	697
6	"6-out19499"	.09951	102	923	1025
6	"6-out19500"	.11544	151	1157	1308
6	"6-out19501"	.06237	30	451	481
6	"6-out19502"	.27118	32	86	118
6	"6-out19503"	.22881	27	91	118
6	"6-out19504"	.15231	23	128	151
6	"6-out19505"	.07325	63	797	860
6	"6-out19506"	.17328	48	229	277
6	"6-out19507"	.06465	15	217	232
6	"6-out19508"	.10503	48	409	457
6	"6-out19509"	.08279	64	709	773
6	"6-out19510"	.06214	11	166	177
6	"6-out19511"	.07287	54	687	741
6	"6-out19512"	.04076	120	2824	2944
6	"6-out19513"	.09845	83	760	843
6	"6-out19514"	.06182	46	698	744
6	"6-out19515"	.11643	68	516	584
6	"6-out19516"	.05445	11	191	202
6	"6-out19517"	.06840	63	858	921
6	"6-out19518"	.07111	49	640	689
6	"6-out19519"	.13698	20	126	146
6	"6-out19520"	.08045	7	80	87
6	"6-out19521"	.11585	38	290	328
6	"6-out19522"	.10726	31	258	289
6	"6-out19523"	.39361	37	57	94
6	"6-out19524"	.13767	239	1497	1736
6	"6-out19525"	.15282	184	1020	1204
6	"6-out19526"	.15023	32	181	213
6	"6-out19527"	.05965	97	1529	1626
6	"6-out19529"	.07537	15	184	199
6	"6-out19530"	.08205	16	179	195
6	"6-out19531"	.22613	45	154	199
6	"6-out19532"	.19642	44	180	224
6	"6-out19533"	.04145	8	185	193
6	"6-out19534"	.05050	10	188	198
6	"6-out19535"	.09072	44	441	485
6	"6-out19536"	.03975	13	314	327
6	"6-out19537"	.04294	7	156	163
6	"6-out19538"	.22285	39	136	175
6	"6-out19539"	.07563	9	110	119
6	"6-out19540"	.07592	41	499	540
6	"6-out19541"	.11668	200	1514	1714
6	"6-out19542"	.09879	90	821	911
6	"6-out19543"	.23666	173	558	731
6	"6-out19544"	.29607	98	233	331
6	"6-out19545"	.16800	84	416	500
6	"6-out19546"	.14658	73	425	498
6	"6-out19547"	.09259	35	343	378
6	"6-out19548"	.12085	51	371	422
6	"6-out19549"	.09523	36	342	378
6	"6-out19550"	.06129	19	291	310
6	"6-out19551"	.31610	104	225	329
6	"6-out19552"	.04127	22	511	533
6	"6-out19553"	.13427	76	490	566
6	"6-out19554"	.09819	98	900	998
6	"6-out19555"	.27815	289	750	1039
6	"6-out19556"	.13567	54	344	398
6	"6-out19557"	.06168	19	289	308
6	"6-out19558"	.10000	18	162	180
6	"6-out19559"	.55238	58	47	105
6	"6-out19560"	.57186	187	140	327
6	"6-out19561"	.07692	11	132	143
6	"6-out19562"	.06949	36	482	518
6	"6-out19563"	.07902	26	303	329
6	"6-out19564"	.46031	116	136	252
6	"6-out19565"	.06962	22	294	316
6	"6-out19566"	.06187	31	470	501
6	"6-out19567"	.05660	15	250	265
6	"6-out19568"	.06434	37	538	575
6	"6-out19569"	.08876	49	503	552
6	"6-out19570"	.07051	33	435	468
6	"6-out19571"	.06451	14	203	217
6	"6-out19572"	.12790	22	150	172
6	"6-out19573"	.16178	127	658	785
6	"6-out19574"	.19917	48	193	241
6	"6-out19575"	.05974	19	299	318
6	"6-out19576"	.07751	30	357	387
6	"6-out19577"	.06810	19	260	279
6	"6-out19578"	.05112	25	464	489
6	"6-out19579"	.04761	25	500	525
6	"6-out19580"	.07258	135	1725	1860
6	"6-out19581"	.16299	37	190	227
6	"6-out19582"	.12532	195	1361	1556
6	"6-out19583"	.06934	50	671	721
6	"6-out19584"	.42703	199	267	466
6	"6-out19585"	.39659	163	248	411
6	"6-out19586"	.04551	32	671	703
6	"6-out19587"	.15867	43	228	271
6	"6-out19588"	.09392	17	164	181
6	"6-out19589"	.08317	43	474	517
6	"6-out19590"	.10629	206	1732	1938
6	"6-out19591"	.15577	62	336	398
6	"6-out19592"	.07641	35	423	458
6	"6-out19593"	.56198	68	53	121
6	"6-out19594"	.43846	57	73	130
6	"6-out19595"	.03786	17	432	449
6	"6-out19596"	.30031	94	219	313
6	"6-out19597"	.31674	70	151	221
6	"6-out19598"	.09644	19	178	197
6	"6-out19599"	.22797	44	149	193
6	"6-out19600"	.10204	10	88	98
6	"6-out19601"	.42988	187	248	435
6	"6-out19602"	.05791	97	1578	1675
6	"6-out19603"	.04390	72	1568	1640
6	"6-out19604"	.16552	97	489	586
6	"6-out19605"	.44129	109	138	247
6	"6-out19606"	.30830	78	175	253
6	"6-out19607"	.10500	151	1287	1438
6	"6-out19608"	.08226	45	502	547
6	"6-out19609"	.39669	48	73	121
6	"6-out19610"	.15121	31	174	205
6	"6-out19611"	.21428	48	176	224
6	"6-out19612"	.03846	11	275	286
6	"6-out19613"	.13593	115	731	846
6	"6-out19614"	.06484	95	1370	1465
6	"6-out19615"	.08000	34	391	425
6	"6-out19616"	.04802	17	337	354
6	"6-out19617"	.10703	35	292	327
6	"6-out19618"	.06764	23	317	340
6	"6-out19619"	.42682	70	94	164
6	"6-out19620"	.50153	163	162	325
6	"6-out19621"	.42924	91	121	212
6	"6-out19622"	.15500	82	447	529
6	"6-out19623"	.13003	42	281	323
6	"6-out19624"	.09354	42	407	449
6	"6-out19625"	.09160	24	238	262
6	"6-out19626"	.10299	86	749	835
6	"6-out19627"	.12877	524	3545	4069
6	"6-out19628"	.15714	22	118	140
6	"6-out19629"	.40963	34	49	83
6	"6-out19630"	.25925	14	40	54
6	"6-out19631"	.41891	62	86	148
6	"6-out19632"	.08750	14	146	160
6	"6-out19633"	.11012	99	800	899
6	"6-out19634"	.15868	53	281	334
6	"6-out19635"	.43689	135	174	309
6	"6-out19636"	.06285	55	820	875
6	"6-out19637"	.05799	41	666	707
6	"6-out19638"	.12768	95	649	744
6	"6-out19639"	.08235	42	468	510
6	"6-out19640"	.19565	18	74	92
6	"6-out19641"	.06355	30	442	472
6	"6-out19642"	.11111	40	320	360
6	"6-out19643"	.05206	53	965	1018
6	"6-out19644"	.11727	129	971	1100
6	"6-out19645"	.09691	129	1202	1331
6	"6-out19646"	.69148	65	29	94
6	"6-out19647"	.18539	33	145	178
6	"6-out19648"	.12416	130	917	1047
6	"6-out19649"	.11764	18	135	153
6	"6-out19650"	.09252	26	255	281
6	"6-out19651"	.08379	15	164	179
6	"6-out19652"	.06557	12	171	183
6	"6-out19653"	.16149	26	135	161
6	"6-out19654"	.02857	5	170	175
6	"6-out19655"	.66942	81	40	121
6	"6-out19656"	.03620	53	1411	1464
6	"6-out19657"	.05581	83	1404	1487
6	"6-out19658"	.35297	587	1076	1663
6	"6-out19659"	.03834	64	1605	1669
6	"6-out19660"	.04556	78	1634	1712
6	"6-out19661"	.04985	84	1601	1685
6	"6-out19662"	.43692	762	982	1744
6	"6-out19663"	.44151	770	974	1744
6	"6-out19664"	.04202	63	1436	1499
6	"6-out19665"	.03015	31	997	1028
6	"6-out19666"	.04317	44	975	1019
6	"6-out19667"	.08705	197	2066	2263
6	"6-out19668"	.14132	132	802	934
6	"6-out19669"	.06543	46	657	703
6	"6-out19670"	.13874	82	509	591
6	"6-out19671"	.04093	28	656	684
6	"6-out19672"	.16100	90	469	559
6	"6-out19673"	.03773	4	102	106
6	"6-out19674"	.16216	12	62	74
6	"6-out19675"	.32800	41	84	125
6	"6-out19676"	.10389	24	207	231
6	"6-out19677"	.05735	39	641	680
6	"6-out19678"	.07198	130	1676	1806
6	"6-out19679"	.14115	178	1083	1261
6	"6-out19680"	.12037	166	1213	1379
6	"6-out19681"	.07407	62	775	837
6	"6-out19682"	.08992	174	1761	1935
6	"6-out19683"	.10854	287	2357	2644
6	"6-out19684"	.05530	61	1042	1103
6	"6-out19685"	.06842	65	885	950
6	"6-out19686"	.08127	89	1006	1095
6	"6-out19687"	.11101	134	1073	1207
6	"6-out19688"	.06736	32	443	475
6	"6-out19689"	.41953	451	624	1075
6	"6-out19690"	.08783	13	135	148
6	"6-out19691"	.12094	41	298	339
6	"6-out19692"	.17647	63	294	357
6	"6-out19693"	.31513	127	276	403
6	"6-out19694"	.34011	117	227	344
6	"6-out19695"	.09794	300	2763	3063
6	"6-out19696"	.13090	72	478	550
6	"6-out19697"	.03347	24	693	717
6	"6-out19698"	.10952	100	813	913
6	"6-out19699"	.05468	28	484	512
6	"6-out19700"	.07275	43	548	591
6	"6-out19701"	.06086	35	540	575
6	"6-out19702"	.24096	40	126	166
6	"6-out19703"	.17098	33	160	193
6	"6-out19704"	.12650	21	145	166
6	"6-out19705"	.07348	102	1286	1388
6	"6-out19706"	.09134	77	766	843
6	"6-out19707"	.10267	46	402	448
6	"6-out19708"	.48913	225	235	460
6	"6-out19709"	.06114	48	737	785
6	"6-out19710"	.05940	42	665	707
6	"6-out19711"	.03437	23	646	669
6	"6-out19712"	.30630	68	154	222
6	"6-out19713"	.18811	19	82	101
6	"6-out19714"	.06458	29	420	449
6	"6-out19715"	.13903	182	1127	1309
6	"6-out19716"	.15053	42	237	279
6	"6-out19717"	.05241	63	1139	1202
6	"6-out19718"	.15324	118	652	770
6	"6-out19719"	.08550	46	492	538
6	"6-out19720"	.47863	56	61	117
6	"6-out19721"	.13600	17	108	125
6	"6-out19722"	.40163	49	73	122
6	"6-out19723"	.20061	65	259	324
6	"6-out19724"	.02375	10	411	421
6	"6-out19725"	.21330	93	343	436
6	"6-out19726"	.06770	39	537	576
6	"6-out19727"	.20788	211	804	1015
6	"6-out19728"	.08744	131	1367	1498
6	"6-out19729"	.07100	36	471	507
6	"6-out19730"	.08473	106	1145	1251
6	"6-out19731"	.14956	121	688	809
6	"6-out19732"	.13194	19	125	144
6	"6-out19733"	.05625	9	151	160
6	"6-out19734"	.30215	42	97	139
6	"6-out19735"	.14589	48	281	329
6	"6-out19736"	.06624	63	888	951
6	"6-out19737"	.09677	75	700	775
6	"6-out19738"	.07037	38	502	540
6	"6-out19739"	.07835	59	694	753
6	"6-out19740"	.01190	2	166	168
6	"6-out19741"	.13736	25	157	182
6	"6-out19742"	.06115	17	261	278
6	"6-out19743"	.11862	86	639	725
6	"6-out19744"	.38975	502	786	1288
6	"6-out19745"	.07879	81	947	1028
6	"6-out19746"	.38742	499	789	1288
6	"6-out19747"	.14602	191	1117	1308
6	"6-out19748"	.08575	112	1194	1306
6	"6-out19749"	.11526	268	2057	2325
6	"6-out19750"	.13375	21	136	157
6	"6-out19751"	.03001	41	1325	1366
6	"6-out19752"	.03819	56	1410	1466
6	"6-out19753"	.37919	113	185	298
6	"6-out19754"	.51785	29	27	56
6	"6-out19755"	.13725	28	176	204
6	"6-out19756"	.06737	38	526	564
6	"6-out19757"	.16981	27	132	159
6	"6-out19758"	.10366	82	709	791
6	"6-out19759"	.13717	262	1648	1910
6	"6-out19760"	.08257	100	1111	1211
6	"6-out19761"	.19983	498	1994	2492
6	"6-out19762"	.07634	71	859	930
6	"6-out19763"	.12358	197	1397	1594
6	"6-out19764"	.54625	248	206	454
6	"6-out19765"	.08830	108	1115	1223
6	"6-out19766"	.08660	106	1118	1224
6	"6-out19767"	.07135	69	898	967
6	"6-out19768"	.07547	52	637	689
6	"6-out19769"	.08588	70	745	815
6	"6-out19770"	.03750	3	77	80
6	"6-out19771"	.19718	70	285	355
6	"6-out19772"	.33518	121	240	361
6	"6-out19773"	.07766	24	285	309
6	"6-out19774"	.11040	139	1120	1259
6	"6-out19775"	.08058	66	753	819
6	"6-out19776"	.10045	66	591	657
6	"6-out19777"	.07547	56	686	742
6	"6-out19778"	.08441	13	141	154
6	"6-out19779"	.33884	41	80	121
6	"6-out19780"	.06593	30	425	455
6	"6-out19781"	.12500	14	98	112
6	"6-out19782"	.06866	16	217	233
6	"6-out19783"	.21176	18	67	85
6	"6-out19784"	.11000	22	178	200
6	"6-out19785"	.15300	28	155	183
6	"6-out19786"	.04040	8	190	198
6	"6-out19787"	.12376	25	177	202
6	"6-out19788"	.08762	17	177	194
6	"6-out19789"	.28742	96	238	334
6	"6-out19790"	.04095	31	726	757
6	"6-out19791"	.04797	13	258	271
6	"6-out19792"	.08380	104	1137	1241
6	"6-out19793"	.08441	104	1128	1232
6	"6-out19794"	.07324	72	911	983
6	"6-out19795"	.17241	25	120	145
6	"6-out19796"	.07784	26	308	334
6	"6-out19797"	.13622	44	279	323
6	"6-out19798"	.01681	11	643	654
6	"6-out19799"	.32835	110	225	335
6	"6-out19800"	.05882	72	1152	1224
6	"6-out19801"	.20403	81	316	397
6	"6-out19802"	.17451	63	298	361
6	"6-out19803"	.04761	18	360	378
6	"6-out19804"	.09202	30	296	326
6	"6-out19805"	.05913	22	350	372
6	"6-out19806"	.08000	14	161	175
6	"6-out19807"	.06106	24	369	393
6	"6-out19808"	.10174	35	309	344
6	"6-out19809"	.05235	20	362	382
6	"6-out19810"	.22631	86	294	380
6	"6-out19811"	.11590	43	328	371
6	"6-out19812"	.34354	157	300	457
6	"6-out19813"	.22222	20	70	90
6	"6-out19814"	.05145	23	424	447
6	"6-out19815"	.26376	91	254	345
6	"6-out19816"	.05830	66	1066	1132
6	"6-out19817"	.06823	81	1106	1187
6	"6-out19818"	.17089	451	2188	2639
6	"6-out19819"	.47307	369	411	780
6	"6-out19820"	.11788	58	434	492
6	"6-out19821"	.10200	66	581	647
6	"6-out19822"	.29268	72	174	246
6	"6-out19823"	.14960	38	216	254
6	"6-out19824"	.06118	29	445	474
6	"6-out19825"	.09090	35	350	385
6	"6-out19826"	.11530	171	1312	1483
6	"6-out19827"	.08661	11	116	127
6	"6-out19828"	.13468	292	1876	2168
6	"6-out19829"	.05600	7	118	125
6	"6-out19830"	.11126	79	631	710
6	"6-out19831"	.09110	43	429	472
6	"6-out19832"	.12298	107	763	870
6	"6-out19833"	.08732	51	533	584
6	"6-out19834"	.12127	57	413	470
6	"6-out19835"	.15722	86	461	547
6	"6-out19836"	.15727	148	793	941
6	"6-out19837"	.31282	549	1206	1755
6	"6-out19838"	.11013	50	404	454
6	"6-out19839"	.06515	46	660	706
6	"6-out19840"	.47000	47	53	100
6	"6-out19841"	.10140	152	1347	1499
6	"6-out19842"	.07152	102	1324	1426
6	"6-out19843"	.10787	37	306	343
6	"6-out19844"	.22903	601	2023	2624
6	"6-out19845"	.08431	50	543	593
6	"6-out19846"	.20118	34	135	169
6	"6-out19847"	.19354	54	225	279
6	"6-out19848"	.19267	100	419	519
6	"6-out19849"	.10598	62	523	585
6	"6-out19850"	.08083	54	614	668
6	"6-out19851"	.30000	45	105	150
6	"6-out19852"	.30666	23	52	75
6	"6-out19853"	.38750	31	49	80
6	"6-out19854"	.43396	46	60	106
6	"6-out19855"	.11594	8	61	69
6	"6-out19856"	.48000	60	65	125
6	"6-out19857"	.31531	35	76	111
6	"6-out19858"	.33333	40	80	120
6	"6-out19859"	.45945	51	60	111
6	"6-out19860"	.11555	52	398	450
6	"6-out19861"	.08421	56	609	665
6	"6-out19862"	.13734	57	358	415
6	"6-out19863"	.07828	53	624	677
6	"6-out19864"	.52542	186	168	354
6	"6-out19865"	.38944	155	243	398
6	"6-out19866"	.19911	45	181	226
6	"6-out19867"	.07423	17	212	229
6	"6-out19868"	.07865	28	328	356
6	"6-out19869"	.11796	44	329	373
6	"6-out19870"	.40317	127	188	315
6	"6-out19871"	.29375	47	113	160
6	"6-out19872"	.11042	18	145	163
6	"6-out19873"	.29051	95	232	327
6	"6-out19874"	.03743	7	180	187
6	"6-out19875"	.49315	108	111	219
6	"6-out19876"	.24369	58	180	238
6	"6-out19877"	.10801	62	512	574
6	"6-out19878"	.09543	113	1071	1184
6	"6-out19879"	.09905	21	191	212
6	"6-out19880"	.08020	32	367	399
6	"6-out19881"	.05743	39	640	679
6	"6-out19882"	.04716	5	101	106
6	"6-out19883"	.07734	56	668	724
6	"6-out19884"	.06368	47	691	738
6	"6-out19885"	.12993	56	375	431
6	"6-out19886"	.58333	56	40	96
6	"6-out19887"	.05377	72	1267	1339
6	"6-out19888"	.07874	113	1322	1435
6	"6-out19889"	.05820	66	1068	1134
6	"6-out19890"	.13763	162	1015	1177
6	"6-out19891"	.16631	79	396	475
6	"6-out19892"	.04900	59	1145	1204
6	"6-out19893"	.07711	91	1089	1180
6	"6-out19894"	.16884	207	1019	1226
6	"6-out19895"	.09949	119	1077	1196
6	"6-out19896"	.07240	90	1153	1243
6	"6-out19897"	.39426	110	169	279
6	"6-out19898"	.17605	25	117	142
6	"6-out19899"	.08826	76	785	861
6	"6-out19900"	.06315	6	89	95
6	"6-out19901"	.10444	47	403	450
6	"6-out19902"	.11426	133	1031	1164
6	"6-out19903"	.09929	28	254	282
6	"6-out19904"	.02156	8	363	371
6	"6-out19905"	.09552	64	606	670
6	"6-out19906"	.09855	102	933	1035
6	"6-out19907"	.05498	16	275	291
6	"6-out19908"	.07423	17	212	229
6	"6-out19909"	.38222	86	139	225
6	"6-out19910"	.11234	111	877	988
6	"6-out19911"	.31067	32	71	103
6	"6-out19912"	.12236	93	667	760
6	"6-out19913"	.06708	54	751	805
6	"6-out19914"	.08368	20	219	239
6	"6-out19915"	.10087	23	205	228
6	"6-out19916"	.08296	19	210	229
6	"6-out19917"	.61214	131	83	214
6	"6-out19918"	.07509	19	234	253
6	"6-out19919"	.58849	133	93	226
6	"6-out19920"	.08471	41	443	484
6	"6-out19921"	.06237	30	451	481
6	"6-out19922"	.13448	39	251	290
6	"6-out19923"	.14427	29	172	201
6	"6-out19924"	.18435	66	292	358
6	"6-out19925"	.09112	39	389	428
6	"6-out19926"	.12825	69	469	538
6	"6-out19927"	.05635	59	988	1047
6	"6-out19928"	.77941	53	15	68
6	"6-out19929"	.12931	30	202	232
6	"6-out19930"	.12098	162	1177	1339
6	"6-out19931"	.16184	56	290	346
6	"6-out19932"	.11138	46	367	413
6	"6-out19933"	.18025	84	382	466
6	"6-out19934"	.67346	99	48	147
6	"6-out19935"	.08097	20	227	247
6	"6-out19936"	.46112	172	201	373
6	"6-out19937"	.07650	128	1545	1673
6	"6-out19938"	.18562	31	136	167
6	"6-out19939"	.16451	51	259	310
6	"6-out19940"	.49523	52	53	105
6	"6-out19941"	.03703	3	78	81
6	"6-out19942"	.04819	4	79	83
6	"6-out19943"	.15488	217	1184	1401
6	"6-out19944"	.13035	149	994	1143
6	"6-out19945"	.10082	61	544	605
6	"6-out19946"	.06944	50	670	720
6	"6-out19947"	.14216	147	887	1034
6	"6-out19948"	.10630	59	496	555
6	"6-out19949"	.02693	8	289	297
6	"6-out19950"	.38198	212	343	555
6	"6-out19951"	.07744	184	2192	2376
6	"6-out19952"	.12521	72	503	575
6	"6-out19953"	.09694	54	503	557
6	"6-out19954"	.37543	107	178	285
6	"6-out19955"	.11643	34	258	292
6	"6-out19956"	.15384	46	253	299
6	"6-out19957"	.11463	47	363	410
6	"6-out19958"	.29032	72	176	248
6	"6-out19959"	.17241	15	72	87
6	"6-out19960"	.12195	20	144	164
6	"6-out19961"	.08181	27	303	330
6	"6-out19962"	.09120	28	279	307
6	"6-out19963"	.15591	58	314	372
6	"6-out19964"	.11500	23	177	200
6	"6-out19965"	.14946	210	1195	1405
6	"6-out19966"	.09038	94	946	1040
6	"6-out19967"	.06237	64	962	1026
6	"6-out19968"	.09824	101	927	1028
6	"6-out19969"	.03106	43	1341	1384
6	"6-out19970"	.06976	63	840	903
6	"6-out19971"	.07313	55	697	752
6	"6-out19972"	.09760	163	1507	1670
6	"6-out19973"	.06213	105	1585	1690
6	"6-out19974"	.06150	104	1587	1691
6	"6-out19975"	.04678	86	1752	1838
6	"6-out19976"	.06704	117	1628	1745
6	"6-out19977"	.12887	216	1460	1676
6	"6-out19978"	.05602	178	2999	3177
6	"6-out19979"	.11663	305	2310	2615
6	"6-out19980"	.49206	124	128	252
6	"6-out19981"	.01435	6	412	418
6	"6-out19982"	.13696	73	460	533
6	"6-out19983"	.10854	47	386	433
6	"6-out19984"	.14090	31	189	220
6	"6-out19985"	.60000	99	66	165
6	"6-out19986"	.09353	55	533	588
6	"6-out19987"	.19322	57	238	295
6	"6-out19988"	.20207	39	154	193
6	"6-out19989"	.06177	32	486	518
6	"6-out19990"	.03773	12	306	318
6	"6-out19991"	.30952	91	203	294
6	"6-out19992"	.09844	19	174	193
6	"6-out19993"	.19614	61	250	311
6	"6-out19994"	.14215	29	175	204
6	"6-out19995"	.02475	5	197	202
6	"6-out19996"	.10775	25	207	232
6	"6-out19997"	.11251	71	560	631
6	"6-out19998"	.06813	31	424	455
6	"6-out19999"	.16954	59	289	348
6	"6-out20000"	.10430	92	790	882
6	"6-out20001"	.12176	47	339	386
6	"6-out20002"	.03066	13	411	424
6	"6-out20003"	.10158	45	398	443
6	"6-out20004"	.13068	46	306	352
6	"6-out20005"	.07487	31	383	414
6	"6-out20006"	.12296	68	485	553
6	"6-out20007"	.14285	11	66	77
6	"6-out20008"	.12234	46	330	376
6	"6-out20009"	.26086	18	51	69
6	"6-out20010"	.09267	100	979	1079
6	"6-out20011"	.43157	82	108	190
6	"6-out20012"	.07531	18	221	239
6	"6-out20013"	.22772	23	78	101
6	"6-out20014"	.18226	37	166	203
6	"6-out20015"	.51851	56	52	108
6	"6-out20016"	.14960	19	108	127
6	"6-out20017"	.18817	347	1497	1844
6	"6-out20018"	.25360	88	259	347
6	"6-out20019"	.49461	643	657	1300
6	"6-out20020"	.14429	172	1020	1192
6	"6-out20021"	.14172	197	1193	1390
6	"6-out20022"	.35185	228	420	648
6	"6-out20023"	.11776	61	457	518
6	"6-out20024"	.09514	47	447	494
6	"6-out20025"	.41428	58	82	140
6	"6-out20026"	.07253	14	179	193
6	"6-out20027"	.09769	203	1875	2078
6	"6-out20028"	.15976	27	142	169
6	"6-out20029"	.35714	45	81	126
6	"6-out20030"	.45901	56	66	122
6	"6-out20031"	.05363	45	794	839
6	"6-out20032"	.16341	151	773	924
6	"6-out20033"	.05660	6	100	106
6	"6-out20034"	.11129	67	535	602
6	"6-out20035"	.06583	116	1646	1762
6	"6-out20036"	.38801	369	582	951
6	"6-out20037"	.22222	92	322	414
6	"6-out20038"	.66141	84	43	127
6	"6-out20039"	.25080	156	466	622
6	"6-out20040"	.16734	41	204	245
6	"6-out20041"	.13740	18	113	131
6	"6-out20042"	.09638	16	150	166
6	"6-out20043"	.09438	42	403	445
6	"6-out20044"	.51807	86	80	166
6	"6-out20045"	.53531	144	125	269
6	"6-out20046"	.35211	25	46	71
6	"6-out20047"	.29022	92	225	317
6	"6-out20048"	.13103	19	126	145
6	"6-out20049"	.08243	46	512	558
6	"6-out20050"	.09090	53	530	583
6	"6-out20051"	.10166	55	486	541
6	"6-out20052"	.36559	34	59	93
6	"6-out20053"	.16218	193	997	1190
6	"6-out20054"	.05084	18	336	354
6	"6-out20055"	.13255	125	818	943
6	"6-out20056"	.44978	309	378	687
6	"6-out20057"	.11002	90	728	818
6	"6-out20058"	.06032	45	701	746
6	"6-out20059"	.06214	54	815	869
6	"6-out20060"	.10526	24	204	228
6	"6-out20061"	.09016	22	222	244
6	"6-out20062"	.04980	13	248	261
6	"6-out20063"	.07109	15	196	211
6	"6-out20064"	.08695	20	210	230
6	"6-out20065"	.12272	27	193	220
6	"6-out20066"	.19090	42	178	220
6	"6-out20067"	.06666	15	210	225
6	"6-out20068"	.02994	5	162	167
6	"6-out20069"	.29045	70	171	241
6	"6-out20070"	.07627	18	218	236
6	"6-out20071"	.10369	73	631	704
6	"6-out20072"	.14420	92	546	638
6	"6-out20073"	.17010	33	161	194
6	"6-out20074"	.08132	27	305	332
6	"6-out20075"	.09383	35	338	373
6	"6-out20076"	.08466	127	1373	1500
6	"6-out20077"	.36528	202	351	553
6	"6-out20078"	.13428	85	548	633
6	"6-out20079"	.10176	23	203	226
6	"6-out20080"	.55489	187	150	337
6	"6-out20081"	.12396	15	106	121
6	"6-out20082"	.06927	99	1330	1429
6	"6-out20083"	.05809	70	1135	1205
6	"6-out20084"	.07251	81	1036	1117
6	"6-out20085"	.36654	618	1068	1686
6	"6-out20086"	.08661	77	812	889
6	"6-out20087"	.08969	128	1299	1427
6	"6-out20088"	.06388	78	1143	1221
6	"6-out20089"	.12490	164	1149	1313
6	"6-out20090"	.09304	83	809	892
6	"6-out20091"	.04146	17	393	410
6	"6-out20092"	.11878	43	319	362
6	"6-out20093"	.08950	58	590	648
6	"6-out20094"	.07482	11	136	147
6	"6-out20095"	.11111	57	456	513
6	"6-out20096"	.08892	53	543	596
6	"6-out20097"	.11295	68	534	602
6	"6-out20098"	.09521	171	1625	1796
6	"6-out20099"	.55182	181	147	328
6	"6-out20100"	.06006	20	313	333
6	"6-out20101"	.37758	128	211	339
6	"6-out20102"	.49847	163	164	327
6	"6-out20103"	.13636	138	874	1012
6	"6-out20104"	.08584	74	788	862
6	"6-out20105"	.21938	86	306	392
6	"6-out20106"	.05102	50	930	980
6	"6-out20107"	.07994	59	679	738
6	"6-out20108"	.08454	70	758	828
6	"6-out20109"	.11918	100	739	839
6	"6-out20110"	.15454	119	651	770
6	"6-out20111"	.10784	66	546	612
6	"6-out20112"	.04987	80	1524	1604
6	"6-out20113"	.07414	111	1386	1497
6	"6-out20114"	.05530	97	1657	1754
6	"6-out20115"	.31597	182	394	576
6	"6-out20116"	.09457	108	1034	1142
6	"6-out20117"	.09890	127	1157	1284
6	"6-out20118"	.07220	20	257	277
6	"6-out20119"	.08118	22	249	271
6	"6-out20120"	.09195	88	869	957
6	"6-out20121"	.34677	43	81	124
6	"6-out20122"	.11610	31	236	267
6	"6-out20123"	.13000	13	87	100
6	"6-out20124"	.20149	81	321	402
6	"6-out20125"	.04838	18	354	372
6	"6-out20126"	.07812	30	354	384
6	"6-out20127"	.12219	49	352	401
6	"6-out20128"	.07052	28	369	397
6	"6-out20129"	.08388	76	830	906
6	"6-out20130"	.08604	82	871	953
6	"6-out20131"	.06265	26	389	415
6	"6-out20132"	.13894	71	440	511
6	"6-out20133"	.07352	15	189	204
6	"6-out20134"	.04919	43	831	874
6	"6-out20135"	.35246	307	564	871
6	"6-out20136"	.11244	47	371	418
6	"6-out20137"	.06185	24	364	388
6	"6-out20138"	.11246	37	292	329
6	"6-out20139"	.55434	102	82	184
6	"6-out20140"	.41578	79	111	190
6	"6-out20141"	.14621	56	327	383
6	"6-out20142"	.09604	17	160	177
6	"6-out20143"	.16666	35	175	210
6	"6-out20144"	.09782	72	664	736
6	"6-out20145"	.07253	61	780	841
6	"6-out20146"	.02555	8	305	313
6	"6-out20147"	.14363	53	316	369
6	"6-out20148"	.15476	26	142	168
6	"6-out20149"	.42696	38	51	89
6	"6-out20150"	.09478	20	191	211
6	"6-out20151"	.06116	20	307	327
6	"6-out20152"	.16279	7	36	43
6	"6-out20153"	.25688	28	81	109
6	"6-out20154"	.27522	30	79	109
6	"6-out20155"	.25641	10	29	39
6	"6-out20156"	.16279	7	36	43
6	"6-out20157"	.45023	95	116	211
6	"6-out20158"	.07307	19	241	260
6	"6-out20159"	.40077	208	311	519
6	"6-out20160"	.05761	42	687	729
6	"6-out20161"	.10294	56	488	544
6	"6-out20162"	.04587	15	312	327
6	"6-out20163"	.05668	25	416	441
6	"6-out20164"	.38177	176	285	461
6	"6-out20165"	.15186	118	659	777
6	"6-out20166"	.08125	39	441	480
6	"6-out20167"	.12408	34	240	274
6	"6-out20168"	.20306	53	208	261
6	"6-out20169"	.21243	41	152	193
6	"6-out20170"	.08121	51	577	628
6	"6-out20171"	.13333	14	91	105
6	"6-out20172"	.08363	69	756	825
6	"6-out20173"	.21019	66	248	314
6	"6-out20174"	.12796	27	184	211
6	"6-out20175"	.09422	106	1019	1125
6	"6-out20176"	.09929	42	381	423
6	"6-out20177"	.09903	41	373	414
6	"6-out20178"	.21114	72	269	341
6	"6-out20179"	.06310	26	386	412
6	"6-out20180"	.10300	24	209	233
6	"6-out20181"	.09623	23	216	239
6	"6-out20182"	.12618	385	2666	3051
6	"6-out20183"	.40816	100	145	245
6	"6-out20184"	.12355	32	227	259
6	"6-out20185"	.06666	30	420	450
6	"6-out20186"	.35962	155	276	431
6	"6-out20187"	.11627	55	418	473
6	"6-out20188"	.29729	33	78	111
6	"6-out20189"	.44444	28	35	63
6	"6-out20190"	.23611	17	55	72
6	"6-out20191"	.34905	37	69	106
6	"6-out20192"	.26582	21	58	79
6	"6-out20193"	.36718	47	81	128
6	"6-out20194"	.12073	46	335	381
6	"6-out20195"	.08431	50	543	593
6	"6-out20196"	.06330	113	1672	1785
6	"6-out20197"	.04733	39	785	824
6	"6-out20198"	.52226	258	236	494
6	"6-out20199"	.50694	73	71	144
6	"6-out20200"	.14354	60	358	418
6	"6-out20201"	.09161	211	2092	2303
6	"6-out20202"	.05050	5	94	99
6	"6-out20203"	.10810	56	462	518
6	"6-out20204"	.06363	7	103	110
6	"6-out20205"	.12568	23	160	183
6	"6-out20206"	.06000	6	94	100
6	"6-out20207"	.07584	38	463	501
6	"6-out20208"	.41025	144	207	351
6	"6-out20209"	.02010	4	195	199
6	"6-out20210"	.06606	51	721	772
6	"6-out20211"	.15909	63	333	396
6	"6-out20212"	.25190	33	98	131
6	"6-out20213"	.56626	188	144	332
6	"6-out20214"	.12520	75	524	599
6	"6-out20215"	.09178	38	376	414
6	"6-out20216"	.07655	32	386	418
6	"6-out20217"	.12455	141	991	1132
6	"6-out20218"	.04313	44	976	1020
6	"6-out20219"	.06802	70	959	1029
6	"6-out20220"	.11822	144	1074	1218
6	"6-out20221"	.27722	84	219	303
6	"6-out20222"	.08963	32	325	357
6	"6-out20223"	.08852	108	1112	1220
6	"6-out20224"	.09655	28	262	290
6	"6-out20225"	.07413	92	1149	1241
6	"6-out20226"	.08487	78	841	919
6	"6-out20227"	.20000	20	80	100
6	"6-out20228"	.07751	20	238	258
6	"6-out20229"	.14057	167	1021	1188
6	"6-out20230"	.40281	487	722	1209
6	"6-out20231"	.54000	108	92	200
6	"6-out20232"	.07683	69	829	898
6	"6-out20233"	.24731	23	70	93
6	"6-out20234"	.07284	11	140	151
6	"6-out20235"	.17488	39	184	223
6	"6-out20236"	.15384	36	198	234
6	"6-out20237"	.18750	24	104	128
6	"6-out20238"	.39814	43	65	108
6	"6-out20239"	.16000	24	126	150
6	"6-out20240"	.07922	37	430	467
6	"6-out20241"	.15151	20	112	132
6	"6-out20242"	.33333	49	98	147
6	"6-out20243"	.49308	107	110	217
6	"6-out20244"	.10810	36	297	333
6	"6-out20245"	.13114	16	106	122
6	"6-out20246"	.11034	16	129	145
6	"6-out20247"	.15636	43	232	275
6	"6-out20248"	.10569	13	110	123
6	"6-out20249"	.00847	2	234	236
6	"6-out20250"	.20952	66	249	315
6	"6-out20251"	.07876	23	269	292
6	"6-out20252"	.20869	24	91	115
6	"6-out20253"	.17948	14	64	78
6	"6-out20254"	.07976	151	1742	1893
6	"6-out20255"	.36166	183	323	506
6	"6-out20256"	.54465	372	311	683
6	"6-out20257"	.09694	197	1835	2032
6	"6-out20258"	.06741	114	1577	1691
6	"6-out20259"	.07692	81	972	1053
6	"6-out20260"	.11266	121	953	1074
6	"6-out20261"	.49775	222	224	446
6	"6-out20262"	.51345	229	217	446
6	"6-out20263"	.45588	62	74	136
6	"6-out20264"	.47000	188	212	400
6	"6-out20265"	.07032	91	1203	1294
6	"6-out20266"	.14986	458	2598	3056
6	"6-out20267"	.04923	16	309	325
6	"6-out20268"	.21264	37	137	174
6	"6-out20269"	.18324	35	156	191
6	"6-out20270"	.04545	3	63	66
6	"6-out20271"	.17105	26	126	152
6	"6-out20272"	.13395	43	278	321
6	"6-out20273"	.13921	82	507	589
6	"6-out20274"	.29665	62	147	209
6	"6-out20275"	.10526	26	221	247
6	"6-out20276"	.11487	105	809	914
6	"6-out20277"	.07317	18	228	246
6	"6-out20278"	.48473	127	135	262
6	"6-out20279"	.17338	43	205	248
6	"6-out20280"	.33333	17	34	51
6	"6-out20281"	.48447	78	83	161
6	"6-out20282"	.12341	68	483	551
6	"6-out20283"	.23188	16	53	69
6	"6-out20284"	.41630	286	401	687
6	"6-out20285"	.47222	51	57	108
6	"6-out20286"	.07784	13	154	167
6	"6-out20287"	.05233	47	851	898
6	"6-out20288"	.13953	30	185	215
6	"6-out20289"	.11111	23	184	207
6	"6-out20290"	.06557	20	285	305
6	"6-out20291"	.07142	16	208	224
6	"6-out20292"	.04910	11	213	224
6	"6-out20293"	.09132	20	199	219
6	"6-out20294"	.26363	58	162	220
6	"6-out20295"	.09246	27	265	292
6	"6-out20296"	.30909	68	152	220
6	"6-out20297"	.08133	17	192	209
6	"6-out20298"	.07339	16	202	218
6	"6-out20299"	.18957	40	171	211
6	"6-out20300"	.09216	20	197	217
6	"6-out20301"	.16557	101	509	610
6	"6-out20302"	.07560	31	379	410
6	"6-out20303"	.06405	67	979	1046
6	"6-out20304"	.08794	62	643	705
6	"6-out20305"	.26252	131	368	499
6	"6-out20306"	.15050	45	254	299
6	"6-out20307"	.08083	81	921	1002
6	"6-out20308"	.27397	120	318	438
6	"6-out20309"	.18327	57	254	311
6	"6-out20310"	.08892	102	1045	1147
6	"6-out20311"	.11363	30	234	264
6	"6-out20312"	.05384	14	246	260
6	"6-out20313"	.05882	10	160	170
6	"6-out20314"	.30964	61	136	197
6	"6-out20315"	.52204	225	206	431
6	"6-out20316"	.16756	31	154	185
6	"6-out20317"	.08510	32	344	376
6	"6-out20318"	.06060	24	372	396
6	"6-out20319"	.55094	146	119	265
6	"6-out20320"	.55974	89	70	159
6	"6-out20321"	.31034	63	140	203
6	"6-out20322"	.33766	130	255	385
6	"6-out20323"	.08955	18	183	201
6	"6-out20324"	.08872	37	380	417
6	"6-out20325"	.08486	37	399	436
6	"6-out20326"	.08235	35	390	425
6	"6-out20327"	.23409	195	638	833
6	"6-out20328"	.19031	55	234	289
6	"6-out20329"	.18848	180	775	955
6	"6-out20330"	.27972	40	103	143
6	"6-out20331"	.19932	59	237	296
6	"6-out20332"	.52405	207	188	395
6	"6-out20333"	.26449	187	520	707
6	"6-out20334"	.53924	213	182	395
6	"6-out20335"	.06498	18	259	277
6	"6-out20336"	.12347	142	1008	1150
6	"6-out20337"	.11224	11	87	98
6	"6-out20338"	.04550	42	881	923
6	"6-out20339"	.17224	108	519	627
6	"6-out20340"	.33040	226	458	684
6	"6-out20341"	.08880	50	513	563
6	"6-out20342"	.07516	23	283	306
6	"6-out20343"	.17171	17	82	99
6	"6-out20344"	.08993	59	597	656
6	"6-out20345"	.13131	13	86	99
6	"6-out20346"	.12328	36	256	292
6	"6-out20347"	.08780	36	374	410
6	"6-out20348"	.08365	44	482	526
6	"6-out20349"	.10422	37	318	355
6	"6-out20350"	.24512	88	271	359
6	"6-out20351"	.17318	124	592	716
6	"6-out20352"	.57894	44	32	76
6	"6-out20353"	.28222	405	1030	1435
6	"6-out20354"	.21681	147	531	678
6	"6-out20355"	.26515	105	291	396
6	"6-out20356"	.19841	25	101	126
6	"6-out20357"	.52000	65	60	125
6	"6-out20358"	.12701	252	1732	1984
6	"6-out20359"	.13230	77	505	582
6	"6-out20360"	.08905	70	716	786
6	"6-out20361"	.29665	62	147	209
6	"6-out20362"	.03973	6	145	151
6	"6-out20363"	.06833	30	409	439
6	"6-out20364"	.27570	59	155	214
6	"6-out20365"	.09370	67	648	715
6	"6-out20366"	.24786	58	176	234
6	"6-out20367"	.46766	94	107	201
6	"6-out20368"	.42168	210	288	498
6	"6-out20369"	.54430	215	180	395
6	"6-out20370"	.51230	229	218	447
6	"6-out20371"	.39208	109	169	278
6	"6-out20372"	.30314	77	177	254
6	"6-out20373"	.40217	37	55	92
6	"6-out20374"	.42521	452	611	1063
6	"6-out20375"	.12396	30	212	242
6	"6-out20376"	.16595	39	196	235
6	"6-out20377"	.40211	152	226	378
6	"6-out20378"	.20959	118	445	563
6	"6-out20379"	.58415	59	42	101
6	"6-out20380"	.15901	45	238	283
6	"6-out20381"	.09019	103	1039	1142
6	"6-out20382"	.16417	55	280	335
6	"6-out20383"	.20212	19	75	94
6	"6-out20384"	.36956	34	58	92
6	"6-out20385"	.15915	60	317	377
6	"6-out20386"	.18705	156	678	834
6	"6-out20387"	.12790	44	300	344
6	"6-out20388"	.17548	63	296	359
6	"6-out20389"	.07446	21	261	282
6	"6-out20390"	.22558	67	230	297
6	"6-out20391"	.10572	48	406	454
6	"6-out20392"	.11756	89	668	757
6	"6-out20393"	.18654	61	266	327
6	"6-out20394"	.13946	47	290	337
6	"6-out20395"	.12238	41	294	335
6	"6-out20396"	.32665	163	336	499
6	"6-out20397"	.17337	56	267	323
6	"6-out20398"	.55294	47	38	85
6	"6-out20399"	.20967	104	392	496
6	"6-out20400"	.52495	284	257	541
6	"6-out20401"	.11067	114	916	1030
6	"6-out20402"	.13793	12	75	87
6	"6-out20403"	.06923	9	121	130
6	"6-out20404"	.16014	45	236	281
6	"6-out20405"	.06597	32	453	485
6	"6-out20406"	.47613	449	494	943
6	"6-out20407"	.18392	151	670	821
6	"6-out20408"	.17361	50	238	288
6	"6-out20409"	.24293	43	134	177
6	"6-out20410"	.11627	20	152	172
6	"6-out20411"	.46741	251	286	537
6	"6-out20412"	.15415	76	417	493
7	"7-out1"	.88470	376	49	425
7	"7-out2"	.90138	585	64	649
7	"7-out3"	.22254	77	269	346
7	"7-out4"	.27966	99	255	354
7	"7-out5"	.26296	71	199	270
7	"7-out6"	.22781	77	261	338
7	"7-out7"	.65454	504	266	770
7	"7-out8"	.23492	148	482	630
7	"7-out9"	.24331	91	283	374
7	"7-out10"	.23734	464	1491	1955
7	"7-out11"	.85892	688	113	801
7	"7-out12"	.17828	588	2710	3298
7	"7-out13"	.16134	187	972	1159
7	"7-out14"	.18766	213	922	1135
7	"7-out15"	.78006	720	203	923
7	"7-out16"	.75995	706	223	929
7	"7-out17"	.17179	173	834	1007
7	"7-out18"	.13771	130	814	944
7	"7-out19"	.71535	666	265	931
7	"7-out20"	.78004	727	205	932
7	"7-out21"	.21221	330	1225	1555
7	"7-out22"	.24127	83	261	344
7	"7-out23"	.12400	31	219	250
7	"7-out24"	.29435	146	350	496
7	"7-out25"	.45095	354	431	785
7	"7-out26"	.52692	137	123	260
7	"7-out27"	.70860	535	220	755
7	"7-out28"	.21155	205	764	969
7	"7-out29"	.24119	89	280	369
7	"7-out30"	.14601	297	1737	2034
7	"7-out31"	.26706	313	859	1172
7	"7-out32"	.22346	80	278	358
7	"7-out33"	.92013	265	23	288
7	"7-out34"	.94476	325	19	344
7	"7-out35"	.52412	239	217	456
7	"7-out36"	.50000	443	443	886
7	"7-out37"	.55854	477	377	854
7	"7-out38"	.24592	211	647	858
7	"7-out39"	.14956	51	290	341
7	"7-out40"	.28211	123	313	436
7	"7-out41"	.10164	37	327	364
7	"7-out42"	.22660	92	314	406
7	"7-out43"	.63489	353	203	556
7	"7-out44"	.24288	111	346	457
7	"7-out45"	.61094	201	128	329
7	"7-out46"	.83845	737	142	879
7	"7-out47"	.11359	61	476	537
7	"7-out48"	.57487	453	335	788
7	"7-out49"	.19172	51	215	266
7	"7-out50"	.54566	239	199	438
7	"7-out51"	.57297	212	158	370
7	"7-out52"	.91746	289	26	315
7	"7-out53"	.22276	137	478	615
7	"7-out54"	.15853	104	552	656
7	"7-out55"	.24426	181	560	741
7	"7-out56"	.41509	264	372	636
7	"7-out57"	.24246	201	628	829
7	"7-out58"	.38174	184	298	482
7	"7-out59"	.29120	235	572	807
7	"7-out60"	.22891	171	576	747
7	"7-out61"	.30136	88	204	292
7	"7-out62"	.24166	116	364	480
7	"7-out63"	.19842	176	711	887
7	"7-out64"	.22696	564	1921	2485
7	"7-out65"	.17354	206	981	1187
7	"7-out66"	.13064	110	732	842
7	"7-out67"	.26546	236	653	889
7	"7-out68"	.19310	84	351	435
7	"7-out69"	.32465	262	545	807
7	"7-out70"	.18398	301	1335	1636
7	"7-out71"	.73012	303	112	415
7	"7-out72"	.14895	136	777	913
7	"7-out73"	.46176	157	183	340
7	"7-out74"	.38281	49	79	128
7	"7-out75"	.21176	126	469	595
7	"7-out76"	.80106	604	150	754
7	"7-out77"	.40985	416	599	1015
7	"7-out78"	.17830	143	659	802
7	"7-out79"	.18678	373	1624	1997
7	"7-out80"	.30321	396	910	1306
7	"7-out81"	.14001	267	1640	1907
7	"7-out82"	.42242	471	644	1115
7	"7-out83"	.09779	142	1310	1452
7	"7-out84"	.90849	556	56	612
7	"7-out85"	.21348	19	70	89
7	"7-out86"	.21922	317	1129	1446
7	"7-out87"	.31749	294	632	926
7	"7-out88"	.21323	29	107	136
7	"7-out89"	.14028	39	239	278
7	"7-out90"	.17107	97	470	567
7	"7-out91"	.90543	383	40	423
7	"7-out92"	.88294	792	105	897
7	"7-out93"	.38302	167	269	436
7	"7-out94"	.47222	85	95	180
7	"7-out95"	.94395	320	19	339
7	"7-out96"	.35761	162	291	453
7	"7-out97"	.24260	82	256	338
7	"7-out98"	.41043	692	994	1686
7	"7-out99"	.75409	230	75	305
7	"7-out100"	.27528	147	387	534
7	"7-out101"	.26286	143	401	544
7	"7-out102"	.21119	83	310	393
7	"7-out103"	.25939	145	414	559
7	"7-out104"	.85236	306	53	359
7	"7-out105"	.20634	39	150	189
7	"7-out106"	.15092	179	1007	1186
7	"7-out107"	.34169	109	210	319
7	"7-out108"	.62008	142	87	229
7	"7-out109"	.92640	214	17	231
7	"7-out110"	.21762	163	586	749
7	"7-out111"	.24953	135	406	541
7	"7-out112"	.30985	44	98	142
7	"7-out113"	.19642	33	135	168
7	"7-out114"	.80000	132	33	165
7	"7-out115"	.80810	299	71	370
7	"7-out116"	.13121	235	1556	1791
7	"7-out117"	.19381	119	495	614
7	"7-out118"	.95491	932	44	976
7	"7-out119"	.28277	151	383	534
7	"7-out120"	.17226	41	197	238
7	"7-out121"	.89560	918	107	1025
7	"7-out122"	.13908	58	359	417
7	"7-out123"	.27941	57	147	204
7	"7-out124"	.35324	136	249	385
7	"7-out125"	.19075	66	280	346
7	"7-out126"	.22985	97	325	422
7	"7-out127"	.17419	54	256	310
7	"7-out128"	.23447	302	986	1288
7	"7-out129"	.72424	675	257	932
7	"7-out130"	.14471	78	461	539
7	"7-out131"	.09100	85	849	934
7	"7-out132"	.72151	684	264	948
7	"7-out133"	.36355	389	681	1070
7	"7-out134"	.75617	704	227	931
7	"7-out135"	.28758	132	327	459
7	"7-out136"	.76394	712	220	932
7	"7-out137"	.72315	687	263	950
7	"7-out138"	.74000	703	247	950
7	"7-out139"	.23166	60	199	259
7	"7-out140"	.79714	279	71	350
7	"7-out141"	.64351	278	154	432
7	"7-out142"	.20400	1049	4093	5142
7	"7-out143"	.54406	142	119	261
7	"7-out144"	.37096	23	39	62
7	"7-out145"	.10690	48	401	449
7	"7-out146"	.94392	101	6	107
7	"7-out147"	.16666	310	1550	1860
7	"7-out148"	.37057	136	231	367
7	"7-out149"	.15719	368	1973	2341
7	"7-out150"	.22365	87	302	389
7	"7-out151"	.35849	76	136	212
7	"7-out152"	.19768	154	625	779
7	"7-out153"	.47422	230	255	485
7	"7-out154"	.23272	165	544	709
7	"7-out155"	.24229	228	713	941
7	"7-out156"	.23400	267	874	1141
7	"7-out157"	.31742	153	329	482
7	"7-out158"	.10222	46	404	450
7	"7-out159"	.20845	562	2134	2696
7	"7-out160"	.23209	81	268	349
7	"7-out161"	.31428	110	240	350
7	"7-out162"	.91463	225	21	246
7	"7-out163"	.23750	76	244	320
7	"7-out164"	.88157	67	9	76
7	"7-out165"	.21642	195	706	901
7	"7-out166"	.14606	65	380	445
7	"7-out167"	.27561	156	410	566
7	"7-out168"	.23238	155	512	667
7	"7-out169"	.53260	392	344	736
7	"7-out170"	.57843	59	43	102
7	"7-out171"	.51418	145	137	282
7	"7-out172"	.27052	257	693	950
7	"7-out173"	.22321	125	435	560
7	"7-out174"	.20198	102	403	505
7	"7-out175"	.32173	148	312	460
7	"7-out176"	.24923	244	735	979
7	"7-out177"	.21379	251	923	1174
7	"7-out178"	.10902	29	237	266
7	"7-out179"	.08653	27	285	312
7	"7-out180"	.89189	33	4	37
7	"7-out181"	.35853	332	594	926
7	"7-out182"	.22831	129	436	565
7	"7-out183"	.17500	63	297	360
7	"7-out184"	.32209	191	402	593
7	"7-out185"	.15000	15	85	100
7	"7-out186"	.86577	129	20	149
7	"7-out187"	.55607	119	95	214
7	"7-out188"	.24251	81	253	334
7	"7-out189"	.19426	61	253	314
7	"7-out190"	.20111	72	286	358
7	"7-out191"	.17301	250	1195	1445
7	"7-out192"	.18100	242	1095	1337
7	"7-out193"	.69203	1382	615	1997
7	"7-out194"	.24048	158	499	657
7	"7-out195"	.19353	377	1571	1948
7	"7-out196"	.25000	32	96	128
7	"7-out197"	.36615	119	206	325
7	"7-out198"	.17013	49	239	288
7	"7-out199"	.22721	526	1789	2315
7	"7-out200"	.21843	64	229	293
7	"7-out201"	.42758	62	83	145
7	"7-out202"	.17712	48	223	271
7	"7-out203"	.13176	56	369	425
7	"7-out204"	.31155	124	274	398
7	"7-out205"	.87163	971	143	1114
7	"7-out206"	.90186	193	21	214
7	"7-out207"	.25280	90	266	356
7	"7-out208"	.36363	128	224	352
7	"7-out209"	.12994	46	308	354
7	"7-out210"	.40616	158	231	389
7	"7-out211"	.89485	383	45	428
7	"7-out212"	.93526	968	67	1035
7	"7-out213"	.23107	116	386	502
7	"7-out214"	.21987	104	369	473
7	"7-out215"	.28318	288	729	1017
7	"7-out216"	.94623	264	15	279
7	"7-out217"	.94623	264	15	279
7	"7-out218"	.85643	173	29	202
7	"7-out219"	.95714	134	6	140
7	"7-out220"	.89667	243	28	271
7	"7-out221"	.10350	65	563	628
7	"7-out222"	.31601	146	316	462
7	"7-out223"	.81010	401	94	495
7	"7-out224"	.27731	66	172	238
7	"7-out225"	.31855	194	415	609
7	"7-out226"	.58133	218	157	375
7	"7-out227"	.83402	201	40	241
7	"7-out228"	.19365	116	483	599
7	"7-out229"	.12698	104	715	819
7	"7-out230"	.23610	429	1388	1817
7	"7-out231"	.82554	265	56	321
7	"7-out232"	.34603	109	206	315
7	"7-out233"	.78523	234	64	298
7	"7-out234"	.70125	223	95	318
7	"7-out235"	.83174	262	53	315
7	"7-out236"	.77955	244	69	313
7	"7-out237"	.85303	267	46	313
7	"7-out238"	.20061	65	259	324
7	"7-out239"	.75155	242	80	322
7	"7-out240"	.40125	128	191	319
7	"7-out241"	.71009	218	89	307
7	"7-out242"	.40129	124	185	309
7	"7-out243"	.62135	192	117	309
7	"7-out244"	.76510	228	70	298
7	"7-out245"	.79268	260	68	328
7	"7-out246"	.20900	65	246	311
7	"7-out247"	.24683	78	238	316
7	"7-out248"	.24838	77	233	310
7	"7-out249"	.23456	76	248	324
7	"7-out250"	.29005	105	257	362
7	"7-out251"	.79354	246	64	310
7	"7-out252"	.81469	255	58	313
7	"7-out253"	.80128	250	62	312
7	"7-out254"	.84615	264	48	312
7	"7-out255"	.83012	259	53	312
7	"7-out256"	.79487	248	64	312
7	"7-out257"	.84615	264	48	312
7	"7-out258"	.83333	260	52	312
7	"7-out259"	.75811	257	82	339
7	"7-out260"	.77631	236	68	304
7	"7-out261"	.28267	173	439	612
7	"7-out262"	.28458	72	181	253
7	"7-out263"	.21600	54	196	250
7	"7-out264"	.91758	334	30	364
7	"7-out265"	.92857	338	26	364
7	"7-out266"	.19287	65	272	337
7	"7-out267"	.17857	125	575	700
7	"7-out268"	.60618	431	280	711
7	"7-out269"	.44557	307	382	689
7	"7-out270"	.35943	101	180	281
7	"7-out271"	.25000	63	189	252
7	"7-out272"	.92803	374	29	403
7	"7-out273"	.21776	76	273	349
7	"7-out274"	.43292	142	186	328
7	"7-out275"	.67175	88	43	131
7	"7-out276"	.84254	503	94	597
7	"7-out277"	.52787	464	415	879
7	"7-out278"	.27397	180	477	657
7	"7-out279"	.36222	280	493	773
7	"7-out280"	.29144	109	265	374
7	"7-out281"	.87156	1174	173	1347
7	"7-out282"	.89552	1200	140	1340
7	"7-out283"	.21346	222	818	1040
7	"7-out284"	.16300	193	991	1184
7	"7-out285"	.31761	128	275	403
7	"7-out286"	.13488	58	372	430
7	"7-out287"	.26785	195	533	728
7	"7-out288"	.23257	267	881	1148
7	"7-out289"	.78363	728	201	929
7	"7-out290"	.76056	702	221	923
7	"7-out291"	.74731	695	235	930
7	"7-out292"	.12253	118	845	963
7	"7-out293"	.49358	462	474	936
7	"7-out294"	.18270	226	1011	1237
7	"7-out295"	.71824	673	264	937
7	"7-out296"	.67157	638	312	950
7	"7-out297"	.19008	46	196	242
7	"7-out298"	.19935	124	498	622
7	"7-out299"	.48199	174	187	361
7	"7-out300"	.91011	162	16	178
7	"7-out301"	.17647	24	112	136
7	"7-out302"	.15789	78	416	494
7	"7-out303"	.21978	60	213	273
7	"7-out304"	.34430	136	259	395
7	"7-out305"	.16417	77	392	469
7	"7-out306"	.18542	173	760	933
7	"7-out307"	.77600	97	28	125
7	"7-out308"	.93193	178	13	191
7	"7-out309"	.16417	88	448	536
7	"7-out310"	.60165	145	96	241
7	"7-out311"	.30056	214	498	712
7	"7-out312"	.22620	183	626	809
7	"7-out313"	.28417	316	796	1112
7	"7-out314"	.26055	216	613	829
7	"7-out315"	.22033	195	690	885
7	"7-out316"	.14864	55	315	370
7	"7-out317"	.12000	18	132	150
7	"7-out318"	.23696	50	161	211
7	"7-out319"	.26840	113	308	421
7	"7-out320"	.86534	437	68	505
7	"7-out321"	.23651	57	184	241
7	"7-out322"	.10810	44	363	407
7	"7-out323"	.21515	71	259	330
7	"7-out324"	.35234	210	386	596
7	"7-out325"	.89393	354	42	396
7	"7-out326"	.15432	25	137	162
7	"7-out327"	.15384	48	264	312
7	"7-out328"	.25590	65	189	254
7	"7-out329"	.88144	342	46	388
7	"7-out330"	.20985	149	561	710
7	"7-out331"	.19072	74	314	388
7	"7-out332"	.28454	243	611	854
7	"7-out333"	.60740	82	53	135
7	"7-out334"	.37346	273	458	731
7	"7-out335"	.21875	63	225	288
7	"7-out336"	.12129	45	326	371
7	"7-out337"	.83396	663	132	795
7	"7-out338"	.82241	653	141	794
7	"7-out339"	.84779	674	121	795
7	"7-out340"	.76684	717	218	935
7	"7-out341"	.87592	833	118	951
7	"7-out342"	.87329	641	93	734
7	"7-out343"	.20370	594	2322	2916
7	"7-out344"	.71488	677	270	947
7	"7-out345"	.72315	687	263	950
7	"7-out346"	.75107	700	232	932
7	"7-out347"	.75106	703	233	936
7	"7-out348"	.27951	116	299	415
7	"7-out349"	.22976	159	533	692
7	"7-out350"	.17828	381	1756	2137
7	"7-out351"	.19603	99	406	505
7	"7-out352"	.15517	45	245	290
7	"7-out353"	.22284	80	279	359
7	"7-out354"	.50115	435	433	868
7	"7-out355"	.08866	54	555	609
7	"7-out356"	.23177	124	411	535
7	"7-out357"	.25820	118	339	457
7	"7-out358"	.90794	217	22	239
7	"7-out359"	.20788	153	583	736
7	"7-out360"	.26057	228	647	875
7	"7-out361"	.23837	205	655	860
7	"7-out362"	.14726	86	498	584
7	"7-out363"	.14370	73	435	508
7	"7-out364"	.25284	89	263	352
7	"7-out365"	.12272	54	386	440
7	"7-out366"	.22619	19	65	84
7	"7-out367"	.19848	105	424	529
7	"7-out368"	.13533	18	115	133
7	"7-out369"	.47349	134	149	283
7	"7-out370"	.91897	431	38	469
7	"7-out371"	.71428	100	40	140
7	"7-out372"	.20570	584	2255	2839
7	"7-out373"	.91916	796	70	866
7	"7-out374"	.39109	562	875	1437
7	"7-out375"	.48351	308	329	637
7	"7-out376"	.19054	403	1712	2115
7	"7-out377"	.67948	159	75	234
7	"7-out378"	.48627	124	131	255
7	"7-out379"	.39463	103	158	261
7	"7-out380"	.61349	200	126	326
7	"7-out381"	.29754	97	229	326
7	"7-out382"	.40526	154	226	380
7	"7-out383"	.31128	80	177	257
7	"7-out384"	.21428	84	308	392
7	"7-out385"	.14715	44	255	299
7	"7-out386"	.20788	58	221	279
7	"7-out387"	.25984	66	188	254
7	"7-out388"	.13846	18	112	130
7	"7-out389"	.30459	106	242	348
7	"7-out390"	.29970	101	236	337
7	"7-out391"	.84931	62	11	73
7	"7-out392"	.29629	24	57	81
7	"7-out393"	.18713	64	278	342
7	"7-out394"	.39303	158	244	402
7	"7-out395"	.91758	334	30	364
7	"7-out396"	.31638	168	363	531
7	"7-out397"	.20338	108	423	531
7	"7-out398"	.19202	106	446	552
7	"7-out399"	.19350	280	1167	1447
7	"7-out400"	.92045	81	7	88
7	"7-out401"	.26822	92	251	343
7	"7-out402"	.20093	86	342	428
7	"7-out403"	.33968	107	208	315
7	"7-out404"	.20174	162	641	803
7	"7-out405"	.16834	184	909	1093
7	"7-out406"	.17802	128	591	719
7	"7-out407"	.19480	75	310	385
7	"7-out408"	.48421	46	49	95
7	"7-out409"	.26893	174	473	647
7	"7-out410"	.31331	506	1109	1615
7	"7-out411"	.47252	43	48	91
7	"7-out412"	.28865	28	69	97
7	"7-out413"	.19047	44	187	231
7	"7-out414"	.86607	97	15	112
7	"7-out415"	.91452	107	10	117
7	"7-out416"	.26633	485	1336	1821
7	"7-out417"	.43456	259	337	596
7	"7-out418"	.19565	63	259	322
7	"7-out419"	.66891	99	49	148
7	"7-out420"	.24607	298	913	1211
7	"7-out421"	.30848	120	269	389
7	"7-out422"	.78417	109	30	139
7	"7-out423"	.15116	26	146	172
7	"7-out424"	.37212	243	410	653
7	"7-out425"	.41846	136	189	325
7	"7-out426"	.39678	148	225	373
7	"7-out427"	.45454	145	174	319
7	"7-out428"	.66855	236	117	353
7	"7-out429"	.15686	40	215	255
7	"7-out430"	.22067	779	2751	3530
7	"7-out431"	.37132	720	1219	1939
7	"7-out432"	.47189	915	1024	1939
7	"7-out433"	.28527	461	1155	1616
7	"7-out434"	.18269	245	1096	1341
7	"7-out435"	.20525	523	2025	2548
7	"7-out436"	.21428	33	121	154
7	"7-out437"	.89628	1400	162	1562
7	"7-out438"	.18068	131	594	725
7	"7-out439"	.46153	78	91	169
7	"7-out440"	.27972	80	206	286
7	"7-out441"	.19545	258	1062	1320
7	"7-out442"	.70875	696	286	982
7	"7-out443"	.14447	102	604	706
7	"7-out444"	.92946	593	45	638
7	"7-out445"	.92161	388	33	421
7	"7-out446"	.92023	796	69	865
7	"7-out447"	.93283	625	45	670
7	"7-out448"	.22623	119	407	526
7	"7-out449"	.13580	99	630	729
7	"7-out450"	.10044	68	609	677
7	"7-out451"	.26915	1795	4874	6669
7	"7-out452"	.28703	31	77	108
7	"7-out453"	.20448	164	638	802
7	"7-out454"	.93400	1203	85	1288
7	"7-out455"	.29104	117	285	402
7	"7-out456"	.32432	120	250	370
7	"7-out457"	.07471	26	322	348
7	"7-out458"	.15361	51	281	332
7	"7-out459"	.54487	170	142	312
7	"7-out460"	.84615	264	48	312
7	"7-out461"	.70382	221	93	314
7	"7-out462"	.76160	246	77	323
7	"7-out463"	.81924	281	62	343
7	"7-out464"	.42307	132	180	312
7	"7-out465"	.69871	218	94	312
7	"7-out466"	.20555	74	286	360
7	"7-out467"	.58520	182	129	311
7	"7-out468"	.54466	189	158	347
7	"7-out469"	.21864	68	243	311
7	"7-out470"	.26363	87	243	330
7	"7-out471"	.65094	207	111	318
7	"7-out472"	.46945	146	165	311
7	"7-out473"	.28291	101	256	357
7	"7-out474"	.69230	216	96	312
7	"7-out475"	.23659	75	242	317
7	"7-out476"	.72756	227	85	312
7	"7-out477"	.18750	60	260	320
7	"7-out478"	.73376	226	82	308
7	"7-out479"	.21212	70	260	330
7	"7-out480"	.79495	252	65	317
7	"7-out481"	.21682	67	242	309
7	"7-out482"	.46518	147	169	316
7	"7-out483"	.75316	238	78	316
7	"7-out484"	.60576	189	123	312
7	"7-out485"	.34782	120	225	345
7	"7-out486"	.61217	191	121	312
7	"7-out487"	.63461	198	114	312
7	"7-out488"	.71474	223	89	312
7	"7-out489"	.69740	242	105	347
7	"7-out490"	.21864	68	243	311
7	"7-out491"	.68589	214	98	312
7	"7-out492"	.35736	114	205	319
7	"7-out493"	.24661	91	278	369
7	"7-out494"	.70977	247	101	348
7	"7-out495"	.26948	83	225	308
7	"7-out496"	.67532	208	100	308
7	"7-out497"	.88437	283	37	320
7	"7-out498"	.72641	231	87	318
7	"7-out499"	.84482	294	54	348
7	"7-out500"	.80602	241	58	299
7	"7-out501"	.39735	120	182	302
7	"7-out502"	.78527	256	70	326
7	"7-out503"	.36774	114	196	310
7	"7-out504"	.73462	227	82	309
7	"7-out505"	.38709	120	190	310
7	"7-out506"	.68789	216	98	314
7	"7-out507"	.34076	107	207	314
7	"7-out508"	.37500	117	195	312
7	"7-out509"	.80573	253	61	314
7	"7-out510"	.65517	228	120	348
7	"7-out511"	.70512	220	92	312
7	"7-out512"	.84984	266	47	313
7	"7-out513"	.73734	233	83	316
7	"7-out514"	.48376	149	159	308
7	"7-out515"	.73633	229	82	311
7	"7-out516"	.19365	61	254	315
7	"7-out517"	.79299	249	65	314
7	"7-out518"	.29617	93	221	314
7	"7-out519"	.29936	94	220	314
7	"7-out520"	.50479	158	155	313
7	"7-out521"	.71974	226	88	314
7	"7-out522"	.51592	162	152	314
7	"7-out523"	.32802	103	211	314
7	"7-out524"	.44236	142	179	321
7	"7-out525"	.46417	149	172	321
7	"7-out526"	.57328	176	131	307
7	"7-out527"	.52090	162	149	311
7	"7-out528"	.28852	88	217	305
7	"7-out529"	.34726	108	203	311
7	"7-out530"	.21913	71	253	324
7	"7-out531"	.60736	198	128	326
7	"7-out532"	.79705	271	69	340
7	"7-out533"	.15755	49	262	311
7	"7-out534"	.67307	210	102	312
7	"7-out535"	.81410	254	58	312
7	"7-out536"	.79611	246	63	309
7	"7-out537"	.80115	278	69	347
7	"7-out538"	.35951	119	212	331
7	"7-out539"	.22756	71	241	312
7	"7-out540"	.19558	62	255	317
7	"7-out541"	.19871	62	250	312
7	"7-out542"	.45454	145	174	319
7	"7-out543"	.59870	185	124	309
7	"7-out544"	.69871	218	94	312
7	"7-out545"	.81672	254	57	311
7	"7-out546"	.74358	232	80	312
7	"7-out547"	.75483	234	76	310
7	"7-out548"	.73633	229	82	311
7	"7-out549"	.52848	167	149	316
7	"7-out550"	.29850	100	235	335
7	"7-out551"	.27419	85	225	310
7	"7-out552"	.51592	162	152	314
7	"7-out553"	.33559	99	196	295
7	"7-out554"	.57837	214	156	370
7	"7-out555"	.11254	87	686	773
7	"7-out556"	.19026	86	366	452
7	"7-out557"	.14285	56	336	392
7	"7-out558"	.21540	137	499	636
7	"7-out559"	.19562	170	699	869
7	"7-out560"	.20940	187	706	893
7	"7-out561"	.25431	118	346	464
7	"7-out562"	.90740	98	10	108
7	"7-out563"	.29278	544	1314	1858
7	"7-out564"	.14690	57	331	388
7	"7-out565"	.19902	286	1151	1437
7	"7-out566"	.88704	2081	265	2346
7	"7-out567"	.23913	44	140	184
7	"7-out568"	.13865	99	615	714
7	"7-out569"	.20577	228	880	1108
7	"7-out570"	.28517	527	1321	1848
7	"7-out571"	.46871	974	1104	2078
7	"7-out572"	.30864	75	168	243
7	"7-out573"	.28836	171	422	593
7	"7-out574"	.11822	24	179	203
7	"7-out575"	.26153	170	480	650
7	"7-out576"	.51428	198	187	385
7	"7-out577"	.34417	127	242	369
7	"7-out578"	.13144	51	337	388
7	"7-out579"	.81404	197	45	242
7	"7-out580"	.91758	334	30	364
7	"7-out581"	.36221	209	368	577
7	"7-out582"	.42718	132	177	309
7	"7-out583"	.51456	159	150	309
7	"7-out584"	.79742	248	63	311
7	"7-out585"	.77151	260	77	337
7	"7-out586"	.31948	100	213	313
7	"7-out587"	.29859	106	249	355
7	"7-out588"	.36956	119	203	322
7	"7-out589"	.23961	75	238	313
7	"7-out590"	.23734	75	241	316
7	"7-out591"	.28155	87	222	309
7	"7-out592"	.85161	264	46	310
7	"7-out593"	.83548	259	51	310
7	"7-out594"	.25320	79	233	312
7	"7-out595"	.68269	213	99	312
7	"7-out596"	.18750	60	260	320
7	"7-out597"	.20382	64	250	314
7	"7-out598"	.23248	73	241	314
7	"7-out599"	.39365	124	191	315
7	"7-out600"	.64485	207	114	321
7	"7-out601"	.51446	160	151	311
7	"7-out602"	.71803	219	86	305
7	"7-out603"	.68750	209	95	304
7	"7-out604"	.80191	251	62	313
7	"7-out605"	.73397	229	83	312
7	"7-out606"	.31475	96	209	305
7	"7-out607"	.26732	81	222	303
7	"7-out608"	.26543	86	238	324
7	"7-out609"	.78640	243	66	309
7	"7-out610"	.79299	249	65	314
7	"7-out611"	.24271	75	234	309
7	"7-out612"	.14687	47	273	320
7	"7-out613"	.23566	74	240	314
7	"7-out614"	.74695	245	83	328
7	"7-out615"	.76582	242	74	316
7	"7-out616"	.28660	92	229	321
7	"7-out617"	.24516	76	234	310
7	"7-out618"	.22935	75	252	327
7	"7-out619"	.68277	226	105	331
7	"7-out620"	.78456	244	67	311
7	"7-out621"	.25649	79	229	308
7	"7-out622"	.39358	135	208	343
7	"7-out623"	.30990	97	216	313
7	"7-out624"	.22960	76	255	331
7	"7-out625"	.27795	87	226	313
7	"7-out626"	.38871	124	195	319
7	"7-out627"	.71153	222	90	312
7	"7-out628"	.70926	222	91	313
7	"7-out629"	.24919	77	232	309
7	"7-out630"	.36655	114	197	311
7	"7-out631"	.25649	79	229	308
7	"7-out632"	.29581	92	219	311
7	"7-out633"	.65396	206	109	315
7	"7-out634"	.25641	80	232	312
7	"7-out635"	.18662	67	292	359
7	"7-out636"	.45307	140	169	309
7	"7-out637"	.57928	179	130	309
7	"7-out638"	.42038	132	182	314
7	"7-out639"	.27217	89	238	327
7	"7-out640"	.50491	154	151	305
7	"7-out641"	.28662	90	224	314
7	"7-out642"	.25590	65	189	254
7	"7-out643"	.21138	182	679	861
7	"7-out644"	.42857	129	172	301
7	"7-out645"	.99019	101	1	102
7	"7-out646"	.14102	77	469	546
7	"7-out647"	.26573	190	525	715
7	"7-out648"	.28851	191	471	662
7	"7-out649"	.27089	94	253	347
7	"7-out650"	.20283	243	955	1198
7	"7-out651"	.17329	122	582	704
7	"7-out652"	.32058	176	373	549
7	"7-out653"	.29214	227	550	777
7	"7-out654"	.20874	148	561	709
7	"7-out655"	.16713	60	299	359
7	"7-out656"	.18163	91	410	501
7	"7-out657"	.94805	219	12	231
7	"7-out658"	.75988	769	243	1012
7	"7-out659"	.21923	196	698	894
7	"7-out660"	.22571	79	271	350
7	"7-out661"	.26583	277	765	1042
7	"7-out662"	.23694	177	570	747
7	"7-out663"	.23543	299	971	1270
7	"7-out664"	.44106	116	147	263
7	"7-out665"	.17128	173	837	1010
7	"7-out666"	.53690	291	251	542
7	"7-out667"	.34711	235	442	677
7	"7-out668"	.79335	4346	1132	5478
7	"7-out669"	.26757	137	375	512
7	"7-out670"	.36363	164	287	451
7	"7-out671"	.90680	13155	1352	14507
7	"7-out672"	.66837	3003	1490	4493
7	"7-out673"	.19659	127	519	646
7	"7-out674"	.92986	7796	588	8384
7	"7-out675"	.71952	903	352	1255
7	"7-out676"	.70141	397	169	566
7	"7-out677"	.92160	1634	139	1773
7	"7-out678"	.64761	3354	1825	5179
7	"7-out679"	.92162	1999	170	2169
7	"7-out680"	.85921	4858	796	5654
7	"7-out681"	.54907	207	170	377
7	"7-out682"	.48275	126	135	261
7	"7-out683"	.26666	24	66	90
7	"7-out684"	.35589	184	333	517
7	"7-out685"	.11743	64	481	545
7	"7-out686"	.15873	40	212	252
7	"7-out687"	.36111	182	322	504
7	"7-out688"	.56275	278	216	494
7	"7-out689"	.22784	36	122	158
7	"7-out690"	.59217	106	73	179
7	"7-out691"	.25531	36	105	141
7	"7-out692"	.28985	100	245	345
7	"7-out693"	.82474	80	17	97
7	"7-out694"	.18023	186	846	1032
7	"7-out695"	.20549	172	665	837
7	"7-out696"	.89705	488	56	544
7	"7-out697"	.19653	68	278	346
7	"7-out698"	.62738	362	215	577
7	"7-out699"	.66759	478	238	716
7	"7-out700"	.44850	135	166	301
7	"7-out701"	.48703	169	178	347
7	"7-out702"	.68867	219	99	318
7	"7-out703"	.65189	206	110	316
7	"7-out704"	.44072	145	184	329
7	"7-out705"	.73954	230	81	311
7	"7-out706"	.26213	81	228	309
7	"7-out707"	.17105	26	126	152
7	"7-out708"	.19784	165	669	834
7	"7-out709"	.85173	270	47	317
7	"7-out710"	.21036	69	259	328
7	"7-out711"	.35327	248	454	702
7	"7-out712"	.28645	55	137	192
7	"7-out713"	.83606	51	10	61
7	"7-out714"	.35321	77	141	218
7	"7-out715"	.32244	79	166	245
7	"7-out716"	.27651	73	191	264
7	"7-out717"	.23864	436	1391	1827
7	"7-out718"	.28539	258	646	904
7	"7-out719"	.40540	135	198	333
7	"7-out720"	.33031	255	517	772
7	"7-out721"	.26040	194	551	745
7	"7-out722"	.18584	21	92	113
7	"7-out723"	.34042	80	155	235
7	"7-out724"	.31630	613	1325	1938
7	"7-out725"	.25231	491	1455	1946
7	"7-out726"	.17346	357	1701	2058
7	"7-out727"	.19844	409	1652	2061
7	"7-out728"	.23642	222	717	939
7	"7-out729"	.13173	44	290	334
7	"7-out730"	.95808	160	7	167
7	"7-out731"	.17270	62	297	359
7	"7-out732"	.93750	15	1	16
7	"7-out733"	.17808	26	120	146
7	"7-out734"	.39716	616	935	1551
7	"7-out735"	.88581	256	33	289
7	"7-out736"	.16893	261	1284	1545
7	"7-out737"	.87577	282	40	322
7	"7-out738"	.88198	284	38	322
7	"7-out739"	.12750	51	349	400
7	"7-out740"	.27987	89	229	318
7	"7-out741"	.28343	89	225	314
7	"7-out742"	.35463	111	202	313
7	"7-out743"	.16049	52	272	324
7	"7-out744"	.76038	238	75	313
7	"7-out745"	.82121	271	59	330
7	"7-out746"	.29617	93	221	314
7	"7-out747"	.65538	213	112	325
7	"7-out748"	.83692	272	53	325
7	"7-out749"	.73548	228	82	310
7	"7-out750"	.17891	56	257	313
7	"7-out751"	.25559	80	233	313
7	"7-out752"	.77917	247	70	317
7	"7-out753"	.20820	66	251	317
7	"7-out754"	.68037	215	101	316
7	"7-out755"	.61538	192	120	312
7	"7-out756"	.66346	207	105	312
7	"7-out757"	.66881	208	103	311
7	"7-out758"	.76602	239	73	312
7	"7-out759"	.68589	214	98	312
7	"7-out760"	.78703	255	69	324
7	"7-out761"	.82389	262	56	318
7	"7-out762"	.75555	238	77	315
7	"7-out763"	.74038	231	81	312
7	"7-out764"	.54603	172	143	315
7	"7-out765"	.51746	163	152	315
7	"7-out766"	.21543	67	244	311
7	"7-out767"	.79750	256	65	321
7	"7-out768"	.82222	259	56	315
7	"7-out769"	.84126	265	50	315
7	"7-out770"	.47896	148	161	309
7	"7-out771"	.65695	203	106	309
7	"7-out772"	.77669	240	69	309
7	"7-out773"	.29113	92	224	316
7	"7-out774"	.39354	122	188	310
7	"7-out775"	.47231	145	162	307
7	"7-out776"	.16981	54	264	318
7	"7-out777"	.62700	195	116	311
7	"7-out778"	.75873	239	76	315
7	"7-out779"	.17891	56	257	313
7	"7-out780"	.76923	240	72	312
7	"7-out781"	.71475	218	87	305
7	"7-out782"	.27331	85	226	311
7	"7-out783"	.70793	223	92	315
7	"7-out784"	.23219	75	248	323
7	"7-out785"	.23870	74	236	310
7	"7-out786"	.25396	80	235	315
7	"7-out787"	.70032	215	92	307
7	"7-out788"	.71661	220	87	307
7	"7-out789"	.76038	238	75	313
7	"7-out790"	.43365	134	175	309
7	"7-out791"	.54140	170	144	314
7	"7-out792"	.80191	251	62	313
7	"7-out793"	.84615	275	50	325
7	"7-out794"	.75000	231	77	308
7	"7-out795"	.32692	102	210	312
7	"7-out796"	.69480	214	94	308
7	"7-out797"	.58520	182	129	311
7	"7-out798"	.67845	211	100	311
7	"7-out799"	.66666	210	105	315
7	"7-out800"	.29354	91	219	310
7	"7-out801"	.69523	219	96	315
7	"7-out802"	.30124	97	225	322
7	"7-out803"	.49025	176	183	359
7	"7-out804"	.86538	270	42	312
7	"7-out805"	.81847	257	57	314
7	"7-out806"	.12037	39	285	324
7	"7-out807"	.29968	95	222	317
7	"7-out808"	.23974	76	241	317
7	"7-out809"	.16408	53	270	323
7	"7-out810"	.20615	67	258	325
7	"7-out811"	.70000	217	93	310
7	"7-out812"	.57605	178	131	309
7	"7-out813"	.44687	143	177	320
7	"7-out814"	.80246	260	64	324
7	"7-out815"	.38343	125	201	326
7	"7-out816"	.67412	211	102	313
7	"7-out817"	.41290	128	182	310
7	"7-out818"	.35031	110	204	314
7	"7-out819"	.76589	265	81	346
7	"7-out820"	.61414	191	120	311
7	"7-out821"	.76923	240	72	312
7	"7-out822"	.75961	237	75	312
7	"7-out823"	.72903	226	84	310
7	"7-out824"	.53968	170	145	315
7	"7-out825"	.19435	62	257	319
7	"7-out826"	.25407	78	229	307
7	"7-out827"	.45768	146	173	319
7	"7-out828"	.88593	233	30	263
7	"7-out829"	.47096	146	164	310
7	"7-out830"	.50819	155	150	305
7	"7-out831"	.07189	11	142	153
7	"7-out832"	.20261	31	122	153
7	"7-out833"	.24252	73	228	301
7	"7-out834"	.26582	63	174	237
7	"7-out835"	.88837	191	24	215
7	"7-out836"	.21126	90	336	426
7	"7-out837"	.24300	139	433	572
7	"7-out838"	.23956	132	419	551
7	"7-out839"	.15397	93	511	604
7	"7-out840"	.51815	157	146	303
7	"7-out841"	.16556	100	504	604
7	"7-out842"	.69142	242	108	350
7	"7-out843"	.25787	131	377	508
7	"7-out844"	.20984	388	1461	1849
7	"7-out845"	.17238	206	989	1195
7	"7-out846"	.20520	134	519	653
7	"7-out847"	.22544	140	481	621
7	"7-out848"	.22121	146	514	660
7	"7-out849"	.36784	167	287	454
7	"7-out850"	.18624	130	568	698
7	"7-out851"	.27315	115	306	421
7	"7-out852"	.10567	41	347	388
7	"7-out853"	.27465	376	993	1369
7	"7-out854"	.10722	46	383	429
7	"7-out855"	.77467	361	105	466
7	"7-out856"	.30349	278	638	916
7	"7-out857"	.85190	604	105	709
7	"7-out858"	.25380	50	147	197
7	"7-out859"	.92266	3066	257	3323
7	"7-out860"	.90945	1125	112	1237
7	"7-out861"	.61836	3563	2199	5762
7	"7-out862"	.40057	977	1462	2439
7	"7-out863"	.12500	44	308	352
7	"7-out864"	.25000	68	204	272
7	"7-out865"	.25613	167	485	652
7	"7-out866"	.23076	63	210	273
7	"7-out867"	.33206	174	350	524
7	"7-out868"	.25000	240	720	960
7	"7-out869"	.22384	107	371	478
7	"7-out870"	.25085	146	436	582
7	"7-out871"	.67692	220	105	325
7	"7-out872"	.10599	23	194	217
7	"7-out873"	.19155	59	249	308
7	"7-out874"	.96969	96	3	99
7	"7-out875"	.32461	273	568	841
7	"7-out876"	.34094	209	404	613
7	"7-out877"	.17431	19	90	109
7	"7-out878"	.20736	107	409	516
7	"7-out879"	.63250	253	147	400
7	"7-out880"	.25632	81	235	316
7	"7-out881"	.79865	238	60	298
7	"7-out882"	.70793	223	92	315
7	"7-out883"	.84782	234	42	276
7	"7-out884"	.44408	139	174	313
7	"7-out885"	.20370	110	430	540
7	"7-out886"	.29073	91	222	313
7	"7-out887"	.78834	257	69	326
7	"7-out888"	.35925	425	758	1183
7	"7-out889"	.37745	77	127	204
7	"7-out890"	.48333	203	217	420
7	"7-out891"	.24409	93	288	381
7	"7-out892"	.21890	88	314	402
7	"7-out893"	.16009	65	341	406
7	"7-out894"	.16862	86	424	510
7	"7-out895"	.57564	156	115	271
7	"7-out896"	.43653	141	182	323
7	"7-out897"	.20133	151	599	750
7	"7-out898"	.31116	131	290	421
7	"7-out899"	.21818	96	344	440
7	"7-out900"	.19631	32	131	163
7	"7-out901"	.95412	104	5	109
7	"7-out902"	.42953	64	85	149
7	"7-out903"	.95934	118	5	123
7	"7-out904"	.95854	185	8	193
7	"7-out905"	.14406	51	303	354
7	"7-out906"	.20967	78	294	372
7	"7-out907"	.10789	41	339	380
7	"7-out908"	.24712	86	262	348
7	"7-out909"	.54241	211	178	389
7	"7-out910"	.39737	757	1148	1905
7	"7-out911"	.14868	62	355	417
7	"7-out912"	.19938	129	518	647
7	"7-out913"	.16993	26	127	153
7	"7-out914"	.24736	141	429	570
7	"7-out915"	.19940	135	542	677
7	"7-out916"	.31615	184	398	582
7	"7-out917"	.23294	379	1248	1627
7	"7-out918"	.22751	301	1022	1323
7	"7-out919"	.27777	35	91	126
7	"7-out920"	.23469	23	75	98
7	"7-out921"	.19736	45	183	228
7	"7-out922"	.86312	309	49	358
7	"7-out923"	.28716	85	211	296
7	"7-out924"	.28245	557	1415	1972
7	"7-out925"	.87146	956	141	1097
7	"7-out926"	.38989	756	1183	1939
7	"7-out927"	.26174	156	440	596
7	"7-out928"	.20368	431	1685	2116
7	"7-out929"	.17448	294	1391	1685
7	"7-out930"	.24816	135	409	544
7	"7-out931"	.26393	161	449	610
7	"7-out932"	.22479	417	1438	1855
7	"7-out933"	.20735	62	237	299
7	"7-out934"	.26515	70	194	264
7	"7-out935"	.16865	85	419	504
7	"7-out936"	.82675	482	101	583
7	"7-out937"	.31829	127	272	399
7	"7-out938"	.88732	189	24	213
7	"7-out939"	.24069	97	306	403
7	"7-out940"	.86531	257	40	297
7	"7-out941"	.13425	29	187	216
7	"7-out942"	.72727	64	24	88
7	"7-out943"	.16509	35	177	212
7	"7-out944"	.10648	23	193	216
7	"7-out945"	.11808	32	239	271
7	"7-out946"	.19665	94	384	478
7	"7-out947"	.64885	255	138	393
7	"7-out948"	.09937	16	145	161
7	"7-out949"	.65346	198	105	303
7	"7-out950"	.80448	251	61	312
7	"7-out951"	.76205	237	74	311
7	"7-out952"	.28125	90	230	320
7	"7-out953"	.48076	150	162	312
7	"7-out954"	.31629	99	214	313
7	"7-out955"	.78834	257	69	326
7	"7-out956"	.54883	472	388	860
7	"7-out957"	.17183	72	347	419
7	"7-out958"	.50867	176	170	346
7	"7-out959"	.65600	82	43	125
7	"7-out960"	.26714	74	203	277
7	"7-out961"	.24431	43	133	176
7	"7-out962"	.15319	36	199	235
7	"7-out963"	.11046	19	153	172
7	"7-out964"	.23500	94	306	400
7	"7-out965"	.18255	270	1209	1479
7	"7-out966"	.17201	59	284	343
7	"7-out967"	.74223	239	83	322
7	"7-out968"	.79393	262	68	330
7	"7-out969"	.88717	173	22	195
7	"7-out970"	.19424	54	224	278
7	"7-out971"	.29700	278	658	936
7	"7-out972"	.24632	335	1025	1360
7	"7-out973"	.85714	48	8	56
7	"7-out974"	.47549	97	107	204
7	"7-out975"	.24320	179	557	736
7	"7-out976"	.23200	174	576	750
7	"7-out977"	.13750	55	345	400
7	"7-out978"	.21032	432	1622	2054
7	"7-out979"	.22624	50	171	221
7	"7-out980"	.15290	224	1241	1465
7	"7-out981"	.64485	138	76	214
7	"7-out982"	.86585	71	11	82
7	"7-out983"	.25531	60	175	235
7	"7-out984"	.26875	86	234	320
7	"7-out985"	.26446	64	178	242
7	"7-out986"	.22562	81	278	359
7	"7-out987"	.29320	302	728	1030
7	"7-out988"	.14046	42	257	299
7	"7-out989"	.25496	167	488	655
7	"7-out990"	.92668	455	36	491
7	"7-out991"	.12365	23	163	186
7	"7-out992"	.18604	104	455	559
7	"7-out993"	.22580	77	264	341
7	"7-out994"	.42261	213	291	504
7	"7-out995"	.16507	104	526	630
7	"7-out996"	.51302	315	299	614
7	"7-out997"	.31578	36	78	114
7	"7-out998"	.31297	41	90	131
7	"7-out999"	.91328	653	62	715
7	"7-out1000"	.52808	141	126	267
7	"7-out1001"	.89795	44	5	49
7	"7-out1002"	.93726	254	17	271
7	"7-out1003"	.81967	50	11	61
7	"7-out1004"	.49616	259	263	522
7	"7-out1005"	.96330	105	4	109
7	"7-out1006"	.16822	18	89	107
7	"7-out1007"	.14871	58	332	390
7	"7-out1008"	.39664	71	108	179
7	"7-out1009"	.18270	131	586	717
7	"7-out1010"	.34745	41	77	118
7	"7-out1011"	.23204	84	278	362
7	"7-out1012"	.19611	121	496	617
7	"7-out1013"	.21986	166	589	755
7	"7-out1014"	.09923	13	118	131
7	"7-out1015"	.19551	61	251	312
7	"7-out1016"	.33428	117	233	350
7	"7-out1017"	.37931	121	198	319
7	"7-out1018"	.26666	92	253	345
7	"7-out1019"	.16438	60	305	365
7	"7-out1020"	.26646	89	245	334
7	"7-out1021"	.18546	194	852	1046
7	"7-out1022"	.92676	367	29	396
7	"7-out1023"	.89761	754	86	840
7	"7-out1024"	.22026	50	177	227
7	"7-out1025"	.15396	97	533	630
7	"7-out1026"	.19475	52	215	267
7	"7-out1027"	.27631	42	110	152
7	"7-out1028"	.24397	324	1004	1328
7	"7-out1029"	.15739	181	969	1150
7	"7-out1030"	.22535	80	275	355
7	"7-out1031"	.28865	84	207	291
7	"7-out1032"	.69714	122	53	175
7	"7-out1033"	.46951	77	87	164
7	"7-out1034"	.89189	66	8	74
7	"7-out1035"	.34223	282	542	824
7	"7-out1036"	.15417	72	395	467
7	"7-out1037"	.19202	212	892	1104
7	"7-out1038"	.75294	64	21	85
7	"7-out1039"	.22649	559	1909	2468
7	"7-out1040"	.17677	169	787	956
7	"7-out1041"	.87209	75	11	86
7	"7-out1042"	.19797	98	397	495
7	"7-out1043"	.22125	281	989	1270
7	"7-out1044"	.24092	73	230	303
7	"7-out1045"	.18304	95	424	519
7	"7-out1046"	.20606	163	628	791
7	"7-out1047"	.23595	105	340	445
7	"7-out1048"	.12447	59	415	474
7	"7-out1049"	.13636	24	152	176
7	"7-out1050"	.57432	85	63	148
7	"7-out1051"	.41293	83	118	201
7	"7-out1052"	.35742	89	160	249
7	"7-out1053"	.96521	444	16	460
7	"7-out1054"	.21060	143	536	679
7	"7-out1055"	.24523	90	277	367
7	"7-out1056"	.96541	335	12	347
7	"7-out1057"	.20442	120	467	587
7	"7-out1058"	.26838	219	597	816
7	"7-out1059"	.27205	148	396	544
7	"7-out1060"	.18771	107	463	570
7	"7-out1061"	.22040	162	573	735
7	"7-out1062"	.14386	61	363	424
7	"7-out1063"	.20192	84	332	416
7	"7-out1064"	.26824	136	371	507
7	"7-out1065"	.60606	20	13	33
7	"7-out1066"	.92376	206	17	223
7	"7-out1067"	.30854	307	688	995
7	"7-out1068"	.21590	76	276	352
7	"7-out1069"	.35664	51	92	143
7	"7-out1070"	.98260	113	2	115
7	"7-out1071"	.25606	95	276	371
7	"7-out1072"	.21636	119	431	550
7	"7-out1073"	.33632	75	148	223
7	"7-out1074"	.36527	629	1093	1722
7	"7-out1075"	.29411	70	168	238
7	"7-out1076"	.20866	130	493	623
7	"7-out1077"	.44400	222	278	500
7	"7-out1078"	.26359	63	176	239
7	"7-out1079"	.22836	351	1186	1537
7	"7-out1080"	.43837	377	483	860
7	"7-out1081"	.20155	104	412	516
7	"7-out1082"	.36090	48	85	133
7	"7-out1083"	.28834	94	232	326
7	"7-out1084"	.44204	164	207	371
7	"7-out1085"	.89430	110	13	123
7	"7-out1086"	.85470	100	17	117
7	"7-out1087"	.88034	103	14	117
7	"7-out1088"	.12125	85	616	701
7	"7-out1089"	.27366	185	491	676
7	"7-out1090"	.57380	241	179	420
7	"7-out1091"	.78378	116	32	148
7	"7-out1092"	.25524	292	852	1144
7	"7-out1093"	.55782	82	65	147
7	"7-out1094"	.34362	356	680	1036
7	"7-out1095"	.15185	94	525	619
7	"7-out1096"	.63144	257	150	407
7	"7-out1097"	.88216	277	37	314
7	"7-out1098"	.64827	94	51	145
7	"7-out1099"	.28278	207	525	732
7	"7-out1100"	.77272	136	40	176
7	"7-out1101"	.60031	386	257	643
7	"7-out1102"	.26610	252	695	947
7	"7-out1103"	.17666	53	247	300
7	"7-out1104"	.49352	648	665	1313
7	"7-out1105"	.15277	33	183	216
7	"7-out1106"	.44305	424	533	957
7	"7-out1107"	.23469	161	525	686
7	"7-out1108"	.33591	260	514	774
7	"7-out1109"	.17137	85	411	496
7	"7-out1110"	.16111	87	453	540
7	"7-out1111"	.16935	42	206	248
7	"7-out1112"	.92105	245	21	266
7	"7-out1113"	.24731	69	210	279
7	"7-out1114"	.87209	75	11	86
7	"7-out1115"	.18117	206	931	1137
7	"7-out1116"	.34423	179	341	520
7	"7-out1117"	.37916	182	298	480
7	"7-out1118"	.19887	106	427	533
7	"7-out1119"	.24411	83	257	340
7	"7-out1120"	.41747	43	60	103
7	"7-out1121"	.32590	234	484	718
7	"7-out1122"	.22198	103	361	464
7	"7-out1123"	.20555	74	286	360
7	"7-out1124"	.17260	63	302	365
7	"7-out1125"	.23611	85	275	360
7	"7-out1126"	.45050	223	272	495
7	"7-out1127"	.85359	309	53	362
7	"7-out1128"	.24469	277	855	1132
7	"7-out1129"	.22663	194	662	856
7	"7-out1130"	.70332	1100	464	1564
7	"7-out1131"	.20723	361	1381	1742
7	"7-out1132"	.57986	167	121	288
7	"7-out1133"	.13731	85	534	619
7	"7-out1134"	.70078	89	38	127
7	"7-out1135"	.89297	559	67	626
7	"7-out1136"	.86146	342	55	397
7	"7-out1137"	.13924	33	204	237
7	"7-out1138"	.52057	291	268	559
7	"7-out1139"	.26800	134	366	500
7	"7-out1140"	.13935	91	562	653
7	"7-out1141"	.25217	522	1548	2070
7	"7-out1142"	.29389	154	370	524
7	"7-out1143"	.83384	271	54	325
7	"7-out1144"	.20189	64	253	317
7	"7-out1145"	.21034	122	458	580
7	"7-out1146"	.62258	193	117	310
7	"7-out1147"	.26283	87	244	331
7	"7-out1148"	.41104	134	192	326
7	"7-out1149"	.57070	226	170	396
7	"7-out1150"	.46086	159	186	345
7	"7-out1151"	.78527	256	70	326
7	"7-out1152"	.37345	121	203	324
7	"7-out1153"	.44299	136	171	307
7	"7-out1154"	.49907	269	270	539
7	"7-out1155"	.20039	102	407	509
7	"7-out1156"	.35446	123	224	347
7	"7-out1157"	.70440	224	94	318
7	"7-out1158"	.19871	62	250	312
7	"7-out1159"	.37540	116	193	309
7	"7-out1160"	.70387	309	130	439
7	"7-out1161"	.25404	440	1292	1732
7	"7-out1162"	.22559	386	1325	1711
7	"7-out1163"	.29906	64	150	214
7	"7-out1164"	.90549	824	86	910
7	"7-out1165"	.74040	1215	426	1641
7	"7-out1166"	.27547	365	960	1325
7	"7-out1167"	.24282	330	1029	1359
7	"7-out1168"	.25327	58	171	229
7	"7-out1169"	.25700	55	159	214
7	"7-out1170"	.63924	101	57	158
7	"7-out1171"	.29296	75	181	256
7	"7-out1172"	.51520	288	271	559
7	"7-out1173"	.64363	177	98	275
7	"7-out1174"	.24352	47	146	193
7	"7-out1175"	.29855	103	242	345
7	"7-out1176"	.22867	260	877	1137
7	"7-out1177"	.24833	112	339	451
7	"7-out1178"	.27642	34	89	123
7	"7-out1179"	.60567	4826	3142	7968
7	"7-out1180"	.29272	555	1341	1896
7	"7-out1181"	.23270	111	366	477
7	"7-out1182"	.30487	25	57	82
7	"7-out1183"	.92631	528	42	570
7	"7-out1184"	.74193	46	16	62
7	"7-out1185"	.57641	132	97	229
7	"7-out1186"	.31746	20	43	63
7	"7-out1187"	.17803	47	217	264
7	"7-out1188"	.45588	31	37	68
7	"7-out1189"	.73730	334	119	453
7	"7-out1190"	.16009	65	341	406
7	"7-out1191"	.86624	272	42	314
7	"7-out1192"	.63430	196	113	309
7	"7-out1193"	.30622	64	145	209
7	"7-out1194"	.66462	759	383	1142
7	"7-out1195"	.17391	32	152	184
7	"7-out1196"	.27417	241	638	879
7	"7-out1197"	.25602	85	247	332
7	"7-out1198"	.57038	389	293	682
7	"7-out1199"	.19657	172	703	875
7	"7-out1200"	.08888	28	287	315
7	"7-out1201"	.95973	429	18	447
7	"7-out1202"	.28784	135	334	469
7	"7-out1203"	.89090	245	30	275
7	"7-out1204"	.89406	211	25	236
7	"7-out1205"	.95275	121	6	127
7	"7-out1206"	.18287	47	210	257
7	"7-out1207"	.46666	98	112	210
7	"7-out1208"	.37179	116	196	312
7	"7-out1209"	.12107	27	196	223
7	"7-out1210"	.18374	52	231	283
7	"7-out1211"	.88382	776	102	878
7	"7-out1212"	.89066	782	96	878
7	"7-out1213"	.87965	709	97	806
7	"7-out1214"	.89066	782	96	878
7	"7-out1215"	.90343	683	73	756
7	"7-out1216"	.89068	660	81	741
7	"7-out1217"	.19294	104	435	539
7	"7-out1218"	.23584	125	405	530
7	"7-out1219"	.43157	82	108	190
7	"7-out1220"	.22966	96	322	418
7	"7-out1221"	.26829	110	300	410
7	"7-out1222"	.32848	113	231	344
7	"7-out1223"	.22110	176	620	796
7	"7-out1224"	.17153	141	681	822
7	"7-out1225"	.18116	152	687	839
7	"7-out1226"	.23459	217	708	925
7	"7-out1227"	.25432	294	862	1156
7	"7-out1228"	.27118	400	1075	1475
7	"7-out1229"	.28396	395	996	1391
7	"7-out1230"	.18314	263	1173	1436
7	"7-out1231"	.18467	323	1426	1749
7	"7-out1232"	.94968	302	16	318
7	"7-out1233"	.16650	335	1677	2012
7	"7-out1234"	.16363	342	1748	2090
7	"7-out1235"	.91428	64	6	70
7	"7-out1236"	.34627	214	404	618
7	"7-out1237"	.22168	137	481	618
7	"7-out1238"	.87214	191	28	219
7	"7-out1239"	.46978	171	193	364
7	"7-out1240"	.16393	70	357	427
7	"7-out1241"	.48172	224	241	465
7	"7-out1242"	.22081	157	554	711
7	"7-out1243"	.94674	320	18	338
7	"7-out1244"	.09195	24	237	261
7	"7-out1245"	.54171	435	368	803
7	"7-out1246"	.22926	47	158	205
7	"7-out1247"	.20930	63	238	301
7	"7-out1248"	.41431	469	663	1132
7	"7-out1249"	.20401	61	238	299
7	"7-out1250"	.90029	307	34	341
7	"7-out1251"	.23258	197	650	847
7	"7-out1252"	.88951	1111	138	1249
7	"7-out1253"	.89878	666	75	741
7	"7-out1254"	.25142	220	655	875
7	"7-out1255"	.17939	101	462	563
7	"7-out1256"	.33155	62	125	187
7	"7-out1257"	.32864	304	621	925
7	"7-out1258"	.18823	64	276	340
7	"7-out1259"	.32970	938	1907	2845
7	"7-out1260"	.27866	192	497	689
7	"7-out1261"	.35126	209	386	595
7	"7-out1262"	.18023	228	1037	1265
7	"7-out1263"	.12127	61	442	503
7	"7-out1264"	.41071	230	330	560
7	"7-out1265"	.12737	67	459	526
7	"7-out1266"	.16585	34	171	205
7	"7-out1267"	.51293	119	113	232
7	"7-out1268"	.68571	168	77	245
7	"7-out1269"	.13984	53	326	379
7	"7-out1270"	.80305	579	142	721
7	"7-out1271"	.87372	256	37	293
7	"7-out1272"	.76141	367	115	482
7	"7-out1273"	.86185	418	67	485
7	"7-out1274"	.14669	82	477	559
7	"7-out1275"	.56725	97	74	171
7	"7-out1276"	.56395	97	75	172
7	"7-out1277"	.35460	150	273	423
7	"7-out1278"	.24659	217	663	880
7	"7-out1279"	.21376	118	434	552
7	"7-out1280"	.53525	334	290	624
7	"7-out1281"	.73218	339	124	463
7	"7-out1282"	.32679	100	206	306
7	"7-out1283"	.30582	63	143	206
7	"7-out1284"	.90163	55	6	61
7	"7-out1285"	.85135	126	22	148
7	"7-out1286"	.24166	58	182	240
7	"7-out1287"	.12217	27	194	221
7	"7-out1288"	.28059	94	241	335
7	"7-out1289"	.16707	207	1032	1239
7	"7-out1290"	.57788	115	84	199
7	"7-out1291"	.43967	164	209	373
7	"7-out1292"	.31304	108	237	345
7	"7-out1293"	.66210	145	74	219
7	"7-out1294"	.24935	96	289	385
7	"7-out1295"	.20022	181	723	904
7	"7-out1296"	.27428	96	254	350
7	"7-out1297"	.42514	142	192	334
7	"7-out1298"	.22011	116	411	527
7	"7-out1299"	.18457	189	835	1024
7	"7-out1300"	.22810	336	1137	1473
7	"7-out1301"	.19980	207	829	1036
7	"7-out1302"	.25045	137	410	547
7	"7-out1303"	.17948	70	320	390
7	"7-out1304"	.30578	37	84	121
7	"7-out1305"	.19551	218	897	1115
7	"7-out1306"	.50335	525	518	1043
7	"7-out1307"	.66600	335	168	503
7	"7-out1308"	.13729	201	1263	1464
7	"7-out1309"	.13072	194	1290	1484
7	"7-out1310"	.34225	422	811	1233
7	"7-out1311"	.45883	613	723	1336
7	"7-out1312"	.36993	347	591	938
7	"7-out1313"	.46987	39	44	83
7	"7-out1314"	.26710	82	225	307
7	"7-out1315"	.62724	175	104	279
7	"7-out1316"	.23127	71	236	307
7	"7-out1317"	.26587	67	185	252
7	"7-out1318"	.22073	66	233	299
7	"7-out1319"	.12418	19	134	153
7	"7-out1320"	.28395	23	58	81
7	"7-out1321"	.29971	104	243	347
7	"7-out1322"	.32128	240	507	747
7	"7-out1323"	.74305	214	74	288
7	"7-out1324"	.88500	177	23	200
7	"7-out1325"	.24286	417	1300	1717
7	"7-out1326"	.11574	25	191	216
7	"7-out1327"	.50652	233	227	460
7	"7-out1328"	.16411	107	545	652
7	"7-out1329"	.18045	181	822	1003
7	"7-out1330"	.21232	403	1495	1898
7	"7-out1331"	.42745	218	292	510
7	"7-out1332"	.40764	128	186	314
7	"7-out1333"	.78778	245	66	311
7	"7-out1334"	.23044	109	364	473
7	"7-out1335"	.67405	213	103	316
7	"7-out1336"	.43370	157	205	362
7	"7-out1337"	.44514	142	177	319
7	"7-out1338"	.29773	92	217	309
7	"7-out1339"	.19672	60	245	305
7	"7-out1340"	.76060	251	79	330
7	"7-out1341"	.75477	237	77	314
7	"7-out1342"	.68284	211	98	309
7	"7-out1343"	.81365	834	191	1025
7	"7-out1344"	.27500	88	232	320
7	"7-out1345"	.87048	410	61	471
7	"7-out1346"	.30731	63	142	205
7	"7-out1347"	.77022	238	71	309
7	"7-out1348"	.73417	232	84	316
7	"7-out1349"	.74603	235	80	315
7	"7-out1350"	.57558	198	146	344
7	"7-out1351"	.28525	89	223	312
7	"7-out1352"	.17628	55	257	312
7	"7-out1353"	.26234	85	239	324
7	"7-out1354"	.23437	75	245	320
7	"7-out1355"	.21495	69	252	321
7	"7-out1356"	.15231	46	256	302
7	"7-out1357"	.31962	101	215	316
7	"7-out1358"	.08253	26	289	315
7	"7-out1359"	.28706	91	226	317
7	"7-out1360"	.28660	92	229	321
7	"7-out1361"	.23397	73	239	312
7	"7-out1362"	.27244	88	235	323
7	"7-out1363"	.21337	67	247	314
7	"7-out1364"	.23283	78	257	335
7	"7-out1365"	.44164	140	177	317
7	"7-out1366"	.87962	285	39	324
7	"7-out1367"	.88000	308	42	350
7	"7-out1368"	.48231	150	161	311
7	"7-out1369"	.76751	241	73	314
7	"7-out1370"	.74840	235	79	314
7	"7-out1371"	.81155	267	62	329
7	"7-out1372"	.80564	257	62	319
7	"7-out1373"	.85488	271	46	317
7	"7-out1374"	.20312	65	255	320
7	"7-out1375"	.30218	97	224	321
7	"7-out1376"	.53086	172	152	324
7	"7-out1377"	.11214	36	285	321
7	"7-out1378"	.95652	462	21	483
7	"7-out1379"	.54101	310	263	573
7	"7-out1380"	.35793	548	983	1531
7	"7-out1381"	.29737	102	241	343
7	"7-out1382"	.32456	74	154	228
7	"7-out1383"	.91005	172	17	189
7	"7-out1384"	.63418	449	259	708
7	"7-out1385"	.24463	57	176	233
7	"7-out1386"	.28492	310	778	1088
7	"7-out1387"	.70249	366	155	521
7	"7-out1388"	.16295	95	488	583
7	"7-out1389"	.59593	264	179	443
7	"7-out1390"	.19230	35	147	182
7	"7-out1391"	.85882	146	24	170
7	"7-out1392"	.88823	151	19	170
7	"7-out1393"	.33870	84	164	248
7	"7-out1394"	.07826	36	424	460
7	"7-out1395"	.32343	98	205	303
7	"7-out1396"	.55737	34	27	61
7	"7-out1397"	.78688	48	13	61
7	"7-out1398"	.78688	48	13	61
7	"7-out1399"	.80327	49	12	61
7	"7-out1400"	.78688	48	13	61
7	"7-out1401"	.68852	42	19	61
7	"7-out1402"	.77049	47	14	61
7	"7-out1403"	.42857	66	88	154
7	"7-out1404"	.24302	183	570	753
7	"7-out1405"	.52296	148	135	283
7	"7-out1406"	.34986	134	249	383
7	"7-out1407"	.23172	149	494	643
7	"7-out1408"	.26202	158	445	603
7	"7-out1409"	.34013	150	291	441
7	"7-out1410"	.50623	203	198	401
7	"7-out1411"	.55350	150	121	271
7	"7-out1412"	.17129	37	179	216
7	"7-out1413"	.28878	121	298	419
7	"7-out1414"	.16599	41	206	247
7	"7-out1415"	.14166	34	206	240
7	"7-out1416"	.85294	116	20	136
7	"7-out1417"	.22718	117	398	515
7	"7-out1418"	.34394	108	206	314
7	"7-out1419"	.62907	251	148	399
7	"7-out1420"	.19152	122	515	637
7	"7-out1421"	.46875	75	85	160
7	"7-out1422"	.19858	84	339	423
7	"7-out1423"	.28797	91	225	316
7	"7-out1424"	.61635	196	122	318
7	"7-out1425"	.20872	67	254	321
7	"7-out1426"	.94160	129	8	137
7	"7-out1427"	.36196	118	208	326
7	"7-out1428"	.09183	27	267	294
7	"7-out1429"	.19411	211	876	1087
7	"7-out1430"	.37092	148	251	399
7	"7-out1431"	.24155	93	292	385
7	"7-out1432"	.26766	178	487	665
7	"7-out1433"	.19512	128	528	656
7	"7-out1434"	.31459	235	512	747
7	"7-out1435"	.28640	118	294	412
7	"7-out1436"	.18674	31	135	166
7	"7-out1437"	.47216	882	986	1868
7	"7-out1438"	.75449	252	82	334
7	"7-out1439"	.21537	549	2000	2549
7	"7-out1440"	.91773	502	45	547
7	"7-out1441"	.23611	136	440	576
7	"7-out1442"	.22672	56	191	247
7	"7-out1443"	.20038	103	411	514
7	"7-out1444"	.17812	272	1255	1527
7	"7-out1445"	.22675	300	1023	1323
7	"7-out1446"	.40851	96	139	235
7	"7-out1447"	.18699	279	1213	1492
7	"7-out1448"	.89915	107	12	119
7	"7-out1449"	.12500	30	210	240
7	"7-out1450"	.27730	259	675	934
7	"7-out1451"	.21823	79	283	362
7	"7-out1452"	.15077	87	490	577
7	"7-out1453"	.47098	138	155	293
7	"7-out1454"	.29496	41	98	139
7	"7-out1455"	.31455	67	146	213
7	"7-out1456"	.25675	133	385	518
7	"7-out1457"	.20000	47	188	235
7	"7-out1458"	.18297	43	192	235
7	"7-out1459"	.53448	62	54	116
7	"7-out1460"	.27777	60	156	216
7	"7-out1461"	.66336	67	34	101
7	"7-out1462"	.20812	41	156	197
7	"7-out1463"	.25232	217	643	860
7	"7-out1464"	.17838	170	783	953
7	"7-out1465"	.28286	71	180	251
7	"7-out1466"	.67375	380	184	564
7	"7-out1467"	.18300	140	625	765
7	"7-out1468"	.32522	107	222	329
7	"7-out1469"	.26548	30	83	113
7	"7-out1470"	.32377	237	495	732
7	"7-out1471"	.41353	550	780	1330
7	"7-out1472"	.22535	144	495	639
7	"7-out1473"	.41402	248	351	599
7	"7-out1474"	.51821	128	119	247
7	"7-out1475"	.50202	124	123	247
7	"7-out1476"	.31322	135	296	431
7	"7-out1477"	.20437	56	218	274
7	"7-out1478"	.25119	158	471	629
7	"7-out1479"	.21111	133	497	630
7	"7-out1480"	.21875	77	275	352
7	"7-out1481"	.21250	34	126	160
7	"7-out1482"	.12703	78	536	614
7	"7-out1483"	.20070	114	454	568
7	"7-out1484"	.59285	249	171	420
7	"7-out1485"	.17443	161	762	923
7	"7-out1486"	.30930	206	460	666
7	"7-out1487"	.23886	59	188	247
7	"7-out1488"	.69117	141	63	204
7	"7-out1489"	.21381	65	239	304
7	"7-out1490"	.67473	502	242	744
7	"7-out1491"	.37044	376	639	1015
7	"7-out1492"	.43333	182	238	420
7	"7-out1493"	.94926	1160	62	1222
7	"7-out1494"	.34375	275	525	800
7	"7-out1495"	.31589	163	353	516
7	"7-out1496"	.41067	177	254	431
7	"7-out1497"	.33459	177	352	529
7	"7-out1498"	.29106	140	341	481
7	"7-out1499"	.17287	65	311	376
7	"7-out1500"	.18450	50	221	271
7	"7-out1501"	.25262	506	1497	2003
7	"7-out1502"	.84910	332	59	391
7	"7-out1503"	.57432	170	126	296
7	"7-out1504"	.25403	126	370	496
7	"7-out1505"	.66933	251	124	375
7	"7-out1506"	.40589	468	685	1153
7	"7-out1507"	.89982	1024	114	1138
7	"7-out1508"	.36423	55	96	151
7	"7-out1509"	.16901	216	1062	1278
7	"7-out1510"	.20428	105	409	514
7	"7-out1511"	.95283	101	5	106
7	"7-out1512"	.58585	174	123	297
7	"7-out1513"	.85714	252	42	294
7	"7-out1514"	.90000	945	105	1050
7	"7-out1515"	.90070	1025	113	1138
7	"7-out1516"	.90114	1021	112	1133
7	"7-out1517"	.90117	383	42	425
7	"7-out1518"	.90821	376	38	414
7	"7-out1519"	.88888	384	48	432
7	"7-out1520"	.91142	391	38	429
7	"7-out1521"	.16702	78	389	467
7	"7-out1522"	.18277	104	465	569
7	"7-out1523"	.19761	83	337	420
7	"7-out1524"	.50561	45	44	89
7	"7-out1525"	.94137	273	17	290
7	"7-out1526"	.26250	126	354	480
7	"7-out1527"	.36964	95	162	257
7	"7-out1528"	.21086	97	363	460
7	"7-out1529"	.21890	132	471	603
7	"7-out1530"	.14988	67	380	447
7	"7-out1531"	.34634	142	268	410
7	"7-out1532"	.54207	219	185	404
7	"7-out1533"	.91289	262	25	287
7	"7-out1534"	.25613	334	970	1304
7	"7-out1535"	.31316	88	193	281
7	"7-out1536"	.48223	95	102	197
7	"7-out1537"	.29537	83	198	281
7	"7-out1538"	.37941	129	211	340
7	"7-out1539"	.93678	163	11	174
7	"7-out1540"	.19364	128	533	661
7	"7-out1541"	.69613	126	55	181
7	"7-out1542"	.68902	113	51	164
7	"7-out1543"	.91447	139	13	152
7	"7-out1544"	.60269	179	118	297
7	"7-out1545"	.23170	76	252	328
7	"7-out1546"	.29310	136	328	464
7	"7-out1547"	.87878	174	24	198
7	"7-out1548"	.29323	390	940	1330
7	"7-out1549"	.32268	616	1293	1909
7	"7-out1550"	.17792	79	365	444
7	"7-out1551"	.22580	98	336	434
7	"7-out1552"	.20346	94	368	462
7	"7-out1553"	.48045	1364	1475	2839
7	"7-out1554"	.21523	130	474	604
7	"7-out1555"	.51222	461	439	900
7	"7-out1556"	.74879	155	52	207
7	"7-out1557"	.22018	96	340	436
7	"7-out1558"	.31219	128	282	410
7	"7-out1559"	.09154	13	129	142
7	"7-out1560"	.90043	208	23	231
7	"7-out1561"	.32412	129	269	398
7	"7-out1562"	.26804	130	355	485
7	"7-out1563"	.59645	269	182	451
7	"7-out1564"	.79677	247	63	310
7	"7-out1565"	.51212	190	181	371
7	"7-out1566"	.19780	54	219	273
7	"7-out1567"	.38292	157	253	410
7	"7-out1568"	.44112	266	337	603
7	"7-out1569"	.25617	83	241	324
7	"7-out1570"	.65196	532	284	816
7	"7-out1571"	.32972	213	433	646
7	"7-out1572"	.13722	87	547	634
7	"7-out1573"	.28458	72	181	253
7	"7-out1574"	.40492	115	169	284
7	"7-out1575"	.33596	170	336	506
7	"7-out1576"	.29491	174	416	590
7	"7-out1577"	.30219	55	127	182
7	"7-out1578"	.41922	301	417	718
7	"7-out1579"	.28353	93	235	328
7	"7-out1580"	.24610	79	242	321
7	"7-out1581"	.63200	79	46	125
7	"7-out1582"	.75245	383	126	509
7	"7-out1583"	.22538	261	897	1158
7	"7-out1584"	.34358	67	128	195
7	"7-out1585"	.33867	148	289	437
7	"7-out1586"	.21923	114	406	520
7	"7-out1587"	.27102	116	312	428
7	"7-out1588"	.61935	192	118	310
7	"7-out1589"	.22926	47	158	205
7	"7-out1590"	.81873	271	60	331
7	"7-out1591"	.22292	35	122	157
7	"7-out1592"	.60082	146	97	243
7	"7-out1593"	.82306	521	112	633
7	"7-out1594"	.92789	592	46	638
7	"7-out1595"	.93348	842	60	902
7	"7-out1596"	.26315	30	84	114
7	"7-out1597"	.51612	64	60	124
7	"7-out1598"	.64197	52	29	81
7	"7-out1599"	.36501	96	167	263
7	"7-out1600"	.91803	224	20	244
7	"7-out1601"	.90214	378	41	419
7	"7-out1602"	.15987	102	536	638
7	"7-out1603"	.16717	163	812	975
7	"7-out1604"	.28682	185	460	645
7	"7-out1605"	.30337	297	682	979
7	"7-out1606"	.21849	215	769	984
7	"7-out1607"	.21302	229	846	1075
7	"7-out1608"	.92148	446	38	484
7	"7-out1609"	.26258	120	337	457
7	"7-out1610"	.33540	701	1389	2090
7	"7-out1611"	.43115	119	157	276
7	"7-out1612"	.24154	50	157	207
7	"7-out1613"	.86458	83	13	96
7	"7-out1614"	.51131	113	108	221
7	"7-out1615"	.17159	87	420	507
7	"7-out1616"	.13876	63	391	454
7	"7-out1617"	.22053	189	668	857
7	"7-out1618"	.66945	320	158	478
7	"7-out1619"	.21969	58	206	264
7	"7-out1620"	.90666	68	7	75
7	"7-out1621"	.16832	135	667	802
7	"7-out1622"	.32015	162	344	506
7	"7-out1623"	.91873	407	36	443
7	"7-out1624"	.15072	115	648	763
7	"7-out1625"	.32376	440	919	1359
7	"7-out1626"	.11795	67	501	568
7	"7-out1627"	.21627	93	337	430
7	"7-out1628"	.19926	54	217	271
7	"7-out1629"	.14144	86	522	608
7	"7-out1630"	.19452	497	2058	2555
7	"7-out1631"	.92857	325	25	350
7	"7-out1632"	.90514	334	35	369
7	"7-out1633"	.92571	324	26	350
7	"7-out1634"	.92411	341	28	369
7	"7-out1635"	.92411	341	28	369
7	"7-out1636"	.44392	95	119	214
7	"7-out1637"	.84000	420	80	500
7	"7-out1638"	.30102	59	137	196
7	"7-out1639"	.86060	142	23	165
7	"7-out1640"	.09731	58	538	596
7	"7-out1641"	.28600	139	347	486
7	"7-out1642"	.11981	52	382	434
7	"7-out1643"	.35462	161	293	454
7	"7-out1644"	.49367	117	120	237
7	"7-out1645"	.12676	18	124	142
7	"7-out1646"	.24870	48	145	193
7	"7-out1647"	.94245	868	53	921
7	"7-out1648"	.24172	292	916	1208
7	"7-out1649"	.23872	90	287	377
7	"7-out1650"	.17964	263	1201	1464
7	"7-out1651"	.25906	100	286	386
7	"7-out1652"	.27207	684	1830	2514
7	"7-out1653"	.19895	38	153	191
7	"7-out1654"	.87234	164	24	188
7	"7-out1655"	.49195	214	221	435
7	"7-out1656"	.85772	211	35	246
7	"7-out1657"	.73707	328	117	445
7	"7-out1658"	.46084	153	179	332
7	"7-out1659"	.28429	172	433	605
7	"7-out1660"	.23741	99	318	417
7	"7-out1661"	.18939	100	428	528
7	"7-out1662"	.23944	363	1153	1516
7	"7-out1663"	.22105	84	296	380
7	"7-out1664"	.25595	86	250	336
7	"7-out1665"	.13601	105	667	772
7	"7-out1666"	.20738	146	558	704
7	"7-out1667"	.22669	107	365	472
7	"7-out1668"	.88456	705	92	797
7	"7-out1669"	.23958	92	292	384
7	"7-out1670"	.66197	141	72	213
7	"7-out1671"	.12750	159	1088	1247
7	"7-out1672"	.92810	142	11	153
7	"7-out1673"	.23110	107	356	463
7	"7-out1674"	.54232	378	319	697
7	"7-out1675"	.21739	45	162	207
7	"7-out1676"	.16513	72	364	436
7	"7-out1677"	.95008	1161	61	1222
7	"7-out1678"	.92571	324	26	350
7	"7-out1679"	.26404	47	131	178
7	"7-out1680"	.18157	69	311	380
7	"7-out1681"	.16080	64	334	398
7	"7-out1682"	.17322	66	315	381
7	"7-out1683"	.24074	104	328	432
7	"7-out1684"	.26415	98	273	371
7	"7-out1685"	.29687	114	270	384
7	"7-out1686"	.22510	52	179	231
7	"7-out1687"	.89705	61	7	68
7	"7-out1688"	.90825	99	10	109
7	"7-out1689"	.23756	640	2054	2694
7	"7-out1690"	.34196	132	254	386
7	"7-out1691"	.23333	189	621	810
7	"7-out1692"	.93975	234	15	249
7	"7-out1693"	.19047	40	170	210
7	"7-out1694"	.14871	58	332	390
7	"7-out1695"	.18497	128	564	692
7	"7-out1696"	.41157	377	539	916
7	"7-out1697"	.63779	162	92	254
7	"7-out1698"	.23503	212	690	902
7	"7-out1699"	.15838	118	627	745
7	"7-out1700"	.73588	365	131	496
7	"7-out1701"	.16201	58	300	358
7	"7-out1702"	.24470	404	1247	1651
7	"7-out1703"	.21648	1014	3670	4684
7	"7-out1704"	.63428	222	128	350
7	"7-out1705"	.45643	110	131	241
7	"7-out1706"	.28448	66	166	232
7	"7-out1707"	.17669	94	438	532
7	"7-out1708"	.90666	68	7	75
7	"7-out1709"	.16317	234	1200	1434
7	"7-out1710"	.89130	410	50	460
7	"7-out1711"	.86153	280	45	325
7	"7-out1712"	.16274	83	427	510
7	"7-out1713"	.86915	93	14	107
7	"7-out1714"	.38095	56	91	147
7	"7-out1715"	.71626	414	164	578
7	"7-out1716"	.65094	207	111	318
7	"7-out1717"	.17816	93	429	522
7	"7-out1718"	.22300	318	1108	1426
7	"7-out1719"	.90796	513	52	565
7	"7-out1720"	.34375	110	210	320
7	"7-out1721"	.19275	133	557	690
7	"7-out1722"	.21640	95	344	439
7	"7-out1723"	.41866	157	218	375
7	"7-out1724"	.14606	65	380	445
7	"7-out1725"	.18556	18	79	97
7	"7-out1726"	.18660	117	510	627
7	"7-out1727"	.33617	158	312	470
7	"7-out1728"	.15341	83	458	541
7	"7-out1729"	.18652	108	471	579
7	"7-out1730"	.13669	19	120	139
7	"7-out1731"	.92865	781	60	841
7	"7-out1732"	.31750	214	460	674
7	"7-out1733"	.21890	44	157	201
7	"7-out1734"	.17282	430	2058	2488
7	"7-out1735"	.21593	515	1870	2385
7	"7-out1736"	.28623	79	197	276
7	"7-out1737"	.15441	63	345	408
7	"7-out1738"	.07364	19	239	258
7	"7-out1739"	.84201	517	97	614
7	"7-out1740"	.47383	996	1106	2102
7	"7-out1741"	.12254	100	716	816
7	"7-out1742"	.31016	58	129	187
7	"7-out1743"	.18712	125	543	668
7	"7-out1744"	.22962	231	775	1006
7	"7-out1745"	.59124	81	56	137
7	"7-out1746"	.09638	40	375	415
7	"7-out1747"	.89041	195	24	219
7	"7-out1748"	.20000	75	300	375
7	"7-out1749"	.24715	87	265	352
7	"7-out1750"	.13281	17	111	128
7	"7-out1751"	.22222	78	273	351
7	"7-out1752"	.83190	678	137	815
7	"7-out1753"	.31866	268	573	841
7	"7-out1754"	.17037	46	224	270
7	"7-out1755"	.46863	127	144	271
7	"7-out1756"	.82018	707	155	862
7	"7-out1757"	.09813	42	386	428
7	"7-out1758"	.13681	97	612	709
7	"7-out1759"	.28486	96	241	337
7	"7-out1760"	.55000	99	81	180
7	"7-out1761"	.85416	82	14	96
7	"7-out1762"	.62749	315	187	502
7	"7-out1763"	.21875	329	1175	1504
7	"7-out1764"	.10000	84	756	840
7	"7-out1765"	.49410	419	429	848
7	"7-out1766"	.18686	128	557	685
7	"7-out1767"	.81041	607	142	749
7	"7-out1768"	.32521	227	471	698
7	"7-out1769"	.15251	97	539	636
7	"7-out1770"	.23412	118	386	504
7	"7-out1771"	.90666	68	7	75
7	"7-out1772"	.36794	854	1467	2321
7	"7-out1773"	.59409	161	110	271
7	"7-out1774"	.19614	183	750	933
7	"7-out1775"	.20000	65	260	325
7	"7-out1776"	.43148	148	195	343
7	"7-out1777"	.89577	1040	121	1161
7	"7-out1778"	.17073	84	408	492
7	"7-out1779"	.14617	44	257	301
7	"7-out1780"	.21273	264	977	1241
7	"7-out1781"	.93954	373	24	397
7	"7-out1782"	.35988	122	217	339
7	"7-out1783"	.95289	263	13	276
7	"7-out1784"	.30244	891	2055	2946
7	"7-out1785"	.34688	128	241	369
7	"7-out1786"	.23146	153	508	661
7	"7-out1787"	.19705	107	436	543
7	"7-out1788"	.15656	31	167	198
7	"7-out1789"	.67934	125	59	184
7	"7-out1790"	.10952	46	374	420
7	"7-out1791"	.35443	84	153	237
7	"7-out1792"	.33823	92	180	272
7	"7-out1793"	.23037	91	304	395
7	"7-out1794"	.09905	21	191	212
7	"7-out1795"	.96666	145	5	150
7	"7-out1796"	.19495	85	351	436
7	"7-out1797"	.22365	104	361	465
7	"7-out1798"	.16346	34	174	208
7	"7-out1799"	.22535	48	165	213
7	"7-out1800"	.33242	243	488	731
7	"7-out1801"	.60239	703	464	1167
7	"7-out1802"	.34006	202	392	594
7	"7-out1803"	.14181	78	472	550
7	"7-out1804"	.17662	68	317	385
7	"7-out1805"	.16647	288	1442	1730
7	"7-out1806"	.21052	24	90	114
7	"7-out1807"	.10367	62	536	598
7	"7-out1808"	.36102	226	400	626
7	"7-out1809"	.23110	266	885	1151
7	"7-out1810"	.19845	231	933	1164
7	"7-out1811"	.20781	133	507	640
7	"7-out1812"	.26470	225	625	850
7	"7-out1813"	.29007	76	186	262
7	"7-out1814"	.17826	41	189	230
7	"7-out1815"	.21179	79	294	373
7	"7-out1816"	.20803	88	335	423
7	"7-out1817"	.37127	610	1033	1643
7	"7-out1818"	.22807	52	176	228
7	"7-out1819"	.23354	149	489	638
7	"7-out1820"	.95027	1204	63	1267
7	"7-out1821"	.48638	125	132	257
7	"7-out1822"	.34883	240	448	688
7	"7-out1823"	.43061	301	398	699
7	"7-out1824"	.11239	39	308	347
7	"7-out1825"	.23776	102	327	429
7	"7-out1826"	.17866	144	662	806
7	"7-out1827"	.73437	47	17	64
7	"7-out1828"	.12861	40	271	311
7	"7-out1829"	.29844	345	811	1156
7	"7-out1830"	.17354	143	681	824
7	"7-out1831"	.22073	132	466	598
7	"7-out1832"	.20159	101	400	501
7	"7-out1833"	.15514	83	452	535
7	"7-out1834"	.03508	6	165	171
7	"7-out1835"	.14503	95	560	655
7	"7-out1836"	.40000	154	231	385
7	"7-out1837"	.21003	67	252	319
7	"7-out1838"	.97633	165	4	169
7	"7-out1839"	.24185	141	442	583
7	"7-out1840"	.69444	125	55	180
7	"7-out1841"	.69512	114	50	164
7	"7-out1842"	.84102	164	31	195
7	"7-out1843"	.53231	140	123	263
7	"7-out1844"	.21812	142	509	651
7	"7-out1845"	.27863	90	233	323
7	"7-out1846"	.16129	40	208	248
7	"7-out1847"	.13289	40	261	301
7	"7-out1848"	.93067	1356	101	1457
7	"7-out1849"	.87878	87	12	99
7	"7-out1850"	.22872	86	290	376
7	"7-out1851"	.12596	82	569	651
7	"7-out1852"	.26470	135	375	510
7	"7-out1853"	.26598	732	2020	2752
7	"7-out1854"	.22711	129	439	568
7	"7-out1855"	.12857	9	61	70
7	"7-out1856"	.18289	139	621	760
7	"7-out1857"	.86419	70	11	81
7	"7-out1858"	.93103	108	8	116
7	"7-out1859"	.94897	93	5	98
7	"7-out1860"	.22420	113	391	504
7	"7-out1861"	.28142	309	789	1098
7	"7-out1862"	.17796	63	291	354
7	"7-out1863"	.58550	315	223	538
7	"7-out1864"	.19970	269	1078	1347
7	"7-out1865"	.25123	152	453	605
7	"7-out1866"	.85446	593	101	694
7	"7-out1867"	.20679	73	280	353
7	"7-out1868"	.37179	87	147	234
7	"7-out1869"	.25068	92	275	367
7	"7-out1870"	.64528	171	94	265
7	"7-out1871"	.24242	40	125	165
7	"7-out1872"	.17704	108	502	610
7	"7-out1873"	.26231	181	509	690
7	"7-out1874"	.36111	143	253	396
7	"7-out1875"	.33434	110	219	329
7	"7-out1876"	.43611	157	203	360
7	"7-out1877"	.41525	147	207	354
7	"7-out1878"	.21115	106	396	502
7	"7-out1879"	.63970	522	294	816
7	"7-out1880"	.37238	89	150	239
7	"7-out1881"	.25352	72	212	284
7	"7-out1882"	.24125	69	217	286
7	"7-out1883"	.31134	302	668	970
7	"7-out1884"	.93154	313	23	336
7	"7-out1885"	.54395	99	83	182
7	"7-out1886"	.13157	20	132	152
7	"7-out1887"	.84223	347	65	412
7	"7-out1888"	.73852	531	188	719
7	"7-out1889"	.25759	178	513	691
7	"7-out1890"	.27777	195	507	702
7	"7-out1891"	.66036	908	467	1375
7	"7-out1892"	.47760	629	688	1317
7	"7-out1893"	.43094	337	445	782
7	"7-out1894"	.87815	418	58	476
7	"7-out1895"	.86458	249	39	288
7	"7-out1896"	.89333	67	8	75
7	"7-out1897"	.11083	45	361	406
7	"7-out1898"	.41016	121	174	295
7	"7-out1899"	.27191	183	490	673
7	"7-out1900"	.12021	22	161	183
7	"7-out1901"	.48148	78	84	162
7	"7-out1902"	.90476	285	30	315
7	"7-out1903"	.40921	151	218	369
7	"7-out1904"	.89510	384	45	429
7	"7-out1905"	.30735	280	631	911
7	"7-out1906"	.19654	91	372	463
7	"7-out1907"	.28000	49	126	175
7	"7-out1908"	.47428	249	276	525
7	"7-out1909"	.07344	26	328	354
7	"7-out1910"	.08307	27	298	325
7	"7-out1911"	.67878	112	53	165
7	"7-out1912"	.12642	133	919	1052
7	"7-out1913"	.09827	57	523	580
7	"7-out1914"	.21201	120	446	566
7	"7-out1915"	.35955	64	114	178
7	"7-out1916"	.16333	98	502	600
7	"7-out1917"	.91639	285	26	311
7	"7-out1918"	.41481	112	158	270
7	"7-out1919"	.33333	82	164	246
7	"7-out1920"	.21113	110	411	521
7	"7-out1921"	.20810	226	860	1086
7	"7-out1922"	.24839	194	587	781
7	"7-out1923"	.26149	273	771	1044
7	"7-out1924"	.18718	187	812	999
7	"7-out1925"	.32960	59	120	179
7	"7-out1926"	.34247	337	647	984
7	"7-out1927"	.45057	196	239	435
7	"7-out1928"	.20426	115	448	563
7	"7-out1929"	.30319	57	131	188
7	"7-out1930"	.62857	88	52	140
7	"7-out1931"	.20869	24	91	115
7	"7-out1932"	.18281	100	447	547
7	"7-out1933"	.15268	71	394	465
7	"7-out1934"	.26523	309	856	1165
7	"7-out1935"	.23076	18	60	78
7	"7-out1936"	.22018	120	425	545
7	"7-out1937"	.27863	163	422	585
7	"7-out1938"	.29127	277	674	951
7	"7-out1939"	.24586	223	684	907
7	"7-out1940"	.94701	429	24	453
7	"7-out1941"	.25000	217	651	868
7	"7-out1942"	.37091	375	636	1011
7	"7-out1943"	.89604	431	50	481
7	"7-out1944"	.23926	117	372	489
7	"7-out1945"	.41164	601	859	1460
7	"7-out1946"	.92362	653	54	707
7	"7-out1947"	.96124	124	5	129
7	"7-out1948"	.39275	661	1022	1683
7	"7-out1949"	.23928	134	426	560
7	"7-out1950"	.96549	1231	44	1275
7	"7-out1951"	.35365	203	371	574
7	"7-out1952"	.11475	21	162	183
7	"7-out1953"	.21428	192	704	896
7	"7-out1954"	.11274	69	543	612
7	"7-out1955"	.33732	169	332	501
7	"7-out1956"	.89750	359	41	400
7	"7-out1957"	.24270	133	415	548
7	"7-out1958"	.55135	204	166	370
7	"7-out1959"	.26315	65	182	247
7	"7-out1960"	.23000	46	154	200
7	"7-out1961"	.33579	182	360	542
7	"7-out1962"	.21837	145	519	664
7	"7-out1963"	.25467	177	518	695
7	"7-out1964"	.37149	159	269	428
7	"7-out1965"	.26119	105	297	402
7	"7-out1966"	.15862	23	122	145
7	"7-out1967"	.27056	148	399	547
7	"7-out1968"	.36757	712	1225	1937
7	"7-out1969"	.21319	42	155	197
7	"7-out1970"	.35834	277	496	773
7	"7-out1971"	.17957	153	699	852
7	"7-out1972"	.15505	138	752	890
7	"7-out1973"	.14453	123	728	851
7	"7-out1974"	.14834	85	488	573
7	"7-out1975"	.12759	86	588	674
7	"7-out1976"	.18770	113	489	602
7	"7-out1977"	.93664	887	60	947
7	"7-out1978"	.41948	211	292	503
7	"7-out1979"	.20125	161	639	800
7	"7-out1980"	.26265	83	233	316
7	"7-out1981"	.39495	94	144	238
7	"7-out1982"	.84972	311	55	366
7	"7-out1983"	.23339	130	427	557
7	"7-out1984"	.14049	51	312	363
7	"7-out1985"	.15517	63	343	406
7	"7-out1986"	.32080	128	271	399
7	"7-out1987"	.20289	42	165	207
7	"7-out1988"	.20414	138	538	676
7	"7-out1989"	.21825	165	591	756
7	"7-out1990"	.17857	65	299	364
7	"7-out1991"	.25843	498	1429	1927
7	"7-out1992"	.08547	30	321	351
7	"7-out1993"	.30019	154	359	513
7	"7-out1994"	.36075	114	202	316
7	"7-out1995"	.21492	144	526	670
7	"7-out1996"	.16161	32	166	198
7	"7-out1997"	.10000	64	576	640
7	"7-out1998"	.95589	1192	55	1247
7	"7-out1999"	.20572	589	2274	2863
7	"7-out2000"	.19761	149	605	754
7	"7-out2001"	.21200	53	197	250
7	"7-out2002"	.29140	278	676	954
7	"7-out2003"	.08605	87	924	1011
7	"7-out2004"	.21867	185	661	846
7	"7-out2005"	.94455	494	29	523
7	"7-out2006"	.27687	85	222	307
7	"7-out2007"	.22065	329	1162	1491
7	"7-out2008"	.27249	315	841	1156
7	"7-out2009"	.22696	165	562	727
7	"7-out2010"	.52601	91	82	173
7	"7-out2011"	.24242	112	350	462
7	"7-out2012"	.25972	728	2075	2803
7	"7-out2013"	.26543	129	357	486
7	"7-out2014"	.16875	27	133	160
7	"7-out2015"	.41176	49	70	119
7	"7-out2016"	.91255	814	78	892
7	"7-out2017"	.54187	537	454	991
7	"7-out2018"	.16410	160	815	975
7	"7-out2019"	.13627	74	469	543
7	"7-out2020"	.15120	75	421	496
7	"7-out2021"	.11445	57	441	498
7	"7-out2022"	.15023	64	362	426
7	"7-out2023"	.21458	312	1142	1454
7	"7-out2024"	.29879	124	291	415
7	"7-out2025"	.31609	55	119	174
7	"7-out2026"	.43527	343	445	788
7	"7-out2027"	.34663	304	573	877
7	"7-out2028"	.12500	33	231	264
7	"7-out2029"	.14155	140	849	989
7	"7-out2030"	.26717	35	96	131
7	"7-out2031"	.56179	100	78	178
7	"7-out2032"	.28326	66	167	233
7	"7-out2033"	.20000	73	292	365
7	"7-out2034"	.21987	104	369	473
7	"7-out2035"	.13333	152	988	1140
7	"7-out2036"	.33222	200	402	602
7	"7-out2037"	.95204	536	27	563
7	"7-out2038"	.38539	153	244	397
7	"7-out2039"	.87761	294	41	335
7	"7-out2040"	.29766	153	361	514
7	"7-out2041"	.32046	83	176	259
7	"7-out2042"	.87755	344	48	392
7	"7-out2043"	.27891	82	212	294
7	"7-out2044"	.28015	72	185	257
7	"7-out2045"	.39701	133	202	335
7	"7-out2046"	.22316	158	550	708
7	"7-out2047"	.25405	188	552	740
7	"7-out2048"	.34166	123	237	360
7	"7-out2049"	.34943	123	229	352
7	"7-out2050"	.35475	138	251	389
7	"7-out2051"	.96296	130	5	135
7	"7-out2052"	.31858	36	77	113
7	"7-out2053"	.11657	192	1455	1647
7	"7-out2054"	.86477	275	43	318
7	"7-out2055"	.18566	57	250	307
7	"7-out2056"	.35734	124	223	347
7	"7-out2057"	.21885	188	671	859
7	"7-out2058"	.41690	143	200	343
7	"7-out2059"	.85031	267	47	314
7	"7-out2060"	.65299	207	110	317
7	"7-out2061"	.54838	68	56	124
7	"7-out2062"	.34240	151	290	441
7	"7-out2063"	.36227	121	213	334
7	"7-out2064"	.20915	32	121	153
7	"7-out2065"	.23529	80	260	340
7	"7-out2066"	.24790	148	449	597
7	"7-out2067"	.21479	331	1210	1541
7	"7-out2068"	.19073	243	1031	1274
7	"7-out2069"	.35619	187	338	525
7	"7-out2070"	.36940	99	169	268
7	"7-out2071"	.86764	59	9	68
7	"7-out2072"	.18259	107	479	586
7	"7-out2073"	.13541	52	332	384
7	"7-out2074"	.28488	98	246	344
7	"7-out2075"	.89406	211	25	236
7	"7-out2076"	.69298	79	35	114
7	"7-out2077"	.52542	62	56	118
7	"7-out2078"	.15151	30	168	198
7	"7-out2079"	.36413	67	117	184
7	"7-out2080"	.94478	154	9	163
7	"7-out2081"	.30285	53	122	175
7	"7-out2082"	.96022	169	7	176
7	"7-out2083"	.22425	135	467	602
7	"7-out2084"	.23750	19	61	80
7	"7-out2085"	.14111	58	353	411
7	"7-out2086"	.08310	31	342	373
7	"7-out2087"	.40662	135	197	332
7	"7-out2088"	.62275	208	126	334
7	"7-out2089"	.68072	226	106	332
7	"7-out2090"	.83561	122	24	146
7	"7-out2091"	.34215	168	323	491
7	"7-out2092"	.12874	86	582	668
7	"7-out2093"	.40897	155	224	379
7	"7-out2094"	.11722	49	369	418
7	"7-out2095"	.81967	300	66	366
7	"7-out2096"	.31111	84	186	270
7	"7-out2097"	.28804	53	131	184
7	"7-out2098"	.32272	71	149	220
7	"7-out2099"	.31814	349	748	1097
7	"7-out2100"	.26244	311	874	1185
7	"7-out2101"	.63050	186	109	295
7	"7-out2102"	.24272	217	677	894
7	"7-out2103"	.34823	148	277	425
7	"7-out2104"	.29078	41	100	141
7	"7-out2105"	.21359	44	162	206
7	"7-out2106"	.32508	473	982	1455
7	"7-out2107"	.25274	46	136	182
7	"7-out2108"	.83006	127	26	153
7	"7-out2109"	.20379	86	336	422
7	"7-out2110"	.56849	83	63	146
7	"7-out2111"	.24413	177	548	725
7	"7-out2112"	.20457	143	556	699
7	"7-out2113"	.39912	182	274	456
7	"7-out2114"	.91891	374	33	407
7	"7-out2115"	.23665	133	429	562
7	"7-out2116"	.21929	100	356	456
7	"7-out2117"	.36080	162	287	449
7	"7-out2118"	.34749	180	338	518
7	"7-out2119"	.25293	194	573	767
7	"7-out2120"	.26699	110	302	412
7	"7-out2121"	.17555	79	371	450
7	"7-out2122"	.86713	372	57	429
7	"7-out2123"	.76500	1924	591	2515
7	"7-out2124"	.93032	494	37	531
7	"7-out2125"	.20895	70	265	335
7	"7-out2126"	.23554	110	357	467
7	"7-out2127"	.23239	33	109	142
7	"7-out2128"	.74842	476	160	636
7	"7-out2129"	.30360	143	328	471
7	"7-out2130"	.96192	480	19	499
7	"7-out2131"	.12676	54	372	426
7	"7-out2132"	.75873	239	76	315
7	"7-out2133"	.24038	75	237	312
7	"7-out2134"	.77170	240	71	311
7	"7-out2135"	.21709	127	458	585
7	"7-out2136"	.20089	90	358	448
7	"7-out2137"	.25796	81	233	314
7	"7-out2138"	.21556	72	262	334
7	"7-out2139"	.16768	55	273	328
7	"7-out2140"	.68238	217	101	318
7	"7-out2141"	.77714	408	117	525
7	"7-out2142"	.19791	493	1998	2491
7	"7-out2143"	.29936	94	220	314
7	"7-out2144"	.19108	60	254	314
7	"7-out2145"	.79870	246	62	308
7	"7-out2146"	.84140	573	108	681
7	"7-out2147"	.90068	263	29	292
7	"7-out2148"	.95344	553	27	580
7	"7-out2149"	.20327	62	243	305
7	"7-out2150"	.85818	236	39	275
7	"7-out2151"	.12710	83	570	653
7	"7-out2152"	.21235	55	204	259
7	"7-out2153"	.27246	94	251	345
7	"7-out2154"	.14054	52	318	370
7	"7-out2155"	.69444	175	77	252
7	"7-out2156"	.91366	127	12	139
7	"7-out2157"	.29121	189	460	649
7	"7-out2158"	.26013	77	219	296
7	"7-out2159"	.20489	67	260	327
7	"7-out2160"	.90404	179	19	198
7	"7-out2161"	.18262	124	555	679
7	"7-out2162"	.18125	145	655	800
7	"7-out2163"	.62864	237	140	377
7	"7-out2164"	.17092	107	519	626
7	"7-out2165"	.22023	74	262	336
7	"7-out2166"	.47678	154	169	323
7	"7-out2167"	.22780	313	1061	1374
7	"7-out2168"	.26732	162	444	606
7	"7-out2169"	.17656	107	499	606
7	"7-out2170"	.91521	367	34	401
7	"7-out2171"	.20895	70	265	335
7	"7-out2172"	.68292	112	52	164
7	"7-out2173"	.28895	306	753	1059
7	"7-out2174"	.09075	55	551	606
7	"7-out2175"	.28797	218	539	757
7	"7-out2176"	.23618	94	304	398
7	"7-out2177"	.23640	100	323	423
7	"7-out2178"	.32513	119	247	366
7	"7-out2179"	.19799	79	320	399
7	"7-out2180"	.19422	121	502	623
7	"7-out2181"	.38328	243	391	634
7	"7-out2182"	.34259	185	355	540
7	"7-out2183"	.17808	65	300	365
7	"7-out2184"	.20282	115	452	567
7	"7-out2185"	.18405	127	563	690
7	"7-out2186"	.43200	108	142	250
7	"7-out2187"	.21785	432	1551	1983
7	"7-out2188"	.40185	303	451	754
7	"7-out2189"	.43589	136	176	312
7	"7-out2190"	.18592	140	613	753
7	"7-out2191"	.89393	118	14	132
7	"7-out2192"	.30487	425	969	1394
7	"7-out2193"	.45821	159	188	347
7	"7-out2194"	.16304	30	154	184
7	"7-out2195"	.39481	137	210	347
7	"7-out2196"	.37979	109	178	287
7	"7-out2197"	.27988	192	494	686
7	"7-out2198"	.19934	61	245	306
7	"7-out2199"	.20107	225	894	1119
7	"7-out2200"	.37984	392	640	1032
7	"7-out2201"	.20132	61	242	303
7	"7-out2202"	.95238	140	7	147
7	"7-out2203"	.25675	57	165	222
7	"7-out2204"	.43378	95	124	219
7	"7-out2205"	.97794	133	3	136
7	"7-out2206"	.68644	162	74	236
7	"7-out2207"	.43239	307	403	710
7	"7-out2208"	.53339	615	538	1153
7	"7-out2209"	.33919	791	1541	2332
7	"7-out2210"	.23282	681	2244	2925
7	"7-out2211"	.26624	127	350	477
7	"7-out2212"	.21530	121	441	562
7	"7-out2213"	.13254	191	1250	1441
7	"7-out2214"	.22775	192	651	843
7	"7-out2215"	.29078	164	400	564
7	"7-out2216"	.61746	297	184	481
7	"7-out2217"	.27495	157	414	571
7	"7-out2218"	.14189	63	381	444
7	"7-out2219"	.94514	1120	65	1185
7	"7-out2220"	.18160	79	356	435
7	"7-out2221"	.10416	15	129	144
7	"7-out2222"	.46979	70	79	149
7	"7-out2223"	.28965	42	103	145
7	"7-out2224"	.25568	45	131	176
7	"7-out2225"	.69148	130	58	188
7	"7-out2226"	.19248	128	537	665
7	"7-out2227"	.30618	203	460	663
7	"7-out2228"	.13675	64	404	468
7	"7-out2229"	.19833	191	772	963
7	"7-out2230"	.14735	131	758	889
7	"7-out2231"	.24464	217	670	887
7	"7-out2232"	.18141	246	1110	1356
7	"7-out2233"	.21543	67	244	311
7	"7-out2234"	.27624	150	393	543
7	"7-out2235"	.75989	288	91	379
7	"7-out2236"	.21153	77	287	364
7	"7-out2237"	.16918	56	275	331
7	"7-out2238"	.20454	99	385	484
7	"7-out2239"	.93625	235	16	251
7	"7-out2240"	.58823	40	28	68
7	"7-out2241"	.35393	126	230	356
7	"7-out2242"	.85445	681	116	797
7	"7-out2243"	.81328	649	149	798
7	"7-out2244"	.74973	698	233	931
7	"7-out2245"	.79669	627	160	787
7	"7-out2246"	.07834	34	400	434
7	"7-out2247"	.22637	242	827	1069
7	"7-out2248"	.75987	731	231	962
7	"7-out2249"	.74920	711	238	949
7	"7-out2250"	.16870	138	680	818
7	"7-out2251"	.53884	430	368	798
7	"7-out2252"	.25390	65	191	256
7	"7-out2253"	.21142	74	276	350
7	"7-out2254"	.25797	97	279	376
7	"7-out2255"	.22259	132	461	593
7	"7-out2256"	.12753	44	301	345
7	"7-out2257"	.94293	347	21	368
7	"7-out2258"	.76380	401	124	525
7	"7-out2259"	.29457	190	455	645
7	"7-out2260"	.25048	130	389	519
7	"7-out2261"	.19708	81	330	411
7	"7-out2262"	.49439	661	676	1337
7	"7-out2263"	.26261	380	1067	1447
7	"7-out2264"	.45454	215	258	473
7	"7-out2265"	.24615	96	294	390
7	"7-out2266"	.28193	64	163	227
7	"7-out2267"	.91542	368	34	402
7	"7-out2268"	.94579	698	40	738
7	"7-out2269"	.28677	232	577	809
7	"7-out2270"	.76182	451	141	592
7	"7-out2271"	.33176	212	427	639
7	"7-out2272"	.19554	114	469	583
7	"7-out2273"	.28999	310	759	1069
7	"7-out2274"	.32082	171	362	533
7	"7-out2275"	.18950	112	479	591
7	"7-out2276"	.18257	220	985	1205
7	"7-out2277"	.21311	182	672	854
7	"7-out2278"	.13782	47	294	341
7	"7-out2279"	.32262	653	1371	2024
7	"7-out2280"	.16875	108	532	640
7	"7-out2281"	.41176	147	210	357
7	"7-out2282"	.28417	948	2388	3336
7	"7-out2283"	.19186	335	1411	1746
7	"7-out2284"	.27097	281	756	1037
7	"7-out2285"	.09330	39	379	418
7	"7-out2286"	.55649	394	314	708
7	"7-out2287"	.56043	102	80	182
7	"7-out2288"	.23102	70	233	303
7	"7-out2289"	.22307	29	101	130
7	"7-out2290"	.16883	65	320	385
7	"7-out2291"	.12731	55	377	432
7	"7-out2292"	.19194	143	602	745
7	"7-out2293"	.23896	287	914	1201
7	"7-out2294"	.23382	159	521	680
7	"7-out2295"	.21025	41	154	195
7	"7-out2296"	.92944	685	52	737
7	"7-out2297"	.24687	79	241	320
7	"7-out2298"	.66535	169	85	254
7	"7-out2299"	.36450	191	333	524
7	"7-out2300"	.41626	87	122	209
7	"7-out2301"	.85411	322	55	377
7	"7-out2302"	.19047	52	221	273
7	"7-out2303"	.13333	44	286	330
7	"7-out2304"	.16180	61	316	377
7	"7-out2305"	.55555	105	84	189
7	"7-out2306"	.76682	1322	402	1724
7	"7-out2307"	.05882	23	368	391
7	"7-out2308"	.12000	54	396	450
7	"7-out2309"	.43287	158	207	365
7	"7-out2310"	.82389	655	140	795
7	"7-out2311"	.82849	657	136	793
7	"7-out2312"	.23970	128	406	534
7	"7-out2313"	.85375	683	117	800
7	"7-out2314"	.84190	671	126	797
7	"7-out2315"	.29227	159	385	544
7	"7-out2316"	.78101	724	203	927
7	"7-out2317"	.82603	641	135	776
7	"7-out2318"	.71368	678	272	950
7	"7-out2319"	.74570	695	237	932
7	"7-out2320"	.73819	688	244	932
7	"7-out2321"	.49166	413	427	840
7	"7-out2322"	.74814	704	237	941
7	"7-out2323"	.21311	104	384	488
7	"7-out2324"	.54598	564	469	1033
7	"7-out2325"	.33826	434	849	1283
7	"7-out2326"	.28571	44	110	154
7	"7-out2327"	.92385	182	15	197
7	"7-out2328"	.29177	110	267	377
7	"7-out2329"	.18750	117	507	624
7	"7-out2330"	.26152	471	1330	1801
7	"7-out2331"	.26401	179	499	678
7	"7-out2332"	.11917	46	340	386
7	"7-out2333"	.32815	190	389	579
7	"7-out2334"	.17647	75	350	425
7	"7-out2335"	.18789	90	389	479
7	"7-out2336"	.44705	152	188	340
7	"7-out2337"	.24333	411	1278	1689
7	"7-out2338"	.21782	110	395	505
7	"7-out2339"	.85087	679	119	798
7	"7-out2340"	.41395	178	252	430
7	"7-out2341"	.71684	681	269	950
7	"7-out2342"	.13752	129	809	938
7	"7-out2343"	.73584	780	280	1060
7	"7-out2344"	.75751	706	226	932
7	"7-out2345"	.27067	108	291	399
7	"7-out2346"	.12215	86	618	704
7	"7-out2347"	.72046	683	265	948
7	"7-out2348"	.81909	652	144	796
7	"7-out2349"	.26115	158	447	605
7	"7-out2350"	.83582	336	66	402
7	"7-out2351"	.13128	47	311	358
7	"7-out2352"	.90374	169	18	187
7	"7-out2353"	.59859	170	114	284
7	"7-out2354"	.27155	189	507	696
7	"7-out2355"	.14671	38	221	259
7	"7-out2356"	.22364	140	486	626
7	"7-out2357"	.46753	72	82	154
7	"7-out2358"	.24897	244	736	980
7	"7-out2359"	.30340	98	225	323
7	"7-out2360"	.85820	115	19	134
7	"7-out2361"	.11410	89	691	780
7	"7-out2362"	.90476	171	18	189
7	"7-out2363"	.64361	2075	1149	3224
7	"7-out2364"	.32646	301	621	922
7	"7-out2365"	.18974	37	158	195
7	"7-out2366"	.15041	54	305	359
7	"7-out2367"	.18877	37	159	196
7	"7-out2368"	.29495	187	447	634
7	"7-out2369"	.56500	226	174	400
7	"7-out2370"	.44702	173	214	387
7	"7-out2371"	.64056	679	381	1060
7	"7-out2372"	.19512	48	198	246
7	"7-out2373"	.26557	456	1261	1717
7	"7-out2374"	.91804	1109	99	1208
7	"7-out2375"	.25630	254	737	991
7	"7-out2376"	.91603	120	11	131
7	"7-out2377"	.14696	46	267	313
7	"7-out2378"	.15755	49	262	311
7	"7-out2379"	.70245	229	97	326
7	"7-out2380"	.86000	86	14	100
7	"7-out2381"	.19856	83	335	418
7	"7-out2382"	.22471	60	207	267
7	"7-out2383"	.87113	338	50	388
7	"7-out2384"	.24196	128	401	529
7	"7-out2385"	.20300	297	1166	1463
7	"7-out2386"	.22562	118	405	523
7	"7-out2387"	.19248	338	1418	1756
7	"7-out2388"	.17837	99	456	555
7	"7-out2389"	.69477	412	181	593
7	"7-out2390"	.65227	272	145	417
7	"7-out2391"	.10578	117	989	1106
7	"7-out2392"	.06698	14	195	209
7	"7-out2393"	.16319	94	482	576
7	"7-out2394"	.26654	149	410	559
7	"7-out2395"	.24216	170	532	702
7	"7-out2396"	.17091	67	325	392
7	"7-out2397"	.18351	69	307	376
7	"7-out2398"	.24867	141	426	567
7	"7-out2399"	.20191	253	1000	1253
7	"7-out2400"	.88144	342	46	388
7	"7-out2401"	.45454	120	144	264
7	"7-out2402"	.79508	97	25	122
7	"7-out2403"	.27213	83	222	305
7	"7-out2404"	.26273	98	275	373
7	"7-out2405"	.19302	72	301	373
7	"7-out2406"	.28828	256	632	888
7	"7-out2407"	.19482	113	467	580
7	"7-out2408"	.86553	869	135	1004
7	"7-out2409"	.16403	166	846	1012
7	"7-out2410"	.75702	377	121	498
7	"7-out2411"	.18226	74	332	406
7	"7-out2412"	.16991	61	298	359
7	"7-out2413"	.15384	120	660	780
7	"7-out2414"	.21621	128	464	592
7	"7-out2415"	.12379	64	453	517
7	"7-out2416"	.41691	138	193	331
7	"7-out2417"	.33620	195	385	580
7	"7-out2418"	.35409	199	363	562
7	"7-out2419"	.87867	239	33	272
7	"7-out2420"	.23255	70	231	301
7	"7-out2421"	.49452	542	554	1096
7	"7-out2422"	.28690	585	1454	2039
7	"7-out2423"	.27689	278	726	1004
7	"7-out2424"	.19422	74	307	381
7	"7-out2425"	.24716	327	996	1323
7	"7-out2426"	.88461	391	51	442
7	"7-out2427"	.41304	133	189	322
7	"7-out2428"	.21247	252	934	1186
7	"7-out2429"	.23966	58	184	242
7	"7-out2430"	.17628	171	799	970
7	"7-out2431"	.25000	94	282	376
7	"7-out2432"	.16637	189	947	1136
7	"7-out2433"	.27108	135	363	498
7	"7-out2434"	.93670	148	10	158
7	"7-out2435"	.43367	255	333	588
7	"7-out2436"	.27324	191	508	699
7	"7-out2437"	.92877	326	25	351
7	"7-out2438"	.92307	792	66	858
7	"7-out2439"	.95966	3688	155	3843
7	"7-out2440"	.15024	154	871	1025
7	"7-out2441"	.17418	251	1190	1441
7	"7-out2442"	.26479	170	472	642
7	"7-out2443"	.24395	111	344	455
7	"7-out2444"	.19132	75	317	392
7	"7-out2445"	.34027	147	285	432
7	"7-out2446"	.27844	93	241	334
7	"7-out2447"	.75454	83	27	110
7	"7-out2448"	.61797	55	34	89
7	"7-out2449"	.73913	68	24	92
7	"7-out2450"	.28000	91	234	325
7	"7-out2451"	.25309	184	543	727
7	"7-out2452"	.29518	98	234	332
7	"7-out2453"	.24063	122	385	507
7	"7-out2454"	.16022	29	152	181
7	"7-out2455"	.58863	435	304	739
7	"7-out2456"	.46774	29	33	62
7	"7-out2457"	.94878	352	19	371
7	"7-out2458"	.13006	93	622	715
7	"7-out2459"	.24581	132	405	537
7	"7-out2460"	.24129	97	305	402
7	"7-out2461"	.23152	94	312	406
7	"7-out2462"	.25196	32	95	127
7	"7-out2463"	.17073	42	204	246
7	"7-out2464"	.24505	186	573	759
7	"7-out2465"	.28391	339	855	1194
7	"7-out2466"	.36363	96	168	264
7	"7-out2467"	.16766	28	139	167
7	"7-out2468"	.13793	80	500	580
7	"7-out2469"	.28683	146	363	509
7	"7-out2470"	.44292	97	122	219
7	"7-out2471"	.30185	179	414	593
7	"7-out2472"	.49846	162	163	325
7	"7-out2473"	.14369	49	292	341
7	"7-out2474"	.23046	115	384	499
7	"7-out2475"	.85071	416	73	489
7	"7-out2476"	.76397	369	114	483
7	"7-out2477"	.89799	537	61	598
7	"7-out2478"	.13263	63	412	475
7	"7-out2479"	.63121	546	319	865
7	"7-out2480"	.26404	47	131	178
7	"7-out2481"	.58373	122	87	209
7	"7-out2482"	.24175	176	552	728
7	"7-out2483"	.33633	224	442	666
7	"7-out2484"	.78917	277	74	351
7	"7-out2485"	.11538	45	345	390
7	"7-out2486"	.19647	78	319	397
7	"7-out2487"	.39042	155	242	397
7	"7-out2488"	.18965	22	94	116
7	"7-out2489"	.43043	198	262	460
7	"7-out2490"	.34793	135	253	388
7	"7-out2491"	.27480	180	475	655
7	"7-out2492"	.12624	89	616	705
7	"7-out2493"	.34513	78	148	226
7	"7-out2494"	.29381	57	137	194
7	"7-out2495"	.23512	83	270	353
7	"7-out2496"	.31372	208	455	663
7	"7-out2497"	.41569	143	201	344
7	"7-out2498"	.55891	370	292	662
7	"7-out2499"	.44274	58	73	131
7	"7-out2500"	.60180	133	88	221
7	"7-out2501"	.95238	160	8	168
7	"7-out2502"	.14147	44	267	311
7	"7-out2503"	.13202	47	309	356
7	"7-out2504"	.23684	54	174	228
7	"7-out2505"	.59029	742	515	1257
7	"7-out2506"	.23141	249	827	1076
7	"7-out2507"	.20620	93	358	451
7	"7-out2508"	.27526	128	337	465
7	"7-out2509"	.36830	172	295	467
7	"7-out2510"	.60731	249	161	410
7	"7-out2511"	.91741	411	37	448
7	"7-out2512"	.15527	25	136	161
7	"7-out2513"	.35311	119	218	337
7	"7-out2514"	.12765	36	246	282
7	"7-out2515"	.47619	20	22	42
7	"7-out2516"	.30408	149	341	490
7	"7-out2517"	.17697	266	1237	1503
7	"7-out2518"	.18848	72	310	382
7	"7-out2519"	.24232	142	444	586
7	"7-out2520"	.13690	115	725	840
7	"7-out2521"	.16666	69	345	414
7	"7-out2522"	.32319	170	356	526
7	"7-out2523"	.18181	30	135	165
7	"7-out2524"	.94262	115	7	122
7	"7-out2525"	.25862	90	258	348
7	"7-out2526"	.23333	119	391	510
7	"7-out2527"	.07425	15	187	202
7	"7-out2528"	.11451	71	549	620
7	"7-out2529"	.32601	193	399	592
7	"7-out2530"	.30645	114	258	372
7	"7-out2531"	.40595	259	379	638
7	"7-out2532"	.18885	227	975	1202
7	"7-out2533"	.16243	32	165	197
7	"7-out2534"	.39658	186	283	469
7	"7-out2535"	.90508	534	56	590
7	"7-out2536"	.33042	454	920	1374
7	"7-out2537"	.11235	40	316	356
7	"7-out2538"	.43255	837	1098	1935
7	"7-out2539"	.30810	114	256	370
7	"7-out2540"	.19767	153	621	774
7	"7-out2541"	.20419	107	417	524
7	"7-out2542"	.38762	119	188	307
7	"7-out2543"	.36337	125	219	344
7	"7-out2544"	.28676	78	194	272
7	"7-out2545"	.16834	134	662	796
7	"7-out2546"	.13913	32	198	230
7	"7-out2547"	.11073	33	265	298
7	"7-out2548"	.20610	108	416	524
7	"7-out2549"	.17728	103	478	581
7	"7-out2550"	.10799	77	636	713
7	"7-out2551"	.31580	1435	3109	4544
7	"7-out2552"	.19830	117	473	590
7	"7-out2553"	.88235	90	12	102
7	"7-out2554"	.28648	106	264	370
7	"7-out2555"	.20121	132	524	656
7	"7-out2556"	.31560	184	399	583
7	"7-out2557"	.23023	300	1003	1303
7	"7-out2558"	.36076	320	567	887
7	"7-out2559"	.90666	136	14	150
7	"7-out2560"	.31313	553	1213	1766
7	"7-out2561"	.10183	50	441	491
7	"7-out2562"	.94968	151	8	159
7	"7-out2563"	.22929	72	242	314
7	"7-out2564"	.89539	214	25	239
7	"7-out2565"	.16595	116	583	699
7	"7-out2566"	.12939	125	841	966
7	"7-out2567"	.24681	155	473	628
7	"7-out2568"	.20107	75	298	373
7	"7-out2569"	.33823	161	315	476
7	"7-out2570"	.31818	56	120	176
7	"7-out2571"	.47508	143	158	301
7	"7-out2572"	.17079	138	670	808
7	"7-out2573"	.21699	120	433	553
7	"7-out2574"	.20509	177	686	863
7	"7-out2575"	.11171	82	652	734
7	"7-out2576"	.18343	62	276	338
7	"7-out2577"	.44413	473	592	1065
7	"7-out2578"	.47802	892	974	1866
7	"7-out2579"	.32200	180	379	559
7	"7-out2580"	.18232	130	583	713
7	"7-out2581"	.22960	197	661	858
7	"7-out2582"	.94270	181	11	192
7	"7-out2583"	.21964	123	437	560
7	"7-out2584"	.22802	166	562	728
7	"7-out2585"	.58156	82	59	141
7	"7-out2586"	.45283	168	203	371
7	"7-out2587"	.91452	107	10	117
7	"7-out2588"	.91056	112	11	123
7	"7-out2589"	.90322	112	12	124
7	"7-out2590"	.90163	110	12	122
7	"7-out2591"	.90243	111	12	123
7	"7-out2592"	.27027	60	162	222
7	"7-out2593"	.26368	53	148	201
7	"7-out2594"	.33842	133	260	393
7	"7-out2595"	.46976	101	114	215
7	"7-out2596"	.21593	187	679	866
7	"7-out2597"	.33684	64	126	190
7	"7-out2598"	.21974	69	245	314
7	"7-out2599"	.95454	126	6	132
7	"7-out2600"	.38461	60	96	156
7	"7-out2601"	.17887	149	684	833
7	"7-out2602"	.22195	182	638	820
7	"7-out2603"	.44697	451	558	1009
7	"7-out2604"	.32947	114	232	346
7	"7-out2605"	.42196	146	200	346
7	"7-out2606"	.84726	294	53	347
7	"7-out2607"	.36728	119	205	324
7	"7-out2608"	.20646	332	1276	1608
7	"7-out2609"	.87898	276	38	314
7	"7-out2610"	.26991	227	614	841
7	"7-out2611"	.39840	349	527	876
7	"7-out2612"	.50450	168	165	333
7	"7-out2613"	.21428	276	1012	1288
7	"7-out2614"	.17495	109	514	623
7	"7-out2615"	.94805	2044	112	2156
7	"7-out2616"	.24077	274	864	1138
7	"7-out2617"	.38429	93	149	242
7	"7-out2618"	.18996	106	452	558
7	"7-out2619"	.41794	191	266	457
7	"7-out2620"	.16287	43	221	264
7	"7-out2621"	.17636	94	439	533
7	"7-out2622"	.31270	283	622	905
7	"7-out2623"	.24611	95	291	386
7	"7-out2624"	.38198	212	343	555
7	"7-out2625"	.56000	70	55	125
7	"7-out2626"	.10450	65	557	622
7	"7-out2627"	.68122	577	270	847
7	"7-out2628"	.13312	43	280	323
7	"7-out2629"	.15463	60	328	388
7	"7-out2630"	.78160	136	38	174
7	"7-out2631"	.08196	5	56	61
7	"7-out2632"	.30000	75	175	250
7	"7-out2633"	.26262	156	438	594
7	"7-out2634"	.56120	243	190	433
7	"7-out2635"	.21096	204	763	967
7	"7-out2636"	.43220	102	134	236
7	"7-out2637"	.29906	224	525	749
7	"7-out2638"	.28326	66	167	233
7	"7-out2639"	.17009	149	727	876
7	"7-out2640"	.26406	61	170	231
7	"7-out2641"	.19849	79	319	398
7	"7-out2642"	.90205	396	43	439
7	"7-out2643"	.46907	91	103	194
7	"7-out2644"	.85419	539	92	631
7	"7-out2645"	.23768	111	356	467
7	"7-out2646"	.35459	695	1265	1960
7	"7-out2647"	.24087	231	728	959
7	"7-out2648"	.23589	46	149	195
7	"7-out2649"	.86127	149	24	173
7	"7-out2650"	.48076	100	108	208
7	"7-out2651"	.61589	93	58	151
7	"7-out2652"	.47093	81	91	172
7	"7-out2653"	.25955	197	562	759
7	"7-out2654"	.16352	338	1729	2067
7	"7-out2655"	.26344	98	274	372
7	"7-out2656"	.21315	94	347	441
7	"7-out2657"	.57758	469	343	812
7	"7-out2658"	.18032	88	400	488
7	"7-out2659"	.23364	75	246	321
7	"7-out2660"	.29433	156	374	530
7	"7-out2661"	.28738	221	548	769
7	"7-out2662"	.28980	182	446	628
7	"7-out2663"	.23307	148	487	635
7	"7-out2664"	.16580	64	322	386
7	"7-out2665"	.12460	39	274	313
7	"7-out2666"	.59482	276	188	464
7	"7-out2667"	.31028	193	429	622
7	"7-out2668"	.21591	993	3606	4599
7	"7-out2669"	.17838	307	1414	1721
7	"7-out2670"	.88709	110	14	124
7	"7-out2671"	.86086	99	16	115
7	"7-out2672"	.91964	103	9	112
7	"7-out2673"	.20920	50	189	239
7	"7-out2674"	.86178	106	17	123
7	"7-out2675"	.21722	58	209	267
7	"7-out2676"	.22580	98	336	434
7	"7-out2677"	.12400	62	438	500
7	"7-out2678"	.33780	126	247	373
7	"7-out2679"	.67535	337	162	499
7	"7-out2680"	.88628	265	34	299
7	"7-out2681"	.80000	520	130	650
7	"7-out2682"	.31751	194	417	611
7	"7-out2683"	.29743	232	548	780
7	"7-out2684"	.13872	24	149	173
7	"7-out2685"	.91624	722	66	788
7	"7-out2686"	.22258	138	482	620
7	"7-out2687"	.19000	114	486	600
7	"7-out2688"	.30014	205	478	683
7	"7-out2689"	.93081	148	11	159
7	"7-out2690"	.22053	174	615	789
7	"7-out2691"	.10724	37	308	345
7	"7-out2692"	.29150	223	542	765
7	"7-out2693"	.34501	187	355	542
7	"7-out2694"	.13821	17	106	123
7	"7-out2695"	.19452	128	530	658
7	"7-out2696"	.91304	105	10	115
7	"7-out2697"	.91304	105	10	115
7	"7-out2698"	.14111	58	353	411
7	"7-out2699"	.21712	71	256	327
7	"7-out2700"	.21093	220	823	1043
7	"7-out2701"	.22781	249	844	1093
7	"7-out2702"	.19907	346	1392	1738
7	"7-out2703"	.92467	982	80	1062
7	"7-out2704"	.93080	1130	84	1214
7	"7-out2705"	.17142	54	261	315
7	"7-out2706"	.17503	415	1956	2371
7	"7-out2707"	.79126	163	43	206
7	"7-out2708"	.33156	250	504	754
7	"7-out2709"	.17391	112	532	644
7	"7-out2710"	.22513	86	296	382
7	"7-out2711"	.19211	78	328	406
7	"7-out2712"	.11876	50	371	421
7	"7-out2713"	.91891	544	48	592
7	"7-out2714"	.31560	89	193	282
7	"7-out2715"	.16082	101	527	628
7	"7-out2716"	.91489	387	36	423
7	"7-out2717"	.56329	89	69	158
7	"7-out2718"	.12975	75	503	578
7	"7-out2719"	.39247	73	113	186
7	"7-out2720"	.80620	104	25	129
7	"7-out2721"	.85915	61	10	71
7	"7-out2722"	.15062	133	750	883
7	"7-out2723"	.21093	27	101	128
7	"7-out2724"	.33231	109	219	328
7	"7-out2725"	.27631	21	55	76
7	"7-out2726"	.31092	37	82	119
7	"7-out2727"	.27293	360	959	1319
7	"7-out2728"	.28895	293	721	1014
7	"7-out2729"	.75200	94	31	125
7	"7-out2730"	.14803	49	282	331
7	"7-out2731"	.16037	34	178	212
7	"7-out2732"	.16666	31	155	186
7	"7-out2733"	.16447	25	127	152
7	"7-out2734"	.47368	72	80	152
7	"7-out2735"	.20328	297	1164	1461
7	"7-out2736"	.21381	161	592	753
7	"7-out2737"	.43133	223	294	517
7	"7-out2738"	.24313	124	386	510
7	"7-out2739"	.17456	81	383	464
7	"7-out2740"	.09602	29	273	302
7	"7-out2741"	.22372	132	458	590
7	"7-out2742"	.21934	195	694	889
7	"7-out2743"	.40740	110	160	270
7	"7-out2744"	.28745	165	409	574
7	"7-out2745"	.17321	194	926	1120
7	"7-out2746"	.11378	85	662	747
7	"7-out2747"	.71509	630	251	881
7	"7-out2748"	.90502	162	17	179
7	"7-out2749"	.14522	35	206	241
7	"7-out2750"	.17391	52	247	299
7	"7-out2751"	.28434	416	1047	1463
7	"7-out2752"	.18000	90	410	500
7	"7-out2753"	.22109	304	1071	1375
7	"7-out2754"	.23270	185	610	795
7	"7-out2755"	.25323	235	693	928
7	"7-out2756"	.25871	193	553	746
7	"7-out2757"	.80539	418	101	519
7	"7-out2758"	.22839	333	1125	1458
7	"7-out2759"	.22849	162	547	709
7	"7-out2760"	.23684	36	116	152
7	"7-out2761"	.15479	63	344	407
7	"7-out2762"	.86725	98	15	113
7	"7-out2763"	.28982	151	370	521
7	"7-out2764"	.21951	45	160	205
7	"7-out2765"	.17049	52	253	305
7	"7-out2766"	.21590	190	690	880
7	"7-out2767"	.24629	83	254	337
7	"7-out2768"	.11545	65	498	563
7	"7-out2769"	.26538	289	800	1089
7	"7-out2770"	.34343	34	65	99
7	"7-out2771"	.45238	38	46	84
7	"7-out2772"	.77281	381	112	493
7	"7-out2773"	.91364	529	50	579
7	"7-out2774"	.20986	183	689	872
7	"7-out2775"	.41860	72	100	172
7	"7-out2776"	.53594	82	71	153
7	"7-out2777"	.91124	154	15	169
7	"7-out2778"	.83962	89	17	106
7	"7-out2779"	.30683	386	872	1258
7	"7-out2780"	.53521	114	99	213
7	"7-out2781"	.19327	46	192	238
7	"7-out2782"	.16320	212	1087	1299
7	"7-out2783"	.37423	183	306	489
7	"7-out2784"	.25466	232	679	911
7	"7-out2785"	.17460	55	260	315
7	"7-out2786"	.13521	96	614	710
7	"7-out2787"	.15817	59	314	373
7	"7-out2788"	.30279	119	274	393
7	"7-out2789"	.89761	263	30	293
7	"7-out2790"	.12500	57	399	456
7	"7-out2791"	.18731	65	282	347
7	"7-out2792"	.26829	33	90	123
7	"7-out2793"	.49565	57	58	115
7	"7-out2794"	.34200	171	329	500
7	"7-out2795"	.66838	1685	836	2521
7	"7-out2796"	.52525	156	141	297
7	"7-out2797"	.18413	181	802	983
7	"7-out2798"	.31578	294	637	931
7	"7-out2799"	.23308	31	102	133
7	"7-out2800"	.36111	52	92	144
7	"7-out2801"	.14054	78	477	555
7	"7-out2802"	.12380	13	92	105
7	"7-out2803"	.28294	73	185	258
7	"7-out2804"	.15343	29	160	189
7	"7-out2805"	.22413	65	225	290
7	"7-out2806"	.40952	129	186	315
7	"7-out2807"	.30373	65	149	214
7	"7-out2808"	.92592	50	4	54
7	"7-out2809"	.25757	102	294	396
7	"7-out2810"	.26482	134	372	506
7	"7-out2811"	.28051	154	395	549
7	"7-out2812"	.18493	27	119	146
7	"7-out2813"	.28181	186	474	660
7	"7-out2814"	.30148	284	658	942
7	"7-out2815"	.21600	162	588	750
7	"7-out2816"	.19094	97	411	508
7	"7-out2817"	.40296	272	403	675
7	"7-out2818"	.36363	96	168	264
7	"7-out2819"	.24358	19	59	78
7	"7-out2820"	.17002	59	288	347
7	"7-out2821"	.40980	234	337	571
7	"7-out2822"	.18260	294	1316	1610
7	"7-out2823"	.56652	132	101	233
7	"7-out2824"	.32432	108	225	333
7	"7-out2825"	.91250	219	21	240
7	"7-out2826"	.78481	124	34	158
7	"7-out2827"	.39041	114	178	292
7	"7-out2828"	.30845	124	278	402
7	"7-out2829"	.24468	115	355	470
7	"7-out2830"	.22093	323	1139	1462
7	"7-out2831"	.80048	329	82	411
7	"7-out2832"	.18219	176	790	966
7	"7-out2833"	.26519	48	133	181
7	"7-out2834"	.23297	195	642	837
7	"7-out2835"	.24526	324	997	1321
7	"7-out2836"	.27826	96	249	345
7	"7-out2837"	.45584	191	228	419
7	"7-out2838"	.17221	269	1293	1562
7	"7-out2839"	.64062	82	46	128
7	"7-out2840"	.23088	151	503	654
7	"7-out2841"	.63840	655	371	1026
7	"7-out2842"	.13752	70	439	509
7	"7-out2843"	.18349	209	930	1139
7	"7-out2844"	.29139	44	107	151
7	"7-out2845"	.27570	59	155	214
7	"7-out2846"	.65635	191	100	291
7	"7-out2847"	.31073	55	122	177
7	"7-out2848"	.22589	164	562	726
7	"7-out2849"	.86597	84	13	97
7	"7-out2850"	.33156	125	252	377
7	"7-out2851"	.30318	419	963	1382
7	"7-out2852"	.13761	45	282	327
7	"7-out2853"	.42960	119	158	277
7	"7-out2854"	.12019	25	183	208
7	"7-out2855"	.57349	238	177	415
7	"7-out2856"	.26482	134	372	506
7	"7-out2857"	.30778	257	578	835
7	"7-out2858"	.27472	100	264	364
7	"7-out2859"	.23390	109	357	466
7	"7-out2860"	.41860	126	175	301
7	"7-out2861"	.27318	766	2038	2804
7	"7-out2862"	.33146	59	119	178
7	"7-out2863"	.25654	294	852	1146
7	"7-out2864"	.12343	59	419	478
7	"7-out2865"	.14901	121	691	812
7	"7-out2866"	.85987	405	66	471
7	"7-out2867"	.32535	367	761	1128
7	"7-out2868"	.92070	209	18	227
7	"7-out2869"	.92327	361	30	391
7	"7-out2870"	.91803	336	30	366
7	"7-out2871"	.07303	26	330	356
7	"7-out2872"	.25478	346	1012	1358
7	"7-out2873"	.14182	59	357	416
7	"7-out2874"	.14792	25	144	169
7	"7-out2875"	.18518	100	440	540
7	"7-out2876"	.18558	121	531	652
7	"7-out2877"	.15476	39	213	252
7	"7-out2878"	.18867	70	301	371
7	"7-out2879"	.91970	126	11	137
7	"7-out2880"	.10884	96	786	882
7	"7-out2881"	.22107	193	680	873
7	"7-out2882"	.13947	53	327	380
7	"7-out2883"	.48837	84	88	172
7	"7-out2884"	.57818	159	116	275
7	"7-out2885"	.33050	234	474	708
7	"7-out2886"	.58191	682	490	1172
7	"7-out2887"	.26984	153	414	567
7	"7-out2888"	.26206	152	428	580
7	"7-out2889"	.31893	517	1104	1621
7	"7-out2890"	.19891	184	741	925
7	"7-out2891"	.14939	62	353	415
7	"7-out2892"	.19421	188	780	968
7	"7-out2893"	.91578	87	8	95
7	"7-out2894"	.18990	523	2231	2754
7	"7-out2895"	.12368	47	333	380
7	"7-out2896"	.87417	264	38	302
7	"7-out2897"	.22202	244	855	1099
7	"7-out2898"	.16630	77	386	463
7	"7-out2899"	.57073	355	267	622
7	"7-out2900"	.90076	236	26	262
7	"7-out2901"	.65124	366	196	562
7	"7-out2902"	.29695	117	277	394
7	"7-out2903"	.19806	123	498	621
7	"7-out2904"	.29590	224	533	757
7	"7-out2905"	.34009	218	423	641
7	"7-out2906"	.35379	196	358	554
7	"7-out2907"	.23785	142	455	597
7	"7-out2908"	.18995	155	661	816
7	"7-out2909"	.55140	177	144	321
7	"7-out2910"	.80708	205	49	254
7	"7-out2911"	.35408	381	695	1076
7	"7-out2912"	.15015	47	266	313
7	"7-out2913"	.27359	258	685	943
7	"7-out2914"	.27601	61	160	221
7	"7-out2915"	.36454	183	319	502
7	"7-out2916"	.15789	45	240	285
7	"7-out2917"	.91984	241	21	262
7	"7-out2918"	.38793	225	355	580
7	"7-out2919"	.20700	130	498	628
7	"7-out2920"	.29411	50	120	170
7	"7-out2921"	.24755	379	1152	1531
7	"7-out2922"	.50655	232	226	458
7	"7-out2923"	.37835	451	741	1192
7	"7-out2924"	.23214	117	387	504
7	"7-out2925"	.19141	58	245	303
7	"7-out2926"	.55196	1025	832	1857
7	"7-out2927"	.29268	24	58	82
7	"7-out2928"	.27300	264	703	967
7	"7-out2929"	.43253	109	143	252
7	"7-out2930"	.19542	94	387	481
7	"7-out2931"	.42519	54	73	127
7	"7-out2932"	.62145	197	120	317
7	"7-out2933"	.32587	102	211	313
7	"7-out2934"	.78778	245	66	311
7	"7-out2935"	.84337	280	52	332
7	"7-out2936"	.31641	106	229	335
7	"7-out2937"	.23492	74	241	315
7	"7-out2938"	.35763	206	370	576
7	"7-out2939"	.28881	93	229	322
7	"7-out2940"	.26018	83	236	319
7	"7-out2941"	.22756	71	241	312
7	"7-out2942"	.55010	269	220	489
7	"7-out2943"	.72862	196	73	269
7	"7-out2944"	.38064	118	192	310
7	"7-out2945"	.66129	205	105	310
7	"7-out2946"	.55379	175	141	316
7	"7-out2947"	.24695	81	247	328
7	"7-out2948"	.30746	103	232	335
7	"7-out2949"	.54687	175	145	320
7	"7-out2950"	.75000	234	78	312
7	"7-out2951"	.75625	242	78	320
7	"7-out2952"	.68454	217	100	317
7	"7-out2953"	.79062	253	67	320
7	"7-out2954"	.83333	265	53	318
7	"7-out2955"	.78018	252	71	323
7	"7-out2956"	.77993	241	68	309
7	"7-out2957"	.33225	103	207	310
7	"7-out2958"	.29153	93	226	319
7	"7-out2959"	.28947	99	243	342
7	"7-out2960"	.22611	71	243	314
7	"7-out2961"	.24767	80	243	323
7	"7-out2962"	.17737	58	269	327
7	"7-out2963"	.27044	86	232	318
7	"7-out2964"	.79220	244	64	308
7	"7-out2965"	.49230	160	165	325
7	"7-out2966"	.54517	175	146	321
7	"7-out2967"	.31135	85	188	273
7	"7-out2968"	.19332	139	580	719
7	"7-out2969"	.94780	1380	76	1456
7	"7-out2970"	.25096	195	582	777
7	"7-out2971"	.19882	135	544	679
7	"7-out2972"	.14396	111	660	771
7	"7-out2973"	.15308	124	686	810
7	"7-out2974"	.52910	100	89	189
7	"7-out2975"	.20980	77	290	367
7	"7-out2976"	.28155	145	370	515
7	"7-out2977"	.18511	373	1642	2015
7	"7-out2978"	.29481	745	1782	2527
7	"7-out2979"	.23826	66	211	277
7	"7-out2980"	.18773	98	424	522
7	"7-out2981"	.66460	537	271	808
7	"7-out2982"	.20381	331	1293	1624
7	"7-out2983"	.10355	35	303	338
7	"7-out2984"	.88495	100	13	113
7	"7-out2985"	.35157	167	308	475
7	"7-out2986"	.27653	185	484	669
7	"7-out2987"	.24933	377	1135	1512
7	"7-out2988"	.89516	111	13	124
7	"7-out2989"	.34765	89	167	256
7	"7-out2990"	.39157	251	390	641
7	"7-out2991"	.23750	247	793	1040
7	"7-out2992"	.26357	165	461	626
7	"7-out2993"	.33838	2500	4888	7388
7	"7-out2994"	.14646	58	338	396
7	"7-out2995"	.52094	199	183	382
7	"7-out2996"	.30334	236	542	778
7	"7-out2997"	.33532	112	222	334
7	"7-out2998"	.22181	183	642	825
7	"7-out2999"	.20392	135	527	662
7	"7-out3000"	.82253	876	189	1065
7	"7-out3001"	.31171	173	382	555
7	"7-out3002"	.21820	151	541	692
7	"7-out3003"	.16269	116	597	713
7	"7-out3004"	.15948	137	722	859
7	"7-out3005"	.13609	46	292	338
7	"7-out3006"	.23732	117	376	493
7	"7-out3007"	.13966	100	616	716
7	"7-out3008"	.95320	1385	68	1453
7	"7-out3009"	.16498	768	3887	4655
7	"7-out3010"	.16006	93	488	581
7	"7-out3011"	.89230	174	21	195
7	"7-out3012"	.27012	208	562	770
7	"7-out3013"	.23569	449	1456	1905
7	"7-out3014"	.13205	213	1400	1613
7	"7-out3015"	.27662	239	625	864
7	"7-out3016"	.15000	54	306	360
7	"7-out3017"	.13138	18	119	137
7	"7-out3018"	.24800	31	94	125
7	"7-out3019"	.94949	94	5	99
7	"7-out3020"	.92622	113	9	122
7	"7-out3021"	.88333	106	14	120
7	"7-out3022"	.23018	122	408	530
7	"7-out3023"	.26361	1002	2799	3801
7	"7-out3024"	.95046	307	16	323
7	"7-out3025"	.51209	127	121	248
7	"7-out3026"	.85138	1289	225	1514
7	"7-out3027"	.25821	220	632	852
7	"7-out3028"	.26181	72	203	275
7	"7-out3029"	.91477	161	15	176
7	"7-out3030"	.23042	153	511	664
7	"7-out3031"	.27066	275	741	1016
7	"7-out3032"	.39162	580	901	1481
7	"7-out3033"	.14617	63	368	431
7	"7-out3034"	.11121	118	943	1061
7	"7-out3035"	.94396	219	13	232
7	"7-out3036"	.88829	167	21	188
7	"7-out3037"	.92459	282	23	305
7	"7-out3038"	.92307	360	30	390
7	"7-out3039"	.59075	345	239	584
7	"7-out3040"	.19607	20	82	102
7	"7-out3041"	.33684	64	126	190
7	"7-out3042"	.82051	128	28	156
7	"7-out3043"	.23483	573	1867	2440
7	"7-out3044"	.93236	703	51	754
7	"7-out3045"	.28681	261	649	910
7	"7-out3046"	.59090	286	198	484
7	"7-out3047"	.25888	102	292	394
7	"7-out3048"	.19633	150	614	764
7	"7-out3049"	.67241	39	19	58
7	"7-out3050"	.53631	96	83	179
7	"7-out3051"	.19417	40	166	206
7	"7-out3052"	.77968	683	193	876
7	"7-out3053"	.92483	1415	115	1530
7	"7-out3054"	.17031	109	531	640
7	"7-out3055"	.17307	342	1634	1976
7	"7-out3056"	.24947	119	358	477
7	"7-out3057"	.21348	95	350	445
7	"7-out3058"	.22328	257	894	1151
7	"7-out3059"	.16914	193	948	1141
7	"7-out3060"	.37982	177	289	466
7	"7-out3061"	.38610	739	1175	1914
7	"7-out3062"	.16302	179	919	1098
7	"7-out3063"	.20717	52	199	251
7	"7-out3064"	.21904	115	410	525
7	"7-out3065"	.63888	552	312	864
7	"7-out3066"	.62180	365	222	587
7	"7-out3067"	.64902	233	126	359
7	"7-out3068"	.15306	15	83	98
7	"7-out3069"	.26645	684	1883	2567
7	"7-out3070"	.34000	204	396	600
7	"7-out3071"	.19749	426	1731	2157
7	"7-out3072"	.21296	207	765	972
7	"7-out3073"	.74883	161	54	215
7	"7-out3074"	.34170	272	524	796
7	"7-out3075"	.23826	66	211	277
7	"7-out3076"	.69506	310	136	446
7	"7-out3077"	.28409	50	126	176
7	"7-out3078"	.26935	167	453	620
7	"7-out3079"	.23316	135	444	579
7	"7-out3080"	.27692	126	329	455
7	"7-out3081"	.23938	124	394	518
7	"7-out3082"	.56849	83	63	146
7	"7-out3083"	.42365	197	268	465
7	"7-out3084"	.22736	688	2338	3026
7	"7-out3085"	.22705	47	160	207
7	"7-out3086"	.17419	81	384	465
7	"7-out3087"	.88775	87	11	98
7	"7-out3088"	.94989	436	23	459
7	"7-out3089"	.23717	37	119	156
7	"7-out3090"	.42796	401	536	937
7	"7-out3091"	.10227	27	237	264
7	"7-out3092"	.21171	188	700	888
7	"7-out3093"	.10975	27	219	246
7	"7-out3094"	.31089	97	215	312
7	"7-out3095"	.97192	277	8	285
7	"7-out3096"	.18696	66	287	353
7	"7-out3097"	.45280	758	916	1674
7	"7-out3098"	.24731	392	1193	1585
7	"7-out3099"	.65705	866	452	1318
7	"7-out3100"	.89847	646	73	719
7	"7-out3101"	.17466	251	1186	1437
7	"7-out3102"	.41450	623	880	1503
7	"7-out3103"	.71966	172	67	239
7	"7-out3104"	.30397	283	648	931
7	"7-out3105"	.24557	222	682	904
7	"7-out3106"	.84563	378	69	447
7	"7-out3107"	.26500	53	147	200
7	"7-out3108"	.14285	100	600	700
7	"7-out3109"	.20300	405	1590	1995
7	"7-out3110"	.27016	67	181	248
7	"7-out3111"	.30891	253	566	819
7	"7-out3112"	.14732	33	191	224
7	"7-out3113"	.17309	184	879	1063
7	"7-out3114"	.15730	28	150	178
7	"7-out3115"	.27547	219	576	795
7	"7-out3116"	.32186	159	335	494
7	"7-out3117"	.30810	228	512	740
7	"7-out3118"	.62500	155	93	248
7	"7-out3119"	.84581	192	35	227
7	"7-out3120"	.18357	38	169	207
7	"7-out3121"	.94149	1046	65	1111
7	"7-out3122"	.19689	114	465	579
7	"7-out3123"	.24946	235	707	942
7	"7-out3124"	.23778	443	1420	1863
7	"7-out3125"	.36882	239	409	648
7	"7-out3126"	.24734	186	566	752
7	"7-out3127"	.76699	79	24	103
7	"7-out3128"	.48974	215	224	439
7	"7-out3129"	.23699	41	132	173
7	"7-out3130"	.17845	169	778	947
7	"7-out3131"	.31309	98	215	313
7	"7-out3132"	.35515	689	1251	1940
7	"7-out3133"	.25145	216	643	859
7	"7-out3134"	.24799	278	843	1121
7	"7-out3135"	.92405	146	12	158
7	"7-out3136"	.34254	124	238	362
7	"7-out3137"	.26905	233	633	866
7	"7-out3138"	.13092	69	458	527
7	"7-out3139"	.23607	89	288	377
7	"7-out3140"	.92520	804	65	869
7	"7-out3141"	.16835	133	657	790
7	"7-out3142"	.20856	297	1127	1424
7	"7-out3143"	.19520	220	907	1127
7	"7-out3144"	.22685	468	1595	2063
7	"7-out3145"	.25038	162	485	647
7	"7-out3146"	.88888	104	13	117
7	"7-out3147"	.88888	104	13	117
7	"7-out3148"	.34903	378	705	1083
7	"7-out3149"	.23595	126	408	534
7	"7-out3150"	.23319	163	536	699
7	"7-out3151"	.22191	160	561	721
7	"7-out3152"	.17012	123	600	723
7	"7-out3153"	.21910	211	752	963
7	"7-out3154"	.11801	19	142	161
7	"7-out3155"	.68131	62	29	91
7	"7-out3156"	.94957	113	6	119
7	"7-out3157"	.92307	108	9	117
7	"7-out3158"	.23972	35	111	146
7	"7-out3159"	.43406	158	206	364
7	"7-out3160"	.92963	2629	199	2828
7	"7-out3161"	.81862	167	37	204
7	"7-out3162"	.08437	88	955	1043
7	"7-out3163"	.32144	712	1503	2215
7	"7-out3164"	.22222	42	147	189
7	"7-out3165"	.68937	506	228	734
7	"7-out3166"	.30395	538	1232	1770
7	"7-out3167"	.12823	129	877	1006
7	"7-out3168"	.17092	174	844	1018
7	"7-out3169"	.12189	113	814	927
7	"7-out3170"	.65708	320	167	487
7	"7-out3171"	.83255	179	36	215
7	"7-out3172"	.51357	473	448	921
7	"7-out3173"	.36011	121	215	336
7	"7-out3174"	.33484	148	294	442
7	"7-out3175"	.25459	263	770	1033
7	"7-out3176"	.19729	146	594	740
7	"7-out3177"	.23138	230	764	994
7	"7-out3178"	.18166	218	982	1200
7	"7-out3179"	.23699	41	132	173
7	"7-out3180"	.92786	283	22	305
7	"7-out3181"	.94845	276	15	291
7	"7-out3182"	.73350	578	210	788
7	"7-out3183"	.96216	5010	197	5207
7	"7-out3184"	.32026	49	104	153
7	"7-out3185"	.25566	1196	3482	4678
7	"7-out3186"	.18976	178	760	938
7	"7-out3187"	.37918	736	1205	1941
7	"7-out3188"	.26584	344	950	1294
7	"7-out3189"	.29545	39	93	132
7	"7-out3190"	.62489	713	428	1141
7	"7-out3191"	.15698	200	1074	1274
7	"7-out3192"	.21085	272	1018	1290
7	"7-out3193"	.35265	292	536	828
7	"7-out3194"	.83333	70	14	84
7	"7-out3195"	.27898	486	1256	1742
7	"7-out3196"	.10949	113	919	1032
7	"7-out3197"	.27426	65	172	237
7	"7-out3198"	.18777	43	186	229
7	"7-out3199"	.30245	271	625	896
7	"7-out3200"	.20554	200	773	973
7	"7-out3201"	.93398	382	27	409
7	"7-out3202"	.26744	92	252	344
7	"7-out3203"	.91938	901	79	980
7	"7-out3204"	.16030	168	880	1048
7	"7-out3205"	.57876	169	123	292
7	"7-out3206"	.12318	17	121	138
7	"7-out3207"	.27631	126	330	456
7	"7-out3208"	.95723	291	13	304
7	"7-out3209"	.24134	453	1424	1877
7	"7-out3210"	.28955	97	238	335
7	"7-out3211"	.34972	64	119	183
7	"7-out3212"	.23340	116	381	497
7	"7-out3213"	.40506	32	47	79
7	"7-out3214"	.92346	181	15	196
7	"7-out3215"	.53968	170	145	315
7	"7-out3216"	.25777	174	501	675
7	"7-out3217"	.50102	244	243	487
7	"7-out3218"	.27524	139	366	505
7	"7-out3219"	.64818	339	184	523
7	"7-out3220"	.40566	129	189	318
7	"7-out3221"	.66887	101	50	151
7	"7-out3222"	.60377	192	126	318
7	"7-out3223"	.18241	56	251	307
7	"7-out3224"	.25324	78	230	308
7	"7-out3225"	.31843	57	122	179
7	"7-out3226"	.81028	252	59	311
7	"7-out3227"	.23255	50	165	215
7	"7-out3228"	.67716	86	41	127
7	"7-out3229"	.91139	144	14	158
7	"7-out3230"	.53225	165	145	310
7	"7-out3231"	.21981	71	252	323
7	"7-out3232"	.50316	159	157	316
7	"7-out3233"	.56097	184	144	328
7	"7-out3234"	.82958	258	53	311
7	"7-out3235"	.82200	254	55	309
7	"7-out3236"	.30128	94	218	312
7	"7-out3237"	.71475	218	87	305
7	"7-out3238"	.76923	240	72	312
7	"7-out3239"	.82747	259	54	313
7	"7-out3240"	.80511	252	61	313
7	"7-out3241"	.33333	104	208	312
7	"7-out3242"	.71153	222	90	312
7	"7-out3243"	.18927	60	257	317
7	"7-out3244"	.25796	81	233	314
7	"7-out3245"	.22115	69	243	312
7	"7-out3246"	.27300	89	237	326
7	"7-out3247"	.31578	96	208	304
7	"7-out3248"	.27215	86	230	316
7	"7-out3249"	.32371	101	211	312
7	"7-out3250"	.74311	243	84	327
7	"7-out3251"	.47923	150	163	313
7	"7-out3252"	.42500	136	184	320
7	"7-out3253"	.78365	163	45	208
7	"7-out3254"	.16288	79	406	485
7	"7-out3255"	.24363	67	208	275
7	"7-out3256"	.16730	174	866	1040
7	"7-out3257"	.22501	556	1915	2471
7	"7-out3258"	.21752	494	1777	2271
7	"7-out3259"	.38858	143	225	368
7	"7-out3260"	.34968	499	928	1427
7	"7-out3261"	.22822	76	257	333
7	"7-out3262"	.24438	294	909	1203
7	"7-out3263"	.46101	136	159	295
7	"7-out3264"	.15896	148	783	931
7	"7-out3265"	.21681	343	1239	1582
7	"7-out3266"	.08860	7	72	79
7	"7-out3267"	.79749	445	113	558
7	"7-out3268"	.19047	260	1105	1365
7	"7-out3269"	.13505	47	301	348
7	"7-out3270"	.89570	146	17	163
7	"7-out3271"	.21839	19	68	87
7	"7-out3272"	.70731	116	48	164
7	"7-out3273"	.43213	156	205	361
7	"7-out3274"	.11046	19	153	172
7	"7-out3275"	.20454	72	280	352
7	"7-out3276"	.24172	168	527	695
7	"7-out3277"	.20886	66	250	316
7	"7-out3278"	.93564	189	13	202
7	"7-out3279"	.28874	136	335	471
7	"7-out3280"	.13659	53	335	388
7	"7-out3281"	.21122	79	295	374
7	"7-out3282"	.30409	104	238	342
7	"7-out3283"	.33615	119	235	354
7	"7-out3284"	.06970	26	347	373
7	"7-out3285"	.27404	396	1049	1445
7	"7-out3286"	.30027	221	515	736
7	"7-out3287"	.29519	209	499	708
7	"7-out3288"	.28532	210	526	736
7	"7-out3289"	.20912	55	208	263
7	"7-out3290"	.93081	444	33	477
7	"7-out3291"	.31919	271	578	849
7	"7-out3292"	.95400	726	35	761
7	"7-out3293"	.33078	130	263	393
7	"7-out3294"	.19264	131	549	680
7	"7-out3295"	.15007	95	538	633
7	"7-out3296"	.18646	135	589	724
7	"7-out3297"	.22115	161	567	728
7	"7-out3298"	.16891	25	123	148
7	"7-out3299"	.96446	380	14	394
7	"7-out3300"	.12318	17	121	138
7	"7-out3301"	.33928	133	259	392
7	"7-out3302"	.67511	426	205	631
7	"7-out3303"	.35559	229	415	644
7	"7-out3304"	.32198	123	259	382
7	"7-out3305"	.28301	210	532	742
7	"7-out3306"	.27450	182	481	663
7	"7-out3307"	.15637	76	410	486
7	"7-out3308"	.22289	148	516	664
7	"7-out3309"	.27364	81	215	296
7	"7-out3310"	.28225	70	178	248
7	"7-out3311"	.91498	635	59	694
7	"7-out3312"	.88888	472	59	531
7	"7-out3313"	.31531	35	76	111
7	"7-out3314"	.13010	51	341	392
7	"7-out3315"	.22675	100	341	441
7	"7-out3316"	.49315	72	74	146
7	"7-out3317"	.95495	106	5	111
7	"7-out3318"	.21238	24	89	113
7	"7-out3319"	.50526	48	47	95
7	"7-out3320"	.88757	300	38	338
7	"7-out3321"	.17886	22	101	123
7	"7-out3322"	.90605	434	45	479
7	"7-out3323"	.15779	86	459	545
7	"7-out3324"	.41221	216	308	524
7	"7-out3325"	.60913	360	231	591
7	"7-out3326"	.85365	140	24	164
7	"7-out3327"	.85365	140	24	164
7	"7-out3328"	.87195	143	21	164
7	"7-out3329"	.24620	292	894	1186
7	"7-out3330"	.33116	458	925	1383
7	"7-out3331"	.25593	97	282	379
7	"7-out3332"	.23772	92	295	387
7	"7-out3333"	.28428	170	428	598
7	"7-out3334"	.17426	107	507	614
7	"7-out3335"	.70500	141	59	200
7	"7-out3336"	.26818	188	513	701
7	"7-out3337"	.22981	74	248	322
7	"7-out3338"	.41333	155	220	375
7	"7-out3339"	.57199	580	434	1014
7	"7-out3340"	.42441	146	198	344
7	"7-out3341"	.27455	109	288	397
7	"7-out3342"	.17758	122	565	687
7	"7-out3343"	.15860	59	313	372
7	"7-out3344"	.16935	63	309	372
7	"7-out3345"	.94849	221	12	233
7	"7-out3346"	.30643	281	636	917
7	"7-out3347"	.24659	308	941	1249
7	"7-out3348"	.13461	63	405	468
7	"7-out3349"	.38181	84	136	220
7	"7-out3350"	.94117	48	3	51
7	"7-out3351"	.20000	95	380	475
7	"7-out3352"	.78355	829	229	1058
7	"7-out3353"	.37205	253	427	680
7	"7-out3354"	.19860	57	230	287
7	"7-out3355"	.90625	290	30	320
7	"7-out3356"	.91803	56	5	61
7	"7-out3357"	.09523	12	114	126
7	"7-out3358"	.19119	252	1066	1318
7	"7-out3359"	.45468	291	349	640
7	"7-out3360"	.29302	206	497	703
7	"7-out3361"	.86206	50	8	58
7	"7-out3362"	.27926	198	511	709
7	"7-out3363"	.96022	169	7	176
7	"7-out3364"	.23155	91	302	393
7	"7-out3365"	.17796	21	97	118
7	"7-out3366"	.34131	114	220	334
7	"7-out3367"	.85772	211	35	246
7	"7-out3368"	.55084	65	53	118
7	"7-out3369"	.18787	31	134	165
7	"7-out3370"	.36974	88	150	238
7	"7-out3371"	.13471	26	167	193
7	"7-out3372"	.34782	72	135	207
7	"7-out3373"	.20606	34	131	165
7	"7-out3374"	.21388	228	838	1066
7	"7-out3375"	.92015	242	21	263
7	"7-out3376"	.89719	96	11	107
7	"7-out3377"	.90532	153	16	169
7	"7-out3378"	.37634	35	58	93
7	"7-out3379"	.46534	47	54	101
7	"7-out3380"	.28937	316	776	1092
7	"7-out3381"	.60117	205	136	341
7	"7-out3382"	.23806	663	2122	2785
7	"7-out3383"	.38709	48	76	124
7	"7-out3384"	.95142	568	29	597
7	"7-out3385"	.31187	218	481	699
7	"7-out3386"	.19672	84	343	427
7	"7-out3387"	.92561	112	9	121
7	"7-out3388"	.85483	159	27	186
7	"7-out3389"	.39655	92	140	232
7	"7-out3390"	.19135	186	786	972
7	"7-out3391"	.12422	20	141	161
7	"7-out3392"	.65243	107	57	164
7	"7-out3393"	.29277	308	744	1052
7	"7-out3394"	.19047	28	119	147
7	"7-out3395"	.16432	117	595	712
7	"7-out3396"	.31077	349	774	1123
7	"7-out3397"	.23901	234	745	979
7	"7-out3398"	.96368	345	13	358
7	"7-out3399"	.20353	69	270	339
7	"7-out3400"	.36322	81	142	223
7	"7-out3401"	.23582	104	337	441
7	"7-out3402"	.16946	111	544	655
7	"7-out3403"	.91605	251	23	274
7	"7-out3404"	.92424	488	40	528
7	"7-out3405"	.16666	52	260	312
7	"7-out3406"	.93018	493	37	530
7	"7-out3407"	.58306	179	128	307
7	"7-out3408"	.45070	64	78	142
7	"7-out3409"	.19807	308	1247	1555
7	"7-out3410"	.28278	414	1050	1464
7	"7-out3411"	.59476	477	325	802
7	"7-out3412"	.36477	116	202	318
7	"7-out3413"	.28929	208	511	719
7	"7-out3414"	.89433	474	56	530
7	"7-out3415"	.37078	198	336	534
7	"7-out3416"	.95491	233	11	244
7	"7-out3417"	.89430	220	26	246
7	"7-out3418"	.39344	96	148	244
7	"7-out3419"	.91317	305	29	334
7	"7-out3420"	.85365	210	36	246
7	"7-out3421"	.23552	244	792	1036
7	"7-out3422"	.21398	101	371	472
7	"7-out3423"	.18541	89	391	480
7	"7-out3424"	.25654	568	1646	2214
7	"7-out3425"	.26238	286	804	1090
7	"7-out3426"	.18114	171	773	944
7	"7-out3427"	.19978	186	745	931
7	"7-out3428"	.31509	144	313	457
7	"7-out3429"	.34066	542	1049	1591
7	"7-out3430"	.33976	88	171	259
7	"7-out3431"	.23159	195	647	842
7	"7-out3432"	.14375	137	816	953
7	"7-out3433"	.21480	566	2069	2635
7	"7-out3434"	.17986	586	2672	3258
7	"7-out3435"	.24320	197	613	810
7	"7-out3436"	.79968	503	126	629
7	"7-out3437"	.24909	754	2273	3027
7	"7-out3438"	.23741	99	318	417
7	"7-out3439"	.30303	130	299	429
7	"7-out3440"	.34476	191	363	554
7	"7-out3441"	.54291	253	213	466
7	"7-out3442"	.14361	27	161	188
7	"7-out3443"	.35757	59	106	165
7	"7-out3444"	.16875	27	133	160
7	"7-out3445"	.20754	33	126	159
7	"7-out3446"	.18430	108	478	586
7	"7-out3447"	.28624	233	581	814
7	"7-out3448"	.22222	26	91	117
7	"7-out3449"	.69211	544	242	786
7	"7-out3450"	.23396	62	203	265
7	"7-out3451"	.21959	65	231	296
7	"7-out3452"	.58034	437	316	753
7	"7-out3453"	.27296	104	277	381
7	"7-out3454"	.93107	851	63	914
7	"7-out3455"	.22929	288	968	1256
7	"7-out3456"	.90981	575	57	632
7	"7-out3457"	.36902	224	383	607
7	"7-out3458"	.19759	296	1202	1498
7	"7-out3459"	.22012	105	372	477
7	"7-out3460"	.32694	239	492	731
7	"7-out3461"	.78978	263	70	333
7	"7-out3462"	.17669	91	424	515
7	"7-out3463"	.11212	49	388	437
7	"7-out3464"	.25974	40	114	154
7	"7-out3465"	.24653	89	272	361
7	"7-out3466"	.21933	177	630	807
7	"7-out3467"	.21351	218	803	1021
7	"7-out3468"	.31239	184	405	589
7	"7-out3469"	.47887	204	222	426
7	"7-out3470"	.84766	345	62	407
7	"7-out3471"	.27962	59	152	211
7	"7-out3472"	.73483	327	118	445
7	"7-out3473"	.24024	80	253	333
7	"7-out3474"	.16853	45	222	267
7	"7-out3475"	.23316	90	296	386
7	"7-out3476"	.53784	334	287	621
7	"7-out3477"	.88644	484	62	546
7	"7-out3478"	.19217	54	227	281
7	"7-out3479"	.34300	130	249	379
7	"7-out3480"	.31519	139	302	441
7	"7-out3481"	.18986	251	1071	1322
7	"7-out3482"	.38132	98	159	257
7	"7-out3483"	.95565	668	31	699
7	"7-out3484"	.23096	91	303	394
7	"7-out3485"	.25601	234	680	914
7	"7-out3486"	.45189	263	319	582
7	"7-out3487"	.29326	161	388	549
7	"7-out3488"	.20000	29	116	145
7	"7-out3489"	.16955	49	240	289
7	"7-out3490"	.15409	47	258	305
7	"7-out3491"	.61585	202	126	328
7	"7-out3492"	.49000	196	204	400
7	"7-out3493"	.89033	617	76	693
7	"7-out3494"	.89754	622	71	693
7	"7-out3495"	.91044	549	54	603
7	"7-out3496"	.87939	525	72	597
7	"7-out3497"	.91860	395	35	430
7	"7-out3498"	.26496	270	749	1019
7	"7-out3499"	.27814	126	327	453
7	"7-out3500"	.25454	126	369	495
7	"7-out3501"	.16304	15	77	92
7	"7-out3502"	.22000	22	78	100
7	"7-out3503"	.22727	105	357	462
7	"7-out3504"	.21065	83	311	394
7	"7-out3505"	.20909	92	348	440
7	"7-out3506"	.18805	85	367	452
7	"7-out3507"	.92740	626	49	675
7	"7-out3508"	.40400	101	149	250
7	"7-out3509"	.48584	103	109	212
7	"7-out3510"	.94696	125	7	132
7	"7-out3511"	.24137	77	242	319
7	"7-out3512"	.82841	309	64	373
7	"7-out3513"	.35951	119	212	331
7	"7-out3514"	.32731	308	633	941
7	"7-out3515"	.17395	167	793	960
7	"7-out3516"	.41401	130	184	314
7	"7-out3517"	.35200	176	324	500
7	"7-out3518"	.17375	49	233	282
7	"7-out3519"	.75728	390	125	515
7	"7-out3520"	.10833	39	321	360
7	"7-out3521"	.46239	166	193	359
7	"7-out3522"	.23884	91	290	381
7	"7-out3523"	.25729	97	280	377
7	"7-out3524"	.23380	83	272	355
7	"7-out3525"	.38235	143	231	374
7	"7-out3526"	.86956	160	24	184
7	"7-out3527"	.38282	214	345	559
7	"7-out3528"	.49539	215	219	434
7	"7-out3529"	.25345	110	324	434
7	"7-out3530"	.40783	177	257	434
7	"7-out3531"	.53203	191	168	359
7	"7-out3532"	.11581	41	313	354
7	"7-out3533"	.27352	186	494	680
7	"7-out3534"	.89754	622	71	693
7	"7-out3535"	.19235	166	697	863
7	"7-out3536"	.18506	114	502	616
7	"7-out3537"	.32902	229	467	696
7	"7-out3538"	.20247	98	386	484
7	"7-out3539"	.24336	110	342	452
7	"7-out3540"	.17829	69	318	387
7	"7-out3541"	.67284	399	194	593
7	"7-out3542"	.47663	204	224	428
7	"7-out3543"	.22358	91	316	407
7	"7-out3544"	.25806	72	207	279
7	"7-out3545"	.39305	283	437	720
7	"7-out3546"	.90506	286	30	316
7	"7-out3547"	.16304	45	231	276
7	"7-out3548"	.90930	391	39	430
7	"7-out3549"	.25485	223	652	875
7	"7-out3550"	.72854	730	272	1002
7	"7-out3551"	.31434	701	1529	2230
7	"7-out3552"	.90909	110	11	121
7	"7-out3553"	.26968	113	306	419
7	"7-out3554"	.94513	379	22	401
7	"7-out3555"	.92230	368	31	399
7	"7-out3556"	.33557	100	198	298
7	"7-out3557"	.56435	57	44	101
7	"7-out3558"	.16148	135	701	836
7	"7-out3559"	.12207	120	863	983
7	"7-out3560"	.18045	24	109	133
7	"7-out3561"	.24536	291	895	1186
7	"7-out3562"	.11242	19	150	169
7	"7-out3563"	.14828	199	1143	1342
7	"7-out3564"	.15569	149	808	957
7	"7-out3565"	.28080	351	899	1250
7	"7-out3566"	.29088	201	490	691
7	"7-out3567"	.51412	182	172	354
7	"7-out3568"	.32957	146	297	443
7	"7-out3569"	.33974	53	103	156
7	"7-out3570"	.36535	559	971	1530
7	"7-out3571"	.45384	59	71	130
7	"7-out3572"	.28506	189	474	663
7	"7-out3573"	.94852	129	7	136
7	"7-out3574"	.79613	535	137	672
7	"7-out3575"	.30484	107	244	351
7	"7-out3576"	.24477	246	759	1005
7	"7-out3577"	.18707	136	591	727
7	"7-out3578"	.16560	235	1184	1419
7	"7-out3579"	.15283	81	449	530
7	"7-out3580"	.22881	108	364	472
7	"7-out3581"	.22160	119	418	537
7	"7-out3582"	.49438	44	45	89
7	"7-out3583"	.62857	132	78	210
7	"7-out3584"	.24005	966	3058	4024
7	"7-out3585"	.91379	106	10	116
7	"7-out3586"	.43502	77	100	177
7	"7-out3587"	.18675	835	3636	4471
7	"7-out3588"	.32635	78	161	239
7	"7-out3589"	.23220	124	410	534
7	"7-out3590"	.17127	93	450	543
7	"7-out3591"	.92990	849	64	913
7	"7-out3592"	.81512	291	66	357
7	"7-out3593"	.12500	26	182	208
7	"7-out3594"	.09677	57	532	589
7	"7-out3595"	.28947	165	405	570
7	"7-out3596"	.95376	557	27	584
7	"7-out3597"	.44736	34	42	76
7	"7-out3598"	.95287	182	9	191
7	"7-out3599"	.94398	455	27	482
7	"7-out3600"	.94821	531	29	560
7	"7-out3601"	.95422	667	32	699
7	"7-out3602"	.96418	673	25	698
7	"7-out3603"	.95748	563	25	588
7	"7-out3604"	.96217	636	25	661
7	"7-out3605"	.95918	235	10	245
7	"7-out3606"	.39080	102	159	261
7	"7-out3607"	.14689	52	302	354
7	"7-out3608"	.32957	146	297	443
7	"7-out3609"	.90612	222	23	245
7	"7-out3610"	.29324	178	429	607
7	"7-out3611"	.13559	40	255	295
7	"7-out3612"	.24715	87	265	352
7	"7-out3613"	.14168	52	315	367
7	"7-out3614"	.07105	27	353	380
7	"7-out3615"	.88644	484	62	546
7	"7-out3616"	.14814	40	230	270
7	"7-out3617"	.27067	216	582	798
7	"7-out3618"	.20292	111	436	547
7	"7-out3619"	.86440	102	16	118
7	"7-out3620"	.26962	79	214	293
7	"7-out3621"	.91835	2081	185	2266
7	"7-out3622"	.25943	110	314	424
7	"7-out3623"	.22891	19	64	83
7	"7-out3624"	.10902	29	237	266
7	"7-out3625"	.25283	67	198	265
7	"7-out3626"	.86544	283	44	327
7	"7-out3627"	.18692	366	1592	1958
7	"7-out3628"	.19465	51	211	262
7	"7-out3629"	.16112	160	833	993
7	"7-out3630"	.27255	287	766	1053
7	"7-out3631"	.07006	11	146	157
7	"7-out3632"	.28571	72	180	252
7	"7-out3633"	.44162	261	330	591
7	"7-out3634"	.62318	301	182	483
7	"7-out3635"	.93708	283	19	302
7	"7-out3636"	.94701	286	16	302
7	"7-out3637"	.07142	36	468	504
7	"7-out3638"	.13902	57	353	410
7	"7-out3639"	.93155	490	36	526
7	"7-out3640"	.19086	71	301	372
7	"7-out3641"	.21116	121	452	573
7	"7-out3642"	.20943	111	419	530
7	"7-out3643"	.52816	75	67	142
7	"7-out3644"	.18309	26	116	142
7	"7-out3645"	.22268	216	754	970
7	"7-out3646"	.90506	143	15	158
7	"7-out3647"	.22619	95	325	420
7	"7-out3648"	.05797	20	325	345
7	"7-out3649"	.14942	52	296	348
7	"7-out3650"	.16608	142	713	855
7	"7-out3651"	.73084	353	130	483
7	"7-out3652"	.71363	471	189	660
7	"7-out3653"	.79901	2115	532	2647
7	"7-out3654"	.12893	41	277	318
7	"7-out3655"	.30272	89	205	294
7	"7-out3656"	.29982	170	397	567
7	"7-out3657"	.12012	40	293	333
7	"7-out3658"	.93369	521	37	558
7	"7-out3659"	.10469	165	1411	1576
7	"7-out3660"	.67086	852	418	1270
7	"7-out3661"	.79419	301	78	379
7	"7-out3662"	.09138	35	348	383
7	"7-out3663"	.56071	1353	1060	2413
7	"7-out3664"	.25062	100	299	399
7	"7-out3665"	.22898	207	697	904
7	"7-out3666"	.87068	101	15	116
7	"7-out3667"	.27897	142	367	509
7	"7-out3668"	.33868	190	371	561
7	"7-out3669"	.26190	132	372	504
7	"7-out3670"	.28362	97	245	342
7	"7-out3671"	.26430	97	270	367
7	"7-out3672"	.38760	269	425	694
7	"7-out3673"	.10685	53	443	496
7	"7-out3674"	.16504	17	86	103
7	"7-out3675"	.14651	103	600	703
7	"7-out3676"	.87575	289	41	330
7	"7-out3677"	.38692	426	675	1101
7	"7-out3678"	.30259	361	832	1193
7	"7-out3679"	.14217	148	893	1041
7	"7-out3680"	.21028	90	338	428
7	"7-out3681"	.31162	134	296	430
7	"7-out3682"	.50316	159	157	316
7	"7-out3683"	.21245	58	215	273
7	"7-out3684"	.17948	126	576	702
7	"7-out3685"	.28212	101	257	358
7	"7-out3686"	.19166	46	194	240
7	"7-out3687"	.21292	56	207	263
7	"7-out3688"	.38278	258	416	674
7	"7-out3689"	.67610	382	183	565
7	"7-out3690"	.23569	980	3178	4158
7	"7-out3691"	.45762	81	96	177
7	"7-out3692"	.29366	908	2184	3092
7	"7-out3693"	.25139	90	268	358
7	"7-out3694"	.24875	50	151	201
7	"7-out3695"	.35062	534	989	1523
7	"7-out3696"	.22836	124	419	543
7	"7-out3697"	.21212	35	130	165
7	"7-out3698"	.26250	84	236	320
7	"7-out3699"	.10000	122	1098	1220
7	"7-out3700"	.23150	97	322	419
7	"7-out3701"	.27118	144	387	531
7	"7-out3702"	.30990	97	216	313
7	"7-out3703"	.35182	279	514	793
7	"7-out3704"	.19844	102	412	514
7	"7-out3705"	.33838	67	131	198
7	"7-out3706"	.24038	25	79	104
7	"7-out3707"	.29288	140	338	478
7	"7-out3708"	.20982	205	772	977
7	"7-out3709"	.13541	13	83	96
7	"7-out3710"	.18168	127	572	699
7	"7-out3711"	.87735	372	52	424
7	"7-out3712"	.88324	174	23	197
7	"7-out3713"	.74676	519	176	695
7	"7-out3714"	.16576	122	614	736
7	"7-out3715"	.21078	43	161	204
7	"7-out3716"	.23950	331	1051	1382
7	"7-out3717"	.10616	62	522	584
7	"7-out3718"	.16770	27	134	161
7	"7-out3719"	.83050	196	40	236
7	"7-out3720"	.52293	114	104	218
7	"7-out3721"	.05849	21	338	359
7	"7-out3722"	.17135	140	677	817
7	"7-out3723"	.55088	249	203	452
7	"7-out3724"	.16446	199	1011	1210
7	"7-out3725"	.27963	184	474	658
7	"7-out3726"	.23314	287	944	1231
7	"7-out3727"	.40707	46	67	113
7	"7-out3728"	.71631	404	160	564
7	"7-out3729"	.28982	131	321	452
7	"7-out3730"	.27424	82	217	299
7	"7-out3731"	.14233	116	699	815
7	"7-out3732"	.20758	186	710	896
7	"7-out3733"	.20771	409	1560	1969
7	"7-out3734"	.39846	104	157	261
7	"7-out3735"	.40465	539	793	1332
7	"7-out3736"	.25060	207	619	826
7	"7-out3737"	.24311	247	769	1016
7	"7-out3738"	.27806	213	553	766
7	"7-out3739"	.24868	284	858	1142
7	"7-out3740"	.26033	63	179	242
7	"7-out3741"	.28129	209	534	743
7	"7-out3742"	.31137	156	345	501
7	"7-out3743"	.76285	267	83	350
7	"7-out3744"	.60884	179	115	294
7	"7-out3745"	.18750	54	234	288
7	"7-out3746"	.40687	225	328	553
7	"7-out3747"	.25325	136	401	537
7	"7-out3748"	.14466	80	473	553
7	"7-out3749"	.18675	110	479	589
7	"7-out3750"	.95505	170	8	178
7	"7-out3751"	.33479	229	455	684
7	"7-out3752"	.86503	141	22	163
7	"7-out3753"	.40201	80	119	199
7	"7-out3754"	.67037	181	89	270
7	"7-out3755"	.52222	188	172	360
7	"7-out3756"	.08838	35	361	396
7	"7-out3757"	.26153	85	240	325
7	"7-out3758"	.93301	195	14	209
7	"7-out3759"	.30769	60	135	195
7	"7-out3760"	.22049	71	251	322
7	"7-out3761"	.24367	183	568	751
7	"7-out3762"	.13223	32	210	242
7	"7-out3763"	.21917	32	114	146
7	"7-out3764"	.19225	144	605	749
7	"7-out3765"	.39330	94	145	239
7	"7-out3766"	.45833	110	130	240
7	"7-out3767"	.18691	40	174	214
7	"7-out3768"	.19469	44	182	226
7	"7-out3769"	.43921	112	143	255
7	"7-out3770"	.18536	38	167	205
7	"7-out3771"	.31455	67	146	213
7	"7-out3772"	.35294	84	154	238
7	"7-out3773"	.23245	53	175	228
7	"7-out3774"	.96052	365	15	380
7	"7-out3775"	.22295	68	237	305
7	"7-out3776"	.89873	71	8	79
7	"7-out3777"	.89873	71	8	79
7	"7-out3778"	.96478	137	5	142
7	"7-out3779"	.22507	79	272	351
7	"7-out3780"	.53271	57	50	107
7	"7-out3781"	.41153	107	153	260
7	"7-out3782"	.25779	182	524	706
7	"7-out3783"	.12969	69	463	532
7	"7-out3784"	.28678	115	286	401
7	"7-out3785"	.17708	85	395	480
7	"7-out3786"	.85106	80	14	94
7	"7-out3787"	.25027	682	2043	2725
7	"7-out3788"	.30882	21	47	68
7	"7-out3789"	.24393	191	592	783
7	"7-out3790"	.28792	93	230	323
7	"7-out3791"	.18575	60	263	323
7	"7-out3792"	.19226	194	815	1009
7	"7-out3793"	.19387	247	1027	1274
7	"7-out3794"	.46495	272	313	585
7	"7-out3795"	.12103	145	1053	1198
7	"7-out3796"	.21912	55	196	251
7	"7-out3797"	.92631	88	7	95
7	"7-out3798"	.13690	23	145	168
7	"7-out3799"	.22551	76	261	337
7	"7-out3800"	.11642	90	683	773
7	"7-out3801"	.12925	95	640	735
7	"7-out3802"	.23666	71	229	300
7	"7-out3803"	.18387	57	253	310
7	"7-out3804"	.95014	324	17	341
7	"7-out3805"	.64285	63	35	98
7	"7-out3806"	.29655	43	102	145
7	"7-out3807"	.44329	43	54	97
7	"7-out3808"	.92537	62	5	67
7	"7-out3809"	.22371	266	923	1189
7	"7-out3810"	.22287	452	1576	2028
7	"7-out3811"	.95890	70	3	73
7	"7-out3812"	.22166	133	467	600
7	"7-out3813"	.39185	154	239	393
7	"7-out3814"	.52302	159	145	304
7	"7-out3815"	.16057	123	643	766
7	"7-out3816"	.12876	47	318	365
7	"7-out3817"	.19561	509	2093	2602
7	"7-out3818"	.41031	700	1006	1706
7	"7-out3819"	.20910	101	382	483
7	"7-out3820"	.13752	177	1110	1287
7	"7-out3821"	.24763	131	398	529
7	"7-out3822"	.24893	117	353	470
7	"7-out3823"	.80000	132	33	165
7	"7-out3824"	.57731	112	82	194
7	"7-out3825"	.93750	60	4	64
7	"7-out3826"	.18407	148	656	804
7	"7-out3827"	.97142	68	2	70
7	"7-out3828"	.24118	260	818	1078
7	"7-out3829"	.73214	123	45	168
7	"7-out3830"	.80952	68	16	84
7	"7-out3831"	.27777	110	286	396
7	"7-out3832"	.12454	68	478	546
7	"7-out3833"	.14285	57	342	399
7	"7-out3834"	.13157	150	990	1140
7	"7-out3835"	.11829	108	805	913
7	"7-out3836"	.18448	157	694	851
7	"7-out3837"	.31135	288	637	925
7	"7-out3838"	.71000	71	29	100
7	"7-out3839"	.27524	169	445	614
7	"7-out3840"	.43808	750	962	1712
7	"7-out3841"	.50000	35	35	70
7	"7-out3842"	.33832	271	530	801
7	"7-out3843"	.25969	241	687	928
7	"7-out3844"	.88039	714	97	811
7	"7-out3845"	.31914	75	160	235
7	"7-out3846"	.27699	295	770	1065
7	"7-out3847"	.11157	53	422	475
7	"7-out3848"	.18005	121	551	672
7	"7-out3849"	.27160	110	295	405
7	"7-out3850"	.28144	358	914	1272
7	"7-out3851"	.17248	89	427	516
7	"7-out3852"	.20100	40	159	199
7	"7-out3853"	.24231	134	419	553
7	"7-out3854"	.81318	222	51	273
7	"7-out3855"	.62658	99	59	158
7	"7-out3856"	.16859	204	1006	1210
7	"7-out3857"	.96153	75	3	78
7	"7-out3858"	.43953	229	292	521
7	"7-out3859"	.93548	87	6	93
7	"7-out3860"	.36962	129	220	349
7	"7-out3861"	.93521	332	23	355
7	"7-out3862"	.32860	162	331	493
7	"7-out3863"	.25576	266	774	1040
7	"7-out3864"	.93157	885	65	950
7	"7-out3865"	.27164	91	244	335
7	"7-out3866"	.25692	241	697	938
7	"7-out3867"	.20806	98	373	471
7	"7-out3868"	.45258	105	127	232
7	"7-out3869"	.28172	242	617	859
7	"7-out3870"	.30217	181	418	599
7	"7-out3871"	.46333	278	322	600
7	"7-out3872"	.22972	170	570	740
7	"7-out3873"	.82978	78	16	94
7	"7-out3874"	.28917	179	440	619
7	"7-out3875"	.33495	276	548	824
7	"7-out3876"	.24733	255	776	1031
7	"7-out3877"	.20388	105	410	515
7	"7-out3878"	.28888	117	288	405
7	"7-out3879"	.21110	213	796	1009
7	"7-out3880"	.29257	469	1134	1603
7	"7-out3881"	.21698	46	166	212
7	"7-out3882"	.30211	100	231	331
7	"7-out3883"	.53846	182	156	338
7	"7-out3884"	.58974	184	128	312
7	"7-out3885"	.14426	176	1044	1220
7	"7-out3886"	.64437	607	335	942
7	"7-out3887"	.44565	328	408	736
7	"7-out3888"	.19111	142	601	743
7	"7-out3889"	.53455	611	532	1143
7	"7-out3890"	.19220	74	311	385
7	"7-out3891"	.32404	93	194	287
7	"7-out3892"	.53596	231	200	431
7	"7-out3893"	.24982	350	1051	1401
7	"7-out3894"	.31443	122	266	388
7	"7-out3895"	.22762	178	604	782
7	"7-out3896"	.61513	187	117	304
7	"7-out3897"	.38673	239	379	618
7	"7-out3898"	.28571	136	340	476
7	"7-out3899"	.22125	102	359	461
7	"7-out3900"	.25434	117	343	460
7	"7-out3901"	.11176	19	151	170
7	"7-out3902"	.21311	52	192	244
7	"7-out3903"	.17676	70	326	396
7	"7-out3904"	.20374	87	340	427
7	"7-out3905"	.14951	93	529	622
7	"7-out3906"	.03773	12	306	318
7	"7-out3907"	.56129	435	340	775
7	"7-out3908"	.32894	200	408	608
7	"7-out3909"	.37656	90	149	239
7	"7-out3910"	.53963	177	151	328
7	"7-out3911"	.66069	738	379	1117
7	"7-out3912"	.35000	98	182	280
7	"7-out3913"	.26388	266	742	1008
7	"7-out3914"	.16974	156	763	919
7	"7-out3915"	.21607	250	907	1157
7	"7-out3916"	.68677	535	244	779
7	"7-out3917"	.17901	401	1839	2240
7	"7-out3918"	.25000	389	1167	1556
7	"7-out3919"	.25661	194	562	756
7	"7-out3920"	.18181	62	279	341
7	"7-out3921"	.28571	100	250	350
7	"7-out3922"	.52066	126	116	242
7	"7-out3923"	.19153	190	802	992
7	"7-out3924"	.13397	97	627	724
7	"7-out3925"	.97260	71	2	73
7	"7-out3926"	.30068	218	507	725
7	"7-out3927"	.27899	89	230	319
7	"7-out3928"	.90962	614	61	675
7	"7-out3929"	.58921	426	297	723
7	"7-out3930"	.93055	67	5	72
7	"7-out3931"	.28380	170	429	599
7	"7-out3932"	.38888	301	473	774
7	"7-out3933"	.58963	273	190	463
7	"7-out3934"	.81437	272	62	334
7	"7-out3935"	.34756	171	321	492
7	"7-out3936"	.32576	201	416	617
7	"7-out3937"	.24657	72	220	292
7	"7-out3938"	.29098	71	173	244
7	"7-out3939"	.44736	85	105	190
7	"7-out3940"	.67647	69	33	102
7	"7-out3941"	.21754	62	223	285
7	"7-out3942"	.23246	232	766	998
7	"7-out3943"	.94776	127	7	134
7	"7-out3944"	.66757	492	245	737
7	"7-out3945"	.71542	626	249	875
7	"7-out3946"	.19745	62	252	314
7	"7-out3947"	.14723	48	278	326
7	"7-out3948"	.16460	93	472	565
7	"7-out3949"	.14065	64	391	455
7	"7-out3950"	.15805	202	1076	1278
7	"7-out3951"	.11901	92	681	773
7	"7-out3952"	.23602	114	369	483
7	"7-out3953"	.21685	157	567	724
7	"7-out3954"	.58912	390	272	662
7	"7-out3955"	.93195	904	66	970
7	"7-out3956"	.53635	391	338	729
7	"7-out3957"	.90425	85	9	94
7	"7-out3958"	.79012	192	51	243
7	"7-out3959"	.67968	348	164	512
7	"7-out3960"	.92929	184	14	198
7	"7-out3961"	.20053	300	1196	1496
7	"7-out3962"	.29701	567	1342	1909
7	"7-out3963"	.38576	233	371	604
7	"7-out3964"	.15463	60	328	388
7	"7-out3965"	.91363	201	19	220
7	"7-out3966"	.85663	478	80	558
7	"7-out3967"	.14970	50	284	334
7	"7-out3968"	.96923	63	2	65
7	"7-out3969"	.17981	57	260	317
7	"7-out3970"	.12871	91	616	707
7	"7-out3971"	.92156	329	28	357
7	"7-out3972"	.88679	141	18	159
7	"7-out3973"	.22296	235	819	1054
7	"7-out3974"	.27586	72	189	261
7	"7-out3975"	.19469	66	273	339
7	"7-out3976"	.15220	121	674	795
7	"7-out3977"	.29400	314	754	1068
7	"7-out3978"	.93605	849	58	907
7	"7-out3979"	.90780	128	13	141
7	"7-out3980"	.77304	109	32	141
7	"7-out3981"	.20580	156	602	758
7	"7-out3982"	.23280	44	145	189
7	"7-out3983"	.42483	65	88	153
7	"7-out3984"	.35294	36	66	102
7	"7-out3985"	.43902	36	46	82
7	"7-out3986"	.88636	78	10	88
7	"7-out3987"	.31168	24	53	77
7	"7-out3988"	.36401	87	152	239
7	"7-out3989"	.34362	89	170	259
7	"7-out3990"	.37900	130	213	343
7	"7-out3991"	.36520	191	332	523
7	"7-out3992"	.22727	25	85	110
7	"7-out3993"	.64478	167	92	259
7	"7-out3994"	.32489	77	160	237
7	"7-out3995"	.27872	131	339	470
7	"7-out3996"	.31555	284	616	900
7	"7-out3997"	.22644	161	550	711
7	"7-out3998"	.20728	165	631	796
7	"7-out3999"	.16851	91	449	540
7	"7-out4000"	.43093	287	379	666
7	"7-out4001"	.30110	190	441	631
7	"7-out4002"	.22474	198	683	881
7	"7-out4003"	.81940	549	121	670
7	"7-out4004"	.19744	108	439	547
7	"7-out4005"	.49643	209	212	421
7	"7-out4006"	.22372	66	229	295
7	"7-out4007"	.31455	536	1168	1704
7	"7-out4008"	.84236	171	32	203
7	"7-out4009"	.56818	75	57	132
7	"7-out4010"	.15210	101	563	664
7	"7-out4011"	.42410	95	129	224
7	"7-out4012"	.32727	54	111	165
7	"7-out4013"	.34792	159	298	457
7	"7-out4014"	.83163	163	33	196
7	"7-out4015"	.91441	203	19	222
7	"7-out4016"	.48198	107	115	222
7	"7-out4017"	.68717	134	61	195
7	"7-out4018"	.15306	30	166	196
7	"7-out4019"	.28776	120	297	417
7	"7-out4020"	.79464	89	23	112
7	"7-out4021"	.26029	158	449	607
7	"7-out4022"	.15231	23	128	151
7	"7-out4023"	.26035	132	375	507
7	"7-out4024"	.30575	292	663	955
7	"7-out4025"	.28501	116	291	407
7	"7-out4026"	.18861	106	456	562
7	"7-out4027"	.44649	121	150	271
7	"7-out4028"	.37770	122	201	323
7	"7-out4029"	.17887	105	482	587
7	"7-out4030"	.22958	104	349	453
7	"7-out4031"	.45922	214	252	466
7	"7-out4032"	.22089	74	261	335
7	"7-out4033"	.29250	117	283	400
7	"7-out4034"	.20044	181	722	903
7	"7-out4035"	.26980	126	341	467
7	"7-out4036"	.27542	65	171	236
7	"7-out4037"	.13333	24	156	180
7	"7-out4038"	.80935	225	53	278
7	"7-out4039"	.75675	140	45	185
7	"7-out4040"	.22797	44	149	193
7	"7-out4041"	.26984	51	138	189
7	"7-out4042"	.22927	354	1190	1544
7	"7-out4043"	.17496	144	679	823
7	"7-out4044"	.11666	21	159	180
7	"7-out4045"	.15202	109	608	717
7	"7-out4046"	.19518	154	635	789
7	"7-out4047"	.44327	211	265	476
7	"7-out4048"	.11195	44	349	393
7	"7-out4049"	.23747	109	350	459
7	"7-out4050"	.19658	92	376	468
7	"7-out4051"	.42244	128	175	303
7	"7-out4052"	.28125	54	138	192
7	"7-out4053"	.22587	110	377	487
7	"7-out4054"	.17637	336	1569	1905
7	"7-out4055"	.25587	185	538	723
7	"7-out4056"	.13659	81	512	593
7	"7-out4057"	.18509	149	656	805
7	"7-out4058"	.55434	51	41	92
7	"7-out4059"	.16594	154	774	928
7	"7-out4060"	.14248	55	331	386
7	"7-out4061"	.31632	124	268	392
7	"7-out4062"	.20725	120	459	579
7	"7-out4063"	.92857	78	6	84
7	"7-out4064"	.45070	64	78	142
7	"7-out4065"	.98237	223	4	227
7	"7-out4066"	.24720	221	673	894
7	"7-out4067"	.53658	682	589	1271
7	"7-out4068"	.80813	139	33	172
7	"7-out4069"	.26582	189	522	711
7	"7-out4070"	.79673	733	187	920
7	"7-out4071"	.34108	44	85	129
7	"7-out4072"	.48245	55	59	114
7	"7-out4073"	.94930	618	33	651
7	"7-out4074"	.14805	61	351	412
7	"7-out4075"	.15234	78	434	512
7	"7-out4076"	.36973	193	329	522
7	"7-out4077"	.74923	490	164	654
7	"7-out4078"	.24022	43	136	179
7	"7-out4079"	.92372	218	18	236
7	"7-out4080"	.89000	445	55	500
7	"7-out4081"	.17821	90	415	505
7	"7-out4082"	.22368	102	354	456
7	"7-out4083"	.15414	121	664	785
7	"7-out4084"	.05500	11	189	200
7	"7-out4085"	.35537	43	78	121
7	"7-out4086"	.21808	41	147	188
7	"7-out4087"	.21276	60	222	282
7	"7-out4088"	.14814	8	46	54
7	"7-out4089"	.17587	121	567	688
7	"7-out4090"	.16715	57	284	341
7	"7-out4091"	.20196	185	731	916
7	"7-out4092"	.33554	202	400	602
7	"7-out4093"	.36150	77	136	213
7	"7-out4094"	.38738	86	136	222
7	"7-out4095"	.22746	53	180	233
7	"7-out4096"	.83040	142	29	171
7	"7-out4097"	.37313	75	126	201
7	"7-out4098"	.25165	114	339	453
7	"7-out4099"	.20320	165	647	812
7	"7-out4100"	.22058	30	106	136
7	"7-out4101"	.11698	73	551	624
7	"7-out4102"	.65071	272	146	418
7	"7-out4103"	.78095	164	46	210
7	"7-out4104"	.26984	51	138	189
7	"7-out4105"	.18581	55	241	296
7	"7-out4106"	.41721	252	352	604
7	"7-out4107"	.30814	208	467	675
7	"7-out4108"	.96190	101	4	105
7	"7-out4109"	.74517	193	66	259
7	"7-out4110"	.75700	81	26	107
7	"7-out4111"	.16115	78	406	484
7	"7-out4112"	.58485	448	318	766
7	"7-out4113"	.26431	217	604	821
7	"7-out4114"	.14462	105	621	726
7	"7-out4115"	.17450	115	544	659
7	"7-out4116"	.50181	276	274	550
7	"7-out4117"	.37426	192	321	513
7	"7-out4118"	.18232	33	148	181
7	"7-out4119"	.93076	121	9	130
7	"7-out4120"	.15975	77	405	482
7	"7-out4121"	.76849	322	97	419
7	"7-out4122"	.37254	95	160	255
7	"7-out4123"	.08333	7	77	84
7	"7-out4124"	.29694	68	161	229
7	"7-out4125"	.59523	150	102	252
7	"7-out4126"	.94520	138	8	146
7	"7-out4127"	.18694	63	274	337
7	"7-out4128"	.27106	148	398	546
7	"7-out4129"	.32441	194	404	598
7	"7-out4130"	.28251	202	513	715
7	"7-out4131"	.88965	129	16	145
7	"7-out4132"	.15020	257	1454	1711
7	"7-out4133"	.16766	140	695	835
7	"7-out4134"	.20041	96	383	479
7	"7-out4135"	.19523	41	169	210
7	"7-out4136"	.24752	50	152	202
7	"7-out4137"	.31336	68	149	217
7	"7-out4138"	.20763	87	332	419
7	"7-out4139"	.16194	40	207	247
7	"7-out4140"	.95785	250	11	261
7	"7-out4141"	.28035	224	575	799
7	"7-out4142"	.42512	352	476	828
7	"7-out4143"	.35580	190	344	534
7	"7-out4144"	.30641	129	292	421
7	"7-out4145"	.34502	59	112	171
7	"7-out4146"	.17485	89	420	509
7	"7-out4147"	.75423	89	29	118
7	"7-out4148"	.94871	259	14	273
7	"7-out4149"	.26470	54	150	204
7	"7-out4150"	.71681	405	160	565
7	"7-out4151"	.10671	27	226	253
7	"7-out4152"	.13137	286	1891	2177
7	"7-out4153"	.10256	100	875	975
7	"7-out4154"	.91700	453	41	494
7	"7-out4155"	.19540	17	70	87
7	"7-out4156"	.81343	327	75	402
7	"7-out4157"	.35039	89	165	254
7	"7-out4158"	.20779	64	244	308
7	"7-out4159"	.29300	155	374	529
7	"7-out4160"	.18618	194	848	1042
7	"7-out4161"	.23891	221	704	925
7	"7-out4162"	.20231	105	414	519
7	"7-out4163"	.16873	312	1537	1849
7	"7-out4164"	.40640	165	241	406
7	"7-out4165"	.18480	180	794	974
7	"7-out4166"	.89205	438	53	491
7	"7-out4167"	.48591	69	73	142
7	"7-out4168"	.28791	131	324	455
7	"7-out4169"	.16509	70	354	424
7	"7-out4170"	.23514	91	296	387
7	"7-out4171"	.16326	64	328	392
7	"7-out4172"	.68796	366	166	532
7	"7-out4173"	.17561	193	906	1099
7	"7-out4174"	.23737	94	302	396
7	"7-out4175"	.05839	8	129	137
7	"7-out4176"	.20883	52	197	249
7	"7-out4177"	.32553	167	346	513
7	"7-out4178"	.25853	1015	2911	3926
7	"7-out4179"	.68085	160	75	235
7	"7-out4180"	.18565	44	193	237
7	"7-out4181"	.15199	164	915	1079
7	"7-out4182"	.26153	51	144	195
7	"7-out4183"	.90000	441	49	490
7	"7-out4184"	.22662	80	273	353
7	"7-out4185"	.92513	173	14	187
7	"7-out4186"	.20959	1018	3839	4857
7	"7-out4187"	.09243	33	324	357
7	"7-out4188"	.80597	324	78	402
7	"7-out4189"	.16496	113	572	685
7	"7-out4190"	.34982	99	184	283
7	"7-out4191"	.30434	56	128	184
7	"7-out4192"	.72386	928	354	1282
7	"7-out4193"	.36974	44	75	119
7	"7-out4194"	.96551	112	4	116
7	"7-out4195"	.89861	585	66	651
7	"7-out4196"	.21362	116	427	543
7	"7-out4197"	.26801	331	904	1235
7	"7-out4198"	.20930	90	340	430
7	"7-out4199"	.19157	100	422	522
7	"7-out4200"	.35664	1219	2199	3418
7	"7-out4201"	.22549	138	474	612
7	"7-out4202"	.20561	227	877	1104
7	"7-out4203"	.29047	305	745	1050
7	"7-out4204"	.27926	303	782	1085
7	"7-out4205"	.94344	684	41	725
7	"7-out4206"	.75000	87	29	116
7	"7-out4207"	.83555	188	37	225
7	"7-out4208"	.90752	579	59	638
7	"7-out4209"	.36914	134	229	363
7	"7-out4210"	.95141	470	24	494
7	"7-out4211"	.18158	71	320	391
7	"7-out4212"	.65116	112	60	172
7	"7-out4213"	.28299	401	1016	1417
7	"7-out4214"	.15350	171	943	1114
7	"7-out4215"	.56756	105	80	185
7	"7-out4216"	.10547	104	882	986
7	"7-out4217"	.23427	149	487	636
7	"7-out4218"	.32876	72	147	219
7	"7-out4219"	.32484	102	212	314
7	"7-out4220"	.25714	54	156	210
7	"7-out4221"	.88795	317	40	357
7	"7-out4222"	.24761	26	79	105
7	"7-out4223"	.85656	639	107	746
7	"7-out4224"	.19140	49	207	256
7	"7-out4225"	.43302	1319	1727	3046
7	"7-out4226"	.96000	72	3	75
7	"7-out4227"	.19195	62	261	323
7	"7-out4228"	.45380	334	402	736
7	"7-out4229"	.37151	467	790	1257
7	"7-out4230"	.77554	463	134	597
7	"7-out4231"	.24444	44	136	180
7	"7-out4232"	.26498	84	233	317
7	"7-out4233"	.19730	44	179	223
7	"7-out4234"	.15692	153	822	975
7	"7-out4235"	.44000	220	280	500
7	"7-out4236"	.44351	212	266	478
7	"7-out4237"	.33707	60	118	178
7	"7-out4238"	.80000	100	25	125
7	"7-out4239"	.21648	344	1245	1589
7	"7-out4240"	.47256	155	173	328
7	"7-out4241"	.18590	95	416	511
7	"7-out4242"	.30245	160	369	529
7	"7-out4243"	.68007	372	175	547
7	"7-out4244"	.16250	26	134	160
7	"7-out4245"	.35512	554	1006	1560
7	"7-out4246"	.21428	108	396	504
7	"7-out4247"	.52534	114	103	217
7	"7-out4248"	.21272	107	396	503
7	"7-out4249"	.08737	18	188	206
7	"7-out4250"	.42592	46	62	108
7	"7-out4251"	.20890	61	231	292
7	"7-out4252"	.44099	512	649	1161
7	"7-out4253"	.21978	80	284	364
7	"7-out4254"	.25407	156	458	614
7	"7-out4255"	.21993	64	227	291
7	"7-out4256"	.32969	151	307	458
7	"7-out4257"	.17567	104	488	592
7	"7-out4258"	.94482	137	8	145
7	"7-out4259"	.15730	126	675	801
7	"7-out4260"	.17085	68	330	398
7	"7-out4261"	.11038	84	677	761
7	"7-out4262"	.16392	199	1015	1214
7	"7-out4263"	.25870	104	298	402
7	"7-out4264"	.33609	162	320	482
7	"7-out4265"	.27215	43	115	158
7	"7-out4266"	.28113	79	202	281
7	"7-out4267"	.20505	146	566	712
7	"7-out4268"	.87134	447	66	513
7	"7-out4269"	.91724	133	12	145
7	"7-out4270"	.12857	18	122	140
7	"7-out4271"	.38975	350	548	898
7	"7-out4272"	.25761	93	268	361
7	"7-out4273"	.34337	57	109	166
7	"7-out4274"	.18287	126	563	689
7	"7-out4275"	.14308	89	533	622
7	"7-out4276"	.19951	82	329	411
7	"7-out4277"	.48936	46	48	94
7	"7-out4278"	.15454	85	465	550
7	"7-out4279"	.96296	78	3	81
7	"7-out4280"	.24034	56	177	233
7	"7-out4281"	.27416	173	458	631
7	"7-out4282"	.40390	124	183	307
7	"7-out4283"	.51507	205	193	398
7	"7-out4284"	.33126	107	216	323
7	"7-out4285"	.20845	74	281	355
7	"7-out4286"	.31551	183	397	580
7	"7-out4287"	.27272	102	272	374
7	"7-out4288"	.11764	44	330	374
7	"7-out4289"	.12169	46	332	378
7	"7-out4290"	.19666	177	723	900
7	"7-out4291"	.18356	134	596	730
7	"7-out4292"	.95850	462	20	482
7	"7-out4293"	.89811	714	81	795
7	"7-out4294"	.13375	42	272	314
7	"7-out4295"	.78632	92	25	117
7	"7-out4296"	.27298	98	261	359
7	"7-out4297"	.54098	33	28	61
7	"7-out4298"	.24017	55	174	229
7	"7-out4299"	.30035	167	389	556
7	"7-out4300"	.69475	371	163	534
7	"7-out4301"	.36636	122	211	333
7	"7-out4302"	.30645	190	430	620
7	"7-out4303"	.06741	18	249	267
7	"7-out4304"	.16501	50	253	303
7	"7-out4305"	.27859	285	738	1023
7	"7-out4306"	.32900	431	879	1310
7	"7-out4307"	.25329	96	283	379
7	"7-out4308"	.28911	85	209	294
7	"7-out4309"	.45238	57	69	126
7	"7-out4310"	.59803	61	41	102
7	"7-out4311"	.81558	429	97	526
7	"7-out4312"	.42073	1043	1436	2479
7	"7-out4313"	.15991	75	394	469
7	"7-out4314"	.32318	361	756	1117
7	"7-out4315"	.16500	33	167	200
7	"7-out4316"	.16941	72	353	425
7	"7-out4317"	.57992	156	113	269
7	"7-out4318"	.72962	197	73	270
7	"7-out4319"	.24365	96	298	394
7	"7-out4320"	.14973	28	159	187
7	"7-out4321"	.16049	78	408	486
7	"7-out4322"	.35677	137	247	384
7	"7-out4323"	.19333	58	242	300
7	"7-out4324"	.19333	29	121	150
7	"7-out4325"	.76961	461	138	599
7	"7-out4326"	.31309	330	724	1054
7	"7-out4327"	.24242	136	425	561
7	"7-out4328"	.17919	155	710	865
7	"7-out4329"	.51394	387	366	753
7	"7-out4330"	.47388	127	141	268
7	"7-out4331"	.35991	167	297	464
7	"7-out4332"	.29213	78	189	267
7	"7-out4333"	.64765	193	105	298
7	"7-out4334"	.22853	173	584	757
7	"7-out4335"	.35510	212	385	597
7	"7-out4336"	.27544	46	121	167
7	"7-out4337"	.41935	234	324	558
7	"7-out4338"	.90000	117	13	130
7	"7-out4339"	.30000	105	245	350
7	"7-out4340"	.90036	244	27	271
7	"7-out4341"	.96610	114	4	118
7	"7-out4342"	.28987	189	463	652
7	"7-out4343"	.48760	118	124	242
7	"7-out4344"	.85526	65	11	76
7	"7-out4345"	.97849	182	4	186
7	"7-out4346"	.39370	50	77	127
7	"7-out4347"	.20000	28	112	140
7	"7-out4348"	.32470	602	1252	1854
7	"7-out4349"	.92376	206	17	223
7	"7-out4350"	.59146	1885	1302	3187
7	"7-out4351"	.24354	151	469	620
7	"7-out4352"	.25609	42	122	164
7	"7-out4353"	.37792	113	186	299
7	"7-out4354"	.34387	87	166	253
7	"7-out4355"	.25883	337	965	1302
7	"7-out4356"	.49685	79	80	159
7	"7-out4357"	.09138	35	348	383
7	"7-out4358"	.21940	52	185	237
7	"7-out4359"	.44159	155	196	351
7	"7-out4360"	.43877	129	165	294
7	"7-out4361"	.26666	44	121	165
7	"7-out4362"	.20000	37	148	185
7	"7-out4363"	.44467	426	532	958
7	"7-out4364"	.94117	192	12	204
7	"7-out4365"	.23553	57	185	242
7	"7-out4366"	.22181	61	214	275
7	"7-out4367"	.36631	137	237	374
7	"7-out4368"	.37763	358	590	948
7	"7-out4369"	.33043	38	77	115
7	"7-out4370"	.28282	28	71	99
7	"7-out4371"	.33620	78	154	232
7	"7-out4372"	.22619	76	260	336
7	"7-out4373"	.17867	62	285	347
7	"7-out4374"	.92432	171	14	185
7	"7-out4375"	.15482	122	666	788
7	"7-out4376"	.76213	628	196	824
7	"7-out4377"	.12413	54	381	435
7	"7-out4378"	.19409	92	382	474
7	"7-out4379"	.50207	121	120	241
7	"7-out4380"	.28571	72	180	252
7	"7-out4381"	.19435	172	713	885
7	"7-out4382"	.61780	118	73	191
7	"7-out4383"	.11011	49	396	445
7	"7-out4384"	.82394	234	50	284
7	"7-out4385"	.50000	299	299	598
7	"7-out4386"	.16778	50	248	298
7	"7-out4387"	.34659	61	115	176
7	"7-out4388"	.89330	1415	169	1584
7	"7-out4389"	.93767	331	22	353
7	"7-out4390"	.92376	206	17	223
7	"7-out4391"	.17627	52	243	295
7	"7-out4392"	.24000	462	1463	1925
7	"7-out4393"	.45802	431	510	941
7	"7-out4394"	.39076	127	198	325
7	"7-out4395"	.61063	356	227	583
7	"7-out4396"	.31578	48	104	152
7	"7-out4397"	.21037	73	274	347
7	"7-out4398"	.36394	107	187	294
7	"7-out4399"	.42207	65	89	154
7	"7-out4400"	.92513	173	14	187
7	"7-out4401"	.29687	152	360	512
7	"7-out4402"	.21691	118	426	544
7	"7-out4403"	.28200	141	359	500
7	"7-out4404"	.30384	742	1700	2442
7	"7-out4405"	.83429	433	86	519
7	"7-out4406"	.95294	324	16	340
7	"7-out4407"	.12984	77	516	593
7	"7-out4408"	.24550	41	126	167
7	"7-out4409"	.26315	30	84	114
7	"7-out4410"	.17765	124	574	698
7	"7-out4411"	.91860	79	7	86
7	"7-out4412"	.92265	167	14	181
7	"7-out4413"	.30364	208	477	685
7	"7-out4414"	.95555	129	6	135
7	"7-out4415"	.14601	66	386	452
7	"7-out4416"	.22521	309	1063	1372
7	"7-out4417"	.49097	136	141	277
7	"7-out4418"	.17062	79	384	463
7	"7-out4419"	.26706	90	247	337
7	"7-out4420"	.87234	287	42	329
7	"7-out4421"	.93333	364	26	390
7	"7-out4422"	.31117	234	518	752
7	"7-out4423"	.66428	372	188	560
7	"7-out4424"	.80339	331	81	412
7	"7-out4425"	.19696	78	318	396
7	"7-out4426"	.93781	377	25	402
7	"7-out4427"	.92920	105	8	113
7	"7-out4428"	.30479	89	203	292
7	"7-out4429"	.28888	39	96	135
7	"7-out4430"	.15200	38	212	250
7	"7-out4431"	.87116	142	21	163
7	"7-out4432"	.25405	141	414	555
7	"7-out4433"	.30942	151	337	488
7	"7-out4434"	.38682	364	577	941
7	"7-out4435"	.18487	22	97	119
7	"7-out4436"	.25635	111	322	433
7	"7-out4437"	.80000	236	59	295
7	"7-out4438"	.24709	85	259	344
7	"7-out4439"	.32525	94	195	289
7	"7-out4440"	.17048	134	652	786
7	"7-out4441"	.20281	72	283	355
7	"7-out4442"	.90421	708	75	783
7	"7-out4443"	.16600	42	211	253
7	"7-out4444"	.26415	294	819	1113
7	"7-out4445"	.91459	257	24	281
7	"7-out4446"	.25900	151	432	583
7	"7-out4447"	.12831	29	197	226
7	"7-out4448"	.24576	116	356	472
7	"7-out4449"	.23181	51	169	220
7	"7-out4450"	.37993	125	204	329
7	"7-out4451"	.41935	143	198	341
7	"7-out4452"	.20903	74	280	354
7	"7-out4453"	.27395	183	485	668
7	"7-out4454"	.31479	266	579	845
7	"7-out4455"	.37466	139	232	371
7	"7-out4456"	.29056	77	188	265
7	"7-out4457"	.10679	22	184	206
7	"7-out4458"	.20283	43	169	212
7	"7-out4459"	.27116	410	1102	1512
7	"7-out4460"	.28335	737	1864	2601
7	"7-out4461"	.38697	101	160	261
7	"7-out4462"	.20134	30	119	149
7	"7-out4463"	.26229	272	765	1037
7	"7-out4464"	.09482	11	105	116
7	"7-out4465"	.23470	165	538	703
7	"7-out4466"	.17931	104	476	580
7	"7-out4467"	.38803	253	399	652
7	"7-out4468"	.30803	69	155	224
7	"7-out4469"	.07317	15	190	205
7	"7-out4470"	.27669	184	481	665
7	"7-out4471"	.35582	58	105	163
7	"7-out4472"	.27448	398	1052	1450
7	"7-out4473"	.82702	153	32	185
7	"7-out4474"	.11659	26	197	223
7	"7-out4475"	.30711	164	370	534
7	"7-out4476"	.37307	97	163	260
7	"7-out4477"	.12886	25	169	194
7	"7-out4478"	.49357	192	197	389
7	"7-out4479"	.27492	91	240	331
7	"7-out4480"	.34000	34	66	100
7	"7-out4481"	.44534	110	137	247
7	"7-out4482"	.51485	104	98	202
7	"7-out4483"	.09444	34	326	360
7	"7-out4484"	.07301	23	292	315
7	"7-out4485"	.18367	18	80	98
7	"7-out4486"	.14199	47	284	331
7	"7-out4487"	.28666	43	107	150
7	"7-out4488"	.33103	144	291	435
7	"7-out4489"	.70698	263	109	372
7	"7-out4490"	.33289	252	505	757
7	"7-out4491"	.34659	122	230	352
7	"7-out4492"	.18732	136	590	726
7	"7-out4493"	.17391	48	228	276
7	"7-out4494"	.17821	36	166	202
7	"7-out4495"	.59615	217	147	364
7	"7-out4496"	.21130	71	265	336
7	"7-out4497"	.37548	193	321	514
7	"7-out4498"	.32599	400	827	1227
7	"7-out4499"	.26153	68	192	260
7	"7-out4500"	.16363	81	414	495
7	"7-out4501"	.31623	111	240	351
7	"7-out4502"	.16065	49	256	305
7	"7-out4503"	.27290	137	365	502
7	"7-out4504"	.46927	168	190	358
7	"7-out4505"	.49275	68	70	138
7	"7-out4506"	.23322	73	240	313
7	"7-out4507"	.30051	58	135	193
7	"7-out4508"	.23536	414	1345	1759
7	"7-out4509"	.13669	57	360	417
7	"7-out4510"	.20567	87	336	423
7	"7-out4511"	.29855	412	968	1380
7	"7-out4512"	.45067	201	245	446
7	"7-out4513"	.17218	156	750	906
7	"7-out4514"	.33671	199	392	591
7	"7-out4515"	.80451	428	104	532
7	"7-out4516"	.27737	76	198	274
7	"7-out4517"	.18954	29	124	153
7	"7-out4518"	.40837	78	113	191
7	"7-out4519"	.18725	47	204	251
7	"7-out4520"	.29485	281	672	953
7	"7-out4521"	.25304	83	245	328
7	"7-out4522"	.24235	222	694	916
7	"7-out4523"	.21481	58	212	270
7	"7-out4524"	.21835	69	247	316
7	"7-out4525"	.29310	119	287	406
7	"7-out4526"	.90225	240	26	266
7	"7-out4527"	.30357	68	156	224
7	"7-out4528"	.23602	114	369	483
7	"7-out4529"	.39682	175	266	441
7	"7-out4530"	.13432	18	116	134
7	"7-out4531"	.93577	102	7	109
7	"7-out4532"	.23148	100	332	432
7	"7-out4533"	.42541	154	208	362
7	"7-out4534"	.38279	534	861	1395
7	"7-out4535"	.33269	173	347	520
7	"7-out4536"	.26000	91	259	350
7	"7-out4537"	.17915	55	252	307
7	"7-out4538"	.53658	110	95	205
7	"7-out4539"	.27792	102	265	367
7	"7-out4540"	.15546	37	201	238
7	"7-out4541"	.17695	43	200	243
7	"7-out4542"	.15384	28	154	182
7	"7-out4543"	.28384	130	328	458
7	"7-out4544"	.10964	25	203	228
7	"7-out4545"	.25746	69	199	268
7	"7-out4546"	.17229	148	711	859
7	"7-out4547"	.14634	24	140	164
7	"7-out4548"	.31818	63	135	198
7	"7-out4549"	.28199	130	331	461
7	"7-out4550"	.08333	14	154	168
7	"7-out4551"	.26086	138	391	529
7	"7-out4552"	.19609	291	1193	1484
7	"7-out4553"	.65902	230	119	349
7	"7-out4554"	.10869	15	123	138
7	"7-out4555"	.31180	251	554	805
7	"7-out4556"	.13385	68	440	508
7	"7-out4557"	.63043	87	51	138
7	"7-out4558"	.16558	484	2439	2923
7	"7-out4559"	.25242	52	154	206
7	"7-out4560"	.57615	87	64	151
7	"7-out4561"	.43379	534	697	1231
7	"7-out4562"	.35776	205	368	573
7	"7-out4563"	.25553	173	504	677
7	"7-out4564"	.93877	460	30	490
7	"7-out4565"	.82751	1161	242	1403
7	"7-out4566"	.32679	50	103	153
7	"7-out4567"	.69718	99	43	142
7	"7-out4568"	.50000	101	101	202
7	"7-out4569"	.25986	112	319	431
7	"7-out4570"	.21086	132	494	626
7	"7-out4571"	.14643	152	886	1038
7	"7-out4572"	.19416	193	801	994
7	"7-out4573"	.36785	103	177	280
7	"7-out4574"	.16949	80	392	472
7	"7-out4575"	.13265	26	170	196
7	"7-out4576"	.53149	135	119	254
7	"7-out4577"	.11519	47	361	408
7	"7-out4578"	.14325	104	622	726
7	"7-out4579"	.27642	68	178	246
7	"7-out4580"	.20767	384	1465	1849
7	"7-out4581"	.61473	217	136	353
7	"7-out4582"	.91666	77	7	84
7	"7-out4583"	.29239	50	121	171
7	"7-out4584"	.70059	234	100	334
7	"7-out4585"	.17993	52	237	289
7	"7-out4586"	.30434	77	176	253
7	"7-out4587"	.92760	205	16	221
7	"7-out4588"	.70798	257	106	363
7	"7-out4589"	.33065	206	417	623
7	"7-out4590"	.29754	291	687	978
7	"7-out4591"	.41637	117	164	281
7	"7-out4592"	.93939	341	22	363
7	"7-out4593"	.25316	20	59	79
7	"7-out4594"	.28806	70	173	243
7	"7-out4595"	.47027	174	196	370
7	"7-out4596"	.28873	41	101	142
7	"7-out4597"	.12692	66	454	520
7	"7-out4598"	.17974	142	648	790
7	"7-out4599"	.21243	164	608	772
7	"7-out4600"	.19094	173	733	906
7	"7-out4601"	.34124	115	222	337
7	"7-out4602"	.12336	113	803	916
7	"7-out4603"	.28606	117	292	409
7	"7-out4604"	.52073	226	208	434
7	"7-out4605"	.26239	127	357	484
7	"7-out4606"	.21122	64	239	303
7	"7-out4607"	.28971	93	228	321
7	"7-out4608"	.32142	117	247	364
7	"7-out4609"	.14421	76	451	527
7	"7-out4610"	.25075	83	248	331
7	"7-out4611"	.88106	363	49	412
7	"7-out4612"	.11111	18	144	162
7	"7-out4613"	.40721	79	115	194
7	"7-out4614"	.29326	61	147	208
7	"7-out4615"	.21951	126	448	574
7	"7-out4616"	.96402	134	5	139
7	"7-out4617"	.62033	183	112	295
7	"7-out4618"	.22394	202	700	902
7	"7-out4619"	.10739	45	374	419
7	"7-out4620"	.25574	256	745	1001
7	"7-out4621"	.12723	64	439	503
7	"7-out4622"	.16049	26	136	162
7	"7-out4623"	.32835	66	135	201
7	"7-out4624"	.28381	107	270	377
7	"7-out4625"	.18543	56	246	302
7	"7-out4626"	.28632	268	668	936
7	"7-out4627"	.92123	269	23	292
7	"7-out4628"	.54263	140	118	258
7	"7-out4629"	.94276	280	17	297
7	"7-out4630"	.46920	259	293	552
7	"7-out4631"	.39215	340	527	867
7	"7-out4632"	.34285	72	138	210
7	"7-out4633"	.41258	295	420	715
7	"7-out4634"	.92105	350	30	380
7	"7-out4635"	.21880	121	432	553
7	"7-out4636"	.51474	192	181	373
7	"7-out4637"	.65039	333	179	512
7	"7-out4638"	.47307	123	137	260
7	"7-out4639"	.66024	377	194	571
7	"7-out4640"	.26041	25	71	96
7	"7-out4641"	.22680	22	75	97
7	"7-out4642"	.25984	33	94	127
7	"7-out4643"	.34275	97	186	283
7	"7-out4644"	.18428	68	301	369
7	"7-out4645"	.75789	72	23	95
7	"7-out4646"	.22727	15	51	66
7	"7-out4647"	.34170	68	131	199
7	"7-out4648"	.73226	320	117	437
7	"7-out4649"	.14674	97	564	661
7	"7-out4650"	.17916	43	197	240
7	"7-out4651"	.14843	19	109	128
7	"7-out4652"	.20689	54	207	261
7	"7-out4653"	.31531	105	228	333
7	"7-out4654"	.56603	420	322	742
7	"7-out4655"	.11695	20	151	171
7	"7-out4656"	.34468	81	154	235
7	"7-out4657"	.18040	81	368	449
7	"7-out4658"	.21440	128	469	597
7	"7-out4659"	.67357	130	63	193
7	"7-out4660"	.31250	65	143	208
7	"7-out4661"	.18738	98	425	523
7	"7-out4662"	.62090	1461	892	2353
7	"7-out4663"	.33468	744	1479	2223
7	"7-out4664"	.30065	138	321	459
7	"7-out4665"	.20433	66	257	323
7	"7-out4666"	.20919	91	344	435
7	"7-out4667"	.79687	102	26	128
7	"7-out4668"	.29523	93	222	315
7	"7-out4669"	.24705	42	128	170
7	"7-out4670"	.18976	304	1298	1602
7	"7-out4671"	.18906	121	519	640
7	"7-out4672"	.19401	266	1105	1371
7	"7-out4673"	.15555	91	494	585
7	"7-out4674"	.24705	63	192	255
7	"7-out4675"	.23590	113	366	479
7	"7-out4676"	.42181	116	159	275
7	"7-out4677"	.19732	59	240	299
7	"7-out4678"	.16512	178	900	1078
7	"7-out4679"	.93119	203	15	218
7	"7-out4680"	.24620	81	248	329
7	"7-out4681"	.85889	140	23	163
7	"7-out4682"	.15990	67	352	419
7	"7-out4683"	.17617	173	809	982
7	"7-out4684"	.16593	38	191	229
7	"7-out4685"	.12341	68	483	551
7	"7-out4686"	.12341	68	483	551
7	"7-out4687"	.17525	17	80	97
7	"7-out4688"	.35740	99	178	277
7	"7-out4689"	.30303	180	414	594
7	"7-out4690"	.42682	630	846	1476
7	"7-out4691"	.95189	376	19	395
7	"7-out4692"	.29588	79	188	267
7	"7-out4693"	.37895	551	903	1454
7	"7-out4694"	.51899	560	519	1079
7	"7-out4695"	.18036	79	359	438
7	"7-out4696"	.25806	24	69	93
7	"7-out4697"	.23880	64	204	268
7	"7-out4698"	.37683	205	339	544
7	"7-out4699"	.29553	159	379	538
7	"7-out4700"	.12956	110	739	849
7	"7-out4701"	.76235	324	101	425
7	"7-out4702"	.89010	81	10	91
7	"7-out4703"	.39208	307	476	783
7	"7-out4704"	.55437	209	168	377
7	"7-out4705"	.23867	158	504	662
7	"7-out4706"	.18811	57	246	303
7	"7-out4707"	.17829	69	318	387
7	"7-out4708"	.70629	202	84	286
7	"7-out4709"	.24945	230	692	922
7	"7-out4710"	.43413	145	189	334
7	"7-out4711"	.31481	51	111	162
7	"7-out4712"	.93518	101	7	108
7	"7-out4713"	.29059	34	83	117
7	"7-out4714"	.13092	116	770	886
7	"7-out4715"	.28906	37	91	128
7	"7-out4716"	.29289	338	816	1154
7	"7-out4717"	.41641	279	391	670
7	"7-out4718"	.16666	30	150	180
7	"7-out4719"	.22349	137	476	613
7	"7-out4720"	.26998	358	968	1326
7	"7-out4721"	.40326	444	657	1101
7	"7-out4722"	.65354	166	88	254
7	"7-out4723"	.50549	138	135	273
7	"7-out4724"	.43076	140	185	325
7	"7-out4725"	.35500	71	129	200
7	"7-out4726"	.24077	150	473	623
7	"7-out4727"	.39817	131	198	329
7	"7-out4728"	.39011	371	580	951
7	"7-out4729"	.96666	87	3	90
7	"7-out4730"	.95138	137	7	144
7	"7-out4731"	.79566	1102	283	1385
7	"7-out4732"	.81521	75	17	92
7	"7-out4733"	.34375	33	63	96
7	"7-out4734"	.30000	57	133	190
7	"7-out4735"	.19047	68	289	357
7	"7-out4736"	.20215	94	371	465
7	"7-out4737"	.21388	77	283	360
7	"7-out4738"	.41192	152	217	369
7	"7-out4739"	.34405	139	265	404
7	"7-out4740"	.90725	225	23	248
7	"7-out4741"	.34237	101	194	295
7	"7-out4742"	.90027	325	36	361
7	"7-out4743"	.31141	450	995	1445
7	"7-out4744"	.14963	41	233	274
7	"7-out4745"	.94623	88	5	93
7	"7-out4746"	.11585	19	145	164
7	"7-out4747"	.33333	73	146	219
7	"7-out4748"	.26486	98	272	370
7	"7-out4749"	.16101	38	198	236
7	"7-out4750"	.57936	219	159	378
7	"7-out4751"	.95027	344	18	362
7	"7-out4752"	.09160	12	119	131
7	"7-out4753"	.44311	74	93	167
7	"7-out4754"	.99218	127	1	128
7	"7-out4755"	.33333	259	518	777
7	"7-out4756"	.23014	455	1522	1977
7	"7-out4757"	.87213	266	39	305
7	"7-out4758"	.41109	326	467	793
7	"7-out4759"	.14545	96	564	660
7	"7-out4760"	.13144	51	337	388
7	"7-out4761"	.14942	52	296	348
7	"7-out4762"	.20569	253	977	1230
7	"7-out4763"	.21197	85	316	401
7	"7-out4764"	.13585	97	617	714
7	"7-out4765"	.18252	117	524	641
7	"7-out4766"	.31415	71	155	226
7	"7-out4767"	.11616	69	525	594
7	"7-out4768"	.19148	63	266	329
7	"7-out4769"	.26315	105	294	399
7	"7-out4770"	.70629	202	84	286
7	"7-out4771"	.62000	93	57	150
7	"7-out4772"	.39694	52	79	131
7	"7-out4773"	.19298	44	184	228
7	"7-out4774"	.42771	71	95	166
7	"7-out4775"	.20941	89	336	425
7	"7-out4776"	.09501	40	381	421
7	"7-out4777"	.17448	186	880	1066
7	"7-out4778"	.23927	106	337	443
7	"7-out4779"	.15283	70	388	458
7	"7-out4780"	.22797	44	149	193
7	"7-out4781"	.13368	50	324	374
7	"7-out4782"	.20024	489	1953	2442
7	"7-out4783"	.24159	115	361	476
7	"7-out4784"	.23164	284	942	1226
7	"7-out4785"	.17932	85	389	474
7	"7-out4786"	.85714	540	90	630
7	"7-out4787"	.95189	376	19	395
7	"7-out4788"	.97058	66	2	68
7	"7-out4789"	.23280	396	1305	1701
7	"7-out4790"	.56974	290	219	509
7	"7-out4791"	.19528	58	239	297
7	"7-out4792"	.70741	353	146	499
7	"7-out4793"	.13622	44	279	323
7	"7-out4794"	.18965	77	329	406
7	"7-out4795"	.32203	171	360	531
7	"7-out4796"	.18083	117	530	647
7	"7-out4797"	.12105	23	167	190
7	"7-out4798"	.24596	61	187	248
7	"7-out4799"	.96521	222	8	230
7	"7-out4800"	.31914	135	288	423
7	"7-out4801"	.47604	159	175	334
7	"7-out4802"	.92387	716	59	775
7	"7-out4803"	.26982	211	571	782
7	"7-out4804"	.11585	38	290	328
7	"7-out4805"	.26058	80	227	307
7	"7-out4806"	.93448	271	19	290
7	"7-out4807"	.22071	130	459	589
7	"7-out4808"	.13001	94	629	723
7	"7-out4809"	.23589	138	447	585
7	"7-out4810"	.31788	96	206	302
7	"7-out4811"	.20812	82	312	394
7	"7-out4812"	.22926	423	1422	1845
7	"7-out4813"	.42346	296	403	699
7	"7-out4814"	.27894	200	517	717
7	"7-out4815"	.17329	170	811	981
7	"7-out4816"	.43103	75	99	174
7	"7-out4817"	.19790	189	766	955
7	"7-out4818"	.26760	38	104	142
7	"7-out4819"	.87878	29	4	33
7	"7-out4820"	.15545	67	364	431
7	"7-out4821"	.20634	26	100	126
7	"7-out4822"	.04098	5	117	122
7	"7-out4823"	.95454	252	12	264
7	"7-out4824"	.85763	247	41	288
7	"7-out4825"	.67558	202	97	299
7	"7-out4826"	.58095	122	88	210
7	"7-out4827"	.41741	508	709	1217
7	"7-out4828"	.46003	259	304	563
7	"7-out4829"	.32778	315	646	961
7	"7-out4830"	.15325	40	221	261
7	"7-out4831"	.17028	47	229	276
7	"7-out4832"	.89575	696	81	777
7	"7-out4833"	.34977	78	145	223
7	"7-out4834"	.77647	264	76	340
7	"7-out4835"	.56849	83	63	146
7	"7-out4836"	.28770	206	510	716
7	"7-out4837"	.08139	21	237	258
7	"7-out4838"	.69383	349	154	503
7	"7-out4839"	.36842	42	72	114
7	"7-out4840"	.34811	212	397	609
7	"7-out4841"	.79078	635	168	803
7	"7-out4842"	.25438	261	765	1026
7	"7-out4843"	.19460	101	418	519
7	"7-out4844"	.90926	1854	185	2039
7	"7-out4845"	.83653	261	51	312
7	"7-out4846"	.28375	124	313	437
7	"7-out4847"	.92233	380	32	412
7	"7-out4848"	.30663	134	303	437
7	"7-out4849"	.61505	286	179	465
7	"7-out4850"	.45408	89	107	196
7	"7-out4851"	.60919	106	68	174
7	"7-out4852"	.22527	41	141	182
7	"7-out4853"	.45544	46	55	101
7	"7-out4854"	.33649	142	280	422
7	"7-out4855"	.70081	342	146	488
7	"7-out4856"	.69608	1404	613	2017
7	"7-out4857"	.19736	60	244	304
7	"7-out4858"	.88153	253	34	287
7	"7-out4859"	.24635	169	517	686
7	"7-out4860"	.15800	79	421	500
7	"7-out4861"	.28080	139	356	495
7	"7-out4862"	.16996	43	210	253
7	"7-out4863"	.32169	129	272	401
7	"7-out4864"	.09826	17	156	173
7	"7-out4865"	.23684	36	116	152
7	"7-out4866"	.23728	28	90	118
7	"7-out4867"	.21367	25	92	117
7	"7-out4868"	.23076	81	270	351
7	"7-out4869"	.13875	29	180	209
7	"7-out4870"	.38759	50	79	129
7	"7-out4871"	.93939	186	12	198
7	"7-out4872"	.49264	67	69	136
7	"7-out4873"	.15821	78	415	493
7	"7-out4874"	.95098	97	5	102
7	"7-out4875"	.65625	546	286	832
7	"7-out4876"	.27127	153	411	564
7	"7-out4877"	.09826	17	156	173
7	"7-out4878"	.17968	46	210	256
7	"7-out4879"	.24729	137	417	554
7	"7-out4880"	.91705	199	18	217
7	"7-out4881"	.37500	54	90	144
7	"7-out4882"	.67519	264	127	391
7	"7-out4883"	.25296	362	1069	1431
7	"7-out4884"	.22046	265	937	1202
7	"7-out4885"	.70843	277	114	391
7	"7-out4886"	.35789	102	183	285
7	"7-out4887"	.46435	228	263	491
7	"7-out4888"	.11042	36	290	326
7	"7-out4889"	.67919	235	111	346
7	"7-out4890"	.87951	146	20	166
7	"7-out4891"	.91481	494	46	540
7	"7-out4892"	.20212	38	150	188
7	"7-out4893"	.31250	30	66	96
7	"7-out4894"	.36920	518	885	1403
7	"7-out4895"	.30952	169	377	546
7	"7-out4896"	.31928	250	533	783
7	"7-out4897"	.32361	433	905	1338
7	"7-out4898"	.21906	154	549	703
7	"7-out4899"	.56441	92	71	163
7	"7-out4900"	.90731	186	19	205
7	"7-out4901"	.24736	94	286	380
7	"7-out4902"	.30510	508	1157	1665
7	"7-out4903"	.70000	168	72	240
7	"7-out4904"	.23605	55	178	233
7	"7-out4905"	.28217	57	145	202
7	"7-out4906"	.83636	138	27	165
7	"7-out4907"	.49775	111	112	223
7	"7-out4908"	.95049	96	5	101
7	"7-out4909"	.19963	108	433	541
7	"7-out4910"	.24938	101	304	405
7	"7-out4911"	.95652	88	4	92
7	"7-out4912"	.27419	68	180	248
7	"7-out4913"	.30341	71	163	234
7	"7-out4914"	.27802	62	161	223
7	"7-out4915"	.15606	27	146	173
7	"7-out4916"	.34868	53	99	152
7	"7-out4917"	.28828	96	237	333
7	"7-out4918"	.74203	233	81	314
7	"7-out4919"	.53333	48	42	90
7	"7-out4920"	.21052	12	45	57
7	"7-out4921"	.95126	488	25	513
7	"7-out4922"	.17237	166	797	963
7	"7-out4923"	.21456	109	399	508
7	"7-out4924"	.35443	56	102	158
7	"7-out4925"	.86346	449	71	520
7	"7-out4926"	.91348	454	43	497
7	"7-out4927"	.87626	432	61	493
7	"7-out4928"	.15655	80	431	511
7	"7-out4929"	.25836	224	643	867
7	"7-out4930"	.32608	165	341	506
7	"7-out4931"	.45526	229	274	503
7	"7-out4932"	.28571	134	335	469
7	"7-out4933"	.25087	143	427	570
7	"7-out4934"	.35272	97	178	275
7	"7-out4935"	.95714	67	3	70
7	"7-out4936"	.31552	124	269	393
7	"7-out4937"	.38255	57	92	149
7	"7-out4938"	.09720	87	808	895
7	"7-out4939"	.18539	198	870	1068
7	"7-out4940"	.23232	23	76	99
7	"7-out4941"	.47761	32	35	67
7	"7-out4942"	.26315	25	70	95
7	"7-out4943"	.33802	24	47	71
7	"7-out4944"	.53559	158	137	295
7	"7-out4945"	.23417	37	121	158
7	"7-out4946"	.15724	64	343	407
7	"7-out4947"	.21300	131	484	615
7	"7-out4948"	.45500	273	327	600
7	"7-out4949"	.82250	519	112	631
7	"7-out4950"	.21288	119	440	559
7	"7-out4951"	.23620	107	346	453
7	"7-out4952"	.25663	87	252	339
7	"7-out4953"	.48164	223	240	463
7	"7-out4954"	.11695	40	302	342
7	"7-out4955"	.41958	300	415	715
7	"7-out4956"	.30451	236	539	775
7	"7-out4957"	.36428	153	267	420
7	"7-out4958"	.13649	46	291	337
7	"7-out4959"	.50000	346	346	692
7	"7-out4960"	.59340	108	74	182
7	"7-out4961"	.06811	25	342	367
7	"7-out4962"	.64853	310	168	478
7	"7-out4963"	.68058	326	153	479
7	"7-out4964"	.14385	41	244	285
7	"7-out4965"	.23076	39	130	169
7	"7-out4966"	.55853	458	362	820
7	"7-out4967"	.17098	33	160	193
7	"7-out4968"	.17929	97	444	541
7	"7-out4969"	.14531	76	447	523
7	"7-out4970"	.19375	31	129	160
7	"7-out4971"	.27941	38	98	136
7	"7-out4972"	.90804	79	8	87
7	"7-out4973"	.17391	12	57	69
7	"7-out4974"	.13157	10	66	76
7	"7-out4975"	.93189	520	38	558
7	"7-out4976"	.11453	52	402	454
7	"7-out4977"	.26868	133	362	495
7	"7-out4978"	.19532	184	758	942
7	"7-out4979"	.12702	94	646	740
7	"7-out4980"	.17592	114	534	648
7	"7-out4981"	.16292	29	149	178
7	"7-out4982"	.19892	37	149	186
7	"7-out4983"	.27510	263	693	956
7	"7-out4984"	.25731	334	964	1298
7	"7-out4985"	.14935	23	131	154
7	"7-out4986"	.97142	68	2	70
7	"7-out4987"	.45901	28	33	61
7	"7-out4988"	.34328	23	44	67
7	"7-out4989"	.19459	72	298	370
7	"7-out4990"	.22507	79	272	351
7	"7-out4991"	.48953	421	439	860
7	"7-out4992"	.82277	1467	316	1783
7	"7-out4993"	.66771	426	212	638
7	"7-out4994"	.19931	116	466	582
7	"7-out4995"	.29538	96	229	325
7	"7-out4996"	.15000	45	255	300
7	"7-out4997"	.95744	360	16	376
7	"7-out4998"	.92307	60	5	65
7	"7-out4999"	.94854	719	39	758
7	"7-out5000"	.28415	52	131	183
7	"7-out5001"	.23373	97	318	415
7	"7-out5002"	.04901	5	97	102
7	"7-out5003"	.35772	44	79	123
7	"7-out5004"	.92424	61	5	66
7	"7-out5005"	.14102	11	67	78
7	"7-out5006"	.96153	150	6	156
7	"7-out5007"	.27027	30	81	111
7	"7-out5008"	.93918	139	9	148
7	"7-out5009"	.28860	114	281	395
7	"7-out5010"	.21323	116	428	544
7	"7-out5011"	.78426	349	96	445
7	"7-out5012"	.38153	124	201	325
7	"7-out5013"	.30318	181	416	597
7	"7-out5014"	.16203	35	181	216
7	"7-out5015"	.30769	160	360	520
7	"7-out5016"	.11688	27	204	231
7	"7-out5017"	.40145	605	902	1507
7	"7-out5018"	.34453	164	312	476
7	"7-out5019"	.15894	230	1217	1447
7	"7-out5020"	.16124	104	541	645
7	"7-out5021"	.12355	32	227	259
7	"7-out5022"	.16834	67	331	398
7	"7-out5023"	.17346	17	81	98
7	"7-out5024"	.23545	263	854	1117
7	"7-out5025"	.39263	64	99	163
7	"7-out5026"	.96280	233	9	242
7	"7-out5027"	.29396	112	269	381
7	"7-out5028"	.26887	146	397	543
7	"7-out5029"	.94761	398	22	420
7	"7-out5030"	.16496	97	491	588
7	"7-out5031"	.45714	128	152	280
7	"7-out5032"	.22123	25	88	113
7	"7-out5033"	.21216	157	583	740
7	"7-out5034"	.90053	670	74	744
7	"7-out5035"	.93209	453	33	486
7	"7-out5036"	.90846	526	53	579
7	"7-out5037"	.83679	564	110	674
7	"7-out5038"	.17441	75	355	430
7	"7-out5039"	.17272	247	1183	1430
7	"7-out5040"	.56989	371	280	651
7	"7-out5041"	.39367	137	211	348
7	"7-out5042"	.19289	76	318	394
7	"7-out5043"	.95384	186	9	195
7	"7-out5044"	.90026	343	38	381
7	"7-out5045"	.30362	109	250	359
7	"7-out5046"	.46422	292	337	629
7	"7-out5047"	.26548	30	83	113
7	"7-out5048"	.88343	144	19	163
7	"7-out5049"	.22727	175	595	770
7	"7-out5050"	.18500	74	326	400
7	"7-out5051"	.33824	344	673	1017
7	"7-out5052"	.73049	103	38	141
7	"7-out5053"	.41774	226	315	541
7	"7-out5054"	.92654	391	31	422
7	"7-out5055"	.21172	177	659	836
7	"7-out5056"	.89356	764	91	855
7	"7-out5057"	.97080	133	4	137
7	"7-out5058"	.24852	169	511	680
7	"7-out5059"	.24845	282	853	1135
7	"7-out5060"	.21415	118	433	551
7	"7-out5061"	.33777	76	149	225
7	"7-out5062"	.40533	167	245	412
7	"7-out5063"	.26735	104	285	389
7	"7-out5064"	.80211	304	75	379
7	"7-out5065"	.16157	180	934	1114
7	"7-out5066"	.31076	101	224	325
7	"7-out5067"	.54756	236	195	431
7	"7-out5068"	.33711	119	234	353
7	"7-out5069"	.25142	44	131	175
7	"7-out5070"	.45454	95	114	209
7	"7-out5071"	.36559	68	118	186
7	"7-out5072"	.25301	42	124	166
7	"7-out5073"	.92753	128	10	138
7	"7-out5074"	.28078	171	438	609
7	"7-out5075"	.31630	260	562	822
7	"7-out5076"	.08764	22	229	251
7	"7-out5077"	.20210	96	379	475
7	"7-out5078"	.31174	361	797	1158
7	"7-out5079"	.25379	184	541	725
7	"7-out5080"	.25708	118	341	459
7	"7-out5081"	.34412	85	162	247
7	"7-out5082"	.77976	393	111	504
7	"7-out5083"	.43689	90	116	206
7	"7-out5084"	.93939	310	20	330
7	"7-out5085"	.44292	357	449	806
7	"7-out5086"	.50092	270	269	539
7	"7-out5087"	.83790	977	189	1166
7	"7-out5088"	.13729	60	377	437
7	"7-out5089"	.21198	244	907	1151
7	"7-out5090"	.20613	121	466	587
7	"7-out5091"	.47397	173	192	365
7	"7-out5092"	.29100	110	268	378
7	"7-out5093"	.20052	153	610	763
7	"7-out5094"	.84242	278	52	330
7	"7-out5095"	.15244	134	745	879
7	"7-out5096"	.19881	101	407	508
7	"7-out5097"	.23780	117	375	492
7	"7-out5098"	.18491	586	2583	3169
7	"7-out5099"	.43757	361	464	825
7	"7-out5100"	.29122	166	404	570
7	"7-out5101"	.23373	115	377	492
7	"7-out5102"	.06425	32	466	498
7	"7-out5103"	.24339	129	401	530
7	"7-out5104"	.81000	162	38	200
7	"7-out5105"	.23118	43	143	186
7	"7-out5106"	.20178	68	269	337
7	"7-out5107"	.11548	44	337	381
7	"7-out5108"	.92622	113	9	122
7	"7-out5109"	.19675	97	396	493
7	"7-out5110"	.31607	293	634	927
7	"7-out5111"	.52344	547	498	1045
7	"7-out5112"	.17993	113	515	628
7	"7-out5113"	.14486	103	608	711
7	"7-out5114"	.71808	135	53	188
7	"7-out5115"	.23641	87	281	368
7	"7-out5116"	.28260	130	330	460
7	"7-out5117"	.54377	236	198	434
7	"7-out5118"	.24666	74	226	300
7	"7-out5119"	.23636	78	252	330
7	"7-out5120"	.87572	303	43	346
7	"7-out5121"	.32095	121	256	377
7	"7-out5122"	.18004	148	674	822
7	"7-out5123"	.63917	124	70	194
7	"7-out5124"	.25212	356	1056	1412
7	"7-out5125"	.51366	94	89	183
7	"7-out5126"	.86069	173	28	201
7	"7-out5127"	.53199	1272	1119	2391
7	"7-out5128"	.20327	87	341	428
7	"7-out5129"	.13297	50	326	376
7	"7-out5130"	.17871	131	602	733
7	"7-out5131"	.24375	439	1362	1801
7	"7-out5132"	.35276	115	211	326
7	"7-out5133"	.21890	132	471	603
7	"7-out5134"	.33972	124	241	365
7	"7-out5135"	.89763	456	52	508
7	"7-out5136"	.09368	46	445	491
7	"7-out5137"	.29946	112	262	374
7	"7-out5138"	.17273	503	2409	2912
7	"7-out5139"	.68908	461	208	669
7	"7-out5140"	.23263	211	696	907
7	"7-out5141"	.94982	549	29	578
7	"7-out5142"	.83304	474	95	569
7	"7-out5143"	.51445	89	84	173
7	"7-out5144"	.20919	141	533	674
7	"7-out5145"	.55421	92	74	166
7	"7-out5146"	.52321	169	154	323
7	"7-out5147"	.15171	362	2024	2386
7	"7-out5148"	.27822	138	358	496
7	"7-out5149"	.29794	87	205	292
7	"7-out5150"	.27099	71	191	262
7	"7-out5151"	.50205	612	607	1219
7	"7-out5152"	.84035	479	91	570
7	"7-out5153"	.60714	136	88	224
7	"7-out5154"	.89887	80	9	89
7	"7-out5155"	.15969	84	442	526
7	"7-out5156"	.84513	191	35	226
7	"7-out5157"	.44705	114	141	255
7	"7-out5158"	.79012	192	51	243
7	"7-out5159"	.37822	205	337	542
7	"7-out5160"	.17058	58	282	340
7	"7-out5161"	.24097	888	2797	3685
7	"7-out5162"	.15937	656	3460	4116
7	"7-out5163"	.19204	888	3736	4624
7	"7-out5164"	.15820	735	3911	4646
7	"7-out5165"	.23529	148	481	629
7	"7-out5166"	.42201	1480	2027	3507
7	"7-out5167"	.13477	81	520	601
7	"7-out5168"	.22500	117	403	520
7	"7-out5169"	.11176	38	302	340
7	"7-out5170"	.44719	199	246	445
7	"7-out5171"	.18907	90	386	476
7	"7-out5172"	.59692	194	131	325
7	"7-out5173"	.85658	221	37	258
7	"7-out5174"	.21527	155	565	720
7	"7-out5175"	.18401	122	541	663
7	"7-out5176"	.73437	470	170	640
7	"7-out5177"	.31738	126	271	397
7	"7-out5178"	.35031	110	204	314
7	"7-out5179"	.20658	69	265	334
7	"7-out5180"	.19414	126	523	649
7	"7-out5181"	.35693	242	436	678
7	"7-out5182"	.16351	121	619	740
7	"7-out5183"	.91732	233	21	254
7	"7-out5184"	.40575	127	186	313
7	"7-out5185"	.28025	132	339	471
7	"7-out5186"	.26503	141	391	532
7	"7-out5187"	.22118	71	250	321
7	"7-out5188"	.14018	60	368	428
7	"7-out5189"	.72549	333	126	459
7	"7-out5190"	.32882	73	149	222
7	"7-out5191"	.26133	317	896	1213
7	"7-out5192"	.32113	553	1169	1722
7	"7-out5193"	.16574	180	906	1086
7	"7-out5194"	.14821	79	454	533
7	"7-out5195"	.83484	369	73	442
7	"7-out5196"	.14285	32	192	224
7	"7-out5197"	.32350	329	688	1017
7	"7-out5198"	.61829	622	384	1006
7	"7-out5199"	.47878	237	258	495
7	"7-out5200"	.38840	134	211	345
7	"7-out5201"	.90746	1628	166	1794
7	"7-out5202"	.16674	343	1714	2057
7	"7-out5203"	.19063	354	1503	1857
7	"7-out5204"	.82384	304	65	369
7	"7-out5205"	.25684	75	217	292
7	"7-out5206"	.29783	193	455	648
7	"7-out5207"	.19342	100	417	517
7	"7-out5208"	.91304	273	26	299
7	"7-out5209"	.19742	261	1061	1322
7	"7-out5210"	.43023	148	196	344
7	"7-out5211"	.70059	234	100	334
7	"7-out5212"	.23821	96	307	403
7	"7-out5213"	.19057	93	395	488
7	"7-out5214"	.24137	112	352	464
7	"7-out5215"	.25387	180	529	709
7	"7-out5216"	.93031	267	20	287
7	"7-out5217"	.16875	121	596	717
7	"7-out5218"	.24547	95	292	387
7	"7-out5219"	.26483	183	508	691
7	"7-out5220"	.06230	20	301	321
7	"7-out5221"	.19099	157	665	822
7	"7-out5222"	.18957	40	171	211
7	"7-out5223"	.27057	286	771	1057
7	"7-out5224"	.16624	65	326	391
7	"7-out5225"	.08620	35	371	406
7	"7-out5226"	.31330	73	160	233
7	"7-out5227"	.19047	28	119	147
7	"7-out5228"	.36559	68	118	186
7	"7-out5229"	.12008	55	403	458
7	"7-out5230"	.83920	548	105	653
7	"7-out5231"	.32692	102	210	312
7	"7-out5232"	.47767	107	117	224
7	"7-out5233"	.15412	43	236	279
7	"7-out5234"	.21478	186	680	866
7	"7-out5235"	.18126	180	813	993
7	"7-out5236"	.56589	803	616	1419
7	"7-out5237"	.93663	340	23	363
7	"7-out5238"	.26582	168	464	632
7	"7-out5239"	.30578	148	336	484
7	"7-out5240"	.29807	62	146	208
7	"7-out5241"	.42776	151	202	353
7	"7-out5242"	.24151	185	581	766
7	"7-out5243"	.11031	46	371	417
7	"7-out5244"	.69565	144	63	207
7	"7-out5245"	.34309	82	157	239
7	"7-out5246"	.13028	37	247	284
7	"7-out5247"	.14903	31	177	208
7	"7-out5248"	.16686	137	684	821
7	"7-out5249"	.95151	314	16	330
7	"7-out5250"	.26859	307	836	1143
7	"7-out5251"	.24724	112	341	453
7	"7-out5252"	.47139	206	231	437
7	"7-out5253"	.23030	114	381	495
7	"7-out5254"	.13790	175	1094	1269
7	"7-out5255"	.16814	19	94	113
7	"7-out5256"	.13375	63	408	471
7	"7-out5257"	.13467	87	559	646
7	"7-out5258"	.87570	155	22	177
7	"7-out5259"	.93197	137	10	147
7	"7-out5260"	.39539	189	289	478
7	"7-out5261"	.13154	98	647	745
7	"7-out5262"	.24197	196	614	810
7	"7-out5263"	.78733	174	47	221
7	"7-out5264"	.75000	81	27	108
7	"7-out5265"	.54740	179	148	327
7	"7-out5266"	.24078	111	350	461
7	"7-out5267"	.19718	28	114	142
7	"7-out5268"	.20112	107	425	532
7	"7-out5269"	.89887	80	9	89
7	"7-out5270"	.18968	195	833	1028
7	"7-out5271"	.36569	113	196	309
7	"7-out5272"	.77623	392	113	505
7	"7-out5273"	.22285	78	272	350
7	"7-out5274"	.62231	145	88	233
7	"7-out5275"	.71904	151	59	210
7	"7-out5276"	.83054	348	71	419
7	"7-out5277"	.46530	228	262	490
7	"7-out5278"	.75789	288	92	380
7	"7-out5279"	.50000	85	85	170
7	"7-out5280"	.17283	42	201	243
7	"7-out5281"	.33515	490	972	1462
7	"7-out5282"	.44927	93	114	207
7	"7-out5283"	.25000	54	162	216
7	"7-out5284"	.17537	47	221	268
7	"7-out5285"	.19931	232	932	1164
7	"7-out5286"	.40000	62	93	155
7	"7-out5287"	.34123	72	139	211
7	"7-out5288"	.20000	37	148	185
7	"7-out5289"	.16151	94	488	582
7	"7-out5290"	.40740	44	64	108
7	"7-out5291"	.11461	40	309	349
7	"7-out5292"	.11946	54	398	452
7	"7-out5293"	.89887	80	9	89
7	"7-out5294"	.17361	25	119	144
7	"7-out5295"	.85884	432	71	503
7	"7-out5296"	.56684	530	405	935
7	"7-out5297"	.12252	31	222	253
7	"7-out5298"	.17551	43	202	245
7	"7-out5299"	.23193	199	659	858
7	"7-out5300"	.51063	168	161	329
7	"7-out5301"	.19784	55	223	278
7	"7-out5302"	.15570	45	244	289
7	"7-out5303"	.39698	79	120	199
7	"7-out5304"	.02958	5	164	169
7	"7-out5305"	.08241	15	167	182
7	"7-out5306"	.91935	114	10	124
7	"7-out5307"	.51034	74	71	145
7	"7-out5308"	.18709	29	126	155
7	"7-out5309"	.93051	1366	102	1468
7	"7-out5310"	.20220	55	217	272
7	"7-out5311"	.28242	135	343	478
7	"7-out5312"	.23152	47	156	203
7	"7-out5313"	.38148	956	1550	2506
7	"7-out5314"	.19545	43	177	220
7	"7-out5315"	.23770	556	1783	2339
7	"7-out5316"	.08101	64	726	790
7	"7-out5317"	.33333	123	246	369
7	"7-out5318"	.20547	45	174	219
7	"7-out5319"	.14893	119	680	799
7	"7-out5320"	.27960	229	590	819
7	"7-out5321"	.23642	148	478	626
7	"7-out5322"	.32584	116	240	356
7	"7-out5323"	.14634	48	280	328
7	"7-out5324"	.20338	72	282	354
7	"7-out5325"	.32051	100	212	312
7	"7-out5326"	.14935	46	262	308
7	"7-out5327"	.23756	43	138	181
7	"7-out5328"	.85156	327	57	384
7	"7-out5329"	.20134	30	119	149
7	"7-out5330"	.73894	351	124	475
7	"7-out5331"	.29729	88	208	296
7	"7-out5332"	.20149	108	428	536
7	"7-out5333"	.22184	65	228	293
7	"7-out5334"	.20943	71	268	339
7	"7-out5335"	.91139	72	7	79
7	"7-out5336"	.27447	143	378	521
7	"7-out5337"	.29263	163	394	557
7	"7-out5338"	.26132	75	212	287
7	"7-out5339"	.53753	179	154	333
7	"7-out5340"	.21186	100	372	472
7	"7-out5341"	.25738	122	352	474
7	"7-out5342"	.16312	23	118	141
7	"7-out5343"	.13992	75	461	536
7	"7-out5344"	.33402	161	321	482
7	"7-out5345"	.14877	79	452	531
7	"7-out5346"	.25787	131	377	508
7	"7-out5347"	.37216	230	388	618
7	"7-out5348"	.90754	373	38	411
7	"7-out5349"	.25153	82	244	326
7	"7-out5350"	.18685	91	396	487
7	"7-out5351"	.12609	158	1095	1253
7	"7-out5352"	.25059	105	314	419
7	"7-out5353"	.35606	47	85	132
7	"7-out5354"	.51072	238	228	466
7	"7-out5355"	.52523	281	254	535
7	"7-out5356"	.26190	99	279	378
7	"7-out5357"	.20501	237	919	1156
7	"7-out5358"	.23238	221	730	951
7	"7-out5359"	.30252	72	166	238
7	"7-out5360"	.19478	127	525	652
7	"7-out5361"	.20325	50	196	246
7	"7-out5362"	.13888	35	217	252
7	"7-out5363"	.18480	90	397	487
7	"7-out5364"	.26913	436	1184	1620
7	"7-out5365"	.17168	194	936	1130
7	"7-out5366"	.13932	152	939	1091
7	"7-out5367"	.10891	11	90	101
7	"7-out5368"	.94871	185	10	195
7	"7-out5369"	.88625	187	24	211
7	"7-out5370"	.27315	233	620	853
7	"7-out5371"	.21965	38	135	173
7	"7-out5372"	.18820	166	716	882
7	"7-out5373"	.14669	492	2862	3354
7	"7-out5374"	.31165	139	307	446
7	"7-out5375"	.85958	502	82	584
7	"7-out5376"	.93037	147	11	158
7	"7-out5377"	.17460	22	104	126
7	"7-out5378"	.90793	286	29	315
7	"7-out5379"	.24163	231	725	956
7	"7-out5380"	.43649	244	315	559
7	"7-out5381"	.17893	141	647	788
7	"7-out5382"	.27184	84	225	309
7	"7-out5383"	.40952	129	186	315
7	"7-out5384"	.24045	63	199	262
7	"7-out5385"	.69287	564	250	814
7	"7-out5386"	.11271	39	307	346
7	"7-out5387"	.39262	181	280	461
7	"7-out5388"	.10179	51	450	501
7	"7-out5389"	.85988	1074	175	1249
7	"7-out5390"	.15537	39	212	251
7	"7-out5391"	.82222	74	16	90
7	"7-out5392"	.68129	295	138	433
7	"7-out5393"	.35633	284	513	797
7	"7-out5394"	.76446	185	57	242
7	"7-out5395"	.19471	81	335	416
7	"7-out5396"	.12359	22	156	178
7	"7-out5397"	.64964	458	247	705
7	"7-out5398"	.21728	88	317	405
7	"7-out5399"	.39463	103	158	261
7	"7-out5400"	.21967	96	341	437
7	"7-out5401"	.26190	33	93	126
7	"7-out5402"	.74380	180	62	242
7	"7-out5403"	.25000	226	678	904
7	"7-out5404"	.22266	167	583	750
7	"7-out5405"	.27120	665	1787	2452
7	"7-out5406"	.34408	96	183	279
7	"7-out5407"	.43683	204	263	467
7	"7-out5408"	.49432	392	401	793
7	"7-out5409"	.16638	99	496	595
7	"7-out5410"	.39762	268	406	674
7	"7-out5411"	.81967	150	33	183
7	"7-out5412"	.13537	106	677	783
7	"7-out5413"	.87864	181	25	206
7	"7-out5414"	.17241	30	144	174
7	"7-out5415"	.94197	276	17	293
7	"7-out5416"	.09824	28	257	285
7	"7-out5417"	.31490	188	409	597
7	"7-out5418"	.69848	739	319	1058
7	"7-out5419"	.38016	46	75	121
7	"7-out5420"	.95833	92	4	96
7	"7-out5421"	.96825	122	4	126
7	"7-out5422"	.14847	34	195	229
7	"7-out5423"	.27488	174	459	633
7	"7-out5424"	.17073	112	544	656
7	"7-out5425"	.24448	543	1678	2221
7	"7-out5426"	.21274	177	655	832
7	"7-out5427"	.18891	150	644	794
7	"7-out5428"	.21954	182	647	829
7	"7-out5429"	.21000	147	553	700
7	"7-out5430"	.23391	160	524	684
7	"7-out5431"	.20473	277	1076	1353
7	"7-out5432"	.22010	254	900	1154
7	"7-out5433"	.93421	213	15	228
7	"7-out5434"	.69554	281	123	404
7	"7-out5435"	.14835	27	155	182
7	"7-out5436"	.14626	49	286	335
7	"7-out5437"	.27044	205	553	758
7	"7-out5438"	.24046	82	259	341
7	"7-out5439"	.35058	332	615	947
7	"7-out5440"	.78747	415	112	527
7	"7-out5441"	.40274	176	261	437
7	"7-out5442"	.94583	1170	67	1237
7	"7-out5443"	.65582	242	127	369
7	"7-out5444"	.65384	238	126	364
7	"7-out5445"	.19811	63	255	318
7	"7-out5446"	.19622	135	553	688
7	"7-out5447"	.57223	202	151	353
7	"7-out5448"	.12252	31	222	253
7	"7-out5449"	.54852	130	107	237
7	"7-out5450"	.31972	47	100	147
7	"7-out5451"	.33879	62	121	183
7	"7-out5452"	.24340	83	258	341
7	"7-out5453"	.26511	57	158	215
7	"7-out5454"	.20689	54	207	261
7	"7-out5455"	.17363	137	652	789
7	"7-out5456"	.22370	285	989	1274
7	"7-out5457"	.19095	76	322	398
7	"7-out5458"	.17985	75	342	417
7	"7-out5459"	.19488	160	661	821
7	"7-out5460"	.21375	143	526	669
7	"7-out5461"	.18441	239	1057	1296
7	"7-out5462"	.41633	418	586	1004
7	"7-out5463"	.08059	103	1175	1278
7	"7-out5464"	.24159	115	361	476
7	"7-out5465"	.15500	164	894	1058
7	"7-out5466"	.70308	547	231	778
7	"7-out5467"	.22807	411	1391	1802
7	"7-out5468"	.86055	216	35	251
7	"7-out5469"	.59381	288	197	485
7	"7-out5470"	.31939	168	358	526
7	"7-out5471"	.91586	479	44	523
7	"7-out5472"	.91296	535	51	586
7	"7-out5473"	.32653	32	66	98
7	"7-out5474"	.92307	156	13	169
7	"7-out5475"	.97959	96	2	98
7	"7-out5476"	.36259	95	167	262
7	"7-out5477"	.95358	1890	92	1982
7	"7-out5478"	.38837	127	200	327
7	"7-out5479"	.44044	159	202	361
7	"7-out5480"	.25773	50	144	194
7	"7-out5481"	.25373	34	100	134
7	"7-out5482"	.91935	171	15	186
7	"7-out5483"	.27043	311	839	1150
7	"7-out5484"	.28000	77	198	275
7	"7-out5485"	.31763	263	565	828
7	"7-out5486"	.12437	99	697	796
7	"7-out5487"	.92145	657	56	713
7	"7-out5488"	.28060	667	1710	2377
7	"7-out5489"	.36687	175	302	477
7	"7-out5490"	.25892	174	498	672
7	"7-out5491"	.20065	122	486	608
7	"7-out5492"	.17625	147	687	834
7	"7-out5493"	.20472	104	404	508
7	"7-out5494"	.10834	74	609	683
7	"7-out5495"	.66891	99	49	148
7	"7-out5496"	.15638	71	383	454
7	"7-out5497"	.17596	41	192	233
7	"7-out5498"	.25312	81	239	320
7	"7-out5499"	.19180	192	809	1001
7	"7-out5500"	.89556	283	33	316
7	"7-out5501"	.30000	78	182	260
7	"7-out5502"	.94183	1344	83	1427
7	"7-out5503"	.88469	445	58	503
7	"7-out5504"	.95035	134	7	141
7	"7-out5505"	.24845	361	1092	1453
7	"7-out5506"	.43554	125	162	287
7	"7-out5507"	.95762	113	5	118
7	"7-out5508"	.18269	38	170	208
7	"7-out5509"	.73636	81	29	110
7	"7-out5510"	.24275	176	549	725
7	"7-out5511"	.16778	50	248	298
7	"7-out5512"	.35377	75	137	212
7	"7-out5513"	.20717	104	398	502
7	"7-out5514"	.88372	76	10	86
7	"7-out5515"	.19499	109	450	559
7	"7-out5516"	.32303	115	241	356
7	"7-out5517"	.27152	123	330	453
7	"7-out5518"	.29411	115	276	391
7	"7-out5519"	.51873	263	244	507
7	"7-out5520"	.20802	83	316	399
7	"7-out5521"	.29221	398	964	1362
7	"7-out5522"	.22327	71	247	318
7	"7-out5523"	.26520	109	302	411
7	"7-out5524"	.19419	234	971	1205
7	"7-out5525"	.35317	89	163	252
7	"7-out5526"	.40194	455	677	1132
7	"7-out5527"	.70105	333	142	475
7	"7-out5528"	.78078	260	73	333
7	"7-out5529"	.24081	59	186	245
7	"7-out5530"	.21621	48	174	222
7	"7-out5531"	.30212	213	492	705
7	"7-out5532"	.21034	61	229	290
7	"7-out5533"	.13095	77	511	588
7	"7-out5534"	.25675	152	440	592
7	"7-out5535"	.30086	698	1622	2320
7	"7-out5536"	.25711	479	1384	1863
7	"7-out5537"	.16057	123	643	766
7	"7-out5538"	.57333	301	224	525
7	"7-out5539"	.92087	419	36	455
7	"7-out5540"	.92783	270	21	291
7	"7-out5541"	.16798	85	421	506
7	"7-out5542"	.12714	37	254	291
7	"7-out5543"	.14843	57	327	384
7	"7-out5544"	.23605	127	411	538
7	"7-out5545"	.81381	271	62	333
7	"7-out5546"	.36129	323	571	894
7	"7-out5547"	.50831	214	207	421
7	"7-out5548"	.25862	180	516	696
7	"7-out5549"	.34424	810	1543	2353
7	"7-out5550"	.28200	282	718	1000
7	"7-out5551"	.25298	106	313	419
7	"7-out5552"	.17714	62	288	350
7	"7-out5553"	.19788	225	912	1137
7	"7-out5554"	.20603	41	158	199
7	"7-out5555"	.53012	44	39	83
7	"7-out5556"	.20634	26	100	126
7	"7-out5557"	.51750	207	193	400
7	"7-out5558"	.33333	90	180	270
7	"7-out5559"	.88421	336	44	380
7	"7-out5560"	.22720	157	534	691
7	"7-out5561"	.22531	89	306	395
7	"7-out5562"	.24746	122	371	493
7	"7-out5563"	.17769	411	1902	2313
7	"7-out5564"	.23557	196	636	832
7	"7-out5565"	.16968	75	367	442
7	"7-out5566"	.20134	30	119	149
7	"7-out5567"	.20134	30	119	149
7	"7-out5568"	.22901	341	1148	1489
7	"7-out5569"	.37788	82	135	217
7	"7-out5570"	.27063	200	539	739
7	"7-out5571"	.25098	127	379	506
7	"7-out5572"	.33518	241	478	719
7	"7-out5573"	.24231	197	616	813
7	"7-out5574"	.32147	226	477	703
7	"7-out5575"	.20434	141	549	690
7	"7-out5576"	.26470	45	125	170
7	"7-out5577"	.23977	170	539	709
7	"7-out5578"	.22271	251	876	1127
7	"7-out5579"	.26714	74	203	277
7	"7-out5580"	.26937	278	754	1032
7	"7-out5581"	.20678	128	491	619
7	"7-out5582"	.69858	197	85	282
7	"7-out5583"	.18555	131	575	706
7	"7-out5584"	.36434	94	164	258
7	"7-out5585"	.24462	91	281	372
7	"7-out5586"	.29629	184	437	621
7	"7-out5587"	.24839	155	469	624
7	"7-out5588"	.08921	24	245	269
7	"7-out5589"	.12345	30	213	243
7	"7-out5590"	.51219	63	60	123
7	"7-out5591"	.44709	131	162	293
7	"7-out5592"	.22448	22	76	98
7	"7-out5593"	.94400	118	7	125
7	"7-out5594"	.42777	77	103	180
7	"7-out5595"	.35398	40	73	113
7	"7-out5596"	.18153	403	1817	2220
7	"7-out5597"	.29102	321	782	1103
7	"7-out5598"	.17355	84	400	484
7	"7-out5599"	.70000	77	33	110
7	"7-out5600"	.10486	84	717	801
7	"7-out5601"	.10318	81	704	785
7	"7-out5602"	.16427	355	1806	2161
7	"7-out5603"	.25304	83	245	328
7	"7-out5604"	.17441	60	284	344
7	"7-out5605"	.23566	74	240	314
7	"7-out5606"	.20769	54	206	260
7	"7-out5607"	.12062	100	729	829
7	"7-out5608"	.41324	131	186	317
7	"7-out5609"	.17602	138	646	784
7	"7-out5610"	.41134	58	83	141
7	"7-out5611"	.17031	319	1554	1873
7	"7-out5612"	.35424	96	175	271
7	"7-out5613"	.12207	73	525	598
7	"7-out5614"	.25000	49	147	196
7	"7-out5615"	.18493	27	119	146
7	"7-out5616"	.69291	88	39	127
7	"7-out5617"	.24015	122	386	508
7	"7-out5618"	.21601	267	969	1236
7	"7-out5619"	.87200	947	139	1086
7	"7-out5620"	.23175	108	358	466
7	"7-out5621"	.87529	365	52	417
7	"7-out5622"	.32296	135	283	418
7	"7-out5623"	.18230	239	1072	1311
7	"7-out5624"	.97413	113	3	116
7	"7-out5625"	.94017	110	7	117
7	"7-out5626"	.96846	645	21	666
7	"7-out5627"	.27311	257	684	941
7	"7-out5628"	.97297	648	18	666
7	"7-out5629"	.25625	41	119	160
7	"7-out5630"	.13836	22	137	159
7	"7-out5631"	.21723	121	436	557
7	"7-out5632"	.94047	158	10	168
7	"7-out5633"	.17595	120	562	682
7	"7-out5634"	.30490	622	1418	2040
7	"7-out5635"	.19024	394	1677	2071
7	"7-out5636"	.35000	168	312	480
7	"7-out5637"	.20524	94	364	458
7	"7-out5638"	.39955	181	272	453
7	"7-out5639"	.30462	145	331	476
7	"7-out5640"	.24166	58	182	240
7	"7-out5641"	.90967	141	14	155
7	"7-out5642"	.41646	349	489	838
7	"7-out5643"	.56811	196	149	345
7	"7-out5644"	.11409	51	396	447
7	"7-out5645"	.20393	114	445	559
7	"7-out5646"	.34183	67	129	196
7	"7-out5647"	.16942	41	201	242
7	"7-out5648"	.34582	120	227	347
7	"7-out5649"	.82051	96	21	117
7	"7-out5650"	.97142	34	1	35
7	"7-out5651"	.27868	68	176	244
7	"7-out5652"	.11111	69	552	621
7	"7-out5653"	.16155	58	301	359
7	"7-out5654"	.19953	85	341	426
7	"7-out5655"	.35682	162	292	454
7	"7-out5656"	.15591	87	471	558
7	"7-out5657"	.17610	56	262	318
7	"7-out5658"	.16196	195	1009	1204
7	"7-out5659"	.21224	402	1492	1894
7	"7-out5660"	.27350	64	170	234
7	"7-out5661"	.56132	119	93	212
7	"7-out5662"	.18209	59	265	324
7	"7-out5663"	.59674	330	223	553
7	"7-out5664"	.23157	88	292	380
7	"7-out5665"	.41353	165	234	399
7	"7-out5666"	.40957	154	222	376
7	"7-out5667"	.22205	151	529	680
7	"7-out5668"	.56272	157	122	279
7	"7-out5669"	.14893	154	880	1034
7	"7-out5670"	.89714	157	18	175
7	"7-out5671"	.41444	109	154	263
7	"7-out5672"	.68372	147	68	215
7	"7-out5673"	.29657	390	925	1315
7	"7-out5674"	.23955	86	273	359
7	"7-out5675"	.33922	96	187	283
7	"7-out5676"	.82580	256	54	310
7	"7-out5677"	.14225	169	1019	1188
7	"7-out5678"	.90128	210	23	233
7	"7-out5679"	.22535	80	275	355
7	"7-out5680"	.24608	110	337	447
7	"7-out5681"	.28387	44	111	155
7	"7-out5682"	.12529	53	370	423
7	"7-out5683"	.21709	193	696	889
7	"7-out5684"	.32697	240	494	734
7	"7-out5685"	.84343	167	31	198
7	"7-out5686"	.30241	163	376	539
7	"7-out5687"	.35494	104	189	293
7	"7-out5688"	.22913	162	545	707
7	"7-out5689"	.22240	133	465	598
7	"7-out5690"	.20851	49	186	235
7	"7-out5691"	.93714	164	11	175
7	"7-out5692"	.12272	81	579	660
7	"7-out5693"	.11864	77	572	649
7	"7-out5694"	.30196	77	178	255
7	"7-out5695"	.09302	16	156	172
7	"7-out5696"	.25370	154	453	607
7	"7-out5697"	.66451	309	156	465
7	"7-out5698"	.88461	368	48	416
7	"7-out5699"	.34905	185	345	530
7	"7-out5700"	.32857	46	94	140
7	"7-out5701"	.34355	112	214	326
7	"7-out5702"	.93965	109	7	116
7	"7-out5703"	.94545	104	6	110
7	"7-out5704"	.18434	106	469	575
7	"7-out5705"	.21551	25	91	116
7	"7-out5706"	.95652	638	29	667
7	"7-out5707"	.27220	95	254	349
7	"7-out5708"	.40880	130	188	318
7	"7-out5709"	.93103	162	12	174
7	"7-out5710"	.24224	164	513	677
7	"7-out5711"	.29893	197	462	659
7	"7-out5712"	.28205	99	252	351
7	"7-out5713"	.17140	687	3321	4008
7	"7-out5714"	.91908	443	39	482
7	"7-out5715"	.30232	39	90	129
7	"7-out5716"	.16219	121	625	746
7	"7-out5717"	.37614	41	68	109
7	"7-out5718"	.93548	464	32	496
7	"7-out5719"	.13961	43	265	308
7	"7-out5720"	.89770	430	49	479
7	"7-out5721"	.11988	82	602	684
7	"7-out5722"	.25287	22	65	87
7	"7-out5723"	.93820	167	11	178
7	"7-out5724"	.53684	51	44	95
7	"7-out5725"	.18956	109	466	575
7	"7-out5726"	.31106	149	330	479
7	"7-out5727"	.20000	73	292	365
7	"7-out5728"	.97597	650	16	666
7	"7-out5729"	.89207	405	49	454
7	"7-out5730"	.21001	109	410	519
7	"7-out5731"	.33181	73	147	220
7	"7-out5732"	.30842	161	361	522
7	"7-out5733"	.14942	52	296	348
7	"7-out5734"	.42280	178	243	421
7	"7-out5735"	.84101	566	107	673
7	"7-out5736"	.55350	150	121	271
7	"7-out5737"	.41308	202	287	489
7	"7-out5738"	.85046	91	16	107
7	"7-out5739"	.35247	178	327	505
7	"7-out5740"	.96103	148	6	154
7	"7-out5741"	.67914	254	120	374
7	"7-out5742"	.90350	309	33	342
7	"7-out5743"	.19001	99	422	521
7	"7-out5744"	.23357	160	525	685
7	"7-out5745"	.23076	147	490	637
7	"7-out5746"	.25368	172	506	678
7	"7-out5747"	.15761	90	481	571
7	"7-out5748"	.19658	46	188	234
7	"7-out5749"	.28461	407	1023	1430
7	"7-out5750"	.20613	1002	3859	4861
7	"7-out5751"	.57778	2793	2041	4834
7	"7-out5752"	.22932	122	410	532
7	"7-out5753"	.26818	295	805	1100
7	"7-out5754"	.26666	148	407	555
7	"7-out5755"	.20283	243	955	1198
7	"7-out5756"	.13614	84	533	617
7	"7-out5757"	.79761	335	85	420
7	"7-out5758"	.87471	384	55	439
7	"7-out5759"	.40610	266	389	655
7	"7-out5760"	.15384	88	484	572
7	"7-out5761"	.90476	171	18	189
7	"7-out5762"	.31456	229	499	728
7	"7-out5763"	.25806	112	322	434
7	"7-out5764"	.55167	395	321	716
7	"7-out5765"	.87740	365	51	416
7	"7-out5766"	.33523	235	466	701
7	"7-out5767"	.13483	12	77	89
7	"7-out5768"	.26660	289	795	1084
7	"7-out5769"	.27032	133	359	492
7	"7-out5770"	.15300	321	1777	2098
7	"7-out5771"	.27810	94	244	338
7	"7-out5772"	.47504	238	263	501
7	"7-out5773"	.82800	621	129	750
7	"7-out5774"	.43535	165	214	379
7	"7-out5775"	.44819	199	245	444
7	"7-out5776"	.23633	147	475	622
7	"7-out5777"	.56823	229	174	403
7	"7-out5778"	.29284	258	623	881
7	"7-out5779"	.17865	77	354	431
7	"7-out5780"	.92446	257	21	278
7	"7-out5781"	.93971	265	17	282
7	"7-out5782"	.91366	254	24	278
7	"7-out5783"	.83060	152	31	183
7	"7-out5784"	.18785	566	2447	3013
7	"7-out5785"	.21569	470	1709	2179
7	"7-out5786"	.57888	466	339	805
7	"7-out5787"	.22544	179	615	794
7	"7-out5788"	.49436	307	314	621
7	"7-out5789"	.15750	106	567	673
7	"7-out5790"	.30000	90	210	300
7	"7-out5791"	.87769	366	51	417
7	"7-out5792"	.66016	237	122	359
7	"7-out5793"	.97597	650	16	666
7	"7-out5794"	.08943	11	112	123
7	"7-out5795"	.11344	54	422	476
7	"7-out5796"	.21125	214	799	1013
7	"7-out5797"	.20635	305	1173	1478
7	"7-out5798"	.67962	437	206	643
7	"7-out5799"	.92879	300	23	323
7	"7-out5800"	.27458	148	391	539
7	"7-out5801"	.88593	932	120	1052
7	"7-out5802"	.25391	81	238	319
7	"7-out5803"	.10578	64	541	605
7	"7-out5804"	.25680	66	191	257
7	"7-out5805"	.30291	156	359	515
7	"7-out5806"	.20724	143	547	690
7	"7-out5807"	.12888	29	196	225
7	"7-out5808"	.36326	89	156	245
7	"7-out5809"	.56126	142	111	253
7	"7-out5810"	.61627	159	99	258
7	"7-out5811"	.08333	18	198	216
7	"7-out5812"	.24683	351	1071	1422
7	"7-out5813"	.71481	193	77	270
7	"7-out5814"	.20816	158	601	759
7	"7-out5815"	.18928	53	227	280
7	"7-out5816"	.54713	325	269	594
7	"7-out5817"	.14473	22	130	152
7	"7-out5818"	.16915	34	167	201
7	"7-out5819"	.23222	49	162	211
7	"7-out5820"	.21881	100	357	457
7	"7-out5821"	.44191	175	221	396
7	"7-out5822"	.22107	128	451	579
7	"7-out5823"	.31144	147	325	472
7	"7-out5824"	.63424	163	94	257
7	"7-out5825"	.12195	70	504	574
7	"7-out5826"	.92812	297	23	320
7	"7-out5827"	.17046	269	1309	1578
7	"7-out5828"	.28151	201	513	714
7	"7-out5829"	.14653	74	431	505
7	"7-out5830"	.20897	177	670	847
7	"7-out5831"	.17732	61	283	344
7	"7-out5832"	.39785	2748	4159	6907
7	"7-out5833"	.28925	70	172	242
7	"7-out5834"	.18322	118	526	644
7	"7-out5835"	.31831	106	227	333
7	"7-out5836"	.97990	634	13	647
7	"7-out5837"	.17845	111	511	622
7	"7-out5838"	.12573	43	299	342
7	"7-out5839"	.39276	152	235	387
7	"7-out5840"	.17821	18	83	101
7	"7-out5841"	.26792	71	194	265
7	"7-out5842"	.35000	63	117	180
7	"7-out5843"	.50285	88	87	175
7	"7-out5844"	.17038	168	818	986
7	"7-out5845"	.19961	105	421	526
7	"7-out5846"	.21043	250	938	1188
7	"7-out5847"	.20298	163	640	803
7	"7-out5848"	.31491	57	124	181
7	"7-out5849"	.25000	46	138	184
7	"7-out5850"	.32793	263	539	802
7	"7-out5851"	.51129	181	173	354
7	"7-out5852"	.77157	152	45	197
7	"7-out5853"	.90960	161	16	177
7	"7-out5854"	.81461	457	104	561
7	"7-out5855"	.34128	429	828	1257
7	"7-out5856"	.22317	104	362	466
7	"7-out5857"	.23949	114	362	476
7	"7-out5858"	.49907	271	272	543
7	"7-out5859"	.30061	147	342	489
7	"7-out5860"	.32311	295	618	913
7	"7-out5861"	.22857	208	702	910
7	"7-out5862"	.13060	99	659	758
7	"7-out5863"	.30885	164	367	531
7	"7-out5864"	.21744	182	655	837
7	"7-out5865"	.13479	43	276	319
7	"7-out5866"	.33742	632	1241	1873
7	"7-out5867"	.25806	72	207	279
7	"7-out5868"	.93621	1820	124	1944
7	"7-out5869"	.22157	76	267	343
7	"7-out5870"	.18548	69	303	372
7	"7-out5871"	.31888	103	220	323
7	"7-out5872"	.86826	145	22	167
7	"7-out5873"	.16574	30	151	181
7	"7-out5874"	.36811	501	860	1361
7	"7-out5875"	.26750	149	408	557
7	"7-out5876"	.20111	36	143	179
7	"7-out5877"	.41397	77	109	186
7	"7-out5878"	.36593	217	376	593
7	"7-out5879"	.39563	163	249	412
7	"7-out5880"	.32469	426	886	1312
7	"7-out5881"	.13586	25	159	184
7	"7-out5882"	.38451	293	469	762
7	"7-out5883"	.34596	283	535	818
7	"7-out5884"	.57801	163	119	282
7	"7-out5885"	.26560	183	506	689
7	"7-out5886"	.28899	252	620	872
7	"7-out5887"	.86092	130	21	151
7	"7-out5888"	.11818	13	97	110
7	"7-out5889"	.20600	412	1588	2000
7	"7-out5890"	.20317	397	1557	1954
7	"7-out5891"	.18453	501	2214	2715
7	"7-out5892"	.23196	672	2225	2897
7	"7-out5893"	.19865	118	476	594
7	"7-out5894"	.31444	344	750	1094
7	"7-out5895"	.19119	139	588	727
7	"7-out5896"	.38814	144	227	371
7	"7-out5897"	.29319	56	135	191
7	"7-out5898"	.15428	162	888	1050
7	"7-out5899"	.18711	151	656	807
7	"7-out5900"	.22619	19	65	84
7	"7-out5901"	.19195	62	261	323
7	"7-out5902"	.07586	33	402	435
7	"7-out5903"	.18363	110	489	599
7	"7-out5904"	.26735	104	285	389
7	"7-out5905"	.17421	173	820	993
7	"7-out5906"	.16147	83	431	514
7	"7-out5907"	.79079	189	50	239
7	"7-out5908"	.72162	267	103	370
7	"7-out5909"	.17548	63	296	359
7	"7-out5910"	.35467	288	524	812
7	"7-out5911"	.74635	256	87	343
7	"7-out5912"	.15588	53	287	340
7	"7-out5913"	.30334	263	604	867
7	"7-out5914"	.30645	171	387	558
7	"7-out5915"	.47663	51	56	107
7	"7-out5916"	.33786	149	292	441
7	"7-out5917"	.43220	51	67	118
7	"7-out5918"	.28421	486	1224	1710
7	"7-out5919"	.17083	512	2485	2997
7	"7-out5920"	.22913	173	582	755
7	"7-out5921"	.23537	1074	3489	4563
7	"7-out5922"	.19172	51	215	266
7	"7-out5923"	.87850	282	39	321
7	"7-out5924"	.11708	61	460	521
7	"7-out5925"	.19889	36	145	181
7	"7-out5926"	.24011	85	269	354
7	"7-out5927"	.45779	141	167	308
7	"7-out5928"	.27407	185	490	675
7	"7-out5929"	.27670	215	562	777
7	"7-out5930"	.20276	308	1211	1519
7	"7-out5931"	.24496	146	450	596
7	"7-out5932"	.17314	254	1213	1467
7	"7-out5933"	.31117	426	943	1369
7	"7-out5934"	.25824	47	135	182
7	"7-out5935"	.26923	602	1634	2236
7	"7-out5936"	.79500	159	41	200
7	"7-out5937"	.89839	168	19	187
7	"7-out5938"	.23191	202	669	871
7	"7-out5939"	.22906	93	313	406
7	"7-out5940"	.19468	249	1030	1279
7	"7-out5941"	.68695	474	216	690
7	"7-out5942"	.88040	1406	191	1597
7	"7-out5943"	.52631	480	432	912
7	"7-out5944"	.17875	276	1268	1544
7	"7-out5945"	.18311	154	687	841
7	"7-out5946"	.76323	274	85	359
7	"7-out5947"	.90030	298	33	331
7	"7-out5948"	.15816	31	165	196
7	"7-out5949"	.33823	69	135	204
7	"7-out5950"	.32960	59	120	179
7	"7-out5951"	.56592	279	214	493
7	"7-out5952"	.24410	145	449	594
7	"7-out5953"	.17567	39	183	222
7	"7-out5954"	.85714	228	38	266
7	"7-out5955"	.87845	318	44	362
7	"7-out5956"	.87845	318	44	362
7	"7-out5957"	.21119	83	310	393
7	"7-out5958"	.86027	314	51	365
7	"7-out5959"	.23333	70	230	300
7	"7-out5960"	.22916	198	666	864
7	"7-out5961"	.20142	113	448	561
7	"7-out5962"	.93317	768	55	823
7	"7-out5963"	.22662	80	273	353
7	"7-out5964"	.70704	321	133	454
7	"7-out5965"	.12962	35	235	270
7	"7-out5966"	.11349	37	289	326
7	"7-out5967"	.18895	89	382	471
7	"7-out5968"	.20206	254	1003	1257
7	"7-out5969"	.34124	115	222	337
7	"7-out5970"	.31325	156	342	498
7	"7-out5971"	.18019	91	414	505
7	"7-out5972"	.93273	943	68	1011
7	"7-out5973"	.71887	179	70	249
7	"7-out5974"	.36170	170	300	470
7	"7-out5975"	.56275	278	216	494
7	"7-out5976"	.90530	239	25	264
7	"7-out5977"	.08121	32	362	394
7	"7-out5978"	.13397	125	808	933
7	"7-out5979"	.81518	494	112	606
7	"7-out5980"	.73619	120	43	163
7	"7-out5981"	.22670	73	249	322
7	"7-out5982"	.29690	144	341	485
7	"7-out5983"	.87536	302	43	345
7	"7-out5984"	.22884	73	246	319
7	"7-out5985"	.46476	244	281	525
7	"7-out5986"	.17647	87	406	493
7	"7-out5987"	.24237	159	497	656
7	"7-out5988"	.87426	1495	215	1710
7	"7-out5989"	.14576	143	838	981
7	"7-out5990"	.30455	127	290	417
7	"7-out5991"	.26596	254	701	955
7	"7-out5992"	.12679	53	365	418
7	"7-out5993"	.22115	115	405	520
7	"7-out5994"	.11881	12	89	101
7	"7-out5995"	.28504	122	306	428
7	"7-out5996"	.15724	228	1222	1450
7	"7-out5997"	.95041	460	24	484
7	"7-out5998"	.29696	294	696	990
7	"7-out5999"	.85940	434	71	505
7	"7-out6000"	.21052	88	330	418
7	"7-out6001"	.19722	71	289	360
7	"7-out6002"	.24358	304	944	1248
7	"7-out6003"	.25984	66	188	254
7	"7-out6004"	.10851	107	879	986
7	"7-out6005"	.14437	122	723	845
7	"7-out6006"	.18912	80	343	423
7	"7-out6007"	.20913	87	329	416
7	"7-out6008"	.61658	119	74	193
7	"7-out6009"	.87977	461	63	524
7	"7-out6010"	.92405	146	12	158
7	"7-out6011"	.62650	52	31	83
7	"7-out6012"	.18348	140	623	763
7	"7-out6013"	.53810	233	200	433
7	"7-out6014"	.20116	69	274	343
7	"7-out6015"	.24224	125	391	516
7	"7-out6016"	.93924	773	50	823
7	"7-out6017"	.21461	138	505	643
7	"7-out6018"	.35820	96	172	268
7	"7-out6019"	.29024	128	313	441
7	"7-out6020"	.18298	142	634	776
7	"7-out6021"	.21171	159	592	751
7	"7-out6022"	.23410	81	265	346
7	"7-out6023"	.88748	560	71	631
7	"7-out6024"	.38009	168	274	442
7	"7-out6025"	.20422	29	113	142
7	"7-out6026"	.27340	73	194	267
7	"7-out6027"	.94237	278	17	295
7	"7-out6028"	.65048	134	72	206
7	"7-out6029"	.19018	62	264	326
7	"7-out6030"	.75203	370	122	492
7	"7-out6031"	.20937	192	725	917
7	"7-out6032"	.37268	161	271	432
7	"7-out6033"	.24420	179	554	733
7	"7-out6034"	.32094	190	402	592
7	"7-out6035"	.24408	134	415	549
7	"7-out6036"	.26633	159	438	597
7	"7-out6037"	.23021	160	535	695
7	"7-out6038"	.26168	196	553	749
7	"7-out6039"	.26617	144	397	541
7	"7-out6040"	.15384	56	308	364
7	"7-out6041"	.93162	109	8	117
7	"7-out6042"	.94017	110	7	117
7	"7-out6043"	.05844	9	145	154
7	"7-out6044"	.18425	110	487	597
7	"7-out6045"	.18036	158	718	876
7	"7-out6046"	.17505	160	754	914
7	"7-out6047"	.13636	63	399	462
7	"7-out6048"	.31228	183	403	586
7	"7-out6049"	.19444	14	58	72
7	"7-out6050"	.91304	63	6	69
7	"7-out6051"	.33836	112	219	331
7	"7-out6052"	.20691	317	1215	1532
7	"7-out6053"	.27196	130	348	478
7	"7-out6054"	.18427	75	332	407
7	"7-out6055"	.27922	86	222	308
7	"7-out6056"	.68548	255	117	372
7	"7-out6057"	.28438	122	307	429
7	"7-out6058"	.12362	45	319	364
7	"7-out6059"	.20000	50	200	250
7	"7-out6060"	.17964	90	411	501
7	"7-out6061"	.34285	156	299	455
7	"7-out6062"	.46666	210	240	450
7	"7-out6063"	.16576	122	614	736
7	"7-out6064"	.20215	94	371	465
7	"7-out6065"	.93133	529	39	568
7	"7-out6066"	.94482	137	8	145
7	"7-out6067"	.98620	143	2	145
7	"7-out6068"	.88973	234	29	263
7	"7-out6069"	.93155	245	18	263
7	"7-out6070"	.91634	241	22	263
7	"7-out6071"	.96226	102	4	106
7	"7-out6072"	.97169	103	3	106
7	"7-out6073"	.86764	177	27	204
7	"7-out6074"	.17945	152	695	847
7	"7-out6075"	.84955	96	17	113
7	"7-out6076"	.91428	96	9	105
7	"7-out6077"	.28409	225	567	792
7	"7-out6078"	.31117	117	259	376
7	"7-out6079"	.33846	308	602	910
7	"7-out6080"	.89130	82	10	92
7	"7-out6081"	.15500	31	169	200
7	"7-out6082"	.62443	138	83	221
7	"7-out6083"	.70443	143	60	203
7	"7-out6084"	.30493	68	155	223
7	"7-out6085"	.10697	23	192	215
7	"7-out6086"	.19537	93	383	476
7	"7-out6087"	.22222	46	161	207
7	"7-out6088"	.48834	356	373	729
7	"7-out6089"	.92156	47	4	51
7	"7-out6090"	.88992	380	47	427
7	"7-out6091"	.28235	240	610	850
7	"7-out6092"	.83333	695	139	834
7	"7-out6093"	.46351	108	125	233
7	"7-out6094"	.21179	79	294	373
7	"7-out6095"	.11340	22	172	194
7	"7-out6096"	.39915	285	429	714
7	"7-out6097"	.25339	56	165	221
7	"7-out6098"	.15189	36	201	237
7	"7-out6099"	.30875	67	150	217
7	"7-out6100"	.74178	158	55	213
7	"7-out6101"	.81422	206	47	253
7	"7-out6102"	.18527	151	664	815
7	"7-out6103"	.56862	203	154	357
7	"7-out6104"	.31302	149	327	476
7	"7-out6105"	.11161	49	390	439
7	"7-out6106"	.78015	511	144	655
7	"7-out6107"	.86774	807	123	930
7	"7-out6108"	.32863	70	143	213
7	"7-out6109"	.23624	73	236	309
7	"7-out6110"	.32004	297	631	928
7	"7-out6111"	.08374	17	186	203
7	"7-out6112"	.26562	68	188	256
7	"7-out6113"	.93548	87	6	93
7	"7-out6114"	.24324	81	252	333
7	"7-out6115"	.06481	14	202	216
7	"7-out6116"	.10900	23	188	211
7	"7-out6117"	.19587	38	156	194
7	"7-out6118"	.20091	44	175	219
7	"7-out6119"	.34951	72	134	206
7	"7-out6120"	.13461	28	180	208
7	"7-out6121"	.72047	183	71	254
7	"7-out6122"	.75196	191	63	254
7	"7-out6123"	.63681	128	73	201
7	"7-out6124"	.92964	185	14	199
7	"7-out6125"	.29173	166	403	569
7	"7-out6126"	.26041	50	142	192
7	"7-out6127"	.63866	403	228	631
7	"7-out6128"	.27474	136	359	495
7	"7-out6129"	.30640	402	910	1312
7	"7-out6130"	.17001	127	620	747
7	"7-out6131"	.32629	139	287	426
7	"7-out6132"	.82630	333	70	403
7	"7-out6133"	.17647	54	252	306
7	"7-out6134"	.21720	414	1492	1906
7	"7-out6135"	.21869	124	443	567
7	"7-out6136"	.43689	90	116	206
7	"7-out6137"	.57608	106	78	184
7	"7-out6138"	.16370	46	235	281
7	"7-out6139"	.90410	726	77	803
7	"7-out6140"	.39960	404	607	1011
7	"7-out6141"	.26442	55	153	208
7	"7-out6142"	.25460	83	243	326
7	"7-out6143"	.18691	60	261	321
7	"7-out6144"	.21241	89	330	419
7	"7-out6145"	.22659	242	826	1068
7	"7-out6146"	.21371	240	883	1123
7	"7-out6147"	.24166	116	364	480
7	"7-out6148"	.05660	18	300	318
7	"7-out6149"	.40040	199	298	497
7	"7-out6150"	.96875	186	6	192
7	"7-out6151"	.22222	332	1162	1494
7	"7-out6152"	.25352	234	689	923
7	"7-out6153"	.20872	359	1361	1720
7	"7-out6154"	.23680	157	506	663
7	"7-out6155"	.10606	7	59	66
7	"7-out6156"	.93500	561	39	600
7	"7-out6157"	.26885	82	223	305
7	"7-out6158"	.28571	96	240	336
7	"7-out6159"	.22222	74	259	333
7	"7-out6160"	.23876	85	271	356
7	"7-out6161"	.14400	54	321	375
7	"7-out6162"	.28157	107	273	380
7	"7-out6163"	.56545	203	156	359
7	"7-out6164"	.29899	119	279	398
7	"7-out6165"	.14913	78	445	523
7	"7-out6166"	.18085	51	231	282
7	"7-out6167"	.28395	92	232	324
7	"7-out6168"	.20446	55	214	269
7	"7-out6169"	.24921	79	238	317
7	"7-out6170"	.15877	57	302	359
7	"7-out6171"	.26847	109	297	406
7	"7-out6172"	.36483	193	336	529
7	"7-out6173"	.28533	107	268	375
7	"7-out6174"	.20574	86	332	418
7	"7-out6175"	.12500	104	728	832
7	"7-out6176"	.71776	501	197	698
7	"7-out6177"	.77478	461	134	595
7	"7-out6178"	.92676	367	29	396
7	"7-out6179"	.88048	361	49	410
7	"7-out6180"	.16243	32	165	197
7	"7-out6181"	.88203	486	65	551
7	"7-out6182"	.60599	283	184	467
7	"7-out6183"	.28991	227	556	783
7	"7-out6184"	.79766	205	52	257
7	"7-out6185"	.18611	59	258	317
7	"7-out6186"	.84210	96	18	114
7	"7-out6187"	.21459	147	538	685
7	"7-out6188"	.21311	65	240	305
7	"7-out6189"	.67708	130	62	192
7	"7-out6190"	.16467	138	700	838
7	"7-out6191"	.30737	225	507	732
7	"7-out6192"	.06802	10	137	147
7	"7-out6193"	.27609	82	215	297
7	"7-out6194"	.22043	82	290	372
7	"7-out6195"	.11486	17	131	148
7	"7-out6196"	.94055	269	17	286
7	"7-out6197"	.25464	137	401	538
7	"7-out6198"	.25766	42	121	163
7	"7-out6199"	.18483	217	957	1174
7	"7-out6200"	.92173	106	9	115
7	"7-out6201"	.33858	43	84	127
7	"7-out6202"	.28517	152	381	533
7	"7-out6203"	.28448	198	498	696
7	"7-out6204"	.38035	151	246	397
7	"7-out6205"	.16735	122	607	729
7	"7-out6206"	.81914	154	34	188
7	"7-out6207"	.35958	105	187	292
7	"7-out6208"	.37078	66	112	178
7	"7-out6209"	.15625	20	108	128
7	"7-out6210"	.13994	55	338	393
7	"7-out6211"	.16052	61	319	380
7	"7-out6212"	.38513	114	182	296
7	"7-out6213"	.56341	231	179	410
7	"7-out6214"	.20000	114	456	570
7	"7-out6215"	.22439	149	515	664
7	"7-out6216"	.24571	86	264	350
7	"7-out6217"	.44871	70	86	156
7	"7-out6218"	.32903	153	312	465
7	"7-out6219"	.14728	38	220	258
7	"7-out6220"	.90238	379	41	420
7	"7-out6221"	.65760	121	63	184
7	"7-out6222"	.20634	26	100	126
7	"7-out6223"	.24928	87	262	349
7	"7-out6224"	.26582	84	232	316
7	"7-out6225"	.86868	172	26	198
7	"7-out6226"	.21863	61	218	279
7	"7-out6227"	.24808	97	294	391
7	"7-out6228"	.38520	151	241	392
7	"7-out6229"	.22005	79	280	359
7	"7-out6230"	.31250	185	407	592
7	"7-out6231"	.18623	46	201	247
7	"7-out6232"	.96732	148	5	153
7	"7-out6233"	.31770	61	131	192
7	"7-out6234"	.92551	584	47	631
7	"7-out6235"	.90204	221	24	245
7	"7-out6236"	.62978	148	87	235
7	"7-out6237"	.44334	90	113	203
7	"7-out6238"	.41304	95	135	230
7	"7-out6239"	.23711	161	518	679
7	"7-out6240"	.31223	74	163	237
7	"7-out6241"	.44545	98	122	220
7	"7-out6242"	.30472	174	397	571
7	"7-out6243"	.98026	149	3	152
7	"7-out6244"	.94411	321	19	340
7	"7-out6245"	.29166	77	187	264
7	"7-out6246"	.79265	302	79	381
7	"7-out6247"	.09364	28	271	299
7	"7-out6248"	.74482	324	111	435
7	"7-out6249"	.21759	47	169	216
7	"7-out6250"	.60546	155	101	256
7	"7-out6251"	.20224	108	426	534
7	"7-out6252"	.14316	199	1191	1390
7	"7-out6253"	.20613	309	1190	1499
7	"7-out6254"	.12781	17	116	133
7	"7-out6255"	.24623	343	1050	1393
7	"7-out6256"	.24246	177	553	730
7	"7-out6257"	.80196	818	202	1020
7	"7-out6258"	.75574	263	85	348
7	"7-out6259"	.17073	21	102	123
7	"7-out6260"	.76143	233	73	306
7	"7-out6261"	.84466	87	16	103
7	"7-out6262"	.38281	49	79	128
7	"7-out6263"	.17737	58	269	327
7	"7-out6264"	.37378	77	129	206
7	"7-out6265"	.38048	78	127	205
7	"7-out6266"	.35922	74	132	206
7	"7-out6267"	.23936	90	286	376
7	"7-out6268"	.17780	125	578	703
7	"7-out6269"	.30084	213	495	708
7	"7-out6270"	.76393	233	72	305
7	"7-out6271"	.32210	153	322	475
7	"7-out6272"	.25322	255	752	1007
7	"7-out6273"	.22096	78	275	353
7	"7-out6274"	.89686	200	23	223
7	"7-out6275"	.60135	89	59	148
7	"7-out6276"	.23775	165	529	694
7	"7-out6277"	.34181	94	181	275
7	"7-out6278"	.17330	74	353	427
7	"7-out6279"	.85889	140	23	163
7	"7-out6280"	.31880	139	297	436
7	"7-out6281"	.17935	106	485	591
7	"7-out6282"	.29640	396	940	1336
7	"7-out6283"	.69811	148	64	212
7	"7-out6284"	.26527	152	421	573
7	"7-out6285"	.18286	143	639	782
7	"7-out6286"	.26721	194	532	726
7	"7-out6287"	.14666	22	128	150
7	"7-out6288"	.90526	172	18	190
7	"7-out6289"	.24390	50	155	205
7	"7-out6290"	.25670	67	194	261
7	"7-out6291"	.71304	82	33	115
7	"7-out6292"	.25170	37	110	147
7	"7-out6293"	.44689	324	401	725
7	"7-out6294"	.76344	284	88	372
7	"7-out6295"	.80188	170	42	212
7	"7-out6296"	.65517	38	20	58
7	"7-out6297"	.93043	107	8	115
7	"7-out6298"	.48241	192	206	398
7	"7-out6299"	.95081	116	6	122
7	"7-out6300"	.97142	204	6	210
7	"7-out6301"	.30243	62	143	205
7	"7-out6302"	.43770	267	343	610
7	"7-out6303"	.24679	77	235	312
7	"7-out6304"	.26940	59	160	219
7	"7-out6305"	.24423	53	164	217
7	"7-out6306"	.94009	204	13	217
7	"7-out6307"	.98620	143	2	145
7	"7-out6308"	.83941	115	22	137
7	"7-out6309"	.91525	54	5	59
7	"7-out6310"	.97348	257	7	264
7	"7-out6311"	.96296	234	9	243
7	"7-out6312"	.95408	187	9	196
7	"7-out6313"	.23134	31	103	134
7	"7-out6314"	.21387	185	680	865
7	"7-out6315"	.23027	108	361	469
7	"7-out6316"	.91000	546	54	600
7	"7-out6317"	.65153	445	238	683
7	"7-out6318"	.10594	130	1097	1227
7	"7-out6319"	.77710	129	37	166
7	"7-out6320"	.28559	347	868	1215
7	"7-out6321"	.24719	110	335	445
7	"7-out6322"	.71482	188	75	263
7	"7-out6323"	.82926	170	35	205
7	"7-out6324"	.30434	35	80	115
7	"7-out6325"	.19363	73	304	377
7	"7-out6326"	.17537	104	489	593
7	"7-out6327"	.18435	33	146	179
7	"7-out6328"	.15280	180	998	1178
7	"7-out6329"	.53608	52	45	97
7	"7-out6330"	.95766	475	21	496
7	"7-out6331"	.26524	87	241	328
7	"7-out6332"	.26153	51	144	195
7	"7-out6333"	.19723	157	639	796
7	"7-out6334"	.09578	25	236	261
7	"7-out6335"	.32352	88	184	272
7	"7-out6336"	.17553	297	1395	1692
7	"7-out6337"	.20443	83	323	406
7	"7-out6338"	.59383	231	158	389
7	"7-out6339"	.87906	189	26	215
7	"7-out6340"	.80851	152	36	188
7	"7-out6341"	.88970	121	15	136
7	"7-out6342"	.18215	49	220	269
7	"7-out6343"	.73364	157	57	214
7	"7-out6344"	.88669	180	23	203
7	"7-out6345"	.96923	126	4	130
7	"7-out6346"	.93881	445	29	474
7	"7-out6347"	.92827	440	34	474
7	"7-out6348"	.93277	444	32	476
7	"7-out6349"	.93248	442	32	474
7	"7-out6350"	.35671	239	431	670
7	"7-out6351"	.61380	925	582	1507
7	"7-out6352"	.94570	209	12	221
7	"7-out6353"	.94570	209	12	221
7	"7-out6354"	.66586	277	139	416
7	"7-out6355"	.86731	268	41	309
7	"7-out6356"	.46225	649	755	1404
7	"7-out6357"	.15355	123	678	801
7	"7-out6358"	.66071	148	76	224
7	"7-out6359"	.96153	175	7	182
7	"7-out6360"	.13071	123	818	941
7	"7-out6361"	.86231	119	19	138
7	"7-out6362"	.33034	221	448	669
7	"7-out6363"	.90794	434	44	478
7	"7-out6364"	.12559	53	369	422
7	"7-out6365"	.23091	242	806	1048
7	"7-out6366"	.30000	93	217	310
7	"7-out6367"	.94318	166	10	176
7	"7-out6368"	.75522	253	82	335
7	"7-out6369"	.83333	355	71	426
7	"7-out6370"	.26912	496	1347	1843
7	"7-out6371"	.55714	195	155	350
7	"7-out6372"	.38257	101	163	264
7	"7-out6373"	.14634	18	105	123
7	"7-out6374"	.38461	295	472	767
7	"7-out6375"	.34472	121	230	351
7	"7-out6376"	.19542	94	387	481
7	"7-out6377"	.18585	92	403	495
7	"7-out6378"	.23515	99	322	421
7	"7-out6379"	.16857	191	942	1133
7	"7-out6380"	.16352	52	266	318
7	"7-out6381"	.96153	100	4	104
7	"7-out6382"	.24680	135	412	547
7	"7-out6383"	.95238	100	5	105
7	"7-out6384"	.24545	162	498	660
7	"7-out6385"	.28924	164	403	567
7	"7-out6386"	.94473	359	21	380
7	"7-out6387"	.26306	297	832	1129
7	"7-out6388"	.18651	83	362	445
7	"7-out6389"	.21402	58	213	271
7	"7-out6390"	.18669	87	379	466
7	"7-out6391"	.23046	177	591	768
7	"7-out6392"	.06153	24	366	390
7	"7-out6393"	.25740	200	577	777
7	"7-out6394"	.24880	52	157	209
7	"7-out6395"	.26356	204	570	774
7	"7-out6396"	.81481	308	70	378
7	"7-out6397"	.47346	232	258	490
7	"7-out6398"	.85007	550	97	647
7	"7-out6399"	.13832	122	760	882
7	"7-out6400"	.14885	39	223	262
7	"7-out6401"	.93003	1635	123	1758
7	"7-out6402"	.20411	119	464	583
7	"7-out6403"	.35220	56	103	159
7	"7-out6404"	.23471	96	313	409
7	"7-out6405"	.36544	110	191	301
7	"7-out6406"	.66312	500	254	754
7	"7-out6407"	.26086	42	119	161
7	"7-out6408"	.13461	7	45	52
7	"7-out6409"	.26096	125	354	479
7	"7-out6410"	.17685	107	498	605
7	"7-out6411"	.22781	172	583	755
7	"7-out6412"	.26211	119	335	454
7	"7-out6413"	.39302	169	261	430
7	"7-out6414"	.25537	95	277	372
7	"7-out6415"	.40928	282	407	689
7	"7-out6416"	.62639	560	334	894
7	"7-out6417"	.95198	456	23	479
7	"7-out6418"	.24469	173	534	707
7	"7-out6419"	.92927	473	36	509
7	"7-out6420"	.23915	248	789	1037
7	"7-out6421"	.94979	454	24	478
7	"7-out6422"	.52020	103	95	198
7	"7-out6423"	.23225	373	1233	1606
7	"7-out6424"	.36507	69	120	189
7	"7-out6425"	.94525	3902	226	4128
7	"7-out6426"	.46016	283	332	615
7	"7-out6427"	.12775	29	198	227
7	"7-out6428"	.53191	50	44	94
7	"7-out6429"	.19523	131	540	671
7	"7-out6430"	.21666	117	423	540
7	"7-out6431"	.17054	22	107	129
7	"7-out6432"	.29284	135	326	461
7	"7-out6433"	.33625	192	379	571
7	"7-out6434"	.22777	82	278	360
7	"7-out6435"	.27645	81	212	293
7	"7-out6436"	.81784	220	49	269
7	"7-out6437"	.82267	283	61	344
7	"7-out6438"	.89606	319	37	356
7	"7-out6439"	.86590	381	59	440
7	"7-out6440"	.17449	52	246	298
7	"7-out6441"	.21880	121	432	553
7	"7-out6442"	.15696	62	333	395
7	"7-out6443"	.84742	511	92	603
7	"7-out6444"	.21161	51	190	241
7	"7-out6445"	.19148	45	190	235
7	"7-out6446"	.18173	209	941	1150
7	"7-out6447"	.24682	233	711	944
7	"7-out6448"	.24203	190	595	785
7	"7-out6449"	.50704	144	140	284
7	"7-out6450"	.38983	253	396	649
7	"7-out6451"	.74193	184	64	248
7	"7-out6452"	.23288	296	975	1271
7	"7-out6453"	.17518	24	113	137
7	"7-out6454"	.15374	117	644	761
7	"7-out6455"	.34597	73	138	211
7	"7-out6456"	.24899	62	187	249
7	"7-out6457"	.22792	222	752	974
7	"7-out6458"	.26635	285	785	1070
7	"7-out6459"	.34674	181	341	522
7	"7-out6460"	.14040	131	802	933
7	"7-out6461"	.39534	68	104	172
7	"7-out6462"	.82989	161	33	194
7	"7-out6463"	.24255	285	890	1175
7	"7-out6464"	.30632	155	351	506
7	"7-out6465"	.17287	65	311	376
7	"7-out6466"	.39024	80	125	205
7	"7-out6467"	.18807	82	354	436
7	"7-out6468"	.40992	157	226	383
7	"7-out6469"	.16748	102	507	609
7	"7-out6470"	.95872	929	40	969
7	"7-out6471"	.95566	776	36	812
7	"7-out6472"	.95681	1396	63	1459
7	"7-out6473"	.14471	100	591	691
7	"7-out6474"	.10775	75	621	696
7	"7-out6475"	.43464	266	346	612
7	"7-out6476"	.17832	153	705	858
7	"7-out6477"	.24342	37	115	152
7	"7-out6478"	.26562	170	470	640
7	"7-out6479"	.80000	88	22	110
7	"7-out6480"	.42696	114	153	267
7	"7-out6481"	.40248	97	144	241
7	"7-out6482"	.92409	280	23	303
7	"7-out6483"	.10633	47	395	442
7	"7-out6484"	.90370	244	26	270
7	"7-out6485"	.28723	81	201	282
7	"7-out6486"	.93060	1636	122	1758
7	"7-out6487"	.31141	90	199	289
7	"7-out6488"	.46095	667	780	1447
7	"7-out6489"	.16461	67	340	407
7	"7-out6490"	.26086	150	425	575
7	"7-out6491"	.38957	127	199	326
7	"7-out6492"	.38810	248	391	639
7	"7-out6493"	.66346	69	35	104
7	"7-out6494"	.35640	103	186	289
7	"7-out6495"	.24110	61	192	253
7	"7-out6496"	.27565	94	247	341
7	"7-out6497"	.93750	120	8	128
7	"7-out6498"	.19424	108	448	556
7	"7-out6499"	.35451	106	193	299
7	"7-out6500"	.18006	177	806	983
7	"7-out6501"	.23009	419	1402	1821
7	"7-out6502"	.22332	90	313	403
7	"7-out6503"	.15353	115	634	749
7	"7-out6504"	.24183	333	1044	1377
7	"7-out6505"	.93863	413	27	440
7	"7-out6506"	.94276	280	17	297
7	"7-out6507"	.22211	227	795	1022
7	"7-out6508"	.17444	86	407	493
7	"7-out6509"	.49330	221	227	448
7	"7-out6510"	.13824	77	480	557
7	"7-out6511"	.86466	345	54	399
7	"7-out6512"	.71338	453	182	635
7	"7-out6513"	.95588	195	9	204
7	"7-out6514"	.16430	58	295	353
7	"7-out6515"	.30406	142	325	467
7	"7-out6516"	.47619	100	110	210
7	"7-out6517"	.88489	123	16	139
7	"7-out6518"	.13313	45	293	338
7	"7-out6519"	.22180	59	207	266
7	"7-out6520"	.82564	483	102	585
7	"7-out6521"	.70472	179	75	254
7	"7-out6522"	.17171	187	902	1089
7	"7-out6523"	.22222	96	336	432
7	"7-out6524"	.20476	172	668	840
7	"7-out6525"	.76829	63	19	82
7	"7-out6526"	.10606	35	295	330
7	"7-out6527"	.32453	123	256	379
7	"7-out6528"	.21942	931	3312	4243
7	"7-out6529"	.84393	438	81	519
7	"7-out6530"	.91304	357	34	391
7	"7-out6531"	.18802	766	3308	4074
7	"7-out6532"	.78285	137	38	175
7	"7-out6533"	.20886	33	125	158
7	"7-out6534"	.19841	275	1111	1386
7	"7-out6535"	.32802	103	211	314
7	"7-out6536"	.38888	343	539	882
7	"7-out6537"	.33333	84	168	252
7	"7-out6538"	.15873	120	636	756
7	"7-out6539"	.26058	80	227	307
7	"7-out6540"	.17821	18	83	101
7	"7-out6541"	.26720	66	181	247
7	"7-out6542"	.32657	161	332	493
7	"7-out6543"	.24066	58	183	241
7	"7-out6544"	.15755	147	786	933
7	"7-out6545"	.26808	126	344	470
7	"7-out6546"	.65803	127	66	193
7	"7-out6547"	.21734	198	713	911
7	"7-out6548"	.23548	1034	3357	4391
7	"7-out6549"	.32490	822	1708	2530
7	"7-out6550"	.25662	155	449	604
7	"7-out6551"	.37889	158	259	417
7	"7-out6552"	.17333	65	310	375
7	"7-out6553"	.38629	124	197	321
7	"7-out6554"	.26855	76	207	283
7	"7-out6555"	.23280	88	290	378
7	"7-out6556"	.30470	376	858	1234
7	"7-out6557"	.29373	136	327	463
7	"7-out6558"	.45708	245	291	536
7	"7-out6559"	.15830	41	218	259
7	"7-out6560"	.82142	138	30	168
7	"7-out6561"	.95336	184	9	193
7	"7-out6562"	.34959	86	160	246
7	"7-out6563"	.13432	63	406	469
7	"7-out6564"	.22246	101	353	454
7	"7-out6565"	.17690	121	563	684
7	"7-out6566"	.19930	230	924	1154
7	"7-out6567"	.19440	139	576	715
7	"7-out6568"	.06299	16	238	254
7	"7-out6569"	.12520	75	524	599
7	"7-out6570"	.26530	52	144	196
7	"7-out6571"	.43946	98	125	223
7	"7-out6572"	.68461	89	41	130
7	"7-out6573"	.25651	423	1226	1649
7	"7-out6574"	.18766	143	619	762
7	"7-out6575"	.58895	96	67	163
7	"7-out6576"	.14096	32	195	227
7	"7-out6577"	.37244	146	246	392
7	"7-out6578"	.27132	773	2076	2849
7	"7-out6579"	.16336	66	338	404
7	"7-out6580"	.30517	242	551	793
7	"7-out6581"	.32348	208	435	643
7	"7-out6582"	.24841	196	593	789
7	"7-out6583"	.21901	129	460	589
7	"7-out6584"	.20997	160	602	762
7	"7-out6585"	.24753	301	915	1216
7	"7-out6586"	.41709	566	791	1357
7	"7-out6587"	.86330	240	38	278
7	"7-out6588"	.15000	75	425	500
7	"7-out6589"	.91304	84	8	92
7	"7-out6590"	.15333	46	254	300
7	"7-out6591"	.36658	147	254	401
7	"7-out6592"	.26771	34	93	127
7	"7-out6593"	.28219	103	262	365
7	"7-out6594"	.83555	188	37	225
7	"7-out6595"	.12500	13	91	104
7	"7-out6596"	.23885	75	239	314
7	"7-out6597"	.16838	49	242	291
7	"7-out6598"	.95496	1654	78	1732
7	"7-out6599"	.22705	339	1154	1493
7	"7-out6600"	.35761	108	194	302
7	"7-out6601"	.24161	36	113	149
7	"7-out6602"	.51351	114	108	222
7	"7-out6603"	.27572	343	901	1244
7	"7-out6604"	.24091	325	1024	1349
7	"7-out6605"	.20649	286	1099	1385
7	"7-out6606"	.24099	194	611	805
7	"7-out6607"	.34935	218	406	624
7	"7-out6608"	.20631	183	704	887
7	"7-out6609"	.16822	54	267	321
7	"7-out6610"	.18806	104	449	553
7	"7-out6611"	.24671	150	458	608
7	"7-out6612"	.26160	310	875	1185
7	"7-out6613"	.36308	179	314	493
7	"7-out6614"	.61851	501	309	810
7	"7-out6615"	.13359	169	1096	1265
7	"7-out6616"	.28813	408	1008	1416
7	"7-out6617"	.79048	1479	392	1871
7	"7-out6618"	.88581	512	66	578
7	"7-out6619"	.51522	203	191	394
7	"7-out6620"	.40483	134	197	331
7	"7-out6621"	.52000	65	60	125
7	"7-out6622"	.24856	303	916	1219
7	"7-out6623"	.19367	153	637	790
7	"7-out6624"	.23764	101	324	425
7	"7-out6625"	.27240	304	812	1116
7	"7-out6626"	.24698	82	250	332
7	"7-out6627"	.93087	983	73	1056
7	"7-out6628"	.69714	122	53	175
7	"7-out6629"	.22183	191	670	861
7	"7-out6630"	.30519	141	321	462
7	"7-out6631"	.31513	329	715	1044
7	"7-out6632"	.19491	138	570	708
7	"7-out6633"	.82500	3550	753	4303
7	"7-out6634"	.59459	110	75	185
7	"7-out6635"	.21830	31	111	142
7	"7-out6636"	.52631	230	207	437
7	"7-out6637"	.16129	70	364	434
7	"7-out6638"	.23035	519	1734	2253
7	"7-out6639"	.23265	114	376	490
7	"7-out6640"	.33241	121	243	364
7	"7-out6641"	.14961	193	1097	1290
7	"7-out6642"	.20909	354	1339	1693
7	"7-out6643"	.22191	243	852	1095
7	"7-out6644"	.25377	286	841	1127
7	"7-out6645"	.95975	310	13	323
7	"7-out6646"	.11147	34	271	305
7	"7-out6647"	.14305	104	623	727
7	"7-out6648"	.27137	200	537	737
7	"7-out6649"	.17208	127	611	738
7	"7-out6650"	.24947	473	1423	1896
7	"7-out6651"	.93333	140	10	150
7	"7-out6652"	.30120	575	1334	1909
7	"7-out6653"	.24426	383	1185	1568
7	"7-out6654"	.94679	1655	93	1748
7	"7-out6655"	.90334	486	52	538
7	"7-out6656"	.93371	1648	117	1765
7	"7-out6657"	.42774	74	99	173
7	"7-out6658"	.88596	101	13	114
7	"7-out6659"	.10952	46	374	420
7	"7-out6660"	.17295	133	636	769
7	"7-out6661"	.70591	1121	467	1588
7	"7-out6662"	.30353	343	787	1130
7	"7-out6663"	.15075	30	169	199
7	"7-out6664"	.18614	43	188	231
7	"7-out6665"	.12914	191	1288	1479
7	"7-out6666"	.24621	309	946	1255
7	"7-out6667"	.17977	128	584	712
7	"7-out6668"	.89113	704	86	790
7	"7-out6669"	.41431	220	311	531
7	"7-out6670"	.20155	26	103	129
7	"7-out6671"	.30819	94	211	305
7	"7-out6672"	.15688	123	661	784
7	"7-out6673"	.20918	41	155	196
7	"7-out6674"	.21515	88	321	409
7	"7-out6675"	.20822	248	943	1191
7	"7-out6676"	.31638	336	726	1062
7	"7-out6677"	.34707	101	190	291
7	"7-out6678"	.18548	253	1111	1364
7	"7-out6679"	.92000	276	24	300
7	"7-out6680"	.55455	432	347	779
7	"7-out6681"	.19714	221	900	1121
7	"7-out6682"	.30344	88	202	290
7	"7-out6683"	.24449	100	309	409
7	"7-out6684"	.24897	122	368	490
7	"7-out6685"	.29638	639	1517	2156
7	"7-out6686"	.29289	99	239	338
7	"7-out6687"	.18848	203	874	1077
7	"7-out6688"	.30941	69	154	223
7	"7-out6689"	.13775	27	169	196
7	"7-out6690"	.27557	264	694	958
7	"7-out6691"	.32075	136	288	424
7	"7-out6692"	.17653	343	1600	1943
7	"7-out6693"	.21963	179	636	815
7	"7-out6694"	.44275	321	404	725
7	"7-out6695"	.83106	428	87	515
7	"7-out6696"	.86524	244	38	282
7	"7-out6697"	.27826	96	249	345
7	"7-out6698"	.42592	115	155	270
7	"7-out6699"	.38271	341	550	891
7	"7-out6700"	.12356	86	610	696
7	"7-out6701"	.07218	61	784	845
7	"7-out6702"	.25179	246	731	977
7	"7-out6703"	.26523	222	615	837
7	"7-out6704"	.09812	94	864	958
7	"7-out6705"	.22989	183	613	796
7	"7-out6706"	.22061	336	1187	1523
7	"7-out6707"	.32180	214	451	665
7	"7-out6708"	.40392	206	304	510
7	"7-out6709"	.17708	85	395	480
7	"7-out6710"	.20121	99	393	492
7	"7-out6711"	.23938	62	197	259
7	"7-out6712"	.43003	126	167	293
7	"7-out6713"	.23897	103	328	431
7	"7-out6714"	.29239	100	242	342
7	"7-out6715"	.37837	98	161	259
7	"7-out6716"	.22736	108	367	475
7	"7-out6717"	.33039	300	608	908
7	"7-out6718"	.22231	277	969	1246
7	"7-out6719"	.84810	134	24	158
7	"7-out6720"	.40207	388	577	965
7	"7-out6721"	.89570	146	17	163
7	"7-out6722"	.30575	255	579	834
7	"7-out6723"	.20175	161	637	798
7	"7-out6724"	.23924	139	442	581
7	"7-out6725"	.41801	492	685	1177
7	"7-out6726"	.26865	90	245	335
7	"7-out6727"	.34036	113	219	332
7	"7-out6728"	.90151	119	13	132
7	"7-out6729"	.30105	171	397	568
7	"7-out6730"	.32530	189	392	581
7	"7-out6731"	.28699	64	159	223
7	"7-out6732"	.34827	202	378	580
7	"7-out6733"	.19767	34	138	172
7	"7-out6734"	.49673	304	308	612
7	"7-out6735"	.90789	207	21	228
7	"7-out6736"	.13312	84	547	631
7	"7-out6737"	.22988	160	536	696
7	"7-out6738"	.93928	263	17	280
7	"7-out6739"	.86666	143	22	165
7	"7-out6740"	.17073	42	204	246
7	"7-out6741"	.42061	151	208	359
7	"7-out6742"	.30120	75	174	249
7	"7-out6743"	.93048	348	26	374
7	"7-out6744"	.36423	110	192	302
7	"7-out6745"	.14095	53	323	376
7	"7-out6746"	.19951	165	662	827
7	"7-out6747"	.58967	411	286	697
7	"7-out6748"	.49695	163	165	328
7	"7-out6749"	.87525	421	60	481
7	"7-out6750"	.29629	232	551	783
7	"7-out6751"	.18250	169	757	926
7	"7-out6752"	.79487	62	16	78
7	"7-out6753"	.19565	18	74	92
7	"7-out6754"	.36263	33	58	91
7	"7-out6755"	.16971	130	636	766
7	"7-out6756"	.72307	94	36	130
7	"7-out6757"	.91578	87	8	95
7	"7-out6758"	.96363	53	2	55
7	"7-out6759"	.25487	170	497	667
7	"7-out6760"	.88135	52	7	59
7	"7-out6761"	.94366	67	4	71
7	"7-out6762"	.90291	93	10	103
7	"7-out6763"	.90909	120	12	132
7	"7-out6764"	.84705	72	13	85
7	"7-out6765"	.86021	80	13	93
7	"7-out6766"	.19540	102	420	522
7	"7-out6767"	.17543	70	329	399
7	"7-out6768"	.20750	83	317	400
7	"7-out6769"	.75000	153	51	204
7	"7-out6770"	.74770	163	55	218
7	"7-out6771"	.78625	206	56	262
7	"7-out6772"	.19429	252	1045	1297
7	"7-out6773"	.79899	318	80	398
7	"7-out6774"	.87500	154	22	176
7	"7-out6775"	.21913	410	1461	1871
7	"7-out6776"	.92233	95	8	103
7	"7-out6777"	.27412	125	331	456
7	"7-out6778"	.28681	224	557	781
7	"7-out6779"	.38039	97	158	255
7	"7-out6780"	.89256	108	13	121
7	"7-out6781"	.34223	141	271	412
7	"7-out6782"	.25348	91	268	359
7	"7-out6783"	.23734	75	241	316
7	"7-out6784"	.24516	203	625	828
7	"7-out6785"	.48123	218	235	453
7	"7-out6786"	.63126	315	184	499
7	"7-out6787"	.64146	297	166	463
7	"7-out6788"	.19152	253	1068	1321
7	"7-out6789"	.31400	65	142	207
7	"7-out6790"	.31670	146	315	461
7	"7-out6791"	.78378	58	16	74
7	"7-out6792"	.89285	50	6	56
7	"7-out6793"	.15654	49	264	313
7	"7-out6794"	.20588	77	297	374
7	"7-out6795"	.21681	276	997	1273
7	"7-out6796"	.16351	190	972	1162
7	"7-out6797"	.10191	32	282	314
7	"7-out6798"	.34516	107	203	310
7	"7-out6799"	.25070	89	266	355
7	"7-out6800"	.41489	117	165	282
7	"7-out6801"	.78955	514	137	651
7	"7-out6802"	.30964	61	136	197
7	"7-out6803"	.92506	358	29	387
7	"7-out6804"	.35342	129	236	365
7	"7-out6805"	.22075	351	1239	1590
7	"7-out6806"	.16788	69	342	411
7	"7-out6807"	.39278	577	892	1469
7	"7-out6808"	.24089	119	375	494
7	"7-out6809"	.25757	34	98	132
7	"7-out6810"	.64516	100	55	155
7	"7-out6811"	.47524	240	265	505
7	"7-out6812"	.21161	357	1330	1687
7	"7-out6813"	.38581	544	866	1410
7	"7-out6814"	.28626	223	556	779
7	"7-out6815"	.23429	194	634	828
7	"7-out6816"	.67001	601	296	897
7	"7-out6817"	.22358	91	316	407
7	"7-out6818"	.13636	18	114	132
7	"7-out6819"	.30947	320	714	1034
7	"7-out6820"	.29692	174	412	586
7	"7-out6821"	.13661	225	1422	1647
7	"7-out6822"	.23049	65	217	282
7	"7-out6823"	.28148	152	388	540
7	"7-out6824"	.75000	63	21	84
7	"7-out6825"	.27135	54	145	199
7	"7-out6826"	.23076	81	270	351
7	"7-out6827"	.23684	54	174	228
7	"7-out6828"	.23478	54	176	230
7	"7-out6829"	.16593	188	945	1133
7	"7-out6830"	.38500	924	1476	2400
7	"7-out6831"	.13039	148	987	1135
7	"7-out6832"	.28431	58	146	204
7	"7-out6833"	.10693	37	309	346
7	"7-out6834"	.69718	99	43	142
7	"7-out6835"	.12660	128	883	1011
7	"7-out6836"	.27232	436	1165	1601
7	"7-out6837"	.21228	273	1013	1286
7	"7-out6838"	.36507	115	200	315
7	"7-out6839"	.26593	146	403	549
7	"7-out6840"	.26179	111	313	424
7	"7-out6841"	.25203	124	368	492
7	"7-out6842"	.89447	356	42	398
7	"7-out6843"	.14967	69	392	461
7	"7-out6844"	.87066	276	41	317
7	"7-out6845"	.42364	172	234	406
7	"7-out6846"	.38301	221	356	577
7	"7-out6847"	.26079	151	428	579
7	"7-out6848"	.23838	118	377	495
7	"7-out6849"	.08000	14	161	175
7	"7-out6850"	.22891	76	256	332
7	"7-out6851"	.14285	16	96	112
7	"7-out6852"	.23913	33	105	138
7	"7-out6853"	.68944	111	50	161
7	"7-out6854"	.19025	125	532	657
7	"7-out6855"	.27213	209	559	768
7	"7-out6856"	.34953	187	348	535
7	"7-out6857"	.22832	79	267	346
7	"7-out6858"	.10424	59	507	566
7	"7-out6859"	.84498	278	51	329
7	"7-out6860"	.70352	439	185	624
7	"7-out6861"	.72362	343	131	474
7	"7-out6862"	.18082	83	376	459
7	"7-out6863"	.34862	76	142	218
7	"7-out6864"	.14000	21	129	150
7	"7-out6865"	.90789	207	21	228
7	"7-out6866"	.78280	173	48	221
7	"7-out6867"	.14558	61	358	419
7	"7-out6868"	.10410	33	284	317
7	"7-out6869"	.23607	195	631	826
7	"7-out6870"	.44099	142	180	322
7	"7-out6871"	.16400	226	1152	1378
7	"7-out6872"	.27953	388	1000	1388
7	"7-out6873"	.15928	223	1177	1400
7	"7-out6874"	.80660	171	41	212
7	"7-out6875"	.88034	103	14	117
7	"7-out6876"	.16417	11	56	67
7	"7-out6877"	.52870	221	197	418
7	"7-out6878"	.21675	370	1337	1707
7	"7-out6879"	.22278	438	1528	1966
7	"7-out6880"	.89512	1101	129	1230
7	"7-out6881"	.18914	108	463	571
7	"7-out6882"	.22656	58	198	256
7	"7-out6883"	.41558	64	90	154
7	"7-out6884"	.36412	1896	3311	5207
7	"7-out6885"	.78333	141	39	180
7	"7-out6886"	.38461	120	192	312
7	"7-out6887"	.24793	90	273	363
7	"7-out6888"	.10801	31	256	287
7	"7-out6889"	.53012	176	156	332
7	"7-out6890"	.36758	93	160	253
7	"7-out6891"	.52120	295	271	566
7	"7-out6892"	.08522	15	161	176
7	"7-out6893"	.23976	82	260	342
7	"7-out6894"	.34987	141	262	403
7	"7-out6895"	.20743	173	661	834
7	"7-out6896"	.14465	46	272	318
7	"7-out6897"	.22388	45	156	201
7	"7-out6898"	.82758	360	75	435
7	"7-out6899"	.50478	264	259	523
7	"7-out6900"	.29906	64	150	214
7	"7-out6901"	.89438	271	32	303
7	"7-out6902"	.37748	57	94	151
7	"7-out6903"	.56934	78	59	137
7	"7-out6904"	.21467	79	289	368
7	"7-out6905"	.27835	108	280	388
7	"7-out6906"	.75714	106	34	140
7	"7-out6907"	.33620	39	77	116
7	"7-out6908"	.18604	24	105	129
7	"7-out6909"	.36407	150	262	412
7	"7-out6910"	.19060	73	310	383
7	"7-out6911"	.23321	66	217	283
7	"7-out6912"	.52619	231	208	439
7	"7-out6913"	.44137	192	243	435
7	"7-out6914"	.85000	408	72	480
7	"7-out6915"	.95098	194	10	204
7	"7-out6916"	.30967	144	321	465
7	"7-out6917"	.16216	84	434	518
7	"7-out6918"	.08812	46	476	522
7	"7-out6919"	.14739	51	295	346
7	"7-out6920"	.72080	648	251	899
7	"7-out6921"	.36153	94	166	260
7	"7-out6922"	.30204	74	171	245
7	"7-out6923"	.69830	206	89	295
7	"7-out6924"	.25592	108	314	422
7	"7-out6925"	.37313	150	252	402
7	"7-out6926"	.82005	319	70	389
7	"7-out6927"	.31135	85	188	273
7	"7-out6928"	.70353	159	67	226
7	"7-out6929"	.91228	104	10	114
7	"7-out6930"	.30018	317	739	1056
7	"7-out6931"	.22363	229	795	1024
7	"7-out6932"	.16861	130	641	771
7	"7-out6933"	.56216	104	81	185
7	"7-out6934"	.25768	218	628	846
7	"7-out6935"	.57633	151	111	262
7	"7-out6936"	.34124	230	444	674
7	"7-out6937"	.14361	27	161	188
7	"7-out6938"	.25254	124	367	491
7	"7-out6939"	.92592	50	4	54
7	"7-out6940"	.83739	412	80	492
7	"7-out6941"	.24608	346	1060	1406
7	"7-out6942"	.27173	397	1064	1461
7	"7-out6943"	.15673	200	1076	1276
7	"7-out6944"	.81935	254	56	310
7	"7-out6945"	.20305	438	1719	2157
7	"7-out6946"	.16363	135	690	825
7	"7-out6947"	.13987	87	535	622
7	"7-out6948"	.32246	178	374	552
7	"7-out6949"	.90951	583	58	641
7	"7-out6950"	.23479	139	453	592
7	"7-out6951"	.21500	86	314	400
7	"7-out6952"	.38735	98	155	253
7	"7-out6953"	.33333	73	146	219
7	"7-out6954"	.91200	342	33	375
7	"7-out6955"	.31097	102	226	328
7	"7-out6956"	.91954	80	7	87
7	"7-out6957"	.84664	265	48	313
7	"7-out6958"	.54272	235	198	433
7	"7-out6959"	.82142	230	50	280
7	"7-out6960"	.27118	112	301	413
7	"7-out6961"	.18404	60	266	326
7	"7-out6962"	.31527	128	278	406
7	"7-out6963"	.29154	100	243	343
7	"7-out6964"	.32490	90	187	277
7	"7-out6965"	.33333	168	336	504
7	"7-out6966"	.71365	648	260	908
7	"7-out6967"	.85774	205	34	239
7	"7-out6968"	.22363	123	427	550
7	"7-out6969"	.86486	96	15	111
7	"7-out6970"	.16666	17	85	102
7	"7-out6971"	.30065	46	107	153
7	"7-out6972"	.24519	204	628	832
7	"7-out6973"	.21370	53	195	248
7	"7-out6974"	.87721	593	83	676
7	"7-out6975"	.43750	56	72	128
7	"7-out6976"	.80014	1077	269	1346
7	"7-out6977"	.51131	113	108	221
7	"7-out6978"	.42922	94	125	219
7	"7-out6979"	.28431	87	219	306
7	"7-out6980"	.92727	204	16	220
7	"7-out6981"	.15340	54	298	352
7	"7-out6982"	.54687	140	116	256
7	"7-out6983"	.07196	19	245	264
7	"7-out6984"	.21875	56	200	256
7	"7-out6985"	.77565	325	94	419
7	"7-out6986"	.27411	54	143	197
7	"7-out6987"	.19685	50	204	254
7	"7-out6988"	.24600	77	236	313
7	"7-out6989"	.80505	223	54	277
7	"7-out6990"	.53869	181	155	336
7	"7-out6991"	.25596	118	343	461
7	"7-out6992"	.37321	209	351	560
7	"7-out6993"	.26974	140	379	519
7	"7-out6994"	.92857	130	10	140
7	"7-out6995"	.19238	96	403	499
7	"7-out6996"	.25000	85	255	340
7	"7-out6997"	.79559	253	65	318
7	"7-out6998"	.55930	514	405	919
7	"7-out6999"	.08675	19	200	219
7	"7-out7000"	.68201	311	145	456
7	"7-out7001"	.14111	104	633	737
7	"7-out7002"	.30319	57	131	188
7	"7-out7003"	.39416	108	166	274
7	"7-out7004"	.89189	132	16	148
7	"7-out7005"	.24786	145	440	585
7	"7-out7006"	.38735	98	155	253
7	"7-out7007"	.15071	63	355	418
7	"7-out7008"	.87009	288	43	331
7	"7-out7009"	.16182	39	202	241
7	"7-out7010"	.94565	174	10	184
7	"7-out7011"	.91489	344	32	376
7	"7-out7012"	.18518	40	176	216
7	"7-out7013"	.76291	325	101	426
7	"7-out7014"	.82716	268	56	324
7	"7-out7015"	.28412	179	451	630
7	"7-out7016"	.93514	447	31	478
7	"7-out7017"	.33437	320	637	957
7	"7-out7018"	.93037	441	33	474
7	"7-out7019"	.83240	298	60	358
7	"7-out7020"	.91324	200	19	219
7	"7-out7021"	.19949	158	634	792
7	"7-out7022"	.28454	348	875	1223
7	"7-out7023"	.87931	153	21	174
7	"7-out7024"	.27358	87	231	318
7	"7-out7025"	.21034	61	229	290
7	"7-out7026"	.27666	83	217	300
7	"7-out7027"	.09623	23	216	239
7	"7-out7028"	.13405	37	239	276
7	"7-out7029"	.29579	176	419	595
7	"7-out7030"	.71794	224	88	312
7	"7-out7031"	.91304	441	42	483
7	"7-out7032"	.94780	454	25	479
7	"7-out7033"	.92827	440	34	474
7	"7-out7034"	.93487	445	31	476
7	"7-out7035"	.17015	65	317	382
7	"7-out7036"	.94142	450	28	478
7	"7-out7037"	.94701	143	8	151
7	"7-out7038"	.94570	209	12	221
7	"7-out7039"	.94570	209	12	221
7	"7-out7040"	.90947	432	43	475
7	"7-out7041"	.37837	84	138	222
7	"7-out7042"	.27764	477	1241	1718
7	"7-out7043"	.22140	60	211	271
7	"7-out7044"	.36448	78	136	214
7	"7-out7045"	.25806	264	759	1023
7	"7-out7046"	.23687	221	712	933
7	"7-out7047"	.25376	118	347	465
7	"7-out7048"	.33626	191	377	568
7	"7-out7049"	.37984	49	80	129
7	"7-out7050"	.20853	44	167	211
7	"7-out7051"	.13847	131	815	946
7	"7-out7052"	.24352	141	438	579
7	"7-out7053"	.49735	94	95	189
7	"7-out7054"	.85171	224	39	263
7	"7-out7055"	.64459	292	161	453
7	"7-out7056"	.19397	599	2489	3088
7	"7-out7057"	.36363	40	70	110
7	"7-out7058"	.16949	40	196	236
7	"7-out7059"	.38302	185	298	483
7	"7-out7060"	.21052	48	180	228
7	"7-out7061"	.72147	373	144	517
7	"7-out7062"	.17609	165	772	937
7	"7-out7063"	.10604	100	843	943
7	"7-out7064"	.20267	106	417	523
7	"7-out7065"	.14255	67	403	470
7	"7-out7066"	.14285	74	444	518
7	"7-out7067"	.83229	268	54	322
7	"7-out7068"	.12258	76	544	620
7	"7-out7069"	.76214	298	93	391
7	"7-out7070"	.16939	31	152	183
7	"7-out7071"	.90476	95	10	105
7	"7-out7072"	.96190	101	4	105
7	"7-out7073"	.19876	193	778	971
7	"7-out7074"	.20782	154	587	741
7	"7-out7075"	.21109	156	583	739
7	"7-out7076"	.69838	389	168	557
7	"7-out7077"	.20398	41	160	201
7	"7-out7078"	.12698	32	220	252
7	"7-out7079"	.31372	80	175	255
7	"7-out7080"	.19455	50	207	257
7	"7-out7081"	.13227	25	164	189
7	"7-out7082"	.84360	178	33	211
7	"7-out7083"	.95180	158	8	166
7	"7-out7084"	.92168	153	13	166
7	"7-out7085"	.24300	304	947	1251
7	"7-out7086"	.27827	871	2259	3130
7	"7-out7087"	.89547	257	30	287
7	"7-out7088"	.56747	328	250	578
7	"7-out7089"	.13498	49	314	363
7	"7-out7090"	.18025	84	382	466
7	"7-out7091"	.81703	259	58	317
7	"7-out7092"	.19918	195	784	979
7	"7-out7093"	.84858	269	48	317
7	"7-out7094"	.31393	205	448	653
7	"7-out7095"	.20689	282	1081	1363
7	"7-out7096"	.63084	135	79	214
7	"7-out7097"	.33898	140	273	413
7	"7-out7098"	.36156	380	671	1051
7	"7-out7099"	.44780	163	201	364
7	"7-out7100"	.27849	303	785	1088
7	"7-out7101"	.15384	24	132	156
7	"7-out7102"	.85632	447	75	522
7	"7-out7103"	.18672	45	196	241
7	"7-out7104"	.57946	237	172	409
7	"7-out7105"	.17296	206	985	1191
7	"7-out7106"	.34384	109	208	317
7	"7-out7107"	.98095	103	2	105
7	"7-out7108"	.51243	103	98	201
7	"7-out7109"	.16127	558	2902	3460
7	"7-out7110"	.09090	56	560	616
7	"7-out7111"	.87898	138	19	157
7	"7-out7112"	.28571	182	455	637
7	"7-out7113"	.53240	115	101	216
7	"7-out7114"	.20033	240	958	1198
7	"7-out7115"	.18711	90	391	481
7	"7-out7116"	.22752	534	1813	2347
7	"7-out7117"	.25346	311	916	1227
7	"7-out7118"	.57493	211	156	367
7	"7-out7119"	.17154	41	198	239
7	"7-out7120"	.91463	225	21	246
7	"7-out7121"	.40957	154	222	376
7	"7-out7122"	.22580	77	264	341
7	"7-out7123"	.29821	467	1099	1566
7	"7-out7124"	.32768	116	238	354
7	"7-out7125"	.30854	390	874	1264
7	"7-out7126"	.89547	257	30	287
7	"7-out7127"	.26287	148	415	563
7	"7-out7128"	.21702	232	837	1069
7	"7-out7129"	.26417	368	1025	1393
7	"7-out7130"	.16455	26	132	158
7	"7-out7131"	.36494	177	308	485
7	"7-out7132"	.29378	156	375	531
7	"7-out7133"	.20110	73	290	363
7	"7-out7134"	.28500	57	143	200
7	"7-out7135"	.76859	93	28	121
7	"7-out7136"	.23529	80	260	340
7	"7-out7137"	.30553	392	891	1283
7	"7-out7138"	.32804	248	508	756
7	"7-out7139"	.24747	196	596	792
7	"7-out7140"	.31851	43	92	135
7	"7-out7141"	.56000	196	154	350
7	"7-out7142"	.54477	73	61	134
7	"7-out7143"	.30630	34	77	111
7	"7-out7144"	.20107	224	890	1114
7	"7-out7145"	.18639	74	323	397
7	"7-out7146"	.28745	330	818	1148
7	"7-out7147"	.18945	97	415	512
7	"7-out7148"	.16598	122	613	735
7	"7-out7149"	.14000	63	387	450
7	"7-out7150"	.17370	74	352	426
7	"7-out7151"	.51057	169	162	331
7	"7-out7152"	.32530	459	952	1411
7	"7-out7153"	.26948	83	225	308
7	"7-out7154"	.11895	32	237	269
7	"7-out7155"	.38697	303	480	783
7	"7-out7156"	.20335	182	713	895
7	"7-out7157"	.22335	220	765	985
7	"7-out7158"	.38461	135	216	351
7	"7-out7159"	.22123	100	352	452
7	"7-out7160"	.94382	168	10	178
7	"7-out7161"	.93838	198	13	211
7	"7-out7162"	.41682	218	305	523
7	"7-out7163"	.86102	285	46	331
7	"7-out7164"	.95070	270	14	284
7	"7-out7165"	.76904	939	282	1221
7	"7-out7166"	.14285	58	348	406
7	"7-out7167"	.61611	260	162	422
7	"7-out7168"	.15891	123	651	774
7	"7-out7169"	.37883	222	364	586
7	"7-out7170"	.17692	46	214	260
7	"7-out7171"	.15589	41	222	263
7	"7-out7172"	.15629	113	610	723
7	"7-out7173"	.59018	373	259	632
7	"7-out7174"	.24025	148	468	616
7	"7-out7175"	.19679	86	351	437
7	"7-out7176"	.21982	204	724	928
7	"7-out7177"	.23902	49	156	205
7	"7-out7178"	.34254	62	119	181
7	"7-out7179"	.13347	63	409	472
7	"7-out7180"	.23232	115	380	495
7	"7-out7181"	.23333	42	138	180
7	"7-out7182"	.18978	26	111	137
7	"7-out7183"	.19005	65	277	342
7	"7-out7184"	.29742	127	300	427
7	"7-out7185"	.20398	41	160	201
7	"7-out7186"	.94106	495	31	526
7	"7-out7187"	.68888	186	84	270
7	"7-out7188"	.38202	136	220	356
7	"7-out7189"	.10993	52	421	473
7	"7-out7190"	.17630	64	299	363
7	"7-out7191"	.35567	138	250	388
7	"7-out7192"	.23684	36	116	152
7	"7-out7193"	.21800	46	165	211
7	"7-out7194"	.14419	108	641	749
7	"7-out7195"	.26062	141	400	541
7	"7-out7196"	.89719	96	11	107
7	"7-out7197"	.48175	66	71	137
7	"7-out7198"	.88785	190	24	214
7	"7-out7199"	.85623	405	68	473
7	"7-out7200"	.91228	208	20	228
7	"7-out7201"	.92105	210	18	228
7	"7-out7202"	.17189	115	554	669
7	"7-out7203"	.32105	61	129	190
7	"7-out7204"	.16562	159	801	960
7	"7-out7205"	.57938	208	151	359
7	"7-out7206"	.32621	275	568	843
7	"7-out7207"	.26315	265	742	1007
7	"7-out7208"	.54339	288	242	530
7	"7-out7209"	.30456	60	137	197
7	"7-out7210"	.57522	65	48	113
7	"7-out7211"	.95766	475	21	496
7	"7-out7212"	.18006	56	255	311
7	"7-out7213"	.95766	475	21	496
7	"7-out7214"	.95766	475	21	496
7	"7-out7215"	.15822	50	266	316
7	"7-out7216"	.95238	100	5	105
7	"7-out7217"	.83478	96	19	115
7	"7-out7218"	.36633	111	192	303
7	"7-out7219"	.26530	52	144	196
7	"7-out7220"	.15671	21	113	134
7	"7-out7221"	.17789	103	476	579
7	"7-out7222"	.24342	296	920	1216
7	"7-out7223"	.21140	63	235	298
7	"7-out7224"	.34355	437	835	1272
7	"7-out7225"	.33517	182	361	543
7	"7-out7226"	.87931	153	21	174
7	"7-out7227"	.63054	256	150	406
7	"7-out7228"	.13827	82	511	593
7	"7-out7229"	.16949	40	196	236
7	"7-out7230"	.18650	152	663	815
7	"7-out7231"	.93402	269	19	288
7	"7-out7232"	.25823	196	563	759
7	"7-out7233"	.26666	312	858	1170
7	"7-out7234"	.41637	117	164	281
7	"7-out7235"	.19849	185	747	932
7	"7-out7236"	.19571	73	300	373
7	"7-out7237"	.31481	34	74	108
7	"7-out7238"	.95766	475	21	496
7	"7-out7239"	.41691	138	193	331
7	"7-out7240"	.38924	427	670	1097
7	"7-out7241"	.86344	411	65	476
7	"7-out7242"	.14572	29	170	199
7	"7-out7243"	.08888	12	123	135
7	"7-out7244"	.23952	120	381	501
7	"7-out7245"	.29718	211	499	710
7	"7-out7246"	.95151	157	8	165
7	"7-out7247"	.90220	286	31	317
7	"7-out7248"	.22149	101	355	456
7	"7-out7249"	.55208	106	86	192
7	"7-out7250"	.55033	82	67	149
7	"7-out7251"	.92993	146	11	157
7	"7-out7252"	.95161	236	12	248
7	"7-out7253"	.91216	135	13	148
7	"7-out7254"	.93710	149	10	159
7	"7-out7255"	.30153	98	227	325
7	"7-out7256"	.39344	120	185	305
7	"7-out7257"	.32209	86	181	267
7	"7-out7258"	.13103	19	126	145
7	"7-out7259"	.29191	148	359	507
7	"7-out7260"	.51595	97	91	188
7	"7-out7261"	.19891	110	443	553
7	"7-out7262"	.24728	114	347	461
7	"7-out7263"	.22374	294	1020	1314
7	"7-out7264"	.22553	106	364	470
7	"7-out7265"	.35426	378	689	1067
7	"7-out7266"	.29268	96	232	328
7	"7-out7267"	.53321	289	253	542
7	"7-out7268"	.93377	141	10	151
7	"7-out7269"	.31870	610	1304	1914
7	"7-out7270"	.13888	30	186	216
7	"7-out7271"	.76245	199	62	261
7	"7-out7272"	.56400	141	109	250
7	"7-out7273"	.17348	89	424	513
7	"7-out7274"	.53229	239	210	449
7	"7-out7275"	.29032	45	110	155
7	"7-out7276"	.27173	25	67	92
7	"7-out7277"	.75641	295	95	390
7	"7-out7278"	.64788	92	50	142
7	"7-out7279"	.20945	31	117	148
7	"7-out7280"	.36334	113	198	311
7	"7-out7281"	.26272	129	362	491
7	"7-out7282"	.11886	63	467	530
7	"7-out7283"	.49408	167	171	338
7	"7-out7284"	.11553	29	222	251
7	"7-out7285"	.58520	182	129	311
7	"7-out7286"	.26257	261	733	994
7	"7-out7287"	.11643	51	387	438
7	"7-out7288"	.81632	200	45	245
7	"7-out7289"	.49592	548	557	1105
7	"7-out7290"	.58441	90	64	154
7	"7-out7291"	.14743	23	133	156
7	"7-out7292"	.32763	422	866	1288
7	"7-out7293"	.21276	90	333	423
7	"7-out7294"	.22807	52	176	228
7	"7-out7295"	.18750	57	247	304
7	"7-out7296"	.31200	195	430	625
7	"7-out7297"	.38686	53	84	137
7	"7-out7298"	.12820	20	136	156
7	"7-out7299"	.29442	111	266	377
7	"7-out7300"	.18061	41	186	227
7	"7-out7301"	.69212	299	133	432
7	"7-out7302"	.46153	72	84	156
7	"7-out7303"	.25618	352	1022	1374
7	"7-out7304"	.45932	271	319	590
7	"7-out7305"	.19223	99	416	515
7	"7-out7306"	.15935	69	364	433
7	"7-out7307"	.49253	528	544	1072
7	"7-out7308"	.61052	116	74	190
7	"7-out7309"	.24099	107	337	444
7	"7-out7310"	.25829	358	1028	1386
7	"7-out7311"	.94736	252	14	266
7	"7-out7312"	.63500	254	146	400
7	"7-out7313"	.27542	195	513	708
7	"7-out7314"	.32702	190	391	581
7	"7-out7315"	.18511	92	405	497
7	"7-out7316"	.68831	53	24	77
7	"7-out7317"	.21860	47	168	215
7	"7-out7318"	.36923	24	41	65
7	"7-out7319"	.77978	517	146	663
7	"7-out7320"	.91304	147	14	161
7	"7-out7321"	.88755	221	28	249
7	"7-out7322"	.18623	138	603	741
7	"7-out7323"	.25323	137	404	541
7	"7-out7324"	.26633	216	595	811
7	"7-out7325"	.33518	544	1079	1623
7	"7-out7326"	.13362	31	201	232
7	"7-out7327"	.09251	21	206	227
7	"7-out7328"	.07786	19	225	244
7	"7-out7329"	.30787	133	299	432
7	"7-out7330"	.54744	375	310	685
7	"7-out7331"	.33608	163	322	485
7	"7-out7332"	.42073	69	95	164
7	"7-out7333"	.17866	72	331	403
7	"7-out7334"	.17777	32	148	180
7	"7-out7335"	.33132	55	111	166
7	"7-out7336"	.71518	113	45	158
7	"7-out7337"	.95238	140	7	147
7	"7-out7338"	.30573	96	218	314
7	"7-out7339"	.18103	42	190	232
7	"7-out7340"	.17289	74	354	428
7	"7-out7341"	.58169	89	64	153
7	"7-out7342"	.24250	97	303	400
7	"7-out7343"	.32870	142	290	432
7	"7-out7344"	.30484	264	602	866
7	"7-out7345"	.27760	176	458	634
7	"7-out7346"	.26243	95	267	362
7	"7-out7347"	.16730	131	652	783
7	"7-out7348"	.25000	31	93	124
7	"7-out7349"	.03246	5	149	154
7	"7-out7350"	.20603	41	158	199
7	"7-out7351"	.17727	39	181	220
7	"7-out7352"	.32462	87	181	268
7	"7-out7353"	.27561	78	205	283
7	"7-out7354"	.46831	170	193	363
7	"7-out7355"	.29166	91	221	312
7	"7-out7356"	.26380	86	240	326
7	"7-out7357"	.21560	315	1146	1461
7	"7-out7358"	.49166	59	61	120
7	"7-out7359"	.04587	5	104	109
7	"7-out7360"	.53061	416	368	784
7	"7-out7361"	.10711	143	1192	1335
7	"7-out7362"	.36111	91	161	252
7	"7-out7363"	.47186	260	291	551
7	"7-out7364"	.95362	473	23	496
7	"7-out7365"	.26182	83	234	317
7	"7-out7366"	.94949	188	10	198
7	"7-out7367"	.32142	108	228	336
7	"7-out7368"	.95238	100	5	105
7	"7-out7369"	.27067	72	194	266
7	"7-out7370"	.17000	212	1035	1247
7	"7-out7371"	.28109	174	445	619
7	"7-out7372"	.33503	131	260	391
7	"7-out7373"	.50925	55	53	108
7	"7-out7374"	.24117	82	258	340
7	"7-out7375"	.19722	142	578	720
7	"7-out7376"	.19130	22	93	115
7	"7-out7377"	.25454	42	123	165
7	"7-out7378"	.17445	112	530	642
7	"7-out7379"	.77362	352	103	455
7	"7-out7380"	.94716	502	28	530
7	"7-out7381"	.36496	200	348	548
7	"7-out7382"	.23045	56	187	243
7	"7-out7383"	.06486	12	173	185
7	"7-out7384"	.47812	153	167	320
7	"7-out7385"	.22413	117	405	522
7	"7-out7386"	.90811	425	43	468
7	"7-out7387"	.26429	134	373	507
7	"7-out7388"	.15738	161	862	1023
7	"7-out7389"	.09489	26	248	274
7	"7-out7390"	.70934	205	84	289
7	"7-out7391"	.40922	142	205	347
7	"7-out7392"	.19584	66	271	337
7	"7-out7393"	.26602	83	229	312
7	"7-out7394"	.40846	357	517	874
7	"7-out7395"	.18571	26	114	140
7	"7-out7396"	.87750	1096	153	1249
7	"7-out7397"	.87529	730	104	834
7	"7-out7398"	.87550	1076	153	1229
7	"7-out7399"	.41438	121	171	292
7	"7-out7400"	.22635	67	229	296
7	"7-out7401"	.20944	102	385	487
7	"7-out7402"	.19226	363	1525	1888
7	"7-out7403"	.74752	151	51	202
7	"7-out7404"	.22055	88	311	399
7	"7-out7405"	.18639	74	323	397
7	"7-out7406"	.16350	69	353	422
7	"7-out7407"	.35798	213	382	595
7	"7-out7408"	.18832	71	306	377
7	"7-out7409"	.18359	300	1334	1634
7	"7-out7410"	.27743	91	237	328
7	"7-out7411"	.90807	326	33	359
7	"7-out7412"	.31941	153	326	479
7	"7-out7413"	.33887	163	318	481
7	"7-out7414"	.17943	96	439	535
7	"7-out7415"	.15338	77	425	502
7	"7-out7416"	.30012	250	583	833
7	"7-out7417"	.35036	96	178	274
7	"7-out7418"	.88942	740	92	832
7	"7-out7419"	.18238	145	650	795
7	"7-out7420"	.19739	91	370	461
7	"7-out7421"	.28616	182	454	636
7	"7-out7422"	.12647	75	518	593
7	"7-out7423"	.40312	129	191	320
7	"7-out7424"	.27750	227	591	818
7	"7-out7425"	.80270	415	102	517
7	"7-out7426"	.23439	199	650	849
7	"7-out7427"	.45061	73	89	162
7	"7-out7428"	.84146	138	26	164
7	"7-out7429"	.83536	137	27	164
7	"7-out7430"	.84756	139	25	164
7	"7-out7431"	.85365	140	24	164
7	"7-out7432"	.54322	465	391	856
7	"7-out7433"	.35958	242	431	673
7	"7-out7434"	.26315	145	406	551
7	"7-out7435"	.10000	72	648	720
7	"7-out7436"	.16888	203	999	1202
7	"7-out7437"	.84640	259	47	306
7	"7-out7438"	.79487	62	16	78
7	"7-out7439"	.56626	47	36	83
7	"7-out7440"	.96703	88	3	91
7	"7-out7441"	.23232	23	76	99
7	"7-out7442"	.94915	112	6	118
7	"7-out7443"	.94736	90	5	95
7	"7-out7444"	.22388	15	52	67
7	"7-out7445"	.88148	119	16	135
7	"7-out7446"	.94186	162	10	172
7	"7-out7447"	.90789	138	14	152
7	"7-out7448"	.97058	99	3	102
7	"7-out7449"	.83870	78	15	93
7	"7-out7450"	.70412	614	258	872
7	"7-out7451"	.89705	61	7	68
7	"7-out7452"	.29462	307	735	1042
7	"7-out7453"	.26000	104	296	400
7	"7-out7454"	.24274	184	574	758
7	"7-out7455"	.18857	33	142	175
7	"7-out7456"	.35563	101	183	284
7	"7-out7457"	.29896	87	204	291
7	"7-out7458"	.23192	77	255	332
7	"7-out7459"	.80108	592	147	739
7	"7-out7460"	.32163	220	464	684
7	"7-out7461"	.26785	195	533	728
7	"7-out7462"	.73826	739	262	1001
7	"7-out7463"	.16871	137	675	812
7	"7-out7464"	.23660	212	684	896
7	"7-out7465"	.22571	151	518	669
7	"7-out7466"	.25891	167	478	645
7	"7-out7467"	.26629	143	394	537
7	"7-out7468"	.33629	378	746	1124
7	"7-out7469"	.18208	61	274	335
7	"7-out7470"	.17543	50	235	285
7	"7-out7471"	.30103	87	202	289
7	"7-out7472"	.23913	66	210	276
7	"7-out7473"	.13409	35	226	261
7	"7-out7474"	.33270	352	706	1058
7	"7-out7475"	.16808	257	1272	1529
7	"7-out7476"	.28744	355	880	1235
7	"7-out7477"	.80577	726	175	901
7	"7-out7478"	.85467	494	84	578
7	"7-out7479"	.21710	198	714	912
7	"7-out7480"	.09356	80	775	855
7	"7-out7481"	.41152	100	143	243
7	"7-out7482"	.16897	61	300	361
7	"7-out7483"	.22690	140	477	617
7	"7-out7484"	.21182	43	160	203
7	"7-out7485"	.32258	80	168	248
7	"7-out7486"	.19290	87	364	451
7	"7-out7487"	.18992	49	209	258
7	"7-out7488"	.18567	70	307	377
7	"7-out7489"	.96478	137	5	142
7	"7-out7490"	1.00000	2	0	2
7	"7-out7491"	.20856	112	425	537
7	"7-out7492"	.24330	109	339	448
7	"7-out7493"	.90836	456	46	502
7	"7-out7494"	.16993	26	127	153
7	"7-out7495"	.28488	98	246	344
7	"7-out7496"	.32278	51	107	158
7	"7-out7497"	.97267	178	5	183
7	"7-out7498"	.33502	66	131	197
7	"7-out7499"	.18251	71	318	389
7	"7-out7500"	.74324	55	19	74
7	"7-out7501"	.87435	842	121	963
7	"7-out7502"	.56216	208	162	370
7	"7-out7503"	.27631	105	275	380
7	"7-out7504"	.16958	155	759	914
7	"7-out7505"	.26603	697	1923	2620
7	"7-out7506"	.31106	284	629	913
7	"7-out7507"	.23991	226	716	942
7	"7-out7508"	.32063	261	553	814
7	"7-out7509"	.18618	194	848	1042
7	"7-out7510"	.20203	139	549	688
7	"7-out7511"	.25242	443	1312	1755
7	"7-out7512"	.20235	86	339	425
7	"7-out7513"	.28543	145	363	508
7	"7-out7514"	.26584	130	359	489
7	"7-out7515"	.74542	448	153	601
7	"7-out7516"	.18269	95	425	520
7	"7-out7517"	.55212	143	116	259
7	"7-out7518"	.21052	68	255	323
7	"7-out7519"	.15884	44	233	277
7	"7-out7520"	.91389	2335	220	2555
7	"7-out7521"	.11713	54	407	461
7	"7-out7522"	.19950	81	325	406
7	"7-out7523"	.39604	381	581	962
7	"7-out7524"	.11516	79	607	686
7	"7-out7525"	.20294	248	974	1222
7	"7-out7526"	.91826	191	17	208
7	"7-out7527"	.92477	418	34	452
7	"7-out7528"	.90996	283	28	311
7	"7-out7529"	.89900	543	61	604
7	"7-out7530"	.89285	125	15	140
7	"7-out7531"	.91256	167	16	183
7	"7-out7532"	.92473	86	7	93
7	"7-out7533"	.88888	136	17	153
7	"7-out7534"	.94478	154	9	163
7	"7-out7535"	.94618	211	12	223
7	"7-out7536"	.86580	200	31	231
7	"7-out7537"	.91139	72	7	79
7	"7-out7538"	.97018	358	11	369
7	"7-out7539"	.94244	131	8	139
7	"7-out7540"	.20268	257	1011	1268
7	"7-out7541"	.16542	111	560	671
7	"7-out7542"	.15114	125	702	827
7	"7-out7543"	.48850	255	267	522
7	"7-out7544"	.95165	374	19	393
7	"7-out7545"	.92342	205	17	222
7	"7-out7546"	.28571	42	105	147
7	"7-out7547"	.64804	116	63	179
7	"7-out7548"	.70514	617	258	875
7	"7-out7549"	.24007	260	823	1083
7	"7-out7550"	.27327	135	359	494
7	"7-out7551"	.16814	95	470	565
7	"7-out7552"	.11735	71	534	605
7	"7-out7553"	.26849	363	989	1352
7	"7-out7554"	.63653	1021	583	1604
7	"7-out7555"	.17827	192	885	1077
7	"7-out7556"	.30648	312	706	1018
7	"7-out7557"	.28581	393	982	1375
7	"7-out7558"	.27149	281	754	1035
7	"7-out7559"	.17237	166	797	963
7	"7-out7560"	.16743	182	905	1087
7	"7-out7561"	.27586	296	777	1073
7	"7-out7562"	.15384	132	726	858
7	"7-out7563"	.16792	111	550	661
7	"7-out7564"	.63942	399	225	624
7	"7-out7565"	.16631	79	396	475
7	"7-out7566"	.07279	19	242	261
7	"7-out7567"	.30153	98	227	325
7	"7-out7568"	.92226	261	22	283
7	"7-out7569"	.27536	38	100	138
7	"7-out7570"	.45131	241	293	534
7	"7-out7571"	.50000	62	62	124
7	"7-out7572"	.26708	43	118	161
7	"7-out7573"	.14657	45	262	307
7	"7-out7574"	.23991	113	358	471
7	"7-out7575"	.25748	43	124	167
7	"7-out7576"	.31108	247	547	794
7	"7-out7577"	.36543	554	962	1516
7	"7-out7578"	.90123	292	32	324
7	"7-out7579"	.23601	135	437	572
7	"7-out7580"	.29648	59	140	199
7	"7-out7581"	.97894	93	2	95
7	"7-out7582"	.13000	13	87	100
7	"7-out7583"	.37588	53	88	141
7	"7-out7584"	.12781	68	464	532
7	"7-out7585"	.95909	211	9	220
7	"7-out7586"	.95652	66	3	69
7	"7-out7587"	.13698	70	441	511
7	"7-out7588"	.07317	15	190	205
7	"7-out7589"	.65724	186	97	283
7	"7-out7590"	.34745	1304	2449	3753
7	"7-out7591"	.95512	149	7	156
7	"7-out7592"	.23987	148	469	617
7	"7-out7593"	.97665	251	6	257
7	"7-out7594"	.19068	86	365	451
7	"7-out7595"	.23636	52	168	220
7	"7-out7596"	.17892	73	335	408
7	"7-out7597"	.24691	80	244	324
7	"7-out7598"	.17307	36	172	208
7	"7-out7599"	.21428	48	176	224
7	"7-out7600"	.91222	291	28	319
7	"7-out7601"	.37758	128	211	339
7	"7-out7602"	.28395	92	232	324
7	"7-out7603"	.53939	89	76	165
7	"7-out7604"	.10096	21	187	208
7	"7-out7605"	.22758	99	336	435
7	"7-out7606"	.18803	66	285	351
7	"7-out7607"	.19650	45	184	229
7	"7-out7608"	.37209	48	81	129
7	"7-out7609"	.21471	143	523	666
7	"7-out7610"	.34630	178	336	514
7	"7-out7611"	.15441	21	115	136
7	"7-out7612"	.16864	71	350	421
7	"7-out7613"	.28395	46	116	162
7	"7-out7614"	.18947	108	462	570
7	"7-out7615"	.20000	48	192	240
7	"7-out7616"	.30810	171	384	555
7	"7-out7617"	.27586	40	105	145
7	"7-out7618"	.37500	108	180	288
7	"7-out7619"	.81280	165	38	203
7	"7-out7620"	.22015	83	294	377
7	"7-out7621"	.25595	86	250	336
7	"7-out7622"	.38461	60	96	156
7	"7-out7623"	.89068	220	27	247
7	"7-out7624"	.49723	90	91	181
7	"7-out7625"	.41759	375	523	898
7	"7-out7626"	.14158	127	770	897
7	"7-out7627"	.17784	61	282	343
7	"7-out7628"	.30175	86	199	285
7	"7-out7629"	.16929	43	211	254
7	"7-out7630"	.25724	71	205	276
7	"7-out7631"	.14716	161	933	1094
7	"7-out7632"	.24071	201	634	835
7	"7-out7633"	.19410	112	465	577
7	"7-out7634"	.24705	126	384	510
7	"7-out7635"	.32894	200	408	608
7	"7-out7636"	.27272	285	760	1045
7	"7-out7637"	.15684	157	844	1001
7	"7-out7638"	.20430	38	148	186
7	"7-out7639"	.65056	404	217	621
7	"7-out7640"	.39869	305	460	765
7	"7-out7641"	.96428	135	5	140
7	"7-out7642"	.21546	39	142	181
7	"7-out7643"	.22363	441	1531	1972
7	"7-out7644"	.98571	138	2	140
7	"7-out7645"	.29756	427	1008	1435
7	"7-out7646"	.22321	100	348	448
7	"7-out7647"	.91379	477	45	522
7	"7-out7648"	.14198	163	985	1148
7	"7-out7649"	.96571	169	6	175
7	"7-out7650"	.60621	234	152	386
7	"7-out7651"	.24723	134	408	542
7	"7-out7652"	.94642	106	6	112
7	"7-out7653"	.90825	99	10	109
7	"7-out7654"	.91964	103	9	112
7	"7-out7655"	.95575	108	5	113
7	"7-out7656"	.97321	109	3	112
7	"7-out7657"	.94736	108	6	114
7	"7-out7658"	.94285	99	6	105
7	"7-out7659"	.92857	104	8	112
7	"7-out7660"	.92660	101	8	109
7	"7-out7661"	.95412	104	5	109
7	"7-out7662"	.97478	116	3	119
7	"7-out7663"	.85840	97	16	113
7	"7-out7664"	.92920	105	8	113
7	"7-out7665"	.93859	107	7	114
7	"7-out7666"	.92035	104	9	113
7	"7-out7667"	.95535	107	5	112
7	"7-out7668"	.96491	110	4	114
7	"7-out7669"	.89565	103	12	115
7	"7-out7670"	.95412	104	5	109
7	"7-out7671"	.94354	117	7	124
7	"7-out7672"	.94782	109	6	115
7	"7-out7673"	.84684	94	17	111
7	"7-out7674"	.93043	107	8	115
7	"7-out7675"	.93859	107	7	114
7	"7-out7676"	.94782	109	6	115
7	"7-out7677"	.90990	101	10	111
7	"7-out7678"	.92105	105	9	114
7	"7-out7679"	.93859	107	7	114
7	"7-out7680"	.91228	104	10	114
7	"7-out7681"	.91228	104	10	114
7	"7-out7682"	.90350	103	11	114
7	"7-out7683"	.42628	133	179	312
7	"7-out7684"	.35714	210	378	588
7	"7-out7685"	.22807	156	528	684
7	"7-out7686"	.61736	192	119	311
7	"7-out7687"	.90816	267	27	294
7	"7-out7688"	.76391	398	123	521
7	"7-out7689"	.37681	78	129	207
7	"7-out7690"	.11619	61	464	525
7	"7-out7691"	.45110	143	174	317
7	"7-out7692"	.18783	213	921	1134
7	"7-out7693"	.23059	101	337	438
7	"7-out7694"	.29411	50	120	170
7	"7-out7695"	.15434	48	263	311
7	"7-out7696"	.15619	82	443	525
7	"7-out7697"	.93924	371	24	395
7	"7-out7698"	.13035	67	447	514
7	"7-out7699"	.96078	343	14	357
7	"7-out7700"	.85429	428	73	501
7	"7-out7701"	.45019	113	138	251
7	"7-out7702"	.19761	166	674	840
7	"7-out7703"	.96794	151	5	156
7	"7-out7704"	.27941	57	147	204
7	"7-out7705"	.28740	146	362	508
7	"7-out7706"	.58709	91	64	155
7	"7-out7707"	.78151	93	26	119
7	"7-out7708"	.88262	188	25	213
7	"7-out7709"	.40689	118	172	290
7	"7-out7710"	.35694	126	227	353
7	"7-out7711"	.95049	96	5	101
7	"7-out7712"	.27500	143	377	520
7	"7-out7713"	.50152	164	163	327
7	"7-out7714"	.24561	70	215	285
7	"7-out7715"	.96153	150	6	156
7	"7-out7716"	.96153	150	6	156
7	"7-out7717"	.44912	128	157	285
7	"7-out7718"	.24953	135	406	541
7	"7-out7719"	.42060	196	270	466
7	"7-out7720"	.30710	160	361	521
7	"7-out7721"	.84541	175	32	207
7	"7-out7722"	.27601	61	160	221
7	"7-out7723"	.26096	119	337	456
7	"7-out7724"	.15562	188	1020	1208
7	"7-out7725"	.16157	164	851	1015
7	"7-out7726"	.24495	182	561	743
7	"7-out7727"	.12435	96	676	772
7	"7-out7728"	.64360	493	273	766
7	"7-out7729"	.25358	106	312	418
7	"7-out7730"	.17588	159	745	904
7	"7-out7731"	.18139	39	176	215
7	"7-out7732"	.90350	103	11	114
7	"7-out7733"	.20000	25	100	125
7	"7-out7734"	.19587	38	156	194
7	"7-out7735"	.82857	87	18	105
7	"7-out7736"	.33421	127	253	380
7	"7-out7737"	.39857	112	169	281
7	"7-out7738"	.24809	65	197	262
7	"7-out7739"	.30451	81	185	266
7	"7-out7740"	.66210	145	74	219
7	"7-out7741"	.26436	92	256	348
7	"7-out7742"	.22529	57	196	253
7	"7-out7743"	.32817	106	217	323
7	"7-out7744"	.92385	546	45	591
7	"7-out7745"	.88006	565	77	642
7	"7-out7746"	.19247	87	365	452
7	"7-out7747"	.25740	113	326	439
7	"7-out7748"	.32722	625	1285	1910
7	"7-out7749"	.19379	25	104	129
7	"7-out7750"	.14691	31	180	211
7	"7-out7751"	.14586	166	972	1138
7	"7-out7752"	.31372	192	420	612
7	"7-out7753"	.30190	317	733	1050
7	"7-out7754"	.22027	126	446	572
7	"7-out7755"	.92063	406	35	441
7	"7-out7756"	.17751	60	278	338
7	"7-out7757"	.39473	195	299	494
7	"7-out7758"	.35881	291	520	811
7	"7-out7759"	.44147	347	439	786
7	"7-out7760"	.37627	295	489	784
7	"7-out7761"	.13104	65	431	496
7	"7-out7762"	.27906	36	93	129
7	"7-out7763"	.80851	342	81	423
7	"7-out7764"	.29908	131	307	438
7	"7-out7765"	.36875	59	101	160
7	"7-out7766"	.23816	166	531	697
7	"7-out7767"	.18000	63	287	350
7	"7-out7768"	.12121	12	87	99
7	"7-out7769"	.40449	72	106	178
7	"7-out7770"	.32911	104	212	316
7	"7-out7771"	.17919	31	142	173
7	"7-out7772"	.15329	86	475	561
7	"7-out7773"	.35082	127	235	362
7	"7-out7774"	.96170	226	9	235
7	"7-out7775"	.28378	84	212	296
7	"7-out7776"	.59666	179	121	300
7	"7-out7777"	.76363	294	91	385
7	"7-out7778"	.16149	26	135	161
7	"7-out7779"	.17810	109	503	612
7	"7-out7780"	.24154	50	157	207
7	"7-out7781"	.20512	56	217	273
7	"7-out7782"	.26991	61	165	226
7	"7-out7783"	.19626	21	86	107
7	"7-out7784"	.18684	142	618	760
7	"7-out7785"	.24363	67	208	275
7	"7-out7786"	.22818	251	849	1100
7	"7-out7787"	.21116	140	523	663
7	"7-out7788"	.33082	44	89	133
7	"7-out7789"	.30948	199	444	643
7	"7-out7790"	.21544	106	386	492
7	"7-out7791"	.14718	34	197	231
7	"7-out7792"	.24336	55	171	226
7	"7-out7793"	.32618	76	157	233
7	"7-out7794"	.25203	62	184	246
7	"7-out7795"	.39622	63	96	159
7	"7-out7796"	.21311	65	240	305
7	"7-out7797"	.36428	51	89	140
7	"7-out7798"	.26729	170	466	636
7	"7-out7799"	.26865	90	245	335
7	"7-out7800"	.86896	126	19	145
7	"7-out7801"	.26322	403	1128	1531
7	"7-out7802"	.22950	112	376	488
7	"7-out7803"	.20015	252	1007	1259
7	"7-out7804"	.80816	198	47	245
7	"7-out7805"	.13529	23	147	170
7	"7-out7806"	.34154	97	187	284
7	"7-out7807"	.18461	96	424	520
7	"7-out7808"	.25565	113	329	442
7	"7-out7809"	.92982	106	8	114
7	"7-out7810"	.88596	101	13	114
7	"7-out7811"	.92982	106	8	114
7	"7-out7812"	.95266	946	47	993
7	"7-out7813"	.20967	26	98	124
7	"7-out7814"	.18877	37	159	196
7	"7-out7815"	.29392	92	221	313
7	"7-out7816"	.95070	135	7	142
7	"7-out7817"	.34666	286	539	825
7	"7-out7818"	.17886	44	202	246
7	"7-out7819"	.47500	114	126	240
7	"7-out7820"	.27734	142	370	512
7	"7-out7821"	.69879	58	25	83
7	"7-out7822"	.22706	99	337	436
7	"7-out7823"	.78000	78	22	100
7	"7-out7824"	.20869	24	91	115
7	"7-out7825"	.15492	33	180	213
7	"7-out7826"	.10052	19	170	189
7	"7-out7827"	.16460	40	203	243
7	"7-out7828"	.18104	128	579	707
7	"7-out7829"	.93277	111	8	119
7	"7-out7830"	.50000	59	59	118
7	"7-out7831"	.32031	41	87	128
7	"7-out7832"	.15277	55	305	360
7	"7-out7833"	.83435	136	27	163
7	"7-out7834"	.30588	52	118	170
7	"7-out7835"	.45731	75	89	164
7	"7-out7836"	.21834	100	358	458
7	"7-out7837"	.12662	39	269	308
7	"7-out7838"	.87500	56	8	64
7	"7-out7839"	.29365	259	623	882
7	"7-out7840"	.18062	151	685	836
7	"7-out7841"	.27064	59	159	218
7	"7-out7842"	.34890	112	209	321
7	"7-out7843"	.85501	230	39	269
7	"7-out7844"	.24631	117	358	475
7	"7-out7845"	.21352	60	221	281
7	"7-out7846"	.22110	44	155	199
7	"7-out7847"	.13541	26	166	192
7	"7-out7848"	.22000	66	234	300
7	"7-out7849"	.32843	67	137	204
7	"7-out7850"	.22380	94	326	420
7	"7-out7851"	.12785	28	191	219
7	"7-out7852"	.16860	29	143	172
7	"7-out7853"	.11409	17	132	149
7	"7-out7854"	.12689	67	461	528
7	"7-out7855"	.23684	144	464	608
7	"7-out7856"	.48295	255	273	528
7	"7-out7857"	.74336	168	58	226
7	"7-out7858"	.53658	66	57	123
7	"7-out7859"	.27745	144	375	519
7	"7-out7860"	.94666	71	4	75
7	"7-out7861"	.90909	140	14	154
7	"7-out7862"	.72413	105	40	145
7	"7-out7863"	.14606	156	912	1068
7	"7-out7864"	.23790	59	189	248
7	"7-out7865"	.80066	241	60	301
7	"7-out7866"	.84482	98	18	116
7	"7-out7867"	.19072	37	157	194
7	"7-out7868"	.78626	607	165	772
7	"7-out7869"	.22325	48	167	215
7	"7-out7870"	.26883	207	563	770
7	"7-out7871"	.21969	58	206	264
7	"7-out7872"	.28909	61	150	211
7	"7-out7873"	.18981	41	175	216
7	"7-out7874"	.31351	58	127	185
7	"7-out7875"	.36283	41	72	113
7	"7-out7876"	.47422	138	153	291
7	"7-out7877"	.19801	40	162	202
7	"7-out7878"	.32309	284	595	879
7	"7-out7879"	.18610	75	328	403
7	"7-out7880"	.95890	210	9	219
7	"7-out7881"	.57911	183	133	316
7	"7-out7882"	.88489	123	16	139
7	"7-out7883"	.54708	122	101	223
7	"7-out7884"	.23963	52	165	217
7	"7-out7885"	.24770	27	82	109
7	"7-out7886"	.25045	139	416	555
7	"7-out7887"	.09787	23	212	235
7	"7-out7888"	.46496	73	84	157
7	"7-out7889"	.43633	257	332	589
7	"7-out7890"	.15949	126	664	790
7	"7-out7891"	.35643	72	130	202
7	"7-out7892"	.82380	173	37	210
7	"7-out7893"	.28884	132	325	457
7	"7-out7894"	.20901	51	193	244
7	"7-out7895"	.36593	116	201	317
7	"7-out7896"	.93617	264	18	282
7	"7-out7897"	.12021	22	161	183
7	"7-out7898"	.58928	165	115	280
7	"7-out7899"	.57719	243	178	421
7	"7-out7900"	.19318	34	142	176
7	"7-out7901"	.31046	86	191	277
7	"7-out7902"	.29457	76	182	258
7	"7-out7903"	.88447	245	32	277
7	"7-out7904"	.21794	51	183	234
7	"7-out7905"	.21985	403	1430	1833
7	"7-out7906"	.52282	126	115	241
7	"7-out7907"	.18260	63	282	345
7	"7-out7908"	.22197	101	354	455
7	"7-out7909"	.20824	96	365	461
7	"7-out7910"	.17254	44	211	255
7	"7-out7911"	.29496	123	294	417
7	"7-out7912"	.62162	46	28	74
7	"7-out7913"	.22330	69	240	309
7	"7-out7914"	.86426	312	49	361
7	"7-out7915"	.44730	365	451	816
7	"7-out7916"	.16517	37	187	224
7	"7-out7917"	.59880	100	67	167
7	"7-out7918"	.60344	175	115	290
7	"7-out7919"	.29655	43	102	145
7	"7-out7920"	.25941	613	1750	2363
7	"7-out7921"	.60483	150	98	248
7	"7-out7922"	.42756	304	407	711
7	"7-out7923"	.24364	182	565	747
7	"7-out7924"	.54440	141	118	259
7	"7-out7925"	.96732	148	5	153
7	"7-out7926"	.26851	116	316	432
7	"7-out7927"	.17272	57	273	330
7	"7-out7928"	.49606	63	64	127
7	"7-out7929"	.90909	40	4	44
7	"7-out7930"	.83969	110	21	131
7	"7-out7931"	.16814	19	94	113
7	"7-out7932"	.36210	172	303	475
7	"7-out7933"	.47500	114	126	240
7	"7-out7934"	.27559	105	276	381
7	"7-out7935"	.37696	288	476	764
7	"7-out7936"	.28293	131	332	463
7	"7-out7937"	.19012	77	328	405
7	"7-out7938"	.50155	161	160	321
7	"7-out7939"	.23000	46	154	200
7	"7-out7940"	.88235	90	12	102
7	"7-out7941"	.18333	99	441	540
7	"7-out7942"	.40170	47	70	117
7	"7-out7943"	.88535	139	18	157
7	"7-out7944"	.42528	74	100	174
7	"7-out7945"	.61643	45	28	73
7	"7-out7946"	.20940	276	1042	1318
7	"7-out7947"	.24162	274	860	1134
7	"7-out7948"	.15643	135	728	863
7	"7-out7949"	.25315	341	1006	1347
7	"7-out7950"	.38089	299	486	785
7	"7-out7951"	.75689	604	194	798
7	"7-out7952"	.26911	264	717	981
7	"7-out7953"	.26066	275	780	1055
7	"7-out7954"	.87096	324	48	372
7	"7-out7955"	.26959	956	2590	3546
7	"7-out7956"	.20241	268	1056	1324
7	"7-out7957"	.32646	301	621	922
7	"7-out7958"	.81937	313	69	382
7	"7-out7959"	.25000	35	105	140
7	"7-out7960"	.05555	10	170	180
7	"7-out7961"	.97101	134	4	138
7	"7-out7962"	.59807	436	293	729
7	"7-out7963"	.31812	523	1121	1644
7	"7-out7964"	.23240	274	905	1179
7	"7-out7965"	.94634	194	11	205
7	"7-out7966"	.94736	108	6	114
7	"7-out7967"	.97222	105	3	108
7	"7-out7968"	.98113	104	2	106
7	"7-out7969"	.93750	105	7	112
7	"7-out7970"	.96428	108	4	112
7	"7-out7971"	.88793	103	13	116
7	"7-out7972"	.94642	106	6	112
7	"7-out7973"	.89090	98	12	110
7	"7-out7974"	.89908	98	11	109
7	"7-out7975"	.93181	123	9	132
7	"7-out7976"	.90265	102	11	113
7	"7-out7977"	.92920	105	8	113
7	"7-out7978"	.94782	109	6	115
7	"7-out7979"	.95535	107	5	112
7	"7-out7980"	.97321	109	3	112
7	"7-out7981"	.94782	109	6	115
7	"7-out7982"	.98214	110	2	112
7	"7-out7983"	.94690	107	6	113
7	"7-out7984"	.90825	99	10	109
7	"7-out7985"	.92173	106	9	115
7	"7-out7986"	.93043	107	8	115
7	"7-out7987"	.98260	113	2	115
7	"7-out7988"	.96521	111	4	115
7	"7-out7989"	.92173	106	9	115
7	"7-out7990"	.93859	107	7	114
7	"7-out7991"	.88288	98	13	111
7	"7-out7992"	.92982	106	8	114
7	"7-out7993"	.90350	103	11	114
7	"7-out7994"	.91228	104	10	114
7	"7-out7995"	.95614	109	5	114
7	"7-out7996"	.94257	673	41	714
7	"7-out7997"	.20668	136	522	658
7	"7-out7998"	.93181	41	3	44
7	"7-out7999"	.34254	124	238	362
7	"7-out8000"	.41872	237	329	566
7	"7-out16001"	.25433	88	258	346
7	"7-out16002"	.35156	90	166	256
7	"7-out16003"	.48960	306	319	625
7	"7-out16004"	.13276	47	307	354
7	"7-out16005"	.14426	88	522	610
7	"7-out16006"	.22834	87	294	381
7	"7-out16007"	.18079	64	290	354
7	"7-out16008"	.95180	79	4	83
7	"7-out16009"	.15211	54	301	355
7	"7-out16010"	.12232	40	287	327
7	"7-out16011"	.70890	207	85	292
7	"7-out16012"	.19746	109	443	552
7	"7-out16013"	.30378	281	644	925
7	"7-out16014"	.90506	572	60	632
7	"7-out16015"	.90189	570	62	632
7	"7-out16016"	.50364	69	68	137
7	"7-out16017"	.70960	325	133	458
7	"7-out16018"	.28504	122	306	428
7	"7-out16019"	.16390	99	505	604
7	"7-out16020"	.77241	336	99	435
7	"7-out16021"	.23181	102	338	440
7	"7-out16022"	.19672	192	784	976
7	"7-out16023"	.79405	347	90	437
7	"7-out16024"	.26480	152	422	574
7	"7-out16025"	.15071	63	355	418
7	"7-out16026"	.40114	140	209	349
7	"7-out16027"	.18663	81	353	434
7	"7-out16028"	.31550	118	256	374
7	"7-out16029"	.36842	168	288	456
7	"7-out16030"	.38266	181	292	473
7	"7-out16031"	.35563	101	183	284
7	"7-out16032"	.28793	167	413	580
7	"7-out16033"	.23451	212	692	904
7	"7-out16034"	.25274	69	204	273
7	"7-out16035"	.66666	174	87	261
7	"7-out16036"	.12972	72	483	555
7	"7-out16037"	.22138	205	721	926
7	"7-out16038"	.32589	73	151	224
7	"7-out16039"	.15718	163	874	1037
7	"7-out16040"	.14864	154	882	1036
7	"7-out16041"	.08490	18	194	212
7	"7-out16042"	.27407	387	1025	1412
7	"7-out16043"	.53061	78	69	147
7	"7-out16044"	.22191	79	277	356
7	"7-out16045"	.19082	158	670	828
7	"7-out16046"	.13103	38	252	290
7	"7-out16047"	.91320	726	69	795
7	"7-out16048"	.39511	275	421	696
7	"7-out16049"	.37956	208	340	548
7	"7-out16050"	.95238	100	5	105
7	"7-out16051"	.18208	63	283	346
7	"7-out16052"	.32505	157	326	483
7	"7-out16053"	.16244	77	397	474
7	"7-out16054"	.21052	100	375	475
7	"7-out16055"	.35470	166	302	468
7	"7-out16056"	.56649	328	251	579
7	"7-out16057"	.24411	114	353	467
7	"7-out16058"	.16129	65	338	403
7	"7-out16059"	.17913	79	362	441
7	"7-out16060"	.28185	261	665	926
7	"7-out16061"	.28078	114	292	406
7	"7-out16062"	.55042	584	477	1061
7	"7-out16063"	.60047	254	169	423
7	"7-out16064"	.09468	41	392	433
7	"7-out16065"	.96016	458	19	477
7	"7-out16066"	.35546	257	466	723
7	"7-out16067"	.38993	124	194	318
7	"7-out16068"	.28251	63	160	223
7	"7-out16069"	.21195	39	145	184
7	"7-out16070"	.77517	662	192	854
7	"7-out16071"	.95495	212	10	222
7	"7-out16072"	.24369	145	450	595
7	"7-out16073"	.13180	46	303	349
7	"7-out16074"	.22241	127	444	571
7	"7-out16075"	.57217	329	246	575
7	"7-out16076"	.18794	53	229	282
7	"7-out16077"	.10597	117	987	1104
7	"7-out16078"	.35613	328	593	921
7	"7-out16079"	.13656	121	765	886
7	"7-out16080"	.50863	471	455	926
7	"7-out16081"	.98305	58	1	59
7	"7-out16082"	.98305	58	1	59
7	"7-out16083"	.94915	56	3	59
7	"7-out16084"	.33933	113	220	333
7	"7-out16085"	.17828	110	507	617
7	"7-out16086"	.61111	55	35	90
7	"7-out16087"	.34645	88	166	254
7	"7-out16088"	.14285	63	378	441
7	"7-out16089"	.43310	191	250	441
7	"7-out16090"	.18433	40	177	217
7	"7-out16091"	.41212	68	97	165
7	"7-out16092"	.32366	145	303	448
7	"7-out16093"	.15384	64	352	416
7	"7-out16094"	.40786	166	241	407
7	"7-out16095"	.17505	87	410	497
7	"7-out16096"	.29074	132	322	454
7	"7-out16097"	.18806	227	980	1207
7	"7-out16098"	.21914	158	563	721
7	"7-out16099"	.12919	50	337	387
7	"7-out16100"	.34871	204	381	585
7	"7-out16101"	.21001	130	489	619
7	"7-out16102"	.11051	41	330	371
7	"7-out16103"	.37769	105	173	278
7	"7-out16104"	.44327	168	211	379
7	"7-out16105"	.14827	90	517	607
7	"7-out16106"	.22201	117	410	527
7	"7-out16107"	.22852	149	503	652
7	"7-out16108"	.27639	89	233	322
7	"7-out16109"	.34353	101	193	294
7	"7-out16110"	.25586	382	1111	1493
7	"7-out16111"	.25757	102	294	396
7	"7-out16112"	.16055	210	1098	1308
7	"7-out16113"	.16822	36	178	214
7	"7-out16114"	.16433	94	478	572
7	"7-out16115"	.91629	208	19	227
7	"7-out16116"	.56434	478	369	847
7	"7-out16117"	.29154	207	503	710
7	"7-out16118"	.21866	82	293	375
7	"7-out16119"	.34342	295	564	859
7	"7-out16120"	.20250	113	445	558
7	"7-out16121"	.29007	266	651	917
7	"7-out16122"	.14883	32	183	215
7	"7-out16123"	.14928	156	889	1045
7	"7-out16124"	.17175	788	3800	4588
7	"7-out16125"	.15518	773	4208	4981
7	"7-out16126"	.28732	102	253	355
7	"7-out16127"	.18156	65	293	358
7	"7-out16128"	.24068	84	265	349
7	"7-out16129"	.25866	112	321	433
7	"7-out16130"	.25330	287	846	1133
7	"7-out16131"	.32432	228	475	703
7	"7-out16132"	.21030	249	935	1184
7	"7-out16133"	.11963	53	390	443
7	"7-out16134"	.23052	74	247	321
7	"7-out16135"	.26689	79	217	296
7	"7-out16136"	.31355	222	486	708
7	"7-out16137"	.96785	271	9	280
7	"7-out16138"	.12949	54	363	417
7	"7-out16139"	.29069	25	61	86
7	"7-out16140"	.70388	290	122	412
7	"7-out16141"	.23321	132	434	566
7	"7-out16142"	.19508	548	2261	2809
7	"7-out16143"	.22142	31	109	140
7	"7-out16144"	.22975	139	466	605
7	"7-out16145"	.21052	132	495	627
7	"7-out16146"	.29411	25	60	85
7	"7-out16147"	.62890	644	380	1024
7	"7-out16148"	.18750	24	104	128
7	"7-out16149"	.61363	81	51	132
7	"7-out16150"	.26515	35	97	132
7	"7-out16151"	.15819	28	149	177
7	"7-out16152"	.42222	76	104	180
7	"7-out16153"	.19315	79	330	409
7	"7-out16154"	.14733	47	272	319
7	"7-out16155"	.66573	237	119	356
7	"7-out16156"	.96396	321	12	333
7	"7-out16157"	.18678	82	357	439
7	"7-out16158"	.22702	126	429	555
7	"7-out16159"	.34877	128	239	367
7	"7-out16160"	.78233	248	69	317
7	"7-out16161"	.17873	79	363	442
7	"7-out16162"	.13043	39	260	299
7	"7-out16163"	.31314	274	601	875
7	"7-out16164"	.35636	98	177	275
7	"7-out16165"	.19773	122	495	617
7	"7-out16166"	.20980	77	290	367
7	"7-out16167"	.25654	98	284	382
7	"7-out16168"	.49159	117	121	238
7	"7-out16169"	.20918	82	310	392
7	"7-out16170"	.20083	193	768	961
7	"7-out16171"	.18625	122	533	655
7	"7-out16172"	.31818	28	60	88
7	"7-out16173"	.21973	49	174	223
7	"7-out16174"	.94444	272	16	288
7	"7-out16175"	.24007	127	402	529
7	"7-out16176"	.22476	236	814	1050
7	"7-out16177"	.70058	716	306	1022
7	"7-out16178"	.20604	75	289	364
7	"7-out16179"	.28513	140	351	491
7	"7-out16180"	.28214	79	201	280
7	"7-out16181"	.07692	16	192	208
7	"7-out16182"	.19326	155	647	802
7	"7-out16183"	.35159	77	142	219
7	"7-out16184"	.16746	35	174	209
7	"7-out16185"	.78749	3198	863	4061
7	"7-out16186"	.26423	116	323	439
7	"7-out16187"	.90140	128	14	142
7	"7-out16188"	.13970	38	234	272
7	"7-out16189"	.19230	75	315	390
7	"7-out16190"	.37142	65	110	175
7	"7-out16191"	.91139	72	7	79
7	"7-out16192"	.33691	251	494	745
7	"7-out16193"	.91208	166	16	182
7	"7-out16194"	.97826	135	3	138
7	"7-out16195"	.96212	127	5	132
7	"7-out16196"	.35135	65	120	185
7	"7-out16197"	.56097	115	90	205
7	"7-out16198"	.28143	141	360	501
7	"7-out16199"	.49367	39	40	79
7	"7-out16200"	.28163	69	176	245
7	"7-out16201"	.19321	131	547	678
7	"7-out16202"	.20296	137	538	675
7	"7-out16203"	.36764	25	43	68
7	"7-out16204"	.17052	81	394	475
7	"7-out16205"	.33928	38	74	112
7	"7-out16206"	.25507	176	514	690
7	"7-out16207"	.12951	86	578	664
7	"7-out16208"	.27181	704	1886	2590
7	"7-out16209"	.28266	225	571	796
7	"7-out16210"	.20325	100	392	492
7	"7-out16211"	.46947	346	391	737
7	"7-out16212"	.25065	192	574	766
7	"7-out16213"	.24971	216	649	865
7	"7-out16214"	.15812	142	756	898
7	"7-out16215"	.13673	118	745	863
7	"7-out16216"	.88926	265	33	298
7	"7-out16217"	.94968	151	8	159
7	"7-out16218"	.58223	177	127	304
7	"7-out16219"	.62068	72	44	116
7	"7-out16220"	.61780	118	73	191
7	"7-out16221"	.59518	247	168	415
7	"7-out16222"	.26405	108	301	409
7	"7-out16223"	.95959	95	4	99
7	"7-out16224"	.21951	225	800	1025
7	"7-out16225"	.12587	72	500	572
7	"7-out16226"	.12762	73	499	572
7	"7-out16227"	.11052	63	507	570
7	"7-out16228"	.56818	325	247	572
7	"7-out16229"	.17553	99	465	564
7	"7-out16230"	.85338	227	39	266
7	"7-out16231"	.88345	235	31	266
7	"7-out16232"	.86090	229	37	266
7	"7-out16233"	.40979	184	265	449
7	"7-out16234"	.24939	205	617	822
7	"7-out16235"	.27837	206	534	740
7	"7-out16236"	.31611	153	331	484
7	"7-out16237"	.11281	59	464	523
7	"7-out16238"	.23430	112	366	478
7	"7-out16239"	.21756	109	392	501
7	"7-out16240"	.26666	196	539	735
7	"7-out16241"	.24942	218	656	874
7	"7-out16242"	.40148	108	161	269
7	"7-out16243"	.24604	109	334	443
7	"7-out16244"	.15695	70	376	446
7	"7-out16245"	.11060	49	394	443
7	"7-out16246"	.16750	67	333	400
7	"7-out16247"	.53533	250	217	467
7	"7-out16248"	.69182	330	147	477
7	"7-out16249"	.29429	191	458	649
7	"7-out16250"	.76021	279	88	367
7	"7-out16251"	.10164	37	327	364
7	"7-out16252"	.35741	94	169	263
7	"7-out16253"	.56331	129	100	229
7	"7-out16254"	.06461	21	304	325
7	"7-out16255"	.36538	114	198	312
7	"7-out16256"	.83510	157	31	188
7	"7-out16257"	.01010	2	196	198
7	"7-out16258"	.96240	128	5	133
7	"7-out16259"	.94117	32	2	34
7	"7-out16260"	.27350	96	255	351
7	"7-out16261"	.48369	89	95	184
7	"7-out16262"	.49333	74	76	150
7	"7-out16263"	.01895	4	207	211
7	"7-out16264"	.26683	309	849	1158
7	"7-out16265"	.56818	100	76	176
7	"7-out16266"	.84126	53	10	63
7	"7-out16267"	.15821	78	415	493
7	"7-out16268"	.73913	204	72	276
7	"7-out16269"	.24146	99	311	410
7	"7-out16270"	.27150	868	2329	3197
7	"7-out16271"	.55970	75	59	134
7	"7-out16272"	.17021	96	468	564
7	"7-out16273"	.12548	97	676	773
7	"7-out16274"	.21052	52	195	247
7	"7-out16275"	.70974	357	146	503
7	"7-out16276"	.97368	74	2	76
7	"7-out16277"	.91121	195	19	214
7	"7-out16278"	.60975	125	80	205
7	"7-out16279"	.30852	170	381	551
7	"7-out16280"	.86706	1435	220	1655
7	"7-out16281"	.19946	74	297	371
7	"7-out16282"	.32890	99	202	301
7	"7-out16283"	.09900	30	273	303
7	"7-out16284"	.15179	165	922	1087
7	"7-out16285"	.29487	46	110	156
7	"7-out16286"	.90090	100	11	111
7	"7-out16287"	.21173	166	618	784
7	"7-out16288"	.25000	36	108	144
7	"7-out16289"	.18492	260	1146	1406
7	"7-out16290"	.10285	18	157	175
7	"7-out16291"	.21160	124	462	586
7	"7-out16292"	.93575	335	23	358
7	"7-out16293"	.93577	102	7	109
7	"7-out16294"	.24657	162	495	657
7	"7-out16295"	.20980	77	290	367
7	"7-out16296"	.34326	311	595	906
7	"7-out16297"	.18591	132	578	710
7	"7-out16298"	.34671	311	586	897
7	"7-out16299"	.24772	163	495	658
7	"7-out16300"	.21608	86	312	398
7	"7-out16301"	.19696	52	212	264
7	"7-out16302"	.19684	399	1628	2027
7	"7-out16303"	.93243	138	10	148
7	"7-out16304"	.15949	152	801	953
7	"7-out16305"	.20000	156	624	780
7	"7-out16306"	.22471	40	138	178
7	"7-out16307"	.19102	234	991	1225
7	"7-out16308"	.24322	413	1285	1698
7	"7-out16309"	.88646	203	26	229
7	"7-out16310"	.30823	131	294	425
7	"7-out16311"	.90160	394	43	437
7	"7-out16312"	.27389	235	623	858
7	"7-out16313"	.29133	37	90	127
7	"7-out16314"	.23926	39	124	163
7	"7-out16315"	.27097	155	417	572
7	"7-out16316"	.64645	629	344	973
7	"7-out16317"	.35959	178	317	495
7	"7-out16318"	.93835	548	36	584
7	"7-out16319"	.94117	496	31	527
7	"7-out16320"	.60401	241	158	399
7	"7-out16321"	.29873	118	277	395
7	"7-out16322"	.36492	77	134	211
7	"7-out16323"	.24468	23	71	94
7	"7-out16324"	.38244	122	197	319
7	"7-out16325"	.41335	260	369	629
7	"7-out16326"	.20253	16	63	79
7	"7-out16327"	.90410	330	35	365
7	"7-out16328"	.83246	318	64	382
7	"7-out16329"	.84098	238	45	283
7	"7-out16330"	.27192	31	83	114
7	"7-out16331"	.30468	39	89	128
7	"7-out16332"	.15264	49	272	321
7	"7-out16333"	.43678	190	245	435
7	"7-out16334"	.28155	145	370	515
7	"7-out16335"	.13068	46	306	352
7	"7-out16336"	.13636	27	171	198
7	"7-out16337"	.62686	84	50	134
7	"7-out16338"	.92982	212	16	228
7	"7-out16339"	.81346	423	97	520
7	"7-out16340"	.29298	334	806	1140
7	"7-out16341"	.35728	179	322	501
7	"7-out16342"	.35138	2660	4910	7570
7	"7-out16343"	.93069	470	35	505
7	"7-out16344"	.30769	236	531	767
7	"7-out16345"	.19346	142	592	734
7	"7-out16346"	.73617	466	167	633
7	"7-out16347"	.59362	298	204	502
7	"7-out16348"	.98245	56	1	57
7	"7-out16349"	.46684	880	1005	1885
7	"7-out16350"	.15412	84	461	545
7	"7-out16351"	.18655	136	593	729
7	"7-out16352"	.07936	20	232	252
7	"7-out16353"	.18653	97	423	520
7	"7-out16354"	.51843	239	222	461
7	"7-out16355"	.23017	90	301	391
7	"7-out16356"	.22912	321	1080	1401
7	"7-out16357"	.15433	98	537	635
7	"7-out16358"	.30289	199	458	657
7	"7-out16359"	.30349	356	817	1173
7	"7-out16360"	.20415	118	460	578
7	"7-out16361"	.21673	202	730	932
7	"7-out16362"	.27240	304	812	1116
7	"7-out16363"	.32176	306	645	951
7	"7-out16364"	.22001	255	904	1159
7	"7-out16365"	.19000	38	162	200
7	"7-out16366"	.25625	123	357	480
7	"7-out16367"	.63090	294	172	466
7	"7-out16368"	.20444	340	1323	1663
7	"7-out16369"	.26886	57	155	212
7	"7-out16370"	.26702	196	538	734
7	"7-out16371"	.94964	132	7	139
7	"7-out16372"	.92156	141	12	153
7	"7-out16373"	.95070	135	7	142
7	"7-out16374"	.47560	39	43	82
7	"7-out16375"	.37845	534	877	1411
7	"7-out16376"	.49206	217	224	441
7	"7-out16377"	.16168	92	477	569
7	"7-out16378"	.23056	89	297	386
7	"7-out16379"	.94588	437	25	462
7	"7-out16380"	.42396	329	447	776
7	"7-out16381"	.23202	584	1933	2517
7	"7-out16382"	.20810	190	723	913
7	"7-out16383"	.23809	65	208	273
7	"7-out16384"	.17567	26	122	148
7	"7-out16385"	.49668	75	76	151
7	"7-out16386"	.92352	157	13	170
7	"7-out16387"	.43661	62	80	142
7	"7-out16388"	.76892	193	58	251
7	"7-out16389"	.88967	250	31	281
7	"7-out16390"	.37665	342	566	908
7	"7-out16391"	.92424	305	25	330
7	"7-out16392"	.13931	101	624	725
7	"7-out16393"	.32415	153	319	472
7	"7-out16394"	.98734	78	1	79
7	"7-out16395"	.93037	147	11	158
7	"7-out16396"	.93670	148	10	158
7	"7-out16397"	.89583	129	15	144
7	"7-out16398"	.29441	58	139	197
7	"7-out16399"	.44481	266	332	598
7	"7-out16400"	.96721	177	6	183
7	"7-out16401"	.51162	44	42	86
7	"7-out16402"	.87077	438	65	503
7	"7-out16403"	.97727	86	2	88
7	"7-out16404"	.28176	153	390	543
7	"7-out16405"	.15929	36	190	226
7	"7-out16406"	.19519	65	268	333
7	"7-out16407"	.22556	60	206	266
7	"7-out16408"	.23809	65	208	273
7	"7-out16409"	.22067	79	279	358
7	"7-out16410"	.24137	63	198	261
7	"7-out16411"	.65232	182	97	279
7	"7-out16412"	.12598	32	222	254
7	"7-out16413"	.19892	74	298	372
7	"7-out16414"	.19123	48	203	251
7	"7-out16415"	.26223	75	211	286
7	"7-out16416"	.13903	26	161	187
7	"7-out16417"	.25810	215	618	833
7	"7-out16418"	.19531	125	515	640
7	"7-out16419"	.56250	630	490	1120
7	"7-out16420"	.51546	150	141	291
7	"7-out16421"	.28358	57	144	201
7	"7-out16422"	.79479	275	71	346
7	"7-out16423"	.14414	48	285	333
7	"7-out16424"	.36470	124	216	340
7	"7-out16425"	.16227	197	1017	1214
7	"7-out16426"	.87804	1116	155	1271
7	"7-out16427"	.28253	89	226	315
7	"7-out16428"	.17465	51	241	292
7	"7-out16429"	.20000	52	208	260
7	"7-out16430"	.25819	63	181	244
7	"7-out16431"	.28248	250	635	885
7	"7-out16432"	.48283	661	708	1369
7	"7-out16433"	.59731	89	60	149
7	"7-out16434"	.44000	165	210	375
7	"7-out16435"	.14661	39	227	266
7	"7-out16436"	.16642	114	571	685
7	"7-out16437"	.17421	50	237	287
7	"7-out16438"	.06857	12	163	175
7	"7-out16439"	.29622	290	689	979
7	"7-out16440"	.49571	405	412	817
7	"7-out16441"	.32151	272	574	846
7	"7-out16442"	.21677	416	1503	1919
7	"7-out16443"	.38501	221	353	574
7	"7-out16444"	.13012	555	3710	4265
7	"7-out16445"	.31226	84	185	269
7	"7-out16446"	.14416	110	653	763
7	"7-out16447"	.25748	1109	3198	4307
7	"7-out16448"	.21036	950	3566	4516
7	"7-out16449"	.89839	168	19	187
7	"7-out16450"	.34625	1545	2917	4462
7	"7-out16451"	.07993	47	541	588
7	"7-out16452"	.19201	178	749	927
7	"7-out16453"	.21535	101	368	469
7	"7-out16454"	.10882	37	303	340
7	"7-out16455"	.15862	138	732	870
7	"7-out16456"	.14411	49	291	340
7	"7-out16457"	.12428	108	761	869
7	"7-out16458"	.16481	89	451	540
7	"7-out16459"	.13920	87	538	625
7	"7-out16460"	.23394	102	334	436
7	"7-out16461"	.18774	95	411	506
7	"7-out16462"	.13627	364	2307	2671
7	"7-out16463"	.35747	153	275	428
7	"7-out16464"	.21004	92	346	438
7	"7-out16465"	.25827	117	336	453
7	"7-out16466"	.46744	201	229	430
7	"7-out16467"	.92119	339	29	368
7	"7-out16468"	.19512	176	726	902
7	"7-out16469"	.28224	256	651	907
7	"7-out16470"	.19340	129	538	667
7	"7-out16471"	.31250	320	704	1024
7	"7-out16472"	.27462	145	383	528
7	"7-out16473"	.21605	393	1426	1819
7	"7-out16474"	.37966	295	482	777
7	"7-out16475"	.28089	50	128	178
7	"7-out16476"	.88235	900	120	1020
7	"7-out16477"	.32258	130	273	403
7	"7-out16478"	.22463	155	535	690
7	"7-out16479"	.25683	188	544	732
7	"7-out16480"	.19870	123	496	619
7	"7-out16481"	.51377	317	300	617
7	"7-out16482"	.93075	457	34	491
7	"7-out16483"	.21543	120	437	557
7	"7-out16484"	.30379	48	110	158
7	"7-out16485"	.38125	61	99	160
7	"7-out16486"	.45019	113	138	251
7	"7-out16487"	.34801	79	148	227
7	"7-out16488"	.22058	105	371	476
7	"7-out16489"	.93181	574	42	616
7	"7-out16490"	.08837	19	196	215
7	"7-out16491"	.40909	90	130	220
7	"7-out16492"	.19263	68	285	353
7	"7-out16493"	.29292	116	280	396
7	"7-out16494"	.22518	93	320	413
7	"7-out16495"	.13480	67	430	497
7	"7-out16496"	.56561	250	192	442
7	"7-out16497"	.45828	379	448	827
7	"7-out16498"	.88311	612	81	693
7	"7-out16499"	.26972	106	287	393
7	"7-out16500"	.37209	80	135	215
7	"7-out16501"	.27725	117	305	422
7	"7-out16502"	.14606	26	152	178
7	"7-out16503"	.93269	97	7	104
7	"7-out16504"	.93548	174	12	186
7	"7-out16505"	.89639	199	23	222
7	"7-out16506"	.90871	667	67	734
7	"7-out16507"	.22324	121	421	542
7	"7-out16508"	.20446	165	642	807
7	"7-out16509"	.24812	198	600	798
7	"7-out16510"	.17557	92	432	524
7	"7-out16511"	.22014	59	209	268
7	"7-out16512"	.97000	388	12	400
7	"7-out16513"	.25120	52	155	207
7	"7-out16514"	.23714	83	267	350
7	"7-out16515"	.20626	191	735	926
7	"7-out16516"	.10000	45	405	450
7	"7-out16517"	.46049	204	239	443
7	"7-out16518"	.89890	329	37	366
7	"7-out16519"	.19877	65	262	327
7	"7-out16520"	.18181	50	225	275
7	"7-out16521"	.22348	59	205	264
7	"7-out16522"	.86893	179	27	206
7	"7-out16523"	.21171	719	2677	3396
7	"7-out16524"	.61658	119	74	193
7	"7-out16525"	.18041	35	159	194
7	"7-out16526"	.20292	125	491	616
7	"7-out16527"	.27210	40	107	147
7	"7-out16528"	.56603	90	69	159
7	"7-out16529"	.39215	60	93	153
7	"7-out16530"	.94329	183	11	194
7	"7-out16531"	.86772	164	25	189
7	"7-out16532"	.97883	185	4	189
7	"7-out16533"	.97354	184	5	189
7	"7-out16534"	.97354	184	5	189
7	"7-out16535"	.97354	184	5	189
7	"7-out16536"	.97883	185	4	189
7	"7-out16537"	.97883	185	4	189
7	"7-out16538"	.95625	153	7	160
7	"7-out16539"	.31181	285	629	914
7	"7-out16540"	.25641	170	493	663
7	"7-out16541"	.39752	289	438	727
7	"7-out16542"	.68764	306	139	445
7	"7-out16543"	.83221	620	125	745
7	"7-out16544"	.93670	148	10	158
7	"7-out16545"	.90090	700	77	777
7	"7-out16546"	.63681	128	73	201
7	"7-out16547"	.13839	62	386	448
7	"7-out16548"	.28024	183	470	653
7	"7-out16549"	.15898	100	529	629
7	"7-out16550"	.20678	128	491	619
7	"7-out16551"	.17537	47	221	268
7	"7-out16552"	.94491	446	26	472
7	"7-out16553"	.26566	212	586	798
7	"7-out16554"	.54310	189	159	348
7	"7-out16555"	.26601	137	378	515
7	"7-out16556"	.13016	126	842	968
7	"7-out16557"	.19906	85	342	427
7	"7-out16558"	.40740	33	48	81
7	"7-out16559"	.96428	135	5	140
7	"7-out16560"	.78378	58	16	74
7	"7-out16561"	.20135	89	353	442
7	"7-out16562"	.94545	156	9	165
7	"7-out16563"	.94701	286	16	302
7	"7-out16564"	.42837	1552	2071	3623
7	"7-out16565"	.94588	437	25	462
7	"7-out16566"	.25087	72	215	287
7	"7-out16567"	.96328	446	17	463
7	"7-out16568"	.25637	191	554	745
7	"7-out16569"	.27932	50	129	179
7	"7-out16570"	.22716	194	660	854
7	"7-out16571"	.40277	145	215	360
7	"7-out16572"	.40876	569	823	1392
7	"7-out16573"	.17467	40	189	229
7	"7-out16574"	.47333	71	79	150
7	"7-out16575"	.19310	168	702	870
7	"7-out16576"	.48958	47	49	96
7	"7-out16577"	.33333	171	342	513
7	"7-out16578"	.90000	198	22	220
7	"7-out16579"	.87500	168	24	192
7	"7-out16580"	.23026	175	585	760
7	"7-out16581"	.39567	256	391	647
7	"7-out16582"	.23558	94	305	399
7	"7-out16583"	.30526	58	132	190
7	"7-out16584"	.19047	20	85	105
7	"7-out16585"	.21041	101	379	480
7	"7-out16586"	.28967	115	282	397
7	"7-out16587"	.81470	277	63	340
7	"7-out16588"	.77241	112	33	145
7	"7-out16589"	.34951	108	201	309
7	"7-out16590"	.28174	142	362	504
7	"7-out16591"	.87867	239	33	272
7	"7-out16592"	.76377	194	60	254
7	"7-out16593"	.81176	207	48	255
7	"7-out16594"	.13947	100	617	717
7	"7-out16595"	.14184	60	363	423
7	"7-out16596"	.90954	362	36	398
7	"7-out16597"	.19257	83	348	431
7	"7-out16598"	.16386	39	199	238
7	"7-out16599"	.34684	77	145	222
7	"7-out16600"	.22047	56	198	254
7	"7-out16601"	.10788	26	215	241
7	"7-out16602"	.13082	73	485	558
7	"7-out16603"	.19884	69	278	347
7	"7-out16604"	.27586	104	273	377
7	"7-out16605"	.19696	39	159	198
7	"7-out16606"	.21503	143	522	665
7	"7-out16607"	.21253	78	289	367
7	"7-out16608"	.87433	327	47	374
7	"7-out16609"	.26697	114	313	427
7	"7-out16610"	.48000	60	65	125
7	"7-out16611"	.26923	182	494	676
7	"7-out16612"	.16919	759	3727	4486
7	"7-out16613"	.32436	217	452	669
7	"7-out16614"	.32060	277	587	864
7	"7-out16615"	.32348	230	481	711
7	"7-out16616"	.13432	27	174	201
7	"7-out16617"	.26418	135	376	511
7	"7-out16618"	.06909	38	512	550
7	"7-out16619"	.91566	228	21	249
7	"7-out16620"	.24590	120	368	488
7	"7-out16621"	.15762	61	326	387
7	"7-out16622"	.16218	169	873	1042
7	"7-out16623"	.36111	143	253	396
7	"7-out16624"	.11382	42	327	369
7	"7-out16625"	.26525	100	277	377
7	"7-out16626"	.13099	41	272	313
7	"7-out16627"	.27272	87	232	319
7	"7-out16628"	.23133	158	525	683
7	"7-out16629"	.37168	84	142	226
7	"7-out16630"	.21991	159	564	723
7	"7-out16631"	.24444	429	1326	1755
7	"7-out16632"	.26439	101	281	382
7	"7-out16633"	.23339	246	808	1054
7	"7-out16634"	.19914	93	374	467
7	"7-out16635"	.24245	257	803	1060
7	"7-out16636"	.22946	162	544	706
7	"7-out16637"	.20227	160	631	791
7	"7-out16638"	.21630	207	750	957
7	"7-out16639"	.88585	551	71	622
7	"7-out16640"	.27162	201	539	740
7	"7-out16641"	.16639	103	516	619
7	"7-out16642"	.18181	40	180	220
7	"7-out16643"	.18049	87	395	482
7	"7-out16644"	.22058	75	265	340
7	"7-out16645"	.55254	163	132	295
7	"7-out16646"	.47004	102	115	217
7	"7-out16647"	.30607	131	297	428
7	"7-out16648"	.23232	92	304	396
7	"7-out16649"	.62745	128	76	204
7	"7-out16650"	.07612	22	267	289
7	"7-out16651"	.21276	60	222	282
7	"7-out16652"	.84567	274	50	324
7	"7-out16653"	.32047	108	229	337
7	"7-out16654"	.18678	65	283	348
7	"7-out16655"	.66564	217	109	326
7	"7-out16656"	.09913	23	209	232
7	"7-out16657"	.34529	77	146	223
7	"7-out16658"	.52657	327	294	621
7	"7-out16659"	.17842	86	396	482
7	"7-out16660"	.11274	46	362	408
7	"7-out16661"	.80000	268	67	335
7	"7-out16662"	.30828	160	359	519
7	"7-out16663"	.86973	227	34	261
7	"7-out16664"	.64179	172	96	268
7	"7-out16665"	.77935	219	62	281
7	"7-out16666"	.83478	192	38	230
7	"7-out16667"	.15654	49	264	313
7	"7-out16668"	.15226	74	412	486
7	"7-out16669"	.15413	41	225	266
7	"7-out16670"	.49283	172	177	349
7	"7-out16671"	.21126	75	280	355
7	"7-out16672"	.10982	38	308	346
7	"7-out16673"	.14565	52	305	357
7	"7-out16674"	.94368	486	29	515
7	"7-out16675"	.18050	50	227	277
7	"7-out16676"	.18874	57	245	302
7	"7-out16677"	.23309	448	1474	1922
7	"7-out16678"	.22861	155	523	678
7	"7-out16679"	.18676	223	971	1194
7	"7-out16680"	.22346	80	278	358
7	"7-out16681"	.20535	46	178	224
7	"7-out16682"	.06666	17	238	255
7	"7-out16683"	.35363	209	382	591
7	"7-out16684"	.73087	516	190	706
7	"7-out16685"	.26556	64	177	241
7	"7-out16686"	.16839	81	400	481
7	"7-out16687"	.62698	158	94	252
7	"7-out16688"	.87058	148	22	170
7	"7-out16689"	.90355	178	19	197
7	"7-out16690"	.17737	127	589	716
7	"7-out16691"	.76716	514	156	670
7	"7-out16692"	.85294	29	5	34
7	"7-out16693"	.96846	645	21	666
7	"7-out16694"	.37591	256	425	681
7	"7-out16695"	.27500	242	638	880
7	"7-out16696"	.30547	212	482	694
7	"7-out16697"	.19740	137	557	694
7	"7-out16698"	.89024	511	63	574
7	"7-out16699"	.13914	616	3811	4427
7	"7-out16700"	.20400	916	3574	4490
7	"7-out16701"	.19101	17	72	89
7	"7-out16702"	.81415	92	21	113
7	"7-out16703"	.25213	207	614	821
7	"7-out16704"	.46391	45	52	97
7	"7-out16705"	.28240	183	465	648
7	"7-out16706"	.13114	56	371	427
7	"7-out16707"	.43423	274	357	631
7	"7-out16708"	.13356	39	253	292
7	"7-out16709"	.36800	138	237	375
7	"7-out16710"	.20097	577	2294	2871
7	"7-out16711"	.90454	199	21	220
7	"7-out16712"	.17572	139	652	791
7	"7-out16713"	.15000	45	255	300
7	"7-out16714"	.43703	118	152	270
7	"7-out16715"	.82014	228	50	278
7	"7-out16716"	.23809	330	1056	1386
7	"7-out16717"	.16666	33	165	198
7	"7-out16718"	.13685	215	1356	1571
7	"7-out16719"	.18244	79	354	433
7	"7-out16720"	.21194	323	1201	1524
7	"7-out16721"	.21466	120	439	559
7	"7-out16722"	.26393	592	1651	2243
7	"7-out16723"	.15143	58	325	383
7	"7-out16724"	.07335	19	240	259
7	"7-out16725"	.24390	80	248	328
7	"7-out16726"	.27237	70	187	257
7	"7-out16727"	.19302	72	301	373
7	"7-out16728"	.85294	87	15	102
7	"7-out16729"	.20306	53	208	261
7	"7-out16730"	.25988	789	2247	3036
7	"7-out16731"	.19066	286	1214	1500
7	"7-out16732"	.14371	72	429	501
7	"7-out16733"	.12778	132	901	1033
7	"7-out16734"	.22796	150	508	658
7	"7-out16735"	.86818	494	75	569
7	"7-out16736"	.29219	161	390	551
7	"7-out16737"	.98165	107	2	109
7	"7-out16738"	.24318	419	1304	1723
7	"7-out16739"	.69730	2071	899	2970
7	"7-out16740"	.46700	92	105	197
7	"7-out16741"	.29749	332	784	1116
7	"7-out16742"	.21954	182	647	829
7	"7-out16743"	.36363	36	63	99
7	"7-out16744"	.37586	109	181	290
7	"7-out16745"	.33571	141	279	420
7	"7-out16746"	.28000	126	324	450
7	"7-out16747"	.30303	130	299	429
7	"7-out16748"	.22535	144	495	639
7	"7-out16749"	.20437	84	327	411
7	"7-out16750"	.34393	119	227	346
7	"7-out16751"	.80782	227	54	281
7	"7-out16752"	.25862	45	129	174
7	"7-out16753"	.11801	38	284	322
7	"7-out16754"	.18146	188	848	1036
7	"7-out16755"	.24691	60	183	243
7	"7-out16756"	.95687	355	16	371
7	"7-out16757"	.15524	197	1072	1269
7	"7-out16758"	.13961	123	758	881
7	"7-out16759"	.25174	253	752	1005
7	"7-out16760"	.25238	185	548	733
7	"7-out16761"	.32555	293	607	900
7	"7-out16762"	.96636	431	15	446
7	"7-out16763"	.24107	54	170	224
7	"7-out16764"	.33073	425	860	1285
7	"7-out16765"	.37500	45	75	120
7	"7-out16766"	.17990	145	661	806
7	"7-out16767"	.96153	75	3	78
7	"7-out16768"	.97637	124	3	127
7	"7-out16769"	.15679	90	484	574
7	"7-out16770"	.88888	136	17	153
7	"7-out16771"	.11785	66	494	560
7	"7-out16772"	.17789	634	2930	3564
7	"7-out16773"	.14912	520	2967	3487
7	"7-out16774"	.19719	731	2976	3707
7	"7-out16775"	.22875	70	236	306
7	"7-out16776"	.78468	164	45	209
7	"7-out16777"	.35087	20	37	57
7	"7-out16778"	.16623	128	642	770
7	"7-out16779"	.24537	199	612	811
7	"7-out16780"	.28821	362	894	1256
7	"7-out16781"	.71035	542	221	763
7	"7-out16782"	.56329	267	207	474
7	"7-out16783"	.21917	64	228	292
7	"7-out16784"	.40924	124	179	303
7	"7-out16785"	.24125	131	412	543
7	"7-out16786"	.12435	24	169	193
7	"7-out16787"	.13344	77	500	577
7	"7-out16788"	.51034	74	71	145
7	"7-out16789"	.23966	87	276	363
7	"7-out16790"	.15585	149	807	956
7	"7-out16791"	.27480	72	190	262
7	"7-out16792"	.18787	31	134	165
7	"7-out16793"	.44966	67	82	149
7	"7-out16794"	.91176	93	9	102
7	"7-out16795"	.22005	259	918	1177
7	"7-out16796"	.30578	37	84	121
7	"7-out16797"	.91666	165	15	180
7	"7-out16798"	.90540	67	7	74
7	"7-out16799"	.91634	712	65	777
7	"7-out16800"	.91377	710	67	777
7	"7-out16801"	.88740	465	59	524
7	"7-out16802"	.30407	194	444	638
7	"7-out16803"	.08333	31	341	372
7	"7-out16804"	.22758	33	112	145
7	"7-out16805"	.35433	45	82	127
7	"7-out16806"	.21189	196	729	925
7	"7-out16807"	.37382	357	598	955
7	"7-out16808"	.41269	52	74	126
7	"7-out16809"	.19667	272	1111	1383
7	"7-out16810"	.24456	45	139	184
7	"7-out16811"	.31598	85	184	269
7	"7-out16812"	.88602	241	31	272
7	"7-out16813"	.90592	260	27	287
7	"7-out16814"	.38571	54	86	140
7	"7-out16815"	.23284	112	369	481
7	"7-out16816"	.17777	32	148	180
7	"7-out16817"	.14915	203	1158	1361
7	"7-out16818"	.33911	1056	2058	3114
7	"7-out16819"	.54251	134	113	247
7	"7-out16820"	.52600	263	237	500
7	"7-out16821"	.49295	525	540	1065
7	"7-out16822"	.15116	26	146	172
7	"7-out16823"	.33049	155	314	469
7	"7-out16824"	.21989	42	149	191
7	"7-out16825"	.28253	89	226	315
7	"7-out16826"	.25796	170	489	659
7	"7-out16827"	.28011	193	496	689
7	"7-out16828"	.93750	120	8	128
7	"7-out16829"	.35378	248	453	701
7	"7-out16830"	.26732	27	74	101
7	"7-out16831"	.38903	149	234	383
7	"7-out16832"	.31034	90	200	290
7	"7-out16833"	.34664	191	360	551
7	"7-out16834"	.31250	80	176	256
7	"7-out16835"	.23967	209	663	872
7	"7-out16836"	.94444	85	5	90
7	"7-out16837"	.84662	138	25	163
7	"7-out16838"	.35215	106	195	301
7	"7-out16839"	.25000	370	1110	1480
7	"7-out16840"	.91176	93	9	102
7	"7-out16841"	.24644	104	318	422
7	"7-out16842"	.22884	119	401	520
7	"7-out16843"	.26315	20	56	76
7	"7-out16844"	.25283	67	198	265
7	"7-out16845"	.93793	136	9	145
7	"7-out16846"	.19242	61	256	317
7	"7-out16847"	.26368	106	296	402
7	"7-out16848"	.17424	23	109	132
7	"7-out16849"	.24058	147	464	611
7	"7-out16850"	.92857	455	35	490
7	"7-out16851"	.91428	448	42	490
7	"7-out16852"	.90079	454	50	504
7	"7-out16853"	.82442	432	92	524
7	"7-out16854"	.83300	424	85	509
7	"7-out16855"	.22334	111	386	497
7	"7-out16856"	.41340	74	105	179
7	"7-out16857"	.38405	53	85	138
7	"7-out16858"	.16556	25	126	151
7	"7-out16859"	.18978	26	111	137
7	"7-out16860"	.50340	74	73	147
7	"7-out16861"	.46000	23	27	50
7	"7-out16862"	.16275	104	535	639
7	"7-out16863"	.97354	184	5	189
7	"7-out16864"	.97354	184	5	189
7	"7-out16865"	.97883	185	4	189
7	"7-out16866"	.38235	52	84	136
7	"7-out16867"	.95121	195	10	205
7	"7-out16868"	.53828	232	199	431
7	"7-out16869"	.23451	212	692	904
7	"7-out16870"	.25681	113	327	440
7	"7-out16871"	.26568	72	199	271
7	"7-out16872"	.26564	259	716	975
7	"7-out16873"	.91891	714	63	777
7	"7-out16874"	.30945	108	241	349
7	"7-out16875"	.22790	49	166	215
7	"7-out16876"	.12322	87	619	706
7	"7-out16877"	.29629	72	171	243
7	"7-out16878"	.20401	122	476	598
7	"7-out16879"	.19193	138	581	719
7	"7-out16880"	.25984	132	376	508
7	"7-out16881"	.91925	148	13	161
7	"7-out16882"	.72243	190	73	263
7	"7-out16883"	.76425	201	62	263
7	"7-out16884"	.92452	490	40	530
7	"7-out16885"	.17988	161	734	895
7	"7-out16886"	.19846	155	626	781
7	"7-out16887"	.33613	80	158	238
7	"7-out16888"	.06172	5	76	81
7	"7-out16889"	.96296	78	3	81
7	"7-out16890"	.24074	26	82	108
7	"7-out16891"	.34161	110	212	322
7	"7-out16892"	.11415	25	194	219
7	"7-out16893"	.51470	105	99	204
7	"7-out16894"	.88461	46	6	52
7	"7-out16895"	.96031	121	5	126
7	"7-out16896"	.95312	61	3	64
7	"7-out16897"	.96103	74	3	77
7	"7-out16898"	.96610	57	2	59
7	"7-out16899"	.92727	51	4	55
7	"7-out16900"	.26817	332	906	1238
7	"7-out16901"	.30989	238	530	768
7	"7-out16902"	.27564	215	565	780
7	"7-out16903"	.91111	205	20	225
7	"7-out16904"	.49543	217	221	438
7	"7-out16905"	.93548	58	4	62
7	"7-out16906"	.20986	315	1186	1501
7	"7-out16907"	.85600	107	18	125
7	"7-out16908"	.94357	485	29	514
7	"7-out16909"	.88073	96	13	109
7	"7-out16910"	.82882	184	38	222
7	"7-out16911"	.48453	47	50	97
7	"7-out16912"	.62951	209	123	332
7	"7-out16913"	.94444	102	6	108
7	"7-out16914"	.94444	102	6	108
7	"7-out16915"	.94827	165	9	174
7	"7-out16916"	.16534	146	737	883
7	"7-out16917"	.30470	110	251	361
7	"7-out16918"	.27887	99	256	355
7	"7-out16919"	.61445	51	32	83
7	"7-out16920"	.96296	78	3	81
7	"7-out16921"	.46491	53	61	114
7	"7-out16922"	.23099	79	263	342
7	"7-out16923"	.45714	160	190	350
7	"7-out16924"	.31390	70	153	223
7	"7-out16925"	.81308	87	20	107
7	"7-out16926"	.45132	51	62	113
7	"7-out16927"	.24105	229	721	950
7	"7-out16928"	.23006	150	502	652
7	"7-out16929"	.32700	155	319	474
7	"7-out16930"	.38837	127	200	327
7	"7-out16931"	.28727	79	196	275
7	"7-out16932"	.23598	101	327	428
7	"7-out16933"	.16891	75	369	444
7	"7-out16934"	.18279	17	76	93
7	"7-out16935"	.25000	30	90	120
7	"7-out16936"	.17475	54	255	309
7	"7-out16937"	.29629	80	190	270
7	"7-out16938"	.90116	310	34	344
7	"7-out16939"	.23753	81	260	341
7	"7-out16940"	.16765	142	705	847
7	"7-out16941"	.12000	45	330	375
7	"7-out16942"	.77500	62	18	80
7	"7-out16943"	.18666	56	244	300
7	"7-out16944"	.37628	146	242	388
7	"7-out16945"	.23214	130	430	560
7	"7-out16946"	.77970	315	89	404
7	"7-out16947"	.92857	195	15	210
7	"7-out16948"	.66227	553	282	835
7	"7-out16949"	.28140	56	143	199
7	"7-out16950"	.22410	119	412	531
7	"7-out16951"	.27003	155	419	574
7	"7-out16952"	.22065	47	166	213
7	"7-out16953"	.25589	76	221	297
7	"7-out16954"	.94148	177	11	188
7	"7-out16955"	.70542	182	76	258
7	"7-out16956"	.15901	90	476	566
7	"7-out16957"	.16042	30	157	187
7	"7-out16958"	.19367	98	408	506
7	"7-out16959"	.29898	177	415	592
7	"7-out16960"	.36842	630	1080	1710
7	"7-out16961"	.14832	221	1269	1490
7	"7-out16962"	.27044	43	116	159
7	"7-out16963"	.20645	96	369	465
7	"7-out16964"	.15638	71	383	454
7	"7-out16965"	.53903	145	124	269
7	"7-out16966"	.13750	11	69	80
7	"7-out16967"	.43575	156	202	358
7	"7-out16968"	.30232	78	180	258
7	"7-out16969"	.32267	111	233	344
7	"7-out16970"	.93791	559	37	596
7	"7-out16971"	.88395	259	34	293
7	"7-out16972"	.26144	788	2226	3014
7	"7-out16973"	.37168	126	213	339
7	"7-out16974"	.27666	83	217	300
7	"7-out16975"	.38504	1040	1661	2701
7	"7-out16976"	.15909	14	74	88
7	"7-out16977"	.15885	61	323	384
7	"7-out16978"	.27419	17	45	62
7	"7-out16979"	.87456	251	36	287
7	"7-out16980"	.38047	452	736	1188
7	"7-out16981"	.31557	77	167	244
7	"7-out16982"	.25249	76	225	301
7	"7-out16983"	.33434	110	219	329
7	"7-out16984"	.19060	219	930	1149
7	"7-out16985"	.15937	51	269	320
7	"7-out16986"	.20153	79	313	392
7	"7-out16987"	.31832	198	424	622
7	"7-out16988"	.27550	748	1967	2715
7	"7-out16989"	.38157	203	329	532
7	"7-out16990"	.95316	2951	145	3096
7	"7-out16991"	.47826	55	60	115
7	"7-out16992"	.24710	277	844	1121
7	"7-out16993"	.30844	95	213	308
7	"7-out16994"	.95098	97	5	102
7	"7-out16995"	.51107	277	265	542
7	"7-out16996"	.80000	80	20	100
7	"7-out16997"	.33220	196	394	590
7	"7-out16998"	.11299	20	157	177
7	"7-out16999"	.91393	223	21	244
7	"7-out17000"	.92592	75	6	81
7	"7-out17001"	.24783	172	522	694
7	"7-out17002"	.20347	117	458	575
7	"7-out17003"	.17892	107	491	598
7	"7-out17004"	.50677	561	546	1107
7	"7-out17005"	.94882	445	24	469
7	"7-out17006"	.27467	128	338	466
7	"7-out17007"	.11214	12	95	107
7	"7-out17008"	.14610	334	1952	2286
7	"7-out17009"	.30360	160	367	527
7	"7-out17010"	.31972	47	100	147
7	"7-out17011"	.23931	28	89	117
7	"7-out17012"	.19854	246	993	1239
7	"7-out17013"	.17938	87	398	485
7	"7-out17014"	.19972	292	1170	1462
7	"7-out17015"	.31044	104	231	335
7	"7-out17016"	.18434	106	469	575
7	"7-out17017"	.40890	202	292	494
7	"7-out17018"	.29666	267	633	900
7	"7-out17019"	.27881	150	388	538
7	"7-out17020"	.71085	1126	458	1584
7	"7-out17021"	.92405	73	6	79
7	"7-out17022"	.84420	466	86	552
7	"7-out17023"	.74461	242	83	325
7	"7-out17024"	.39877	260	392	652
7	"7-out17025"	.38888	140	220	360
7	"7-out17026"	.42134	75	103	178
7	"7-out17027"	.31793	234	502	736
7	"7-out17028"	.29166	266	646	912
7	"7-out17029"	.14302	122	731	853
7	"7-out17030"	.25129	97	289	386
7	"7-out17031"	.20101	317	1260	1577
7	"7-out17032"	.15779	255	1361	1616
7	"7-out17033"	.18105	86	389	475
7	"7-out17034"	.44827	78	96	174
7	"7-out17035"	.08611	31	329	360
7	"7-out17036"	.19667	71	290	361
7	"7-out17037"	.56622	171	131	302
7	"7-out17038"	.33779	101	198	299
7	"7-out17039"	.21967	67	238	305
7	"7-out17040"	.28400	71	179	250
7	"7-out17041"	.32600	89	184	273
7	"7-out17042"	.26532	580	1606	2186
7	"7-out17043"	.62662	1299	774	2073
7	"7-out17044"	.12750	51	349	400
7	"7-out17045"	.70631	291	121	412
7	"7-out17046"	.18337	342	1523	1865
7	"7-out17047"	.14808	271	1559	1830
7	"7-out17048"	.12660	257	1773	2030
7	"7-out17049"	.24059	473	1493	1966
7	"7-out17050"	.17112	320	1550	1870
7	"7-out17051"	.17537	359	1688	2047
7	"7-out17052"	.21775	466	1674	2140
7	"7-out17053"	.19676	413	1686	2099
7	"7-out17054"	.20396	422	1647	2069
7	"7-out17055"	.33443	101	201	302
7	"7-out17056"	.56340	271	210	481
7	"7-out17057"	.17233	71	341	412
7	"7-out17058"	.32862	163	333	496
7	"7-out17059"	.18711	61	265	326
7	"7-out17060"	.16339	50	256	306
7	"7-out17061"	.11782	39	292	331
7	"7-out17062"	.34722	175	329	504
7	"7-out17063"	.17843	96	442	538
7	"7-out17064"	.45229	256	310	566
7	"7-out17065"	.22677	559	1906	2465
7	"7-out17066"	.18581	427	1871	2298
7	"7-out17067"	.94915	112	6	118
7	"7-out17068"	.13128	81	536	617
7	"7-out17069"	.01680	4	234	238
7	"7-out17070"	.20429	314	1223	1537
7	"7-out17071"	.17784	61	282	343
7	"7-out17072"	.14375	46	274	320
7	"7-out17073"	.30606	217	492	709
7	"7-out17074"	.23795	158	506	664
7	"7-out17075"	.90243	111	12	123
7	"7-out17076"	.32307	84	176	260
7	"7-out17077"	.46899	121	137	258
7	"7-out17078"	.80232	138	34	172
7	"7-out17079"	.10837	22	181	203
7	"7-out17080"	.92457	380	31	411
7	"7-out17081"	.24897	121	365	486
7	"7-out17082"	.22336	109	379	488
7	"7-out17083"	.32105	122	258	380
7	"7-out17084"	.32539	123	255	378
7	"7-out17085"	.17381	77	366	443
7	"7-out17086"	.56032	274	215	489
7	"7-out17087"	.87179	68	10	78
7	"7-out17088"	.60975	50	32	82
7	"7-out17089"	.37192	106	179	285
7	"7-out17090"	.21348	57	210	267
7	"7-out17091"	.38053	172	280	452
7	"7-out17092"	.36923	96	164	260
7	"7-out17093"	.34523	29	55	84
7	"7-out17094"	.44565	41	51	92
7	"7-out17095"	.08108	18	204	222
7	"7-out17096"	.19285	54	226	280
7	"7-out17097"	.38202	34	55	89
7	"7-out17098"	.41964	47	65	112
7	"7-out17099"	.05314	11	196	207
7	"7-out17100"	.60162	74	49	123
7	"7-out17101"	.40086	186	278	464
7	"7-out17102"	.20588	91	351	442
7	"7-out17103"	.29251	43	104	147
7	"7-out17104"	.91203	197	19	216
7	"7-out17105"	.86259	226	36	262
7	"7-out17106"	.45901	112	132	244
7	"7-out17107"	.64529	453	249	702
7	"7-out17108"	.34838	162	303	465
7	"7-out17109"	.21983	82	291	373
7	"7-out17110"	.22596	94	322	416
7	"7-out17111"	.42545	117	158	275
7	"7-out17112"	.56349	426	330	756
7	"7-out17113"	.22222	18	63	81
7	"7-out17114"	.17543	10	47	57
7	"7-out17115"	.24265	157	490	647
7	"7-out17116"	.31346	163	357	520
7	"7-out17117"	.27777	95	247	342
7	"7-out17118"	.27034	206	556	762
7	"7-out17119"	.23857	94	300	394
7	"7-out17120"	.23337	179	588	767
7	"7-out17121"	.40449	108	159	267
7	"7-out17122"	.41176	189	270	459
7	"7-out17123"	.29961	154	360	514
7	"7-out17124"	.15314	117	647	764
7	"7-out17125"	.14507	28	165	193
7	"7-out17126"	.92424	122	10	132
7	"7-out17127"	.93449	214	15	229
7	"7-out17128"	.28820	66	163	229
7	"7-out17129"	.90434	208	22	230
7	"7-out17130"	.79726	291	74	365
7	"7-out17131"	.87700	164	23	187
7	"7-out17132"	.86060	142	23	165
7	"7-out17133"	.11377	19	148	167
7	"7-out17134"	.97435	114	3	117
7	"7-out17135"	.18764	79	342	421
7	"7-out17136"	.34536	67	127	194
7	"7-out17137"	.80169	283	70	353
7	"7-out17138"	.19945	147	590	737
7	"7-out17139"	.18977	902	3851	4753
7	"7-out17140"	.29145	58	141	199
7	"7-out17141"	.11640	22	167	189
7	"7-out17142"	.67758	269	128	397
7	"7-out17143"	.14805	61	351	412
7	"7-out17144"	.38888	77	121	198
7	"7-out17145"	.51012	252	242	494
7	"7-out17146"	.93675	237	16	253
7	"7-out17147"	.81538	212	48	260
7	"7-out17148"	.16757	154	765	919
7	"7-out17149"	.12091	122	887	1009
7	"7-out17150"	.32381	295	616	911
7	"7-out17151"	.11834	20	149	169
7	"7-out17152"	.36813	67	115	182
7	"7-out17153"	.25683	47	136	183
7	"7-out17154"	.15278	189	1048	1237
7	"7-out17155"	.46153	78	91	169
7	"7-out17156"	.23750	114	366	480
7	"7-out17157"	.27536	57	150	207
7	"7-out17158"	.90410	132	14	146
7	"7-out17159"	.26578	101	279	380
7	"7-out17160"	.28703	62	154	216
7	"7-out17161"	.20044	90	359	449
7	"7-out17162"	.25000	145	435	580
7	"7-out17163"	.95402	83	4	87
7	"7-out17164"	.26845	240	654	894
7	"7-out17165"	.30077	271	630	901
7	"7-out17166"	.31361	281	615	896
7	"7-out17167"	.15208	306	1706	2012
7	"7-out17168"	.15148	311	1742	2053
7	"7-out17169"	.31649	94	203	297
7	"7-out17170"	.65254	77	41	118
7	"7-out17171"	.32105	61	129	190
7	"7-out17172"	.61855	60	37	97
7	"7-out17173"	.95302	142	7	149
7	"7-out17174"	.22772	276	936	1212
7	"7-out17175"	.67745	649	309	958
7	"7-out17176"	.18017	189	860	1049
7	"7-out17177"	.26386	295	823	1118
7	"7-out17178"	.20820	208	791	999
7	"7-out17179"	.18750	195	845	1040
7	"7-out17180"	.22752	81	275	356
7	"7-out17181"	.20368	265	1036	1301
7	"7-out17182"	.21859	268	958	1226
7	"7-out17183"	.05741	12	197	209
7	"7-out17184"	.43452	73	95	168
7	"7-out17185"	.30601	239	542	781
7	"7-out17186"	.22602	165	565	730
7	"7-out17187"	.16419	122	621	743
7	"7-out17188"	.10845	68	559	627
7	"7-out17189"	.84210	256	48	304
7	"7-out17190"	.67785	202	96	298
7	"7-out17191"	.35645	221	399	620
7	"7-out17192"	.87971	373	51	424
7	"7-out17193"	.87971	373	51	424
7	"7-out17194"	.88151	372	50	422
7	"7-out17195"	.87971	373	51	424
7	"7-out17196"	.87971	373	51	424
7	"7-out17197"	.87971	373	51	424
7	"7-out17198"	.41328	641	910	1551
7	"7-out17199"	.51356	795	753	1548
7	"7-out17200"	.15263	29	161	190
7	"7-out17201"	.92452	98	8	106
7	"7-out17202"	.47178	209	234	443
7	"7-out17203"	.18307	119	531	650
7	"7-out17204"	.20540	38	147	185
7	"7-out17205"	.36277	115	202	317
7	"7-out17206"	.23604	93	301	394
7	"7-out17207"	.13123	50	331	381
7	"7-out17208"	.72395	278	106	384
7	"7-out17209"	.56363	155	120	275
7	"7-out17210"	.38858	211	332	543
7	"7-out17211"	.30813	159	357	516
7	"7-out17212"	.35430	428	780	1208
7	"7-out17213"	.41196	124	177	301
7	"7-out17214"	.20856	112	425	537
7	"7-out17215"	.45807	661	782	1443
7	"7-out17216"	.17773	99	458	557
7	"7-out17217"	.18386	139	617	756
7	"7-out17218"	.37288	44	74	118
7	"7-out17219"	.49545	109	111	220
7	"7-out17220"	.65594	265	139	404
7	"7-out17221"	.15816	31	165	196
7	"7-out17222"	.14674	97	564	661
7	"7-out17223"	.21212	161	598	759
7	"7-out17224"	.21196	319	1186	1505
7	"7-out17225"	.29744	442	1044	1486
7	"7-out17226"	.18286	111	496	607
7	"7-out17227"	.31250	50	110	160
7	"7-out17228"	.21379	62	228	290
7	"7-out17229"	.25102	61	182	243
7	"7-out17230"	.90977	121	12	133
7	"7-out17231"	.57657	64	47	111
7	"7-out17232"	.22923	69	232	301
7	"7-out17233"	.33000	496	1007	1503
7	"7-out17234"	.38400	48	77	125
7	"7-out17235"	.51020	150	144	294
7	"7-out17236"	.34864	129	241	370
7	"7-out17237"	.96585	198	7	205
7	"7-out17238"	.49422	214	219	433
7	"7-out17239"	.73831	79	28	107
7	"7-out17240"	.24456	90	278	368
7	"7-out17241"	.37755	37	61	98
7	"7-out17242"	.48974	215	224	439
7	"7-out17243"	.37234	35	59	94
7	"7-out17244"	.26605	29	80	109
7	"7-out17245"	.26126	29	82	111
7	"7-out17246"	.39495	47	72	119
7	"7-out17247"	.12652	83	573	656
7	"7-out17248"	.15789	90	480	570
7	"7-out17249"	.74210	141	49	190
7	"7-out17250"	.18000	72	328	400
7	"7-out17251"	.20165	73	289	362
7	"7-out17252"	.29692	87	206	293
7	"7-out17253"	.28662	45	112	157
7	"7-out17254"	.21656	68	246	314
7	"7-out17255"	.12773	70	478	548
7	"7-out17256"	.95833	253	11	264
7	"7-out17257"	.77319	75	22	97
7	"7-out17258"	.41525	98	138	236
7	"7-out17259"	.12953	100	672	772
7	"7-out17260"	.88444	597	78	675
7	"7-out17261"	.23755	105	337	442
7	"7-out17262"	.23291	92	303	395
7	"7-out17263"	.25000	30	90	120
7	"7-out17264"	.58253	367	263	630
7	"7-out17265"	.32890	99	202	301
7	"7-out17266"	.43988	150	191	341
7	"7-out17267"	.45360	748	901	1649
7	"7-out17268"	.23768	82	263	345
7	"7-out17269"	.13582	69	439	508
7	"7-out17270"	.19369	86	358	444
7	"7-out17271"	.46857	82	93	175
7	"7-out17272"	.40804	71	103	174
7	"7-out17273"	.27442	250	661	911
7	"7-out17274"	.23875	207	660	867
7	"7-out17275"	.96103	74	3	77
7	"7-out17276"	.85096	177	31	208
7	"7-out17277"	.29493	64	153	217
7	"7-out17278"	.31726	79	170	249
7	"7-out17279"	.21632	53	192	245
7	"7-out17280"	.26179	222	626	848
7	"7-out17281"	.42271	268	366	634
7	"7-out17282"	.21163	131	488	619
7	"7-out17283"	.21404	64	235	299
7	"7-out17284"	.34090	45	87	132
7	"7-out17285"	.86605	569	88	657
7	"7-out17286"	.27694	185	483	668
7	"7-out17287"	.22257	71	248	319
7	"7-out17288"	.25796	81	233	314
7	"7-out17289"	.19898	118	475	593
7	"7-out17290"	.17798	173	799	972
7	"7-out17291"	.21538	56	204	260
7	"7-out17292"	.92626	201	16	217
7	"7-out17293"	.23684	198	638	836
7	"7-out17294"	.53403	102	89	191
7	"7-out17295"	.86486	192	30	222
7	"7-out17296"	.15833	38	202	240
7	"7-out17297"	.18139	39	176	215
7	"7-out17298"	.39393	52	80	132
7	"7-out17299"	.25367	69	203	272
7	"7-out17300"	.19704	80	326	406
7	"7-out17301"	.66494	1544	778	2322
7	"7-out17302"	.25088	142	424	566
7	"7-out17303"	.31987	206	438	644
7	"7-out17304"	.19019	159	677	836
7	"7-out17305"	.29052	233	569	802
7	"7-out17306"	.92417	195	16	211
7	"7-out17307"	.14680	85	494	579
7	"7-out17308"	.41780	61	85	146
7	"7-out17309"	.20000	72	288	360
7	"7-out17310"	.92819	698	54	752
7	"7-out17311"	.85549	296	50	346
7	"7-out17312"	.36511	180	313	493
7	"7-out17313"	.22465	328	1132	1460
7	"7-out17314"	.21602	213	773	986
7	"7-out17315"	.70639	243	101	344
7	"7-out17316"	.25644	368	1067	1435
7	"7-out17317"	.53623	185	160	345
7	"7-out17318"	.59107	159	110	269
7	"7-out17319"	.94736	234	13	247
7	"7-out17320"	.55760	697	553	1250
7	"7-out17321"	.43678	228	294	522
7	"7-out17322"	.22932	122	410	532
7	"7-out17323"	.26645	85	234	319
7	"7-out17324"	.95031	153	8	161
7	"7-out17325"	.22222	48	168	216
7	"7-out17326"	.65920	412	213	625
7	"7-out17327"	.20882	194	735	929
7	"7-out17328"	.94326	133	8	141
7	"7-out17329"	.27819	37	96	133
7	"7-out17330"	.21875	49	175	224
7	"7-out17331"	.26487	138	383	521
7	"7-out17332"	.25248	127	376	503
7	"7-out17333"	.27865	282	730	1012
7	"7-out17334"	.23376	108	354	462
7	"7-out17335"	.30009	325	758	1083
7	"7-out17336"	.90688	448	46	494
7	"7-out17337"	.67366	353	171	524
7	"7-out17338"	.16442	342	1738	2080
7	"7-out17339"	.93592	482	33	515
7	"7-out17340"	.24740	143	435	578
7	"7-out17341"	.25132	189	563	752
7	"7-out17342"	.16772	79	392	471
7	"7-out17343"	.39575	224	342	566
7	"7-out17344"	.25961	108	308	416
7	"7-out17345"	.80961	421	99	520
7	"7-out17346"	.42016	100	138	238
7	"7-out17347"	.47358	242	269	511
7	"7-out17348"	.29737	102	241	343
7	"7-out17349"	.31086	166	368	534
7	"7-out17350"	.42004	176	243	419
7	"7-out17351"	.20000	24	96	120
7	"7-out17352"	.36561	151	262	413
7	"7-out17353"	.39759	132	200	332
7	"7-out17354"	.62222	224	136	360
7	"7-out17355"	.27702	82	214	296
7	"7-out17356"	.19914	93	374	467
7	"7-out17357"	.88107	689	93	782
7	"7-out17358"	.68750	143	65	208
7	"7-out17359"	.95850	462	20	482
7	"7-out17360"	.17233	309	1484	1793
7	"7-out17361"	.94680	89	5	94
7	"7-out17362"	.21772	113	406	519
7	"7-out17363"	.29032	54	132	186
7	"7-out17364"	.78761	89	24	113
7	"7-out17365"	.19480	75	310	385
7	"7-out17366"	.21527	62	226	288
7	"7-out17367"	.13879	39	242	281
7	"7-out17368"	.85572	172	29	201
7	"7-out17369"	.21283	136	503	639
7	"7-out17370"	.44520	130	162	292
7	"7-out17371"	.28476	43	108	151
7	"7-out17372"	.59810	189	127	316
7	"7-out17373"	.81410	127	29	156
7	"7-out17374"	.76397	123	38	161
7	"7-out17375"	.26527	673	1864	2537
7	"7-out17376"	.49565	57	58	115
7	"7-out17377"	.67857	171	81	252
7	"7-out17378"	.25045	274	820	1094
7	"7-out17379"	.25729	802	2315	3117
7	"7-out17380"	.52075	138	127	265
7	"7-out17381"	.82173	378	82	460
7	"7-out17382"	.72962	197	73	270
7	"7-out17383"	.34188	440	847	1287
7	"7-out17384"	.23251	113	373	486
7	"7-out17385"	.76510	114	35	149
7	"7-out17386"	.88602	241	31	272
7	"7-out17387"	.23822	789	2523	3312
7	"7-out17388"	.55263	231	187	418
7	"7-out17389"	.28205	110	280	390
7	"7-out17390"	.45901	56	66	122
7	"7-out17391"	.22448	66	228	294
7	"7-out17392"	.37048	123	209	332
7	"7-out17393"	.52083	200	184	384
7	"7-out17394"	.36515	153	266	419
7	"7-out17395"	.94915	112	6	118
7	"7-out17396"	.26329	104	291	395
7	"7-out17397"	.38461	70	112	182
7	"7-out17398"	.26205	299	842	1141
7	"7-out17399"	.92063	116	10	126
7	"7-out17400"	.19123	96	406	502
7	"7-out17401"	.33657	173	341	514
7	"7-out17402"	.21468	114	417	531
7	"7-out17403"	.18979	93	397	490
7	"7-out17404"	.24952	131	394	525
7	"7-out17405"	.91136	473	46	519
7	"7-out17406"	.90059	453	50	503
7	"7-out17407"	.27493	215	567	782
7	"7-out17408"	.67910	91	43	134
7	"7-out17409"	.44252	77	97	174
7	"7-out17410"	.76923	170	51	221
7	"7-out17411"	.93617	132	9	141
7	"7-out17412"	.23507	63	205	268
7	"7-out17413"	.46502	113	130	243
7	"7-out17414"	.16883	26	128	154
7	"7-out17415"	.94736	90	5	95
7	"7-out17416"	.92857	104	8	112
7	"7-out17417"	.23048	62	207	269
7	"7-out17418"	.11848	25	186	211
7	"7-out17419"	.58122	161	116	277
7	"7-out17420"	.21112	262	979	1241
7	"7-out17421"	.18333	44	196	240
7	"7-out17422"	.52040	204	188	392
7	"7-out17423"	.20000	45	180	225
7	"7-out17424"	.34545	38	72	110
7	"7-out17425"	.19805	183	741	924
7	"7-out17426"	.13839	62	386	448
7	"7-out17427"	.17327	83	396	479
7	"7-out17428"	.22055	88	311	399
7	"7-out17429"	.22804	161	545	706
7	"7-out17430"	.28742	48	119	167
7	"7-out17431"	.33720	29	57	86
7	"7-out17432"	.32518	346	718	1064
7	"7-out17433"	.21276	20	74	94
7	"7-out17434"	.27760	357	929	1286
7	"7-out17435"	.29113	23	56	79
7	"7-out17436"	.35714	30	54	84
7	"7-out17437"	.19181	89	375	464
7	"7-out17438"	.91168	351	34	385
7	"7-out17439"	.95454	84	4	88
7	"7-out17440"	.24369	232	720	952
7	"7-out17441"	.24249	202	631	833
7	"7-out17442"	.27017	77	208	285
7	"7-out17443"	.15793	211	1125	1336
7	"7-out17444"	.14526	181	1065	1246
7	"7-out17445"	.14143	57	346	403
7	"7-out17446"	.23262	77	254	331
7	"7-out17447"	.94936	300	16	316
7	"7-out17448"	.19020	66	281	347
7	"7-out17449"	.97979	97	2	99
7	"7-out17450"	.24926	426	1283	1709
7	"7-out17451"	.27936	283	730	1013
7	"7-out17452"	.24495	170	524	694
7	"7-out17453"	.17305	280	1338	1618
7	"7-out17454"	.16765	310	1539	1849
7	"7-out17455"	.28620	500	1247	1747
7	"7-out17456"	.32016	381	809	1190
7	"7-out17457"	.22260	130	454	584
7	"7-out17458"	.29387	211	507	718
7	"7-out17459"	.18421	91	403	494
7	"7-out17460"	.18981	950	4055	5005
7	"7-out17461"	.54250	217	183	400
7	"7-out17462"	.64693	306	167	473
7	"7-out17463"	.23584	100	324	424
7	"7-out17464"	.68750	297	135	432
7	"7-out17465"	.26000	117	333	450
7	"7-out17466"	.86976	374	56	430
7	"7-out17467"	.61879	349	215	564
7	"7-out17468"	.63475	358	206	564
7	"7-out17469"	.57288	676	504	1180
7	"7-out17470"	.30919	158	353	511
7	"7-out17471"	.23317	149	490	639
7	"7-out17472"	.34971	185	344	529
7	"7-out17473"	.25000	161	483	644
7	"7-out17474"	.78053	377	106	483
7	"7-out17475"	.21544	226	823	1049
7	"7-out17476"	.46514	347	399	746
7	"7-out17477"	.22539	158	543	701
7	"7-out17478"	.35964	123	219	342
7	"7-out17479"	.32478	76	158	234
7	"7-out17480"	.25537	95	277	372
7	"7-out17481"	.16831	68	336	404
7	"7-out17482"	.20526	39	151	190
7	"7-out17483"	.30874	113	253	366
7	"7-out17484"	.27197	164	439	603
7	"7-out17485"	.33061	81	164	245
7	"7-out17486"	.95502	361	17	378
7	"7-out17487"	.95238	360	18	378
7	"7-out17488"	.37295	91	153	244
7	"7-out17489"	.18852	46	198	244
7	"7-out17490"	.19746	78	317	395
7	"7-out17491"	.46835	185	210	395
7	"7-out17492"	.23255	30	99	129
7	"7-out17493"	.20716	81	310	391
7	"7-out17494"	.92474	1450	118	1568
7	"7-out17495"	.79518	132	34	166
7	"7-out17496"	.27358	29	77	106
7	"7-out17497"	.29620	125	297	422
7	"7-out17498"	.45701	303	360	663
7	"7-out17499"	.23770	58	186	244
7	"7-out17500"	.29425	123	295	418
7	"7-out17501"	.13370	48	311	359
7	"7-out17502"	.90196	46	5	51
7	"7-out17503"	.22604	92	315	407
7	"7-out17504"	.10795	38	314	352
7	"7-out17505"	.23954	63	200	263
7	"7-out17506"	.18285	64	286	350
7	"7-out17507"	.90838	585	59	644
7	"7-out17508"	.45882	234	276	510
7	"7-out17509"	.16017	74	388	462
7	"7-out17510"	.15915	166	877	1043
7	"7-out17511"	.24131	125	393	518
7	"7-out17512"	.27546	265	697	962
7	"7-out17513"	.37068	43	73	116
7	"7-out17514"	.17881	157	721	878
7	"7-out17515"	.29304	80	193	273
7	"7-out17516"	.23214	78	258	336
7	"7-out17517"	.59888	215	144	359
7	"7-out17518"	.17535	37	174	211
7	"7-out17519"	.22931	219	736	955
7	"7-out17520"	.26955	255	691	946
7	"7-out17521"	.20644	141	542	683
7	"7-out17522"	.20849	108	410	518
7	"7-out17523"	.21361	91	335	426
7	"7-out17524"	.13457	72	463	535
7	"7-out17525"	.34615	27	51	78
7	"7-out17526"	.67105	51	25	76
7	"7-out17527"	.84134	350	66	416
7	"7-out17528"	.30564	298	677	975
7	"7-out17529"	.31879	307	656	963
7	"7-out17530"	.19426	210	871	1081
7	"7-out17531"	.74662	775	263	1038
7	"7-out17532"	.28158	292	745	1037
7	"7-out17533"	.89268	183	22	205
7	"7-out17534"	.81463	167	38	205
7	"7-out17535"	.36252	178	313	491
7	"7-out17536"	.18829	103	444	547
7	"7-out17537"	.20197	82	324	406
7	"7-out17538"	.33532	112	222	334
7	"7-out17539"	.74048	214	75	289
7	"7-out17540"	.91198	746	72	818
7	"7-out17541"	.17985	125	570	695
7	"7-out17542"	.27804	57	148	205
7	"7-out17543"	.45121	74	90	164
7	"7-out17544"	.25324	39	115	154
7	"7-out17545"	.47972	71	77	148
7	"7-out17546"	.23369	240	787	1027
7	"7-out17547"	.96606	484	17	501
7	"7-out17548"	.21101	249	931	1180
7	"7-out17549"	.41455	490	692	1182
7	"7-out17550"	.17561	291	1366	1657
7	"7-out17551"	.19497	318	1313	1631
7	"7-out17552"	.24333	137	426	563
7	"7-out17553"	.27180	215	576	791
7	"7-out17554"	.21644	129	467	596
7	"7-out17555"	.12307	40	285	325
7	"7-out17556"	.28037	270	693	963
7	"7-out17557"	.13505	94	602	696
7	"7-out17558"	.14431	99	587	686
7	"7-out17559"	.23429	291	951	1242
7	"7-out17560"	.33333	446	892	1338
7	"7-out17561"	.78117	307	86	393
7	"7-out17562"	.26122	128	362	490
7	"7-out17563"	.23529	20	65	85
7	"7-out17564"	.22680	22	75	97
7	"7-out17565"	.44186	38	48	86
7	"7-out17566"	.26740	96	263	359
7	"7-out17567"	.17718	132	613	745
7	"7-out17568"	.14252	61	367	428
7	"7-out17569"	.40455	231	340	571
7	"7-out17570"	.30872	92	206	298
7	"7-out17571"	.21621	120	435	555
7	"7-out17572"	.32068	93	197	290
7	"7-out17573"	.83760	98	19	117
7	"7-out17574"	.66521	153	77	230
7	"7-out17575"	.13200	73	480	553
7	"7-out17576"	.26239	90	253	343
7	"7-out17577"	.32100	217	459	676
7	"7-out17578"	.91452	107	10	117
7	"7-out17579"	.87603	106	15	121
7	"7-out17580"	.80000	96	24	120
7	"7-out17581"	.15909	42	222	264
7	"7-out17582"	.26428	111	309	420
7	"7-out17583"	.26229	112	315	427
7	"7-out17584"	.79487	93	24	117
7	"7-out17585"	.11785	68	509	577
7	"7-out17586"	.75792	454	145	599
7	"7-out17587"	.46065	240	281	521
7	"7-out17588"	.20345	106	415	521
7	"7-out17589"	.65953	339	175	514
7	"7-out17590"	.22257	278	971	1249
7	"7-out17591"	.24539	120	369	489
7	"7-out17592"	.18694	63	274	337
7	"7-out17593"	.16883	78	384	462
7	"7-out17594"	.91833	551	49	600
7	"7-out17595"	.39644	201	306	507
7	"7-out17596"	.18699	115	500	615
7	"7-out17597"	.20899	172	651	823
7	"7-out17598"	.18590	124	543	667
7	"7-out17599"	.39597	177	270	447
7	"7-out17600"	.20850	103	391	494
7	"7-out17601"	.27741	86	224	310
7	"7-out17602"	.15511	179	975	1154
7	"7-out17603"	.19796	78	316	394
7	"7-out17604"	.54741	381	315	696
7	"7-out17605"	.27272	204	544	748
7	"7-out17606"	.21458	253	926	1179
7	"7-out17607"	.24615	288	882	1170
7	"7-out17608"	.38616	134	213	347
7	"7-out17609"	.24832	555	1680	2235
7	"7-out17610"	.42982	343	455	798
7	"7-out17611"	.19345	207	863	1070
7	"7-out17612"	.30806	317	712	1029
7	"7-out17613"	.19615	102	418	520
7	"7-out17614"	.23000	276	924	1200
7	"7-out17615"	.89393	236	28	264
7	"7-out17616"	.35087	160	296	456
7	"7-out17617"	.63297	357	207	564
7	"7-out17618"	.39579	207	316	523
7	"7-out17619"	.59855	249	167	416
7	"7-out17620"	.27579	580	1523	2103
7	"7-out17621"	.36666	198	342	540
7	"7-out17622"	.34429	199	379	578
7	"7-out17623"	.72281	339	130	469
7	"7-out17624"	.13779	35	219	254
7	"7-out17625"	.25732	79	228	307
7	"7-out17626"	.29605	135	321	456
7	"7-out17627"	.15268	131	727	858
7	"7-out17628"	.20662	106	407	513
7	"7-out17629"	.26000	130	370	500
7	"7-out17630"	.21456	380	1391	1771
7	"7-out17631"	.57509	291	215	506
7	"7-out17632"	.19704	333	1357	1690
7	"7-out17633"	.17307	72	344	416
7	"7-out17634"	.40889	193	279	472
7	"7-out17635"	.91387	191	18	209
7	"7-out17636"	.29559	94	224	318
7	"7-out17637"	.27894	306	791	1097
7	"7-out17638"	.17675	184	857	1041
7	"7-out17639"	.87804	180	25	205
7	"7-out17640"	.94554	191	11	202
7	"7-out17641"	.27910	163	421	584
7	"7-out17642"	.34130	157	303	460
7	"7-out17643"	.23209	81	268	349
7	"7-out17644"	.20177	91	360	451
7	"7-out17645"	.19678	98	400	498
7	"7-out17646"	.41200	199	284	483
7	"7-out17647"	.94573	122	7	129
7	"7-out17648"	.19658	23	94	117
7	"7-out17649"	.21711	472	1702	2174
7	"7-out17650"	.13207	28	184	212
7	"7-out17651"	.46527	67	77	144
7	"7-out17652"	.21500	43	157	200
7	"7-out17653"	.20906	286	1082	1368
7	"7-out17654"	.26865	72	196	268
7	"7-out17655"	.38356	56	90	146
7	"7-out17656"	.19287	92	385	477
7	"7-out17657"	.94276	280	17	297
7	"7-out17658"	.66282	230	117	347
7	"7-out17659"	.94064	523	33	556
7	"7-out17660"	.30121	272	631	903
7	"7-out17661"	.59834	505	339	844
7	"7-out17662"	.19732	59	240	299
7	"7-out17663"	.21140	63	235	298
7	"7-out17664"	.27377	213	565	778
7	"7-out17665"	.30237	140	323	463
7	"7-out17666"	.24468	46	142	188
7	"7-out17667"	.24271	25	78	103
7	"7-out17668"	.20725	120	459	579
7	"7-out17669"	.19272	196	821	1017
7	"7-out17670"	.15485	153	835	988
7	"7-out17671"	.26760	266	728	994
7	"7-out17672"	.19620	155	635	790
7	"7-out17673"	.21111	171	639	810
7	"7-out17674"	.65993	817	421	1238
7	"7-out17675"	.27607	45	118	163
7	"7-out17676"	.25265	286	846	1132
7	"7-out17677"	.44781	369	455	824
7	"7-out17678"	.32575	86	178	264
7	"7-out17679"	.43789	275	353	628
7	"7-out17680"	.18947	36	154	190
7	"7-out17681"	.25591	357	1038	1395
7	"7-out17682"	.20242	217	855	1072
7	"7-out17683"	.38648	223	354	577
7	"7-out17684"	.19076	372	1578	1950
7	"7-out17685"	.34391	444	847	1291
7	"7-out17686"	.94663	745	42	787
7	"7-out17687"	.80897	1461	345	1806
7	"7-out17688"	.27677	354	925	1279
7	"7-out17689"	.56703	406	310	716
7	"7-out17690"	.31623	148	320	468
7	"7-out17691"	.26724	124	340	464
7	"7-out17692"	.20649	89	342	431
7	"7-out17693"	.24558	153	470	623
7	"7-out17694"	.88485	561	73	634
7	"7-out17695"	.31026	139	309	448
7	"7-out17696"	.44357	283	355	638
7	"7-out17697"	.31034	171	380	551
7	"7-out17698"	.28846	150	370	520
7	"7-out17699"	.25981	139	396	535
7	"7-out17700"	.25513	87	254	341
7	"7-out17701"	.35350	222	406	628
7	"7-out17702"	.30524	163	371	534
7	"7-out17703"	.24342	74	230	304
7	"7-out17704"	.16032	80	419	499
7	"7-out17705"	.17571	55	258	313
7	"7-out17706"	.19852	54	218	272
7	"7-out17707"	.23818	126	403	529
7	"7-out17708"	.47470	122	135	257
7	"7-out17709"	.17889	78	358	436
7	"7-out17710"	.95501	276	13	289
7	"7-out17711"	.19839	173	699	872
7	"7-out17712"	.12311	49	349	398
7	"7-out17713"	.12171	51	368	419
7	"7-out17714"	.32159	274	578	852
7	"7-out17715"	.19886	210	846	1056
7	"7-out17716"	.24326	325	1011	1336
7	"7-out17717"	.17163	265	1279	1544
7	"7-out17718"	.57307	894	666	1560
7	"7-out17719"	.24893	409	1234	1643
7	"7-out17720"	.48797	142	149	291
7	"7-out17721"	.86348	253	40	293
7	"7-out17722"	.16618	231	1159	1390
7	"7-out17723"	.10896	62	507	569
7	"7-out17724"	.60079	304	202	506
7	"7-out17725"	.28473	125	314	439
7	"7-out17726"	.64507	478	263	741
7	"7-out17727"	.20205	59	233	292
7	"7-out17728"	.25824	94	270	364
7	"7-out17729"	.28215	215	547	762
7	"7-out17730"	.89075	106	13	119
7	"7-out17731"	.33044	191	387	578
7	"7-out17732"	.21921	219	780	999
7	"7-out17733"	.86440	102	16	118
7	"7-out17734"	.92436	110	9	119
7	"7-out17735"	.10932	34	277	311
7	"7-out17736"	.25268	94	278	372
7	"7-out17737"	.12841	47	319	366
7	"7-out17738"	.25257	49	145	194
7	"7-out17739"	.14025	54	331	385
7	"7-out17740"	.56763	235	179	414
7	"7-out17741"	.57142	92	69	161
7	"7-out17742"	.34977	78	145	223
7	"7-out17743"	.95272	524	26	550
7	"7-out17744"	.32924	215	438	653
7	"7-out17745"	.39102	61	95	156
7	"7-out17746"	.33118	411	830	1241
7	"7-out17747"	.89610	207	24	231
7	"7-out17748"	.14400	18	107	125
7	"7-out17749"	.54065	133	113	246
7	"7-out17750"	.49299	387	398	785
7	"7-out17751"	.31081	46	102	148
7	"7-out17752"	.94294	314	19	333
7	"7-out17753"	.27301	86	229	315
7	"7-out17754"	.89542	137	16	153
7	"7-out17755"	.42908	239	318	557
7	"7-out17756"	.14062	27	165	192
7	"7-out17757"	.19642	55	225	280
7	"7-out17758"	.47887	68	74	142
7	"7-out17759"	.18875	47	202	249
7	"7-out17760"	.11851	16	119	135
7	"7-out17761"	.45081	110	134	244
7	"7-out17762"	.31353	95	208	303
7	"7-out17763"	.26450	278	773	1051
7	"7-out17764"	.17087	203	985	1188
7	"7-out17765"	.25507	201	587	788
7	"7-out17766"	.26371	298	832	1130
7	"7-out17767"	.22900	120	404	524
7	"7-out17768"	.29978	140	327	467
7	"7-out17769"	.25248	127	376	503
7	"7-out17770"	.20892	89	337	426
7	"7-out17771"	.27291	131	349	480
7	"7-out17772"	.17879	86	395	481
7	"7-out17773"	.29281	53	128	181
7	"7-out17774"	.16693	104	519	623
7	"7-out17775"	.19282	86	360	446
7	"7-out17776"	.72077	111	43	154
7	"7-out17777"	.29938	147	344	491
7	"7-out17778"	.22283	1247	4349	5596
7	"7-out17779"	.27500	22	58	80
7	"7-out17780"	.94545	156	9	165
7	"7-out17781"	.12707	23	158	181
7	"7-out17782"	.12320	43	306	349
7	"7-out17783"	.27578	353	927	1280
7	"7-out17784"	.72164	70	27	97
7	"7-out17785"	.51428	72	68	140
7	"7-out17786"	.95121	195	10	205
7	"7-out17787"	.36141	163	288	451
7	"7-out17788"	.95299	223	11	234
7	"7-out17789"	.66058	181	93	274
7	"7-out17790"	.70949	254	104	358
7	"7-out17791"	.18918	35	150	185
7	"7-out17792"	.20375	76	297	373
7	"7-out17793"	.84979	1850	327	2177
7	"7-out17794"	.93833	350	23	373
7	"7-out17795"	.53846	238	204	442
7	"7-out17796"	.64266	241	134	375
7	"7-out17797"	.13056	85	566	651
7	"7-out17798"	.30333	182	418	600
7	"7-out17799"	.15558	131	711	842
7	"7-out17800"	.19129	233	985	1218
7	"7-out17801"	.29645	753	1787	2540
7	"7-out17802"	.20579	213	822	1035
7	"7-out17803"	.58311	677	484	1161
7	"7-out17804"	.46753	72	82	154
7	"7-out17805"	.20572	237	915	1152
7	"7-out17806"	.21564	226	822	1048
7	"7-out17807"	.35507	49	89	138
7	"7-out17808"	.98000	245	5	250
7	"7-out17809"	.32952	317	645	962
7	"7-out17810"	.32029	131	278	409
7	"7-out17811"	.36597	142	246	388
7	"7-out17812"	.89743	105	12	117
7	"7-out17813"	.88135	104	14	118
7	"7-out17814"	.38144	74	120	194
7	"7-out17815"	.92666	139	11	150
7	"7-out17816"	.35454	39	71	110
7	"7-out17817"	.94017	110	7	117
7	"7-out17818"	.90000	126	14	140
7	"7-out17819"	.13333	22	143	165
7	"7-out17820"	.21320	197	727	924
7	"7-out17821"	.62447	148	89	237
7	"7-out17822"	.23816	156	499	655
7	"7-out17823"	.32524	737	1529	2266
7	"7-out17824"	.72199	709	273	982
7	"7-out17825"	.29611	61	145	206
7	"7-out17826"	.27085	276	743	1019
7	"7-out17827"	.14285	17	102	119
7	"7-out17828"	.55172	64	52	116
7	"7-out17829"	.66519	151	76	227
7	"7-out17830"	.29955	68	159	227
7	"7-out17831"	.52544	382	345	727
7	"7-out17832"	.68911	399	180	579
7	"7-out17833"	.19021	35	149	184
7	"7-out17834"	.22524	116	399	515
7	"7-out17835"	.18123	282	1274	1556
7	"7-out17836"	.25971	147	419	566
7	"7-out17837"	.43511	57	74	131
7	"7-out17838"	.31654	44	95	139
7	"7-out17839"	.71250	114	46	160
7	"7-out17840"	.18541	122	536	658
7	"7-out17841"	.70301	677	286	963
7	"7-out17842"	.20215	206	813	1019
7	"7-out17843"	.26751	252	690	942
7	"7-out17844"	.15117	161	904	1065
7	"7-out17845"	.23263	499	1646	2145
7	"7-out17846"	.29526	212	506	718
7	"7-out17847"	.89268	183	22	205
7	"7-out17848"	.62541	374	224	598
7	"7-out17849"	.21888	102	364	466
7	"7-out17850"	.10280	11	96	107
7	"7-out17851"	.35220	56	103	159
7	"7-out17852"	.24041	69	218	287
7	"7-out17853"	.17030	164	799	963
7	"7-out17854"	.42137	627	861	1488
7	"7-out17855"	.21460	338	1237	1575
7	"7-out17856"	.41463	34	48	82
7	"7-out17857"	.88904	633	79	712
7	"7-out17858"	.21600	135	490	625
7	"7-out17859"	.21416	124	455	579
7	"7-out17860"	.13569	176	1121	1297
7	"7-out17861"	.14471	200	1182	1382
7	"7-out17862"	.23703	32	103	135
7	"7-out17863"	.33333	71	142	213
7	"7-out17864"	.23588	284	920	1204
7	"7-out17865"	.17990	394	1796	2190
7	"7-out17866"	.61880	362	223	585
7	"7-out17867"	.30030	300	699	999
7	"7-out17868"	.70165	127	54	181
7	"7-out17869"	.17670	44	205	249
7	"7-out17870"	.13157	40	264	304
7	"7-out17871"	.28774	101	250	351
7	"7-out17872"	.21990	486	1724	2210
7	"7-out17873"	.93442	399	28	427
7	"7-out17874"	.33121	156	315	471
7	"7-out17875"	.28798	362	895	1257
7	"7-out17876"	.45109	226	275	501
7	"7-out17877"	.69749	362	157	519
7	"7-out17878"	.29411	210	504	714
7	"7-out17879"	.22195	273	957	1230
7	"7-out17880"	.25925	126	360	486
7	"7-out17881"	.15207	99	552	651
7	"7-out17882"	.10096	21	187	208
7	"7-out17883"	.14484	229	1352	1581
7	"7-out17884"	.23846	93	297	390
7	"7-out17885"	.21764	74	266	340
7	"7-out17886"	.20903	236	893	1129
7	"7-out17887"	.36258	281	494	775
7	"7-out17888"	.88812	643	81	724
7	"7-out17889"	.53042	340	301	641
7	"7-out17890"	.60765	254	164	418
7	"7-out17891"	.21231	100	371	471
7	"7-out17892"	.94957	113	6	119
7	"7-out17893"	.86324	101	16	117
7	"7-out17894"	.88888	104	13	117
7	"7-out17895"	.21926	66	235	301
7	"7-out17896"	.83760	98	19	117
7	"7-out17897"	.31515	104	226	330
7	"7-out17898"	.23875	138	440	578
7	"7-out17899"	.18064	28	127	155
7	"7-out17900"	.30241	75	173	248
7	"7-out17901"	.47592	168	185	353
7	"7-out17902"	.72000	90	35	125
7	"7-out17903"	.69924	93	40	133
7	"7-out17904"	.47189	277	310	587
7	"7-out17905"	.58091	280	202	482
7	"7-out17906"	.39705	108	164	272
7	"7-out17907"	.26248	452	1270	1722
7	"7-out17908"	.30508	216	492	708
7	"7-out17909"	.23000	92	308	400
7	"7-out17910"	.45150	135	164	299
7	"7-out17911"	.24546	149	458	607
7	"7-out17912"	.40952	129	186	315
7	"7-out17913"	.18859	43	185	228
7	"7-out17914"	.84126	159	30	189
7	"7-out17915"	.83597	158	31	189
7	"7-out17916"	.88359	167	22	189
7	"7-out17917"	.23529	44	143	187
7	"7-out17918"	.37542	223	371	594
7	"7-out17919"	.77000	154	46	200
7	"7-out17920"	.84693	166	30	196
7	"7-out17921"	.88826	159	20	179
7	"7-out17922"	.41772	198	276	474
7	"7-out17923"	.11111	16	128	144
7	"7-out17924"	.24570	200	614	814
7	"7-out17925"	.09948	136	1231	1367
7	"7-out17926"	.94354	117	7	124
7	"7-out17927"	.17665	221	1030	1251
7	"7-out17928"	.90625	348	36	384
7	"7-out17929"	.26415	42	117	159
7	"7-out17930"	.90566	96	10	106
7	"7-out17931"	.75586	161	52	213
7	"7-out17932"	.80697	301	72	373
7	"7-out17933"	.19933	180	723	903
7	"7-out17934"	.22395	43	149	192
7	"7-out17935"	.18488	247	1089	1336
7	"7-out17936"	.65577	783	411	1194
7	"7-out17937"	.32186	131	276	407
7	"7-out17938"	.87840	419	58	477
7	"7-out17939"	.26060	215	610	825
7	"7-out17940"	.30065	46	107	153
7	"7-out17941"	.25555	46	134	180
7	"7-out17942"	.23148	125	415	540
7	"7-out17943"	.13711	58	365	423
7	"7-out17944"	.16498	98	496	594
7	"7-out17945"	.49218	189	195	384
7	"7-out17946"	.32793	81	166	247
7	"7-out17947"	.33164	131	264	395
7	"7-out17948"	.92361	133	11	144
7	"7-out17949"	.28928	162	398	560
7	"7-out17950"	.18500	37	163	200
7	"7-out17951"	.29745	199	470	669
7	"7-out17952"	.35526	108	196	304
7	"7-out17953"	.93518	101	7	108
7	"7-out17954"	.15789	111	592	703
7	"7-out17955"	.17525	34	160	194
7	"7-out17956"	.14932	33	188	221
7	"7-out17957"	.09734	22	204	226
7	"7-out17958"	.94017	110	7	117
7	"7-out17959"	.94017	110	7	117
7	"7-out17960"	.31089	97	215	312
7	"7-out17961"	.93232	675	49	724
7	"7-out17962"	.37861	131	215	346
7	"7-out17963"	.59183	145	100	245
7	"7-out17964"	.47058	72	81	153
7	"7-out17965"	.21374	339	1247	1586
7	"7-out17966"	.13533	36	230	266
7	"7-out17967"	.17903	111	509	620
7	"7-out17968"	.28800	36	89	125
7	"7-out17969"	.92638	302	24	326
7	"7-out17970"	.74626	250	85	335
7	"7-out17971"	.20253	32	126	158
7	"7-out17972"	.95121	156	8	164
7	"7-out17973"	.80188	85	21	106
7	"7-out17974"	.95767	362	16	378
7	"7-out17975"	.10482	63	538	601
7	"7-out17976"	.20714	87	333	420
7	"7-out17977"	.61002	560	358	918
7	"7-out17978"	.20039	102	407	509
7	"7-out17979"	.19389	89	370	459
7	"7-out17980"	.30303	30	69	99
7	"7-out17981"	.20833	30	114	144
7	"7-out17982"	.23809	130	416	546
7	"7-out17983"	.28638	183	456	639
7	"7-out17984"	.22704	89	303	392
7	"7-out17985"	.53025	184	163	347
7	"7-out17986"	.28317	207	524	731
7	"7-out17987"	.35166	211	389	600
7	"7-out17988"	.22298	194	676	870
7	"7-out17989"	.92238	309	26	335
7	"7-out17990"	.18157	69	311	380
7	"7-out17991"	.26502	322	893	1215
7	"7-out17992"	.45748	226	268	494
7	"7-out17993"	.24929	88	265	353
7	"7-out17994"	.49112	166	172	338
7	"7-out17995"	.47772	193	211	404
7	"7-out17996"	.24624	82	251	333
7	"7-out17997"	.45710	325	386	711
7	"7-out17998"	.24082	105	331	436
7	"7-out17999"	.40980	209	301	510
7	"7-out18000"	.12394	117	827	944
7	"7-out18001"	.32265	282	592	874
7	"7-out18002"	.16932	53	260	313
7	"7-out18003"	.53268	220	193	413
7	"7-out18004"	.55978	206	162	368
7	"7-out18005"	.05714	4	66	70
7	"7-out18006"	.74324	440	152	592
7	"7-out18007"	.54843	351	289	640
7	"7-out18008"	.15011	68	385	453
7	"7-out18009"	.20895	14	53	67
7	"7-out18010"	.08114	37	419	456
7	"7-out18011"	.12695	65	447	512
7	"7-out18012"	.58194	980	704	1684
7	"7-out18013"	.31137	104	230	334
7	"7-out18014"	.33668	67	132	199
7	"7-out18015"	.19565	36	148	184
7	"7-out18016"	.18435	33	146	179
7	"7-out18017"	.27184	56	150	206
7	"7-out18018"	.16384	29	148	177
7	"7-out18019"	.48908	112	117	229
7	"7-out18020"	.18818	86	371	457
7	"7-out18021"	.66863	113	56	169
7	"7-out18022"	.74162	155	54	209
7	"7-out18023"	.23717	111	357	468
7	"7-out18024"	.91746	478	43	521
7	"7-out18025"	.26912	102	277	379
7	"7-out18026"	.08185	37	415	452
7	"7-out18027"	.94604	526	30	556
7	"7-out18028"	.13217	76	499	575
7	"7-out18029"	.50921	221	213	434
7	"7-out18030"	.13812	75	468	543
7	"7-out18031"	.17313	58	277	335
7	"7-out18032"	.79969	1050	263	1313
7	"7-out18033"	.27653	99	259	358
7	"7-out18034"	.16812	115	569	684
7	"7-out18035"	.28750	46	114	160
7	"7-out18036"	.16528	40	202	242
7	"7-out18037"	.27419	68	180	248
7	"7-out18038"	.35221	659	1212	1871
7	"7-out18039"	.89675	304	35	339
7	"7-out18040"	.18284	113	505	618
7	"7-out18041"	.45312	261	315	576
7	"7-out18042"	.38613	468	744	1212
7	"7-out18043"	.22813	120	406	526
7	"7-out18044"	.35590	247	447	694
7	"7-out18045"	.96696	644	22	666
7	"7-out18046"	.13059	35	233	268
7	"7-out18047"	.20342	95	372	467
7	"7-out18048"	.29885	104	244	348
7	"7-out18049"	.10666	8	67	75
7	"7-out18050"	.18341	73	325	398
7	"7-out18051"	.10606	35	295	330
7	"7-out18052"	.26086	270	765	1035
7	"7-out18053"	.19195	62	261	323
7	"7-out18054"	.21698	115	415	530
7	"7-out18055"	.26142	103	291	394
7	"7-out18056"	.13095	11	73	84
7	"7-out18057"	.29673	100	237	337
7	"7-out18058"	.89908	98	11	109
7	"7-out18059"	.94011	628	40	668
7	"7-out18060"	.19893	300	1208	1508
7	"7-out18061"	.29698	128	303	431
7	"7-out18062"	.21753	67	241	308
7	"7-out18063"	.90625	145	15	160
7	"7-out18064"	.27007	111	300	411
7	"7-out18065"	.31144	185	409	594
7	"7-out18066"	.15550	72	391	463
7	"7-out18067"	.17981	57	260	317
7	"7-out18068"	.17681	90	419	509
7	"7-out18069"	.86934	173	26	199
7	"7-out18070"	.25570	56	163	219
7	"7-out18071"	.23780	78	250	328
7	"7-out18072"	.39506	64	98	162
7	"7-out18073"	.03225	5	150	155
7	"7-out18074"	.26424	51	142	193
7	"7-out18075"	.16384	29	148	177
7	"7-out18076"	.35964	205	365	570
7	"7-out18077"	.23985	65	206	271
7	"7-out18078"	.39240	217	336	553
7	"7-out18079"	.31568	167	362	529
7	"7-out18080"	.20817	56	213	269
7	"7-out18081"	.23026	35	117	152
7	"7-out18082"	.31985	182	387	569
7	"7-out18083"	.21468	38	139	177
7	"7-out18084"	.14204	25	151	176
7	"7-out18085"	.18401	99	439	538
7	"7-out18086"	.35672	61	110	171
7	"7-out18087"	.28676	78	194	272
7	"7-out18088"	.68157	381	178	559
7	"7-out18089"	.96205	355	14	369
7	"7-out18090"	.12837	38	258	296
7	"7-out18091"	.67210	412	201	613
7	"7-out18092"	.23197	148	490	638
7	"7-out18093"	.15384	60	330	390
7	"7-out18094"	.45934	226	266	492
7	"7-out18095"	.93421	213	15	228
7	"7-out18096"	.92424	122	10	132
7	"7-out18097"	.84126	159	30	189
7	"7-out18098"	.90476	171	18	189
7	"7-out18099"	.92592	175	14	189
7	"7-out18100"	.22660	92	314	406
7	"7-out18101"	.33734	56	110	166
7	"7-out18102"	.85500	171	29	200
7	"7-out18103"	.19068	86	365	451
7	"7-out18104"	.25000	76	228	304
7	"7-out18105"	.36982	250	426	676
7	"7-out18106"	.27692	54	141	195
7	"7-out18107"	.63888	115	65	180
7	"7-out18108"	.28169	100	255	355
7	"7-out18109"	.78571	264	72	336
7	"7-out18110"	.27149	60	161	221
7	"7-out18111"	.25862	75	215	290
7	"7-out18112"	.46747	115	131	246
7	"7-out18113"	.13389	79	511	590
7	"7-out18114"	.20806	191	727	918
7	"7-out18115"	.75369	153	50	203
7	"7-out18116"	.20525	125	484	609
7	"7-out18117"	.69777	157	68	225
7	"7-out18118"	.23754	248	796	1044
7	"7-out18119"	.25043	431	1290	1721
7	"7-out18120"	.26008	116	330	446
7	"7-out18121"	.32552	278	576	854
7	"7-out18122"	.30061	49	114	163
7	"7-out18123"	.92361	133	11	144
7	"7-out18124"	.08469	31	335	366
7	"7-out18125"	.18598	69	302	371
7	"7-out18126"	.29310	153	369	522
7	"7-out18127"	.19053	145	616	761
7	"7-out18128"	.40540	120	176	296
7	"7-out18129"	.42937	76	101	177
7	"7-out18130"	.59230	231	159	390
7	"7-out18131"	.11968	107	787	894
7	"7-out18132"	.41666	50	70	120
7	"7-out18133"	.61356	1375	866	2241
7	"7-out18134"	.31884	44	94	138
7	"7-out18135"	.14558	61	358	419
7	"7-out18136"	.27446	129	341	470
7	"7-out18137"	.93700	476	32	508
7	"7-out18138"	.42036	256	353	609
7	"7-out18139"	.23464	191	623	814
7	"7-out18140"	.38271	31	50	81
7	"7-out18141"	.14426	44	261	305
7	"7-out18142"	.28787	133	329	462
7	"7-out18143"	.12287	65	464	529
7	"7-out18144"	.17006	100	488	588
7	"7-out18145"	.14379	131	780	911
7	"7-out18146"	.68498	648	298	946
7	"7-out18147"	.17528	156	734	890
7	"7-out18148"	.18064	168	762	930
7	"7-out18149"	.19570	82	337	419
7	"7-out18150"	.21270	77	285	362
7	"7-out18151"	.14193	88	532	620
7	"7-out18152"	.33928	114	222	336
7	"7-out18153"	.45367	142	171	313
7	"7-out18154"	.83050	98	20	118
7	"7-out18155"	.13914	75	464	539
7	"7-out18156"	.23478	81	264	345
7	"7-out18157"	.92970	529	40	569
7	"7-out18158"	.62142	174	106	280
7	"7-out18159"	.22706	151	514	665
7	"7-out18160"	.91705	199	18	217
7	"7-out18161"	.20958	35	132	167
7	"7-out18162"	.71487	173	69	242
7	"7-out18163"	.29867	135	317	452
7	"7-out18164"	.32541	178	369	547
7	"7-out18165"	.20754	11	42	53
7	"7-out18166"	.90566	96	10	106
7	"7-out18167"	.26836	274	747	1021
7	"7-out18168"	.25311	61	180	241
7	"7-out18169"	.15044	68	384	452
7	"7-out18170"	.18902	31	133	164
7	"7-out18171"	.20383	85	332	417
7	"7-out18172"	.26446	64	178	242
7	"7-out18173"	.23766	159	510	669
7	"7-out18174"	.43298	126	165	291
7	"7-out18175"	.19964	111	445	556
7	"7-out18176"	.19480	120	496	616
7	"7-out18177"	.25181	139	413	552
7	"7-out18178"	.16666	88	440	528
7	"7-out18179"	.16981	36	176	212
7	"7-out18180"	.26721	97	266	363
7	"7-out18181"	.74567	431	147	578
7	"7-out18182"	.21037	142	533	675
7	"7-out18183"	.20909	69	261	330
7	"7-out18184"	.18320	48	214	262
7	"7-out18185"	.13909	74	458	532
7	"7-out18186"	.11973	108	794	902
7	"7-out18187"	.17401	71	337	408
7	"7-out18188"	.09334	94	913	1007
7	"7-out18189"	.12400	109	770	879
7	"7-out18190"	.14429	115	682	797
7	"7-out18191"	.17120	107	518	625
7	"7-out18192"	.22576	198	679	877
7	"7-out18193"	.86141	317	51	368
7	"7-out18194"	.10446	96	823	919
7	"7-out18195"	.25991	236	672	908
7	"7-out18196"	.26882	257	699	956
7	"7-out18197"	.28110	61	156	217
7	"7-out18198"	.19897	195	785	980
7	"7-out18199"	.69513	472	207	679
7	"7-out18200"	.19881	537	2164	2701
7	"7-out18201"	.59593	205	139	344
7	"7-out18202"	.30208	145	335	480
7	"7-out18203"	.23809	80	256	336
7	"7-out18204"	.25044	425	1272	1697
7	"7-out18205"	.27629	415	1087	1502
7	"7-out18206"	.09469	25	239	264
7	"7-out18207"	.17087	149	723	872
7	"7-out18208"	.19169	120	506	626
7	"7-out18209"	.12362	112	794	906
7	"7-out18210"	.35317	356	652	1008
7	"7-out18211"	.24324	36	112	148
7	"7-out18212"	.91126	267	26	293
7	"7-out18213"	.12676	54	372	426
7	"7-out18214"	.64390	132	73	205
7	"7-out18215"	.35797	92	165	257
7	"7-out18216"	.21975	109	387	496
7	"7-out18217"	.27559	140	368	508
7	"7-out18218"	.58057	281	203	484
7	"7-out18219"	.93305	223	16	239
7	"7-out18220"	.21982	51	181	232
7	"7-out18221"	.21203	74	275	349
7	"7-out18222"	.40875	112	162	274
7	"7-out18223"	.21821	139	498	637
7	"7-out18224"	.80630	179	43	222
7	"7-out18225"	.20833	55	209	264
7	"7-out18226"	.87614	191	27	218
7	"7-out18227"	.94309	895	54	949
7	"7-out18228"	.21760	131	471	602
7	"7-out18229"	.24204	175	548	723
7	"7-out18230"	.11764	18	135	153
7	"7-out18231"	.19220	74	311	385
7	"7-out18232"	.23732	117	376	493
7	"7-out18233"	.91743	300	27	327
7	"7-out18234"	.29000	87	213	300
7	"7-out18235"	.18750	81	351	432
7	"7-out18236"	.38755	81	128	209
7	"7-out18237"	.53636	177	153	330
7	"7-out18238"	.17174	124	598	722
7	"7-out18239"	.42682	70	94	164
7	"7-out18240"	.12931	60	404	464
7	"7-out18241"	.19734	119	484	603
7	"7-out18242"	.18106	109	493	602
7	"7-out18243"	.22030	128	453	581
7	"7-out18244"	.24882	159	480	639
7	"7-out18245"	.25282	112	331	443
7	"7-out18246"	.30602	183	415	598
7	"7-out18247"	.28358	38	96	134
7	"7-out18248"	.67584	221	106	327
7	"7-out18249"	.32885	49	100	149
7	"7-out18250"	.20526	39	151	190
7	"7-out18251"	.06951	13	174	187
7	"7-out18252"	.16414	65	331	396
7	"7-out18253"	.21531	45	164	209
7	"7-out18254"	.91200	767	74	841
7	"7-out18255"	.40807	182	264	446
7	"7-out18256"	.74035	211	74	285
7	"7-out18257"	.32535	394	817	1211
7	"7-out18258"	.15883	142	752	894
7	"7-out18259"	.31920	113	241	354
7	"7-out18260"	.87215	880	129	1009
7	"7-out18261"	.22318	129	449	578
7	"7-out18262"	.19710	109	444	553
7	"7-out18263"	.35060	115	213	328
7	"7-out18264"	.73831	79	28	107
7	"7-out18265"	.23272	293	966	1259
7	"7-out18266"	.36473	151	263	414
7	"7-out18267"	.15010	414	2344	2758
7	"7-out18268"	.12654	338	2333	2671
7	"7-out18269"	.07291	28	356	384
7	"7-out18270"	.20740	28	107	135
7	"7-out18271"	.63492	520	299	819
7	"7-out18272"	.27980	115	296	411
7	"7-out18273"	.55186	133	108	241
7	"7-out18274"	.23417	111	363	474
7	"7-out18275"	.17695	43	200	243
7	"7-out18276"	.25179	35	104	139
7	"7-out18277"	.85871	857	141	998
7	"7-out18278"	.24324	18	56	74
7	"7-out18279"	.94197	763	47	810
7	"7-out18280"	.29522	173	413	586
7	"7-out18281"	.90990	101	10	111
7	"7-out18282"	.29666	89	211	300
7	"7-out18283"	.30065	46	107	153
7	"7-out18284"	.93370	169	12	181
7	"7-out18285"	.77149	314	93	407
7	"7-out18286"	.20262	324	1275	1599
7	"7-out18287"	.27066	429	1156	1585
7	"7-out18288"	.29032	63	154	217
7	"7-out18289"	.13656	124	784	908
7	"7-out18290"	.17214	152	731	883
7	"7-out18291"	.26644	158	435	593
7	"7-out18292"	.16080	192	1002	1194
7	"7-out18293"	.92622	226	18	244
7	"7-out18294"	.36788	181	311	492
7	"7-out18295"	.21478	61	223	284
7	"7-out18296"	.30357	34	78	112
7	"7-out18297"	.19402	39	162	201
7	"7-out18298"	.38750	93	147	240
7	"7-out18299"	.34128	229	442	671
7	"7-out18300"	.19233	502	2108	2610
7	"7-out18301"	.10772	173	1433	1606
7	"7-out18302"	.13804	217	1355	1572
7	"7-out18303"	.92548	1093	88	1181
7	"7-out18304"	.25054	346	1035	1381
7	"7-out18305"	.25298	212	626	838
7	"7-out18306"	.36097	74	131	205
7	"7-out18307"	.24020	141	446	587
7	"7-out18308"	.36298	151	265	416
7	"7-out18309"	.26954	293	794	1087
7	"7-out18310"	.28438	153	385	538
7	"7-out18311"	.34868	106	198	304
7	"7-out18312"	.57040	239	180	419
7	"7-out18313"	.24959	155	466	621
7	"7-out18314"	.10994	21	170	191
7	"7-out18315"	.79376	535	139	674
7	"7-out18316"	.56578	387	297	684
7	"7-out18317"	.34349	124	237	361
7	"7-out18318"	.50445	170	167	337
7	"7-out18319"	.51632	174	163	337
7	"7-out18320"	.13734	57	358	415
7	"7-out18321"	.15384	64	352	416
7	"7-out18322"	.16824	71	351	422
7	"7-out18323"	.44096	183	232	415
7	"7-out18324"	.12080	54	393	447
7	"7-out18325"	.15459	79	432	511
7	"7-out18326"	.22434	94	325	419
7	"7-out18327"	.19729	73	297	370
7	"7-out18328"	.15324	59	326	385
7	"7-out18329"	.21428	102	374	476
7	"7-out18330"	.21886	58	207	265
7	"7-out18331"	.15086	35	197	232
7	"7-out18332"	.15654	67	361	428
7	"7-out18333"	.17183	72	347	419
7	"7-out18334"	.14537	33	194	227
7	"7-out18335"	.18888	51	219	270
7	"7-out18336"	.19788	75	304	379
7	"7-out18337"	.16410	64	326	390
7	"7-out18338"	.33191	78	157	235
7	"7-out18339"	.64157	179	100	279
7	"7-out18340"	.27186	115	308	423
7	"7-out18341"	.36090	48	85	133
7	"7-out18342"	.20118	68	270	338
7	"7-out18343"	.09956	46	416	462
7	"7-out18344"	.35714	30	54	84
7	"7-out18345"	.42769	139	186	325
7	"7-out18346"	.27376	72	191	263
7	"7-out18347"	.34962	93	173	266
7	"7-out18348"	.26966	72	195	267
7	"7-out18349"	.12500	21	147	168
7	"7-out18350"	.19875	96	387	483
7	"7-out18351"	.10164	68	601	669
7	"7-out18352"	.94594	140	8	148
7	"7-out18353"	.76612	380	116	496
7	"7-out18354"	.27016	134	362	496
7	"7-out18355"	.83259	189	38	227
7	"7-out18356"	.95515	213	10	223
7	"7-out18357"	.47186	327	366	693
7	"7-out18358"	.39784	37	56	93
7	"7-out18359"	.45499	278	333	611
7	"7-out18360"	.29891	55	129	184
7	"7-out18361"	.16216	42	217	259
7	"7-out18362"	.10756	27	224	251
7	"7-out18363"	.18024	219	996	1215
7	"7-out18364"	.18697	178	774	952
7	"7-out18365"	.26016	224	637	861
7	"7-out18366"	.15924	161	850	1011
7	"7-out18367"	.95263	543	27	570
7	"7-out18368"	.05291	10	179	189
7	"7-out18369"	.18181	44	198	242
7	"7-out18370"	.19531	125	515	640
7	"7-out18371"	.26938	132	358	490
7	"7-out18372"	.22522	150	516	666
7	"7-out18373"	.13827	69	430	499
7	"7-out18374"	.13620	76	482	558
7	"7-out18375"	.34890	112	209	321
7	"7-out18376"	.23004	98	328	426
7	"7-out18377"	.13333	66	429	495
7	"7-out18378"	.20000	115	460	575
7	"7-out18379"	.12825	64	435	499
7	"7-out18380"	.22551	76	261	337
7	"7-out18381"	.23540	125	406	531
7	"7-out18382"	.96302	599	23	622
7	"7-out18383"	.22170	288	1011	1299
7	"7-out18384"	.46869	292	331	623
7	"7-out18385"	.11600	29	221	250
7	"7-out18386"	.17325	57	272	329
7	"7-out18387"	.15217	161	897	1058
7	"7-out18388"	.85258	775	134	909
7	"7-out18389"	.83275	478	96	574
7	"7-out18390"	.31748	207	445	652
7	"7-out18391"	.31812	265	568	833
7	"7-out18392"	.17985	75	342	417
7	"7-out18393"	.92727	102	8	110
7	"7-out18394"	.96638	115	4	119
7	"7-out18395"	.90368	319	34	353
7	"7-out18396"	.90000	306	34	340
7	"7-out18397"	.93633	353	24	377
7	"7-out18398"	.95143	431	22	453
7	"7-out18399"	.89622	95	11	106
7	"7-out18400"	.21627	101	366	467
7	"7-out18401"	.29073	91	222	313
7	"7-out18402"	.20086	93	370	463
7	"7-out18403"	.22784	126	427	553
7	"7-out18404"	.13684	39	246	285
7	"7-out18405"	.72666	109	41	150
7	"7-out18406"	.92307	84	7	91
7	"7-out18407"	.21910	78	278	356
7	"7-out18408"	.26517	83	230	313
7	"7-out18409"	.07707	40	479	519
7	"7-out18410"	.15209	80	446	526
7	"7-out18411"	.21875	28	100	128
7	"7-out18412"	.10427	61	524	585
7	"7-out18413"	.21241	89	330	419
7	"7-out18414"	.30898	55	123	178
7	"7-out18415"	.92307	72	6	78
7	"7-out18416"	.20547	30	116	146
7	"7-out18417"	.18168	242	1090	1332
7	"7-out18418"	.39444	71	109	180
7	"7-out18419"	.21319	42	155	197
7	"7-out18420"	.53465	108	94	202
7	"7-out18421"	.12883	21	142	163
7	"7-out18422"	.32532	176	365	541
7	"7-out18423"	.68354	378	175	553
7	"7-out18424"	.30653	122	276	398
7	"7-out18425"	.23870	37	118	155
7	"7-out18426"	.20634	39	150	189
7	"7-out18427"	.25596	161	468	629
7	"7-out18428"	.83539	203	40	243
7	"7-out18429"	.29038	160	391	551
7	"7-out18430"	.18954	29	124	153
7	"7-out18431"	.66878	105	52	157
7	"7-out18432"	.20218	148	584	732
7	"7-out18433"	.79487	186	48	234
7	"7-out18434"	.32222	87	183	270
7	"7-out18435"	.20724	103	394	497
7	"7-out18436"	.94954	207	11	218
7	"7-out18437"	.27090	243	654	897
7	"7-out18438"	.23684	36	116	152
7	"7-out18439"	.31698	84	181	265
7	"7-out18440"	.24506	149	459	608
7	"7-out18441"	.16487	92	466	558
7	"7-out18442"	.22899	139	468	607
7	"7-out18443"	.16477	87	441	528
7	"7-out18444"	.16000	84	441	525
7	"7-out18445"	.34629	187	353	540
7	"7-out18446"	.16276	313	1610	1923
7	"7-out18447"	.13824	30	187	217
7	"7-out18448"	.23711	46	148	194
7	"7-out18449"	.20677	403	1546	1949
7	"7-out18450"	.80824	843	200	1043
7	"7-out18451"	.26851	116	316	432
7	"7-out18452"	.19021	35	149	184
7	"7-out18453"	.85135	189	33	222
7	"7-out18454"	.86936	193	29	222
7	"7-out18455"	.93032	227	17	244
7	"7-out18456"	.40952	86	124	210
7	"7-out18457"	.27905	329	850	1179
7	"7-out18458"	.47549	456	503	959
7	"7-out18459"	.97083	233	7	240
7	"7-out18460"	.94099	893	56	949
7	"7-out18461"	.21382	133	489	622
7	"7-out18462"	.18194	131	589	720
7	"7-out18463"	.91279	471	45	516
7	"7-out18464"	.32600	623	1288	1911
7	"7-out18465"	.22246	101	353	454
7	"7-out18466"	.91122	544	53	597
7	"7-out18467"	.71776	295	116	411
7	"7-out18468"	.40157	102	152	254
7	"7-out18469"	.33656	139	274	413
7	"7-out18470"	.19753	96	390	486
7	"7-out18471"	.22768	472	1601	2073
7	"7-out18472"	.19282	129	540	669
7	"7-out18473"	.22283	121	422	543
7	"7-out18474"	.25409	124	364	488
7	"7-out18475"	.22546	85	292	377
7	"7-out18476"	.28865	224	552	776
7	"7-out18477"	.25643	498	1444	1942
7	"7-out18478"	.29700	327	774	1101
7	"7-out18479"	.21212	98	364	462
7	"7-out18480"	.25757	34	98	132
7	"7-out18481"	.14173	54	327	381
7	"7-out18482"	.87341	621	90	711
7	"7-out18483"	.46428	39	45	84
7	"7-out18484"	.42222	95	130	225
7	"7-out18485"	.87155	190	28	218
7	"7-out18486"	.24186	119	373	492
7	"7-out18487"	.22367	240	833	1073
7	"7-out18488"	.32057	67	142	209
7	"7-out18489"	.37230	121	204	325
7	"7-out18490"	.21568	55	200	255
7	"7-out18491"	.13827	69	430	499
7	"7-out18492"	.16346	119	609	728
7	"7-out18493"	.13553	164	1046	1210
7	"7-out18494"	.25760	127	366	493
7	"7-out18495"	.16519	168	849	1017
7	"7-out18496"	.16371	37	189	226
7	"7-out18497"	.29552	185	441	626
7	"7-out18498"	.25042	149	446	595
7	"7-out18499"	.17525	34	160	194
7	"7-out18500"	.80192	417	103	520
7	"7-out18501"	.16375	75	383	458
7	"7-out18502"	.19465	102	422	524
7	"7-out18503"	.17964	30	137	167
7	"7-out18504"	.21256	115	426	541
7	"7-out18505"	.15370	83	457	540
7	"7-out18506"	.23131	130	432	562
7	"7-out18507"	.16075	77	402	479
7	"7-out18508"	.84573	307	56	363
7	"7-out18509"	.18007	47	214	261
7	"7-out18510"	.21685	193	697	890
7	"7-out18511"	.18483	78	344	422
7	"7-out18512"	.19860	398	1606	2004
7	"7-out18513"	.31277	142	312	454
7	"7-out18514"	.17758	84	389	473
7	"7-out18515"	.18092	55	249	304
7	"7-out18516"	.40654	298	435	733
7	"7-out18517"	.94845	92	5	97
7	"7-out18518"	.93396	99	7	106
7	"7-out18519"	.22926	152	511	663
7	"7-out18520"	.14285	33	198	231
7	"7-out18521"	.14326	50	299	349
7	"7-out18522"	.18164	194	874	1068
7	"7-out18523"	.18800	47	203	250
7	"7-out18524"	.55658	241	192	433
7	"7-out18525"	.17222	62	298	360
7	"7-out18526"	.13532	59	377	436
7	"7-out18527"	.17866	67	308	375
7	"7-out18528"	.17224	72	346	418
7	"7-out18529"	.59584	258	175	433
7	"7-out18530"	.24352	301	935	1236
7	"7-out18531"	.15706	30	161	191
7	"7-out18532"	.14285	30	180	210
7	"7-out18533"	.28498	112	281	393
7	"7-out18534"	.19498	70	289	359
7	"7-out18535"	.62280	71	43	114
7	"7-out18536"	.32818	255	522	777
7	"7-out18537"	.24951	129	388	517
7	"7-out18538"	.80710	159	38	197
7	"7-out18539"	.22085	36	127	163
7	"7-out18540"	.18154	61	275	336
7	"7-out18541"	.07575	10	122	132
7	"7-out18542"	.14285	100	600	700
7	"7-out18543"	.16233	100	516	616
7	"7-out18544"	.91911	125	11	136
7	"7-out18545"	.96901	344	11	355
7	"7-out18546"	.22093	38	134	172
7	"7-out18547"	.17391	92	437	529
7	"7-out18548"	.75471	80	26	106
7	"7-out18549"	.76984	97	29	126
7	"7-out18550"	.61173	219	139	358
7	"7-out18551"	.88728	307	39	346
7	"7-out18552"	.88461	299	39	338
7	"7-out18553"	.86740	314	48	362
7	"7-out18554"	.22995	109	365	474
7	"7-out18555"	.82926	34	7	41
7	"7-out18556"	.79166	19	5	24
7	"7-out18557"	.70370	19	8	27
7	"7-out18558"	.14580	92	539	631
7	"7-out18559"	.39638	285	434	719
7	"7-out18560"	.15012	59	334	393
7	"7-out18561"	.88793	309	39	348
7	"7-out18562"	.13074	37	246	283
7	"7-out18563"	.20734	192	734	926
7	"7-out18564"	.19230	50	210	260
7	"7-out18565"	.21621	64	232	296
7	"7-out18566"	.34756	114	214	328
7	"7-out18567"	.20863	116	440	556
7	"7-out18568"	.28985	120	294	414
7	"7-out18569"	.17171	17	82	99
7	"7-out18570"	.34656	227	428	655
7	"7-out18571"	.08430	101	1097	1198
7	"7-out18572"	.97191	346	10	356
7	"7-out18573"	.59649	34	23	57
7	"7-out18574"	.21428	39	143	182
7	"7-out18575"	.52941	27	24	51
7	"7-out18576"	.88468	1005	131	1136
7	"7-out18577"	.33699	92	181	273
7	"7-out18578"	.28301	90	228	318
7	"7-out18579"	.45023	190	232	422
7	"7-out18580"	.29333	88	212	300
7	"7-out18581"	.94017	110	7	117
7	"7-out18582"	.94017	110	7	117
7	"7-out18583"	.94017	110	7	117
7	"7-out18584"	.24820	173	524	697
7	"7-out18585"	.37158	136	230	366
7	"7-out18586"	.34276	218	418	636
7	"7-out18587"	.81773	332	74	406
7	"7-out18588"	.18676	79	344	423
7	"7-out18589"	.94666	213	12	225
7	"7-out18590"	.94954	207	11	218
7	"7-out18591"	.17908	125	573	698
7	"7-out18592"	.93030	307	23	330
7	"7-out18593"	.93883	307	20	327
7	"7-out18594"	.87735	93	13	106
7	"7-out18595"	.28450	268	674	942
7	"7-out18596"	.68093	175	82	257
7	"7-out18597"	.19459	72	298	370
7	"7-out18598"	.20814	46	175	221
7	"7-out18599"	.95020	229	12	241
7	"7-out18600"	.85135	189	33	222
7	"7-out18601"	.90697	156	16	172
7	"7-out18602"	.28668	127	316	443
7	"7-out18603"	.23663	208	671	879
7	"7-out18604"	.17503	129	608	737
7	"7-out18605"	.16153	21	109	130
7	"7-out18606"	.11538	15	115	130
7	"7-out18607"	.10937	14	114	128
7	"7-out18608"	.10852	14	115	129
7	"7-out18609"	.14615	19	111	130
7	"7-out18610"	.90434	104	11	115
7	"7-out18611"	.16129	60	312	372
7	"7-out18612"	.65625	84	44	128
7	"7-out18613"	.33333	42	84	126
7	"7-out18614"	.34920	44	82	126
7	"7-out18615"	.36507	46	80	126
7	"7-out18616"	.36507	46	80	126
7	"7-out18617"	.34920	44	82	126
7	"7-out18618"	.34920	44	82	126
7	"7-out18619"	.42857	54	72	126
7	"7-out18620"	.05147	7	129	136
7	"7-out18621"	.20588	28	108	136
7	"7-out18622"	.10294	14	122	136
7	"7-out18623"	.58275	169	121	290
7	"7-out18624"	.24894	296	893	1189
7	"7-out18625"	.19189	71	299	370
7	"7-out18626"	.50974	183	176	359
7	"7-out18627"	.20380	75	293	368
7	"7-out18628"	.24390	100	310	410
7	"7-out18629"	.91549	130	12	142
7	"7-out18630"	.90845	129	13	142
7	"7-out18631"	.88018	191	26	217
7	"7-out18632"	.24044	107	338	445
7	"7-out18633"	.30449	88	201	289
7	"7-out18634"	.19720	240	977	1217
7	"7-out18635"	.11714	41	309	350
7	"7-out18636"	.20814	46	175	221
7	"7-out18637"	.62208	293	178	471
7	"7-out18638"	.19047	80	340	420
7	"7-out18639"	.16587	105	528	633
7	"7-out18640"	.95871	209	9	218
7	"7-out18641"	.90441	123	13	136
7	"7-out18642"	.30749	119	268	387
7	"7-out18643"	.24351	122	379	501
7	"7-out18644"	.18638	115	502	617
7	"7-out18645"	.26205	125	352	477
7	"7-out18646"	.18495	204	899	1103
7	"7-out18647"	.27916	67	173	240
7	"7-out18648"	.91338	232	22	254
7	"7-out18649"	.63636	280	160	440
7	"7-out18650"	.25316	180	531	711
7	"7-out18651"	.11162	24	191	215
7	"7-out18652"	.15492	33	180	213
7	"7-out18653"	.09589	21	198	219
7	"7-out18654"	.15686	40	215	255
7	"7-out18655"	.93814	91	6	97
7	"7-out18656"	.18622	73	319	392
7	"7-out18657"	.12977	17	114	131
7	"7-out18658"	.14615	19	111	130
7	"7-out18659"	.10000	13	117	130
7	"7-out18660"	.10937	14	114	128
7	"7-out18661"	.05384	7	123	130
7	"7-out18662"	.11188	16	127	143
7	"7-out18663"	.33070	42	85	127
7	"7-out18664"	.77202	149	44	193
7	"7-out18665"	.72560	119	45	164
7	"7-out18666"	.34920	44	82	126
7	"7-out18667"	.33333	42	84	126
7	"7-out18668"	.39682	50	76	126
7	"7-out18669"	.36507	46	80	126
7	"7-out18670"	.43232	313	411	724
7	"7-out18671"	.65929	1879	971	2850
7	"7-out18672"	.89285	25	3	28
7	"7-out18673"	.94326	399	24	423
7	"7-out18674"	.93393	311	22	333
7	"7-out18675"	.93017	373	28	401
7	"7-out18676"	.17045	60	292	352
7	"7-out18677"	.88135	104	14	118
7	"7-out18678"	.26837	84	229	313
7	"7-out18679"	.83760	98	19	117
7	"7-out18680"	.22685	98	334	432
7	"7-out18681"	.45054	123	150	273
7	"7-out18682"	.93043	107	8	115
7	"7-out18683"	.21637	37	134	171
7	"7-out18684"	.94092	223	14	237
7	"7-out18685"	.35021	83	154	237
7	"7-out18686"	.04098	5	117	122
7	"7-out18687"	.88135	416	56	472
7	"7-out18688"	.21989	84	298	382
7	"7-out18689"	.32346	153	320	473
7	"7-out18690"	.19491	23	95	118
7	"7-out18691"	.25519	86	251	337
7	"7-out18692"	.37611	126	209	335
7	"7-out18693"	.18076	94	426	520
7	"7-out18694"	.56626	188	144	332
7	"7-out18695"	.57089	153	115	268
7	"7-out18696"	.07645	25	302	327
7	"7-out18697"	.52313	147	134	281
7	"7-out18698"	.40815	711	1031	1742
7	"7-out18699"	.24567	71	218	289
7	"7-out18700"	.38211	94	152	246
7	"7-out18701"	.07114	18	235	253
7	"7-out18702"	.22195	91	319	410
7	"7-out18703"	.30935	86	192	278
7	"7-out18704"	.19010	173	737	910
7	"7-out18705"	.20170	142	562	704
7	"7-out18706"	.29553	86	205	291
7	"7-out18707"	.30346	105	241	346
7	"7-out18708"	.24628	199	609	808
7	"7-out18709"	.40298	162	240	402
7	"7-out18710"	.10943	87	708	795
7	"7-out18711"	.33756	266	522	788
7	"7-out18712"	.11686	88	665	753
7	"7-out18713"	.22872	172	580	752
7	"7-out18714"	.26984	102	276	378
7	"7-out18715"	.45350	317	382	699
7	"7-out18716"	.21282	146	540	686
7	"7-out18717"	.28535	448	1122	1570
7	"7-out18718"	.29810	536	1262	1798
7	"7-out18719"	.16348	214	1095	1309
7	"7-out18720"	.17041	447	2176	2623
7	"7-out18721"	.22409	93	322	415
7	"7-out18722"	.27350	64	170	234
7	"7-out18723"	.16923	55	270	325
7	"7-out18724"	.30097	93	216	309
7	"7-out18725"	.11976	40	294	334
7	"7-out18726"	.33333	169	338	507
7	"7-out18727"	.06963	25	334	359
7	"7-out18728"	.06406	23	336	359
7	"7-out18729"	.86440	102	16	118
7	"7-out18730"	.91056	112	11	123
7	"7-out18731"	.90400	113	12	125
7	"7-out18732"	.29602	82	195	277
7	"7-out18733"	.22003	112	397	509
7	"7-out18734"	.31103	93	206	299
7	"7-out18735"	.19602	79	324	403
7	"7-out18736"	.22314	54	188	242
7	"7-out18737"	.15291	63	349	412
7	"7-out18738"	.88888	104	13	117
7	"7-out18739"	.17845	53	244	297
7	"7-out18740"	.36438	176	307	483
7	"7-out18741"	.83206	109	22	131
7	"7-out18742"	.25400	127	373	500
7	"7-out18743"	.23132	192	638	830
7	"7-out18744"	.91666	33	3	36
7	"7-out18745"	.12468	49	344	393
7	"7-out18746"	.88695	204	26	230
7	"7-out18747"	.18439	26	115	141
7	"7-out18748"	.95833	138	6	144
7	"7-out18749"	.14161	49	297	346
7	"7-out18750"	.29880	75	176	251
7	"7-out18751"	.18194	266	1196	1462
7	"7-out18752"	.70454	62	26	88
7	"7-out18753"	.28634	195	486	681
7	"7-out18754"	.25607	137	398	535
7	"7-out18755"	.22262	61	213	274
7	"7-out18756"	.40162	839	1250	2089
7	"7-out18757"	.95238	180	9	189
7	"7-out18758"	.28048	69	177	246
7	"7-out18759"	.30487	75	171	246
7	"7-out18760"	.34707	160	301	461
7	"7-out18761"	.22698	217	739	956
7	"7-out18762"	.11337	50	391	441
7	"7-out18763"	.12926	53	357	410
7	"7-out18764"	.17837	99	456	555
7	"7-out18765"	.32894	25	51	76
7	"7-out18766"	.83333	20	4	24
7	"7-out18767"	.87500	21	3	24
7	"7-out18768"	.47809	251	274	525
7	"7-out18769"	.11309	19	149	168
7	"7-out18770"	.11400	35	272	307
7	"7-out18771"	.58283	489	350	839
7	"7-out18772"	.18902	31	133	164
7	"7-out18773"	.93510	317	22	339
7	"7-out18774"	.23041	50	167	217
7	"7-out18775"	.65555	177	93	270
7	"7-out18776"	.38352	135	217	352
7	"7-out18777"	.14626	49	286	335
7	"7-out18778"	.46006	144	169	313
7	"7-out18779"	.17758	84	389	473
7	"7-out18780"	.87179	102	15	117
7	"7-out18781"	.31784	212	455	667
7	"7-out18782"	.89565	103	12	115
7	"7-out18783"	.39923	105	158	263
7	"7-out18784"	.24828	1086	3288	4374
7	"7-out18785"	.16438	96	488	584
7	"7-out18786"	.89743	105	12	117
7	"7-out18787"	.16373	121	618	739
7	"7-out18788"	.51046	244	234	478
7	"7-out18789"	.29615	77	183	260
7	"7-out18790"	.21788	251	901	1152
7	"7-out18791"	.34932	284	529	813
7	"7-out18792"	.26969	202	547	749
7	"7-out18793"	.54559	353	294	647
7	"7-out18794"	.30000	120	280	400
7	"7-out18795"	.94067	111	7	118
7	"7-out18796"	.14942	65	370	435
7	"7-out18797"	.88135	104	14	118
7	"7-out18798"	.89650	4591	530	5121
7	"7-out18799"	.92307	108	9	117
7	"7-out18800"	.90517	105	11	116
7	"7-out18801"	.17142	78	377	455
7	"7-out18802"	.85714	102	17	119
7	"7-out18803"	.19089	151	640	791
7	"7-out18804"	.88888	104	13	117
7	"7-out18805"	.25000	32	96	128
7	"7-out18806"	.34532	96	182	278
7	"7-out18807"	.32500	52	108	160
7	"7-out18808"	.21743	207	745	952
7	"7-out18809"	.19908	87	350	437
7	"7-out18810"	.34838	54	101	155
7	"7-out18811"	.26562	136	376	512
7	"7-out18812"	.27577	115	302	417
7	"7-out18813"	.58103	190	137	327
7	"7-out18814"	.93269	194	14	208
7	"7-out18815"	.93750	195	13	208
7	"7-out18816"	.93750	195	13	208
7	"7-out18817"	.82230	435	94	529
7	"7-out18818"	.17100	92	446	538
7	"7-out18819"	.18843	101	435	536
7	"7-out18820"	.29714	52	123	175
7	"7-out18821"	.45224	161	195	356
7	"7-out18822"	.14089	41	250	291
7	"7-out18823"	.28732	229	568	797
7	"7-out18824"	.23747	218	700	918
7	"7-out18825"	.24187	67	210	277
7	"7-out18826"	.36000	72	128	200
7	"7-out18827"	.14432	14	83	97
7	"7-out18828"	.19436	138	572	710
7	"7-out18829"	.15699	46	247	293
7	"7-out18830"	.24390	240	744	984
7	"7-out18831"	.26945	232	629	861
7	"7-out18832"	.68545	608	279	887
7	"7-out18833"	.23919	238	757	995
7	"7-out18834"	.64878	266	144	410
7	"7-out18835"	.23314	83	273	356
7	"7-out18836"	.21010	79	297	376
7	"7-out18837"	.76744	99	30	129
7	"7-out18838"	.24719	22	67	89
7	"7-out18839"	.38831	113	178	291
7	"7-out18840"	.47122	131	147	278
7	"7-out18841"	.19580	112	460	572
7	"7-out18842"	.42400	212	288	500
7	"7-out18843"	.30446	116	265	381
7	"7-out18844"	.23398	168	550	718
7	"7-out18845"	.80285	281	69	350
7	"7-out18846"	.26308	196	549	745
7	"7-out18847"	.13624	103	653	756
7	"7-out18848"	.26396	189	527	716
7	"7-out18849"	.18512	117	515	632
7	"7-out18850"	.37316	178	299	477
7	"7-out18851"	.17582	48	225	273
7	"7-out18852"	.28213	90	229	319
7	"7-out18853"	.14088	51	311	362
7	"7-out18854"	.93750	195	13	208
7	"7-out18855"	.11340	33	258	291
7	"7-out18856"	.34011	117	227	344
7	"7-out18857"	.20919	91	344	435
7	"7-out18858"	.27104	132	355	487
7	"7-out18859"	.55932	264	208	472
7	"7-out18860"	.14406	51	303	354
7	"7-out18861"	.23026	70	234	304
7	"7-out18862"	.39032	242	378	620
7	"7-out18863"	.16077	132	689	821
7	"7-out18864"	.13212	95	624	719
7	"7-out18865"	.32261	271	569	840
7	"7-out18866"	.21872	250	893	1143
7	"7-out18867"	.14925	80	456	536
7	"7-out18868"	.48062	248	268	516
7	"7-out18869"	.94339	50	3	53
7	"7-out18870"	.27338	38	101	139
7	"7-out18871"	.89285	25	3	28
7	"7-out18872"	.42937	152	202	354
7	"7-out18873"	.24000	132	418	550
7	"7-out18874"	.24651	177	541	718
7	"7-out18875"	.15771	135	721	856
7	"7-out18876"	.84640	259	47	306
7	"7-out18877"	.18894	41	176	217
7	"7-out18878"	.35272	291	534	825
7	"7-out18879"	.47945	35	38	73
7	"7-out18880"	.89913	312	35	347
7	"7-out18881"	.83990	341	65	406
7	"7-out18882"	.82051	96	21	117
7	"7-out18883"	.82905	97	20	117
7	"7-out18884"	.11176	38	302	340
7	"7-out18885"	.88888	104	13	117
7	"7-out18886"	.31075	78	173	251
7	"7-out18887"	.73529	200	72	272
7	"7-out18888"	.84955	96	17	113
7	"7-out18889"	.10256	12	105	117
7	"7-out18890"	.21074	51	191	242
7	"7-out18891"	.24396	202	626	828
7	"7-out18892"	.42471	110	149	259
7	"7-out18893"	.85470	100	17	117
7	"7-out18894"	.37295	455	765	1220
7	"7-out18895"	.60787	355	229	584
7	"7-out18896"	.25496	154	450	604
7	"7-out18897"	.30872	138	309	447
7	"7-out18898"	.24742	48	146	194
7	"7-out18899"	.93137	190	14	204
7	"7-out18900"	.19804	263	1065	1328
7	"7-out18901"	.43220	102	134	236
7	"7-out18902"	.18545	334	1467	1801
7	"7-out18903"	.15972	46	242	288
7	"7-out18904"	.26291	112	314	426
7	"7-out18905"	.24038	125	395	520
7	"7-out18906"	.17192	49	236	285
7	"7-out18907"	.20202	60	237	297
7	"7-out18908"	.95519	533	25	558
7	"7-out18909"	.15250	149	828	977
7	"7-out18910"	.20000	65	260	325
7	"7-out18911"	.29879	124	291	415
7	"7-out18912"	.75000	18	6	24
7	"7-out18913"	.23605	237	767	1004
7	"7-out18914"	.15546	111	603	714
7	"7-out18915"	.18446	19	84	103
7	"7-out18916"	.25600	32	93	125
7	"7-out18917"	.92436	110	9	119
7	"7-out18918"	.87394	104	15	119
7	"7-out18919"	.89655	104	12	116
7	"7-out18920"	.91452	107	10	117
7	"7-out18921"	.19904	83	334	417
7	"7-out18922"	.09356	32	310	342
7	"7-out18923"	.31376	139	304	443
7	"7-out18924"	.20185	174	688	862
7	"7-out18925"	.23705	119	383	502
7	"7-out18926"	.90598	106	11	117
7	"7-out18927"	.89743	105	12	117
7	"7-out18928"	.29899	238	558	796
7	"7-out18929"	.29844	77	181	258
7	"7-out18930"	.16000	44	231	275
7	"7-out18931"	.22878	62	209	271
7	"7-out18932"	.23333	56	184	240
7	"7-out18933"	.37546	508	845	1353
7	"7-out18934"	.94680	178	10	188
7	"7-out18935"	.21052	112	420	532
7	"7-out18936"	.13907	42	260	302
7	"7-out18937"	.67164	90	44	134
7	"7-out18938"	.13679	29	183	212
7	"7-out18939"	.49642	139	141	280
7	"7-out18940"	.84615	99	18	117
7	"7-out18941"	.19423	209	867	1076
7	"7-out18942"	.84615	99	18	117
7	"7-out18943"	.14498	39	230	269
7	"7-out18944"	.86324	101	16	117
7	"7-out18945"	.27052	145	391	536
7	"7-out18946"	.55312	177	143	320
7	"7-out18947"	.07659	18	217	235
7	"7-out18948"	.39230	51	79	130
7	"7-out18949"	.16414	163	830	993
7	"7-out18950"	.50808	440	426	866
7	"7-out18951"	.62050	569	348	917
7	"7-out18952"	.19462	123	509	632
7	"7-out18953"	.35802	58	104	162
7	"7-out18954"	.37588	106	176	282
7	"7-out18955"	.25000	71	213	284
7	"7-out18956"	.21803	133	477	610
7	"7-out18957"	.14572	29	170	199
7	"7-out18958"	.19454	107	443	550
7	"7-out18959"	.37203	141	238	379
7	"7-out18960"	.19247	87	365	452
7	"7-out18961"	.59900	242	162	404
7	"7-out18962"	.27906	72	186	258
7	"7-out18963"	.95833	138	6	144
7	"7-out18964"	.29037	169	413	582
7	"7-out18965"	.21040	368	1381	1749
7	"7-out18966"	.70329	64	27	91
7	"7-out18967"	.41346	43	61	104
7	"7-out18968"	.42307	33	45	78
7	"7-out18969"	.90466	427	45	472
7	"7-out18970"	.18666	14	61	75
7	"7-out18971"	.22691	145	494	639
7	"7-out18972"	.81381	271	62	333
7	"7-out18973"	.85820	460	76	536
7	"7-out18974"	.21694	105	379	484
7	"7-out18975"	.29710	82	194	276
7	"7-out18976"	.88321	363	48	411
7	"7-out18977"	.80241	199	49	248
7	"7-out18978"	.66233	102	52	154
7	"7-out18979"	.30204	148	342	490
7	"7-out18980"	.20746	100	382	482
7	"7-out18981"	.19230	40	168	208
7	"7-out18982"	.36231	75	132	207
7	"7-out18983"	.72307	141	54	195
7	"7-out18984"	.34134	71	137	208
7	"7-out18985"	.35666	214	386	600
7	"7-out18986"	.56547	95	73	168
7	"7-out18987"	.93805	106	7	113
7	"7-out18988"	.85250	289	50	339
7	"7-out18989"	.27520	344	906	1250
7	"7-out18990"	.92523	99	8	107
7	"7-out18991"	.73364	157	57	214
7	"7-out18992"	.25810	677	1946	2623
7	"7-out18993"	.26433	83	231	314
7	"7-out18994"	.29559	94	224	318
7	"7-out18995"	.86486	128	20	148
7	"7-out18996"	.26646	174	479	653
7	"7-out18997"	.53435	70	61	131
7	"7-out18998"	.34845	192	359	551
7	"7-out18999"	.95555	215	10	225
7	"7-out19000"	.21223	111	412	523
7	"7-out19001"	.37946	85	139	224
7	"7-out19002"	.14240	225	1355	1580
7	"7-out19003"	.48259	208	223	431
7	"7-out19004"	.32915	184	375	559
7	"7-out19005"	.33655	174	343	517
7	"7-out19006"	.96946	127	4	131
7	"7-out19007"	.30327	37	85	122
7	"7-out19008"	.10769	14	116	130
7	"7-out19009"	.34439	353	672	1025
7	"7-out19010"	.23305	110	362	472
7	"7-out19011"	.97600	122	3	125
7	"7-out19012"	.96212	127	5	132
7	"7-out19013"	.98496	131	2	133
7	"7-out19014"	.85185	161	28	189
7	"7-out19015"	.90476	171	18	189
7	"7-out19016"	.89947	170	19	189
7	"7-out19017"	.87765	165	23	188
7	"7-out19018"	.88359	167	22	189
7	"7-out19019"	.25098	127	379	506
7	"7-out19020"	.70454	93	39	132
7	"7-out19021"	.31351	58	127	185
7	"7-out19022"	.27956	52	134	186
7	"7-out19023"	.22883	100	337	437
7	"7-out19024"	.20938	116	438	554
7	"7-out19025"	.26340	113	316	429
7	"7-out19026"	.54440	423	354	777
7	"7-out19027"	.15238	48	267	315
7	"7-out19028"	.82937	384	79	463
7	"7-out19029"	.19863	58	234	292
7	"7-out19030"	.14229	108	651	759
7	"7-out19031"	.96000	96	4	100
7	"7-out19032"	.31604	195	422	617
7	"7-out19033"	.90998	556	55	611
7	"7-out19034"	.24216	170	532	702
7	"7-out19035"	.84792	184	33	217
7	"7-out19036"	.12068	14	102	116
7	"7-out19037"	.21183	111	413	524
7	"7-out19038"	.96261	412	16	428
7	"7-out19039"	.90566	96	10	106
7	"7-out19040"	.19738	121	492	613
7	"7-out19041"	.95744	90	4	94
7	"7-out19042"	.68421	247	114	361
7	"7-out19043"	.85784	350	58	408
7	"7-out19044"	.15009	80	453	533
7	"7-out19045"	.93162	109	8	117
7	"7-out19046"	.24644	156	477	633
7	"7-out19047"	.70731	145	60	205
7	"7-out19048"	.17032	31	151	182
7	"7-out19049"	.16000	24	126	150
7	"7-out19050"	.39411	67	103	170
7	"7-out19051"	.14792	275	1584	1859
7	"7-out19052"	.73529	50	18	68
7	"7-out19053"	.11416	54	419	473
7	"7-out19054"	.77941	53	15	68
7	"7-out19055"	.16371	74	378	452
7	"7-out19056"	.17849	83	382	465
7	"7-out19057"	.89595	155	18	173
7	"7-out19058"	.14878	104	595	699
7	"7-out19059"	.23145	181	601	782
7	"7-out19060"	.16874	122	601	723
7	"7-out19061"	.20000	100	400	500
7	"7-out19062"	.14012	22	135	157
7	"7-out19063"	.21613	142	515	657
7	"7-out19064"	.50423	119	117	236
7	"7-out19065"	.43117	260	343	603
7	"7-out19066"	.21786	161	578	739
7	"7-out19067"	.55340	772	623	1395
7	"7-out19068"	.19375	93	387	480
7	"7-out19069"	.75946	401	127	528
7	"7-out19070"	.75749	278	89	367
7	"7-out19071"	.19031	110	468	578
7	"7-out19072"	.52205	71	65	136
7	"7-out19073"	.19148	81	342	423
7	"7-out19074"	.11470	39	301	340
7	"7-out19075"	.39130	27	42	69
7	"7-out19076"	.49315	36	37	73
7	"7-out19077"	.20842	94	357	451
7	"7-out19078"	.82352	14	3	17
7	"7-out19079"	.48257	180	193	373
7	"7-out19080"	.23796	178	570	748
7	"7-out19081"	.16864	142	700	842
7	"7-out19082"	.43373	252	329	581
7	"7-out19083"	.29885	234	549	783
7	"7-out19084"	.28349	419	1059	1478
7	"7-out19085"	.94827	110	6	116
7	"7-out19086"	.94017	110	7	117
7	"7-out19087"	.22828	452	1528	1980
7	"7-out19088"	.57142	124	93	217
7	"7-out19089"	.22427	85	294	379
7	"7-out19090"	.27707	110	287	397
7	"7-out19091"	.24569	157	482	639
7	"7-out19092"	.39495	235	360	595
7	"7-out19093"	.23076	27	90	117
7	"7-out19094"	.87993	557	76	633
7	"7-out19095"	.37600	94	156	250
7	"7-out19096"	.15525	68	370	438
7	"7-out19097"	.23439	154	503	657
7	"7-out19098"	.22698	106	361	467
7	"7-out19099"	.09237	63	619	682
7	"7-out19100"	.91739	522	47	569
7	"7-out19101"	.24935	96	289	385
7	"7-out19102"	.56382	106	82	188
7	"7-out19103"	.93965	109	7	116
7	"7-out19104"	.18731	124	538	662
7	"7-out19105"	.70678	323	134	457
7	"7-out19106"	.71473	228	91	319
7	"7-out19107"	.44857	157	193	350
7	"7-out19108"	.20279	145	570	715
7	"7-out19109"	.21515	142	518	660
7	"7-out19110"	.30225	94	217	311
7	"7-out19111"	.93410	241	17	258
7	"7-out19112"	.69827	324	140	464
7	"7-out19113"	.15731	474	2539	3013
7	"7-out19114"	.17901	186	853	1039
7	"7-out19115"	.18934	405	1734	2139
7	"7-out19116"	.47517	622	687	1309
7	"7-out19117"	.91657	1659	151	1810
7	"7-out19118"	.71399	352	141	493
7	"7-out19119"	.17363	108	514	622
7	"7-out19120"	.22784	90	305	395
7	"7-out19121"	.93243	69	5	74
7	"7-out19122"	.93939	403	26	429
7	"7-out19123"	.96996	646	20	666
7	"7-out19124"	.26881	125	340	465
7	"7-out19125"	.25161	195	580	775
7	"7-out19126"	.39948	312	469	781
7	"7-out19127"	.28693	134	333	467
7	"7-out19128"	.23214	104	344	448
7	"7-out19129"	.93340	897	64	961
7	"7-out19130"	.12175	61	440	501
7	"7-out19131"	.96846	645	21	666
7	"7-out19132"	.14552	39	229	268
7	"7-out19133"	.17381	77	366	443
7	"7-out19134"	.42081	186	256	442
7	"7-out19135"	.23928	201	639	840
7	"7-out19136"	.50773	328	318	646
7	"7-out19137"	.29469	150	359	509
7	"7-out19138"	.21170	199	741	940
7	"7-out19139"	.04411	3	65	68
7	"7-out19140"	.66666	78	39	117
7	"7-out19141"	.10649	59	495	554
7	"7-out19142"	.68571	408	187	595
7	"7-out19143"	.15681	69	371	440
7	"7-out19144"	.18512	117	515	632
7	"7-out19145"	.11392	54	420	474
7	"7-out19146"	.16901	12	59	71
7	"7-out19147"	.87731	379	53	432
7	"7-out19148"	.84865	443	79	522
7	"7-out19149"	.84909	467	83	550
7	"7-out19150"	.20915	64	242	306
7	"7-out19151"	.36422	169	295	464
7	"7-out19152"	.42148	255	350	605
7	"7-out19153"	.95173	493	25	518
7	"7-out19154"	.94017	110	7	117
7	"7-out19155"	.32188	150	316	466
7	"7-out19156"	.53420	164	143	307
7	"7-out19157"	.28939	101	248	349
7	"7-out19158"	.35168	230	424	654
7	"7-out19159"	.20512	24	93	117
7	"7-out19160"	.78723	37	10	47
7	"7-out19161"	.93936	852	55	907
7	"7-out19162"	.72077	111	43	154
7	"7-out19163"	.19168	212	894	1106
7	"7-out19164"	.31117	117	259	376
7	"7-out19165"	.17806	138	637	775
7	"7-out19166"	.15510	38	207	245
7	"7-out19167"	.19580	28	115	143
7	"7-out19168"	.22747	101	343	444
7	"7-out19169"	.53347	255	223	478
7	"7-out19170"	.83068	157	32	189
7	"7-out19171"	.38192	131	212	343
7	"7-out19172"	.21199	99	368	467
7	"7-out19173"	.57085	141	106	247
7	"7-out19174"	.25119	105	313	418
7	"7-out19175"	.15432	75	411	486
7	"7-out19176"	.18063	97	440	537
7	"7-out19177"	.90000	72	8	80
7	"7-out19178"	.96402	134	5	139
7	"7-out19179"	.23979	94	298	392
7	"7-out19180"	.19432	89	369	458
7	"7-out19181"	.20000	15	60	75
7	"7-out19182"	.83417	493	98	591
7	"7-out19183"	.26513	127	352	479
7	"7-out19184"	.87774	560	78	638
7	"7-out19185"	.82051	96	21	117
7	"7-out19186"	.34710	126	237	363
7	"7-out19187"	.14634	72	420	492
7	"7-out19188"	.34584	175	331	506
7	"7-out19189"	.24118	219	689	908
7	"7-out19190"	.32492	103	214	317
7	"7-out19191"	.96910	345	11	356
7	"7-out19192"	.21134	82	306	388
7	"7-out19193"	.43780	454	583	1037
7	"7-out19194"	.87823	4443	616	5059
7	"7-out19195"	.15990	142	746	888
7	"7-out19196"	.51190	215	205	420
7	"7-out19197"	.34246	250	480	730
7	"7-out19198"	.28545	155	388	543
7	"7-out19199"	.10958	16	130	146
7	"7-out19200"	.21678	186	672	858
7	"7-out19201"	.15258	56	311	367
7	"7-out19202"	.88251	646	86	732
7	"7-out19203"	.25757	85	245	330
7	"7-out19204"	.38477	187	299	486
7	"7-out19205"	.25842	115	330	445
7	"7-out19206"	.21951	135	480	615
7	"7-out19207"	.93661	133	9	142
7	"7-out19208"	.89743	350	40	390
7	"7-out19209"	.30941	207	462	669
7	"7-out19210"	.70207	271	115	386
7	"7-out19211"	.14074	171	1044	1215
7	"7-out19212"	.05882	19	304	323
7	"7-out19213"	.12997	49	328	377
7	"7-out19214"	.07936	5	58	63
7	"7-out19215"	.17002	59	288	347
7	"7-out19216"	.16255	916	4719	5635
7	"7-out19217"	.35576	185	335	520
7	"7-out19218"	.39285	154	238	392
7	"7-out19219"	.87096	81	12	93
7	"7-out19220"	.22027	63	223	286
7	"7-out19221"	.16878	133	655	788
7	"7-out19222"	.31739	73	157	230
7	"7-out19223"	.85421	668	114	782
7	"7-out19224"	.58839	426	298	724
7	"7-out19225"	.28800	72	178	250
7	"7-out19226"	.29316	163	393	556
7	"7-out19227"	.37165	375	634	1009
7	"7-out19228"	.14523	61	359	420
7	"7-out19229"	.23446	83	271	354
7	"7-out19230"	.58045	202	146	348
7	"7-out19231"	.23774	97	311	408
7	"7-out19232"	.20860	97	368	465
7	"7-out19233"	.83333	20	4	24
7	"7-out19234"	.66666	60	30	90
7	"7-out19235"	.28434	207	521	728
7	"7-out19236"	.22795	137	464	601
7	"7-out19237"	.17398	103	489	592
7	"7-out19238"	.13149	43	284	327
7	"7-out19239"	.22149	68	239	307
7	"7-out19240"	.90064	417	46	463
7	"7-out19241"	.59219	167	115	282
7	"7-out19242"	.40311	181	268	449
7	"7-out19243"	.36697	80	138	218
7	"7-out19244"	.23846	93	297	390
7	"7-out19245"	.74074	120	42	162
7	"7-out19246"	.20121	33	131	164
7	"7-out19247"	.63513	47	27	74
7	"7-out19248"	.29787	70	165	235
7	"7-out19249"	.14044	50	306	356
7	"7-out19250"	.27298	98	261	359
7	"7-out19251"	.25168	112	333	445
7	"7-out19252"	.69216	371	165	536
7	"7-out19253"	.27032	133	359	492
7	"7-out19254"	.05882	3	48	51
7	"7-out19255"	.33461	87	173	260
7	"7-out19256"	.25200	63	187	250
7	"7-out19257"	.83760	98	19	117
7	"7-out19258"	.16304	90	462	552
7	"7-out19259"	.89075	106	13	119
7	"7-out19260"	.24444	66	204	270
7	"7-out19261"	.41463	136	192	328
7	"7-out19262"	.92307	108	9	117
7	"7-out19263"	.31560	89	193	282
7	"7-out19264"	.93043	107	8	115
7	"7-out19265"	.20367	122	477	599
7	"7-out19266"	.30805	130	292	422
7	"7-out19267"	.38522	245	391	636
7	"7-out19268"	.34461	112	213	325
7	"7-out19269"	.12979	71	476	547
7	"7-out19270"	.89855	124	14	138
7	"7-out19271"	.27129	86	231	317
7	"7-out19272"	.15748	80	428	508
7	"7-out19273"	.36336	121	212	333
7	"7-out19274"	.59154	210	145	355
7	"7-out19275"	.18627	95	415	510
7	"7-out19276"	.07986	23	265	288
7	"7-out19277"	.51026	174	167	341
7	"7-out19278"	.29335	159	383	542
7	"7-out19279"	.22222	80	280	360
7	"7-out19280"	.76923	70	21	91
7	"7-out19281"	.18814	127	548	675
7	"7-out19282"	.27113	186	500	686
7	"7-out19283"	.87755	301	42	343
7	"7-out19284"	.24122	110	346	456
7	"7-out19285"	.32592	44	91	135
7	"7-out19286"	.27049	132	356	488
7	"7-out19287"	.27450	98	259	357
7	"7-out19288"	.91666	22	2	24
7	"7-out19289"	.66666	16	8	24
7	"7-out19290"	.95833	23	1	24
7	"7-out19291"	.73737	73	26	99
7	"7-out19292"	.79286	467	122	589
7	"7-out19293"	.69662	434	189	623
7	"7-out19294"	.31884	44	94	138
7	"7-out19295"	.71673	167	66	233
7	"7-out19296"	.44082	149	189	338
7	"7-out19297"	.89743	105	12	117
7	"7-out19298"	.82203	97	21	118
7	"7-out19299"	.23660	53	171	224
7	"7-out19300"	.16724	96	478	574
7	"7-out19301"	.10810	24	198	222
7	"7-out19302"	.29113	161	392	553
7	"7-out19303"	.65476	220	116	336
7	"7-out19304"	.91452	107	10	117
7	"7-out19305"	.34195	119	229	348
7	"7-out19306"	.37142	533	902	1435
7	"7-out19307"	.70142	148	63	211
7	"7-out19308"	.14786	59	340	399
7	"7-out19309"	.22154	183	643	826
7	"7-out19310"	.92957	132	10	142
7	"7-out19311"	.15454	51	279	330
7	"7-out19312"	.92658	467	37	504
7	"7-out19313"	.16296	22	113	135
7	"7-out19314"	.36296	98	172	270
7	"7-out19315"	.39795	39	59	98
7	"7-out19316"	.24067	71	224	295
7	"7-out19317"	.27837	103	267	370
7	"7-out19318"	.27966	99	255	354
7	"7-out19319"	.24378	98	304	402
7	"7-out19320"	.87500	21	3	24
7	"7-out19321"	.70833	17	7	24
7	"7-out19322"	.21232	62	230	292
7	"7-out19323"	.90102	264	29	293
7	"7-out19324"	.90102	264	29	293
7	"7-out19325"	.17088	54	262	316
7	"7-out19326"	.34395	529	1009	1538
7	"7-out19327"	.17601	204	955	1159
7	"7-out19328"	.23508	130	423	553
7	"7-out19329"	.13276	47	307	354
7	"7-out19330"	.34714	243	457	700
7	"7-out19331"	.93177	1079	79	1158
7	"7-out19332"	.45217	52	63	115
7	"7-out19333"	.37350	282	473	755
7	"7-out19334"	.17708	17	79	96
7	"7-out19335"	.11450	15	116	131
7	"7-out19336"	.26995	115	311	426
7	"7-out19337"	.17253	49	235	284
7	"7-out19338"	.91596	109	10	119
7	"7-out19339"	.90756	108	11	119
7	"7-out19340"	.32369	112	234	346
7	"7-out19341"	.89655	52	6	58
7	"7-out19342"	.89743	105	12	117
7	"7-out19343"	.89830	106	12	118
7	"7-out19344"	.17962	67	306	373
7	"7-out19345"	.16447	50	254	304
7	"7-out19346"	.78000	78	22	100
7	"7-out19347"	.21606	78	283	361
7	"7-out19348"	.50000	45	45	90
7	"7-out19349"	.15978	89	468	557
7	"7-out19350"	.24364	182	565	747
7	"7-out19351"	.16442	61	310	371
7	"7-out19352"	.71319	281	113	394
7	"7-out19353"	.84393	292	54	346
7	"7-out19354"	.30569	59	134	193
7	"7-out19355"	.22613	45	154	199
7	"7-out19356"	.88789	198	25	223
7	"7-out19357"	.32258	90	189	279
7	"7-out19358"	.93712	313	21	334
7	"7-out19359"	.22997	112	375	487
7	"7-out19360"	.60000	234	156	390
7	"7-out19361"	.53042	340	301	641
7	"7-out19362"	.33385	214	427	641
7	"7-out19363"	.68421	52	24	76
7	"7-out19364"	.30812	163	366	529
7	"7-out19365"	.15868	53	281	334
7	"7-out19366"	.93993	313	20	333
7	"7-out19367"	.88395	259	34	293
7	"7-out19368"	.89078	261	32	293
7	"7-out19369"	.44097	198	251	449
7	"7-out19370"	.23121	80	266	346
7	"7-out19371"	.28693	134	333	467
7	"7-out19372"	.51658	327	306	633
7	"7-out19373"	.91364	328	31	359
7	"7-out19374"	.07853	15	176	191
7	"7-out19375"	.23316	45	148	193
7	"7-out19376"	.26412	187	521	708
7	"7-out19377"	.92822	388	30	418
7	"7-out19378"	.21387	74	272	346
7	"7-out19379"	.69883	239	103	342
7	"7-out19380"	.73399	298	108	406
7	"7-out19381"	.24832	148	448	596
7	"7-out19382"	.91666	22	2	24
7	"7-out19383"	.58750	47	33	80
7	"7-out19384"	.17625	49	229	278
7	"7-out19385"	.22857	64	216	280
7	"7-out19386"	.84745	100	18	118
7	"7-out19387"	.88888	104	13	117
7	"7-out19388"	.14117	36	219	255
7	"7-out19389"	.29366	153	368	521
7	"7-out19390"	.15276	141	782	923
7	"7-out19391"	.16326	40	205	245
7	"7-out19392"	.23546	243	789	1032
7	"7-out19393"	.21844	398	1424	1822
7	"7-out19394"	.15509	181	986	1167
7	"7-out19395"	.20901	167	632	799
7	"7-out19396"	.17418	139	659	798
7	"7-out19397"	.24350	253	786	1039
7	"7-out19398"	.23467	310	1011	1321
7	"7-out19399"	.21857	40	143	183
7	"7-out19400"	.24190	239	749	988
7	"7-out19401"	.18133	169	763	932
7	"7-out19402"	.18959	102	436	538
7	"7-out19403"	.29864	66	155	221
7	"7-out19404"	.32318	138	289	427
7	"7-out19405"	.37659	148	245	393
7	"7-out19406"	.20000	109	436	545
7	"7-out19407"	.16067	76	397	473
7	"7-out19408"	.19337	525	2190	2715
7	"7-out19409"	.34412	1690	3221	4911
7	"7-out19410"	.20426	1131	4406	5537
7	"7-out19411"	.74672	342	116	458
7	"7-out19412"	.23238	287	948	1235
7	"7-out19413"	.16220	109	563	672
7	"7-out19414"	.14246	105	632	737
7	"7-out19415"	.12987	50	335	385
7	"7-out19416"	.70621	375	156	531
7	"7-out19417"	.95625	153	7	160
7	"7-out19418"	.24087	33	104	137
7	"7-out19419"	.50617	41	40	81
7	"7-out19420"	.54761	46	38	84
7	"7-out19421"	.69841	44	19	63
7	"7-out19422"	.63475	179	103	282
7	"7-out19423"	.61568	157	98	255
7	"7-out19424"	.62895	139	82	221
7	"7-out19425"	.72820	142	53	195
7	"7-out19426"	.59203	119	82	201
7	"7-out19427"	.75247	152	50	202
7	"7-out19428"	.78205	122	34	156
7	"7-out19429"	.75686	193	62	255
7	"7-out19430"	.70056	124	53	177
7	"7-out19431"	.54166	52	44	96
7	"7-out19432"	.62500	70	42	112
7	"7-out19433"	.83139	143	29	172
7	"7-out19434"	.86734	85	13	98
7	"7-out19435"	.87755	86	12	98
7	"7-out19436"	.54411	74	62	136
7	"7-out19437"	.51794	101	94	195
7	"7-out19438"	.52409	87	79	166
7	"7-out19439"	.69060	125	56	181
7	"7-out19440"	.62926	129	76	205
7	"7-out19441"	.68571	144	66	210
7	"7-out19442"	.72432	134	51	185
7	"7-out19443"	.67142	141	69	210
7	"7-out19444"	.65827	183	95	278
7	"7-out19445"	.76371	181	56	237
7	"7-out19446"	.69767	90	39	129
7	"7-out19447"	.76969	127	38	165
7	"7-out19448"	.79679	149	38	187
7	"7-out19449"	.87573	148	21	169
7	"7-out19450"	.49295	35	36	71
7	"7-out19451"	.50000	31	31	62
7	"7-out19452"	.66990	69	34	103
7	"7-out19453"	.55200	138	112	250
7	"7-out19454"	.75287	131	43	174
7	"7-out19455"	.72327	115	44	159
7	"7-out19456"	.75974	117	37	154
7	"7-out19457"	.73750	118	42	160
7	"7-out19458"	.66272	112	57	169
7	"7-out19459"	.80503	128	31	159
7	"7-out19460"	.18604	88	385	473
7	"7-out19461"	.29514	304	726	1030
7	"7-out19462"	.25781	33	95	128
7	"7-out19463"	.74269	127	44	171
7	"7-out19464"	.42197	192	263	455
7	"7-out19465"	.79064	355	94	449
7	"7-out19466"	.71491	326	130	456
7	"7-out19467"	.62677	309	184	493
7	"7-out19468"	.13369	98	635	733
7	"7-out19469"	.88949	821	102	923
7	"7-out19470"	.24000	228	722	950
7	"7-out19471"	.13485	65	417	482
7	"7-out19472"	.17917	191	875	1066
7	"7-out19473"	.42439	174	236	410
7	"7-out19474"	.70544	285	119	404
7	"7-out19475"	.35294	48	88	136
7	"7-out19476"	.84905	45	8	53
7	"7-out19477"	.95419	125	6	131
7	"7-out19478"	.91609	928	85	1013
7	"7-out19479"	.76923	60	18	78
7	"7-out19480"	.77533	176	51	227
7	"7-out19481"	.15569	175	949	1124
7	"7-out19482"	.89817	344	39	383
7	"7-out19483"	.20378	97	379	476
7	"7-out19484"	.44150	234	296	530
7	"7-out19485"	.51923	243	225	468
7	"7-out19486"	.93787	785	52	837
7	"7-out19487"	.34419	169	322	491
7	"7-out19488"	.18645	300	1309	1609
7	"7-out19489"	.26348	464	1297	1761
7	"7-out19490"	.15758	188	1005	1193
7	"7-out19491"	.24317	383	1192	1575
7	"7-out19492"	.48333	203	217	420
7	"7-out19493"	.65930	209	108	317
7	"7-out19494"	.80108	588	146	734
7	"7-out19495"	.19115	216	914	1130
7	"7-out19496"	.35877	94	168	262
7	"7-out19497"	.90196	368	40	408
7	"7-out19498"	.32711	228	469	697
7	"7-out19499"	.22341	229	796	1025
7	"7-out19500"	.32262	422	886	1308
7	"7-out19501"	.15384	74	407	481
7	"7-out19502"	.61864	73	45	118
7	"7-out19503"	.58474	69	49	118
7	"7-out19504"	.33774	51	100	151
7	"7-out19505"	.16860	145	715	860
7	"7-out19506"	.37545	104	173	277
7	"7-out19507"	.14655	34	198	232
7	"7-out19508"	.33041	151	306	457
7	"7-out19509"	.20957	162	611	773
7	"7-out19510"	.12429	22	155	177
7	"7-out19511"	.19703	146	595	741
7	"7-out19512"	.14334	422	2522	2944
7	"7-out19513"	.21470	181	662	843
7	"7-out19514"	.14247	106	638	744
7	"7-out19515"	.25171	147	437	584
7	"7-out19516"	.18316	37	165	202
7	"7-out19517"	.16395	151	770	921
7	"7-out19518"	.20754	143	546	689
7	"7-out19519"	.21232	31	115	146
7	"7-out19520"	.22988	20	67	87
7	"7-out19521"	.43292	142	186	328
7	"7-out19522"	.23529	68	221	289
7	"7-out19523"	.87234	82	12	94
7	"7-out19524"	.40841	709	1027	1736
7	"7-out19525"	.29485	355	849	1204
7	"7-out19526"	.52582	112	101	213
7	"7-out19527"	.18450	300	1326	1626
7	"7-out19528"	.05789	11	179	190
7	"7-out19529"	.23115	46	153	199
7	"7-out19530"	.21538	42	153	195
7	"7-out19531"	.58291	116	83	199
7	"7-out19532"	.63392	142	82	224
7	"7-out19533"	.12435	24	169	193
7	"7-out19534"	.19696	39	159	198
7	"7-out19535"	.26391	128	357	485
7	"7-out19536"	.15902	52	275	327
7	"7-out19537"	.26993	44	119	163
7	"7-out19538"	.44000	77	98	175
7	"7-out19539"	.17647	21	98	119
7	"7-out19540"	.25185	136	404	540
7	"7-out19541"	.25145	431	1283	1714
7	"7-out19542"	.25246	230	681	911
7	"7-out19543"	.58823	430	301	731
7	"7-out19544"	.53172	176	155	331
7	"7-out19545"	.34600	173	327	500
7	"7-out19546"	.31726	158	340	498
7	"7-out19547"	.19047	72	306	378
7	"7-out19548"	.21090	89	333	422
7	"7-out19549"	.19841	75	303	378
7	"7-out19550"	.15161	47	263	310
7	"7-out19551"	.88145	290	39	329
7	"7-out19552"	.13883	74	459	533
7	"7-out19553"	.29328	166	400	566
7	"7-out19554"	.24949	249	749	998
7	"7-out19555"	.73917	768	271	1039
7	"7-out19556"	.31909	127	271	398
7	"7-out19557"	.18506	57	251	308
7	"7-out19558"	.34444	62	118	180
7	"7-out19559"	.94285	99	6	105
7	"7-out19560"	.93883	307	20	327
7	"7-out19561"	.14685	21	122	143
7	"7-out19562"	.19111	99	419	518
7	"7-out19563"	.17629	58	271	329
7	"7-out19564"	.90873	229	23	252
7	"7-out19565"	.15189	48	268	316
7	"7-out19566"	.11976	60	441	501
7	"7-out19567"	.20377	54	211	265
7	"7-out19568"	.14434	83	492	575
7	"7-out19569"	.20289	112	440	552
7	"7-out19570"	.20726	97	371	468
7	"7-out19571"	.16589	36	181	217
7	"7-out19572"	.29651	51	121	172
7	"7-out19573"	.33248	261	524	785
7	"7-out19574"	.48962	118	123	241
7	"7-out19575"	.23899	76	242	318
7	"7-out19576"	.18863	73	314	387
7	"7-out19577"	.15412	43	236	279
7	"7-out19578"	.15950	78	411	489
7	"7-out19579"	.12571	66	459	525
7	"7-out19580"	.18064	336	1524	1860
7	"7-out19581"	.52863	120	107	227
7	"7-out19582"	.31233	486	1070	1556
7	"7-out19583"	.13176	95	626	721
7	"7-out19584"	.82618	385	81	466
7	"7-out19585"	.81995	337	74	411
7	"7-out19586"	.13655	96	607	703
7	"7-out19587"	.38745	105	166	271
7	"7-out19588"	.17679	32	149	181
7	"7-out19589"	.18762	97	420	517
7	"7-out19590"	.31527	611	1327	1938
7	"7-out19591"	.37939	151	247	398
7	"7-out19592"	.19213	88	370	458
7	"7-out19593"	.90909	110	11	121
7	"7-out19594"	.88461	115	15	130
7	"7-out19595"	.14699	66	383	449
7	"7-out19596"	.43130	135	178	313
7	"7-out19597"	.73303	162	59	221
7	"7-out19598"	.33502	66	131	197
7	"7-out19599"	.48186	93	100	193
7	"7-out19600"	.31632	31	67	98
7	"7-out19601"	.90344	393	42	435
7	"7-out19602"	.13373	224	1451	1675
7	"7-out19603"	.10243	168	1472	1640
7	"7-out19604"	.34300	201	385	586
7	"7-out19605"	.76923	190	57	247
7	"7-out19606"	.64426	163	90	253
7	"7-out19607"	.25660	369	1069	1438
7	"7-out19608"	.19926	109	438	547
7	"7-out19609"	.62809	76	45	121
7	"7-out19610"	.34634	71	134	205
7	"7-out19611"	.56250	126	98	224
7	"7-out19612"	.17132	49	237	286
7	"7-out19613"	.26832	227	619	846
7	"7-out19614"	.19931	292	1173	1465
7	"7-out19615"	.20470	87	338	425
7	"7-out19616"	.13841	49	305	354
7	"7-out19617"	.18654	61	266	327
7	"7-out19618"	.19117	65	275	340
7	"7-out19619"	.93292	153	11	164
7	"7-out19620"	.92923	302	23	325
7	"7-out19621"	.94811	201	11	212
7	"7-out19622"	.35160	186	343	529
7	"7-out19623"	.26934	87	236	323
7	"7-out19624"	.38530	173	276	449
7	"7-out19625"	.30152	79	183	262
7	"7-out19626"	.20598	172	663	835
7	"7-out19627"	.31088	1265	2804	4069
7	"7-out19628"	.33571	47	93	140
7	"7-out19629"	.90361	75	8	83
7	"7-out19630"	.87037	47	7	54
7	"7-out19631"	.93918	139	9	148
7	"7-out19632"	.34375	55	105	160
7	"7-out19633"	.21690	195	704	899
7	"7-out19634"	.25748	86	248	334
7	"7-out19635"	.80906	250	59	309
7	"7-out19636"	.17828	156	719	875
7	"7-out19637"	.35643	252	455	707
7	"7-out19638"	.26747	199	545	744
7	"7-out19639"	.29019	148	362	510
7	"7-out19640"	.45652	42	50	92
7	"7-out19641"	.11228	53	419	472
7	"7-out19642"	.27777	100	260	360
7	"7-out19643"	.13359	136	882	1018
7	"7-out19644"	.26181	288	812	1100
7	"7-out19645"	.17505	233	1098	1331
7	"7-out19646"	.93617	88	6	94
7	"7-out19647"	.30898	55	123	178
7	"7-out19648"	.30563	320	727	1047
7	"7-out19649"	.52287	80	73	153
7	"7-out19650"	.23487	66	215	281
7	"7-out19651"	.34078	61	118	179
7	"7-out19652"	.16393	30	153	183
7	"7-out19653"	.37267	60	101	161
7	"7-out19654"	.12571	22	153	175
7	"7-out19655"	.98347	119	2	121
7	"7-out19656"	.12773	187	1277	1464
7	"7-out19657"	.14324	213	1274	1487
7	"7-out19658"	.68250	1135	528	1663
7	"7-out19659"	.14739	246	1423	1669
7	"7-out19660"	.14427	247	1465	1712
7	"7-out19661"	.12878	217	1468	1685
7	"7-out19662"	.92947	1621	123	1744
7	"7-out19663"	.93119	1624	120	1744
7	"7-out19664"	.13542	203	1296	1499
7	"7-out19665"	.10700	110	918	1028
7	"7-out19666"	.11383	116	903	1019
7	"7-out19667"	.16526	374	1889	2263
7	"7-out19668"	.27087	253	681	934
7	"7-out19669"	.20625	145	558	703
7	"7-out19670"	.22504	133	458	591
7	"7-out19671"	.16666	114	570	684
7	"7-out19672"	.33989	190	369	559
7	"7-out19673"	.16981	18	88	106
7	"7-out19674"	.60810	45	29	74
7	"7-out19675"	.57600	72	53	125
7	"7-out19676"	.23376	54	177	231
7	"7-out19677"	.15735	107	573	680
7	"7-out19678"	.17663	319	1487	1806
7	"7-out19679"	.34099	430	831	1261
7	"7-out19680"	.25018	345	1034	1379
7	"7-out19681"	.21624	181	656	837
7	"7-out19682"	.18397	356	1579	1935
7	"7-out19683"	.24130	638	2006	2644
7	"7-out19684"	.15775	174	929	1103
7	"7-out19685"	.18947	180	770	950
7	"7-out19686"	.23378	256	839	1095
7	"7-out19687"	.26180	316	891	1207
7	"7-out19688"	.17052	81	394	475
7	"7-out19689"	.91906	988	87	1075
7	"7-out19690"	.23648	35	113	148
7	"7-out19691"	.30088	102	237	339
7	"7-out19692"	.36414	130	227	357
7	"7-out19693"	.70719	285	118	403
7	"7-out19694"	.72093	248	96	344
7	"7-out19695"	.20502	628	2435	3063
7	"7-out19696"	.25272	139	411	550
7	"7-out19697"	.15760	113	604	717
7	"7-out19698"	.19386	177	736	913
7	"7-out19699"	.12890	66	446	512
7	"7-out19700"	.12521	74	517	591
7	"7-out19701"	.14608	84	491	575
7	"7-out19702"	.63855	106	60	166
7	"7-out19703"	.33160	64	129	193
7	"7-out19704"	.31325	52	114	166
7	"7-out19705"	.19812	275	1113	1388
7	"7-out19706"	.18623	157	686	843
7	"7-out19707"	.17410	78	370	448
7	"7-out19708"	.93478	430	30	460
7	"7-out19709"	.16305	128	657	785
7	"7-out19710"	.13154	93	614	707
7	"7-out19711"	.13004	87	582	669
7	"7-out19712"	.50000	111	111	222
7	"7-out19713"	.50495	51	50	101
7	"7-out19714"	.18040	81	368	449
7	"7-out19715"	.29640	388	921	1309
7	"7-out19716"	.35483	99	180	279
7	"7-out19717"	.14975	180	1022	1202
7	"7-out19718"	.27012	208	562	770
7	"7-out19719"	.18215	98	440	538
7	"7-out19720"	.93162	109	8	117
7	"7-out19721"	.28800	36	89	125
7	"7-out19722"	.72950	89	33	122
7	"7-out19723"	.37345	121	203	324
7	"7-out19724"	.10213	43	378	421
7	"7-out19725"	.34403	150	286	436
7	"7-out19726"	.13715	79	497	576
7	"7-out19727"	.50147	509	506	1015
7	"7-out19728"	.18157	272	1226	1498
7	"7-out19729"	.19132	97	410	507
7	"7-out19730"	.25899	324	927	1251
7	"7-out19731"	.29542	239	570	809
7	"7-out19732"	.30555	44	100	144
7	"7-out19733"	.15625	25	135	160
7	"7-out19734"	.57553	80	59	139
7	"7-out19735"	.31003	102	227	329
7	"7-out19736"	.29232	278	673	951
7	"7-out19737"	.24387	189	586	775
7	"7-out19738"	.14444	78	462	540
7	"7-out19739"	.28818	217	536	753
7	"7-out19740"	.25595	43	125	168
7	"7-out19741"	.29120	53	129	182
7	"7-out19742"	.26978	75	203	278
7	"7-out19743"	.32551	236	489	725
7	"7-out19744"	.82841	1067	221	1288
7	"7-out19745"	.18287	188	840	1028
7	"7-out19746"	.82841	1067	221	1288
7	"7-out19747"	.28363	371	937	1308
7	"7-out19748"	.18223	238	1068	1306
7	"7-out19749"	.28903	672	1653	2325
7	"7-out19750"	.39490	62	95	157
7	"7-out19751"	.12371	169	1197	1366
7	"7-out19752"	.12278	180	1286	1466
7	"7-out19753"	.71476	213	85	298
7	"7-out19754"	.91071	51	5	56
7	"7-out19755"	.37254	76	128	204
7	"7-out19756"	.17553	99	465	564
7	"7-out19757"	.47169	75	84	159
7	"7-out19758"	.27307	216	575	791
7	"7-out19759"	.28848	551	1359	1910
7	"7-out19760"	.22543	273	938	1211
7	"7-out19761"	.44141	1100	1392	2492
7	"7-out19762"	.17526	163	767	930
7	"7-out19763"	.22961	366	1228	1594
7	"7-out19764"	.93171	423	31	454
7	"7-out19765"	.21831	267	956	1223
7	"7-out19766"	.18790	230	994	1224
7	"7-out19767"	.20165	195	772	967
7	"7-out19768"	.23657	163	526	689
7	"7-out19769"	.24049	196	619	815
7	"7-out19770"	.98750	79	1	80
7	"7-out19771"	.40563	144	211	355
7	"7-out19772"	.70914	256	105	361
7	"7-out19773"	.21035	65	244	309
7	"7-out19774"	.27005	340	919	1259
7	"7-out19775"	.18192	149	670	819
7	"7-out19776"	.23744	156	501	657
7	"7-out19777"	.18328	136	606	742
7	"7-out19778"	.12337	19	135	154
7	"7-out19779"	.53719	65	56	121
7	"7-out19780"	.18901	86	369	455
7	"7-out19781"	.35714	40	72	112
7	"7-out19782"	.15021	35	198	233
7	"7-out19783"	.50588	43	42	85
7	"7-out19784"	.30500	61	139	200
7	"7-out19785"	.48087	88	95	183
7	"7-out19786"	.20202	40	158	198
7	"7-out19787"	.31188	63	139	202
7	"7-out19788"	.30412	59	135	194
7	"7-out19789"	.85029	284	50	334
7	"7-out19790"	.14002	106	651	757
7	"7-out19791"	.15129	41	230	271
7	"7-out19792"	.20145	250	991	1241
7	"7-out19793"	.23863	294	938	1232
7	"7-out19794"	.21261	209	774	983
7	"7-out19795"	.50344	73	72	145
7	"7-out19796"	.20958	70	264	334
7	"7-out19797"	.32507	105	218	323
7	"7-out19798"	.07492	49	605	654
7	"7-out19799"	.83283	279	56	335
7	"7-out19800"	.19281	236	988	1224
7	"7-out19801"	.37783	150	247	397
7	"7-out19802"	.37950	137	224	361
7	"7-out19803"	.12962	49	329	378
7	"7-out19804"	.15644	51	275	326
7	"7-out19805"	.12096	45	327	372
7	"7-out19806"	.28000	49	126	175
7	"7-out19807"	.16030	63	330	393
7	"7-out19808"	.22383	77	267	344
7	"7-out19809"	.13612	52	330	382
7	"7-out19810"	.44473	169	211	380
7	"7-out19811"	.28571	106	265	371
7	"7-out19812"	.67833	310	147	457
7	"7-out19813"	.33333	30	60	90
7	"7-out19814"	.17002	76	371	447
7	"7-out19815"	.56231	194	151	345
7	"7-out19816"	.25000	283	849	1132
7	"7-out19817"	.18365	218	969	1187
7	"7-out19818"	.45168	1192	1447	2639
7	"7-out19819"	.92948	725	55	780
7	"7-out19820"	.29674	146	346	492
7	"7-out19821"	.24420	158	489	647
7	"7-out19822"	.69918	172	74	246
7	"7-out19823"	.27559	70	184	254
7	"7-out19824"	.18354	87	387	474
7	"7-out19825"	.20259	78	307	385
7	"7-out19826"	.26432	392	1091	1483
7	"7-out19827"	.33070	42	85	127
7	"7-out19828"	.33025	716	1452	2168
7	"7-out19829"	.13600	17	108	125
7	"7-out19830"	.23802	169	541	710
7	"7-out19831"	.23940	113	359	472
7	"7-out19832"	.29770	259	611	870
7	"7-out19833"	.17465	102	482	584
7	"7-out19834"	.27659	130	340	470
7	"7-out19835"	.31992	175	372	547
7	"7-out19836"	.32943	310	631	941
7	"7-out19837"	.62621	1099	656	1755
7	"7-out19838"	.31718	144	310	454
7	"7-out19839"	.13739	97	609	706
7	"7-out19840"	.85000	85	15	100
7	"7-out19841"	.27351	410	1089	1499
7	"7-out19842"	.16690	238	1188	1426
7	"7-out19843"	.28279	97	246	343
7	"7-out19844"	.48513	1273	1351	2624
7	"7-out19845"	.23440	139	454	593
7	"7-out19846"	.45562	77	92	169
7	"7-out19847"	.36200	101	178	279
7	"7-out19848"	.33911	176	343	519
7	"7-out19849"	.21538	126	459	585
7	"7-out19850"	.13922	93	575	668
7	"7-out19851"	.73333	110	40	150
7	"7-out19852"	.65333	49	26	75
7	"7-out19853"	.75000	60	20	80
7	"7-out19854"	.85849	91	15	106
7	"7-out19855"	.42028	29	40	69
7	"7-out19856"	.81600	102	23	125
7	"7-out19857"	.53153	59	52	111
7	"7-out19858"	.60000	72	48	120
7	"7-out19859"	.90990	101	10	111
7	"7-out19860"	.21333	96	354	450
7	"7-out19861"	.25112	167	498	665
7	"7-out19862"	.45060	187	228	415
7	"7-out19863"	.20679	140	537	677
7	"7-out19864"	.93502	331	23	354
7	"7-out19865"	.89447	356	42	398
7	"7-out19866"	.43805	99	127	226
7	"7-out19867"	.17903	41	188	229
7	"7-out19868"	.18539	66	290	356
7	"7-out19869"	.27077	101	272	373
7	"7-out19870"	.85714	270	45	315
7	"7-out19871"	.53750	86	74	160
7	"7-out19872"	.21472	35	128	163
7	"7-out19873"	.58715	192	135	327
7	"7-out19874"	.06951	13	174	187
7	"7-out19875"	.91324	200	19	219
7	"7-out19876"	.55042	131	107	238
7	"7-out19877"	.21254	122	452	574
7	"7-out19878"	.20016	237	947	1184
7	"7-out19879"	.26415	56	156	212
7	"7-out19880"	.32080	128	271	399
7	"7-out19881"	.12960	88	591	679
7	"7-out19882"	.09433	10	96	106
7	"7-out19883"	.22513	163	561	724
7	"7-out19884"	.11788	87	651	738
7	"7-out19885"	.27146	117	314	431
7	"7-out19886"	.95833	92	4	96
7	"7-out19887"	.17326	232	1107	1339
7	"7-out19888"	.21393	307	1128	1435
7	"7-out19889"	.12081	137	997	1134
7	"7-out19890"	.24214	285	892	1177
7	"7-out19891"	.34947	166	309	475
7	"7-out19892"	.10880	131	1073	1204
7	"7-out19893"	.24491	289	891	1180
7	"7-out19894"	.32952	404	822	1226
7	"7-out19895"	.20819	249	947	1196
7	"7-out19896"	.14239	177	1066	1243
7	"7-out19897"	.70609	197	82	279
7	"7-out19898"	.41549	59	83	142
7	"7-out19899"	.22880	197	664	861
7	"7-out19900"	.17894	17	78	95
7	"7-out19901"	.22666	102	348	450
7	"7-out19902"	.23797	277	887	1164
7	"7-out19903"	.35106	99	183	282
7	"7-out19904"	.11590	43	328	371
7	"7-out19905"	.21791	146	524	670
7	"7-out19906"	.18937	196	839	1035
7	"7-out19907"	.11340	33	258	291
7	"7-out19908"	.23144	53	176	229
7	"7-out19909"	.76000	171	54	225
7	"7-out19910"	.29858	295	693	988
7	"7-out19911"	.79611	82	21	103
7	"7-out19912"	.27500	209	551	760
7	"7-out19913"	.15652	126	679	805
7	"7-out19914"	.22594	54	185	239
7	"7-out19915"	.19298	44	184	228
7	"7-out19916"	.16157	37	192	229
7	"7-out19917"	.96261	206	8	214
7	"7-out19918"	.17786	45	208	253
7	"7-out19919"	.92920	210	16	226
7	"7-out19920"	.19421	94	390	484
7	"7-out19921"	.12474	60	421	481
7	"7-out19922"	.33793	98	192	290
7	"7-out19923"	.31840	64	137	201
7	"7-out19924"	.34636	124	234	358
7	"7-out19925"	.24299	104	324	428
7	"7-out19926"	.24163	130	408	538
7	"7-out19927"	.15568	163	884	1047
7	"7-out19928"	.97058	66	2	68
7	"7-out19929"	.26293	61	171	232
7	"7-out19930"	.31067	416	923	1339
7	"7-out19931"	.27456	95	251	346
7	"7-out19932"	.26392	109	304	413
7	"7-out19933"	.26824	125	341	466
7	"7-out19934"	.95918	141	6	147
7	"7-out19935"	.23481	58	189	247
7	"7-out19936"	.88203	329	44	373
7	"7-out19937"	.18529	310	1363	1673
7	"7-out19938"	.31736	53	114	167
7	"7-out19939"	.24193	75	235	310
7	"7-out19940"	.94285	99	6	105
7	"7-out19941"	.04938	4	77	81
7	"7-out19942"	.06024	5	78	83
7	"7-out19943"	.37758	529	872	1401
7	"7-out19944"	.29046	332	811	1143
7	"7-out19945"	.22314	135	470	605
7	"7-out19946"	.21805	157	563	720
7	"7-out19947"	.31044	321	713	1034
7	"7-out19948"	.20180	112	443	555
7	"7-out19949"	.10437	31	266	297
7	"7-out19950"	.70090	389	166	555
7	"7-out19951"	.18139	431	1945	2376
7	"7-out19952"	.24173	139	436	575
7	"7-out19953"	.22441	125	432	557
7	"7-out19954"	.74736	213	72	285
7	"7-out19955"	.32534	95	197	292
7	"7-out19956"	.20735	62	237	299
7	"7-out19957"	.31707	130	280	410
7	"7-out19958"	.51612	128	120	248
7	"7-out19959"	.36781	32	55	87
7	"7-out19960"	.31097	51	113	164
7	"7-out19961"	.17575	58	272	330
7	"7-out19962"	.28664	88	219	307
7	"7-out19963"	.29569	110	262	372
7	"7-out19964"	.21500	43	157	200
7	"7-out19965"	.34519	485	920	1405
7	"7-out19966"	.21346	222	818	1040
7	"7-out19967"	.15009	154	872	1026
7	"7-out19968"	.22859	235	793	1028
7	"7-out19969"	.08887	123	1261	1384
7	"7-out19970"	.19379	175	728	903
7	"7-out19971"	.16755	126	626	752
7	"7-out19972"	.22455	375	1295	1670
7	"7-out19973"	.17633	298	1392	1690
7	"7-out19974"	.18036	305	1386	1691
7	"7-out19975"	.12676	233	1605	1838
7	"7-out19976"	.22922	400	1345	1745
7	"7-out19977"	.22136	371	1305	1676
7	"7-out19978"	.13125	417	2760	3177
7	"7-out19979"	.21300	557	2058	2615
7	"7-out19980"	.92857	234	18	252
7	"7-out19981"	.09090	38	380	418
7	"7-out19982"	.30956	165	368	533
7	"7-out19983"	.31177	135	298	433
7	"7-out19984"	.56818	125	95	220
7	"7-out19985"	.96363	159	6	165
7	"7-out19986"	.19727	116	472	588
7	"7-out19987"	.32203	95	200	295
7	"7-out19988"	.33678	65	128	193
7	"7-out19989"	.17953	93	425	518
7	"7-out19990"	.10691	34	284	318
7	"7-out19991"	.61224	180	114	294
7	"7-out19992"	.50777	98	95	193
7	"7-out19993"	.36655	114	197	311
7	"7-out19994"	.26960	55	149	204
7	"7-out19995"	.19306	39	163	202
7	"7-out19996"	.20258	47	185	232
7	"7-out19997"	.21394	135	496	631
7	"7-out19998"	.16263	74	381	455
7	"7-out19999"	.34482	120	228	348
7	"7-out20000"	.29024	256	626	882
7	"7-out20001"	.21502	83	303	386
7	"7-out20002"	.08018	34	390	424
7	"7-out20003"	.21218	94	349	443
7	"7-out20004"	.26420	93	259	352
7	"7-out20005"	.26811	111	303	414
7	"7-out20006"	.33634	186	367	553
7	"7-out20007"	.32467	25	52	77
7	"7-out20008"	.31117	117	259	376
7	"7-out20009"	.53623	37	32	69
7	"7-out20010"	.22706	245	834	1079
7	"7-out20011"	.92105	175	15	190
7	"7-out20012"	.24686	59	180	239
7	"7-out20013"	.39603	40	61	101
7	"7-out20014"	.33004	67	136	203
7	"7-out20015"	.71296	77	31	108
7	"7-out20016"	.25984	33	94	127
7	"7-out20017"	.37093	684	1160	1844
7	"7-out20018"	.47838	166	181	347
7	"7-out20019"	.87384	1136	164	1300
7	"7-out20020"	.24244	289	903	1192
7	"7-out20021"	.31726	441	949	1390
7	"7-out20022"	.81327	527	121	648
7	"7-out20023"	.24903	129	389	518
7	"7-out20024"	.21862	108	386	494
7	"7-out20025"	.73571	103	37	140
7	"7-out20026"	.18134	35	158	193
7	"7-out20027"	.21511	447	1631	2078
7	"7-out20028"	.31360	53	116	169
7	"7-out20029"	.93650	118	8	126
7	"7-out20030"	.90163	110	12	122
7	"7-out20031"	.17163	144	695	839
7	"7-out20032"	.42316	391	533	924
7	"7-out20033"	.17924	19	87	106
7	"7-out20034"	.30897	186	416	602
7	"7-out20035"	.13847	244	1518	1762
7	"7-out20036"	.64984	618	333	951
7	"7-out20037"	.37439	155	259	414
7	"7-out20038"	.97637	124	3	127
7	"7-out20039"	.54180	337	285	622
7	"7-out20040"	.39591	97	148	245
7	"7-out20041"	.40458	53	78	131
7	"7-out20042"	.17469	29	137	166
7	"7-out20043"	.21573	96	349	445
7	"7-out20044"	.94578	157	9	166
7	"7-out20045"	.98513	265	4	269
7	"7-out20046"	.67605	48	23	71
7	"7-out20047"	.83596	265	52	317
7	"7-out20048"	.17241	25	120	145
7	"7-out20049"	.15591	87	471	558
7	"7-out20050"	.21612	126	457	583
7	"7-out20051"	.26062	141	400	541
7	"7-out20052"	.84946	79	14	93
7	"7-out20053"	.46722	556	634	1190
7	"7-out20054"	.25141	89	265	354
7	"7-out20055"	.25874	244	699	943
7	"7-out20056"	.89374	614	73	687
7	"7-out20057"	.26283	215	603	818
7	"7-out20058"	.13941	104	642	746
7	"7-out20059"	.15765	137	732	869
7	"7-out20060"	.19736	45	183	228
7	"7-out20061"	.22131	54	190	244
7	"7-out20062"	.09578	25	236	261
7	"7-out20063"	.21800	46	165	211
7	"7-out20064"	.24347	56	174	230
7	"7-out20065"	.22727	50	170	220
7	"7-out20066"	.60454	133	87	220
7	"7-out20067"	.12888	29	196	225
7	"7-out20068"	.07784	13	154	167
7	"7-out20069"	.60995	147	94	241
7	"7-out20070"	.33474	79	157	236
7	"7-out20071"	.46875	330	374	704
7	"7-out20072"	.35736	228	410	638
7	"7-out20073"	.45876	89	105	194
7	"7-out20074"	.21987	73	259	332
7	"7-out20075"	.30563	114	259	373
7	"7-out20076"	.18000	270	1230	1500
7	"7-out20077"	.74864	414	139	553
7	"7-out20078"	.29699	188	445	633
7	"7-out20079"	.21238	48	178	226
7	"7-out20080"	.92284	311	26	337
7	"7-out20081"	.31404	38	83	121
7	"7-out20082"	.15955	228	1201	1429
7	"7-out20083"	.10954	132	1073	1205
7	"7-out20084"	.16472	184	933	1117
7	"7-out20085"	.77224	1302	384	1686
7	"7-out20086"	.28121	250	639	889
7	"7-out20087"	.24386	348	1079	1427
7	"7-out20088"	.15806	193	1028	1221
7	"7-out20089"	.32520	427	886	1313
7	"7-out20090"	.23766	212	680	892
7	"7-out20091"	.15609	64	346	410
7	"7-out20092"	.39502	143	219	362
7	"7-out20093"	.17283	112	536	648
7	"7-out20094"	.17006	25	122	147
7	"7-out20095"	.22027	113	400	513
7	"7-out20096"	.17785	106	490	596
7	"7-out20097"	.36212	218	384	602
7	"7-out20098"	.19042	342	1454	1796
7	"7-out20099"	.88719	291	37	328
7	"7-out20100"	.16516	55	278	333
7	"7-out20101"	.88200	299	40	339
7	"7-out20102"	.90214	295	32	327
7	"7-out20103"	.28754	291	721	1012
7	"7-out20104"	.22157	191	671	862
7	"7-out20105"	.42091	165	227	392
7	"7-out20106"	.17244	169	811	980
7	"7-out20107"	.15989	118	620	738
7	"7-out20108"	.25603	212	616	828
7	"7-out20109"	.26936	226	613	839
7	"7-out20110"	.32727	252	518	770
7	"7-out20111"	.29901	183	429	612
7	"7-out20112"	.15710	252	1352	1604
7	"7-out20113"	.17434	261	1236	1497
7	"7-out20114"	.20068	352	1402	1754
7	"7-out20115"	.75868	437	139	576
7	"7-out20116"	.18388	210	932	1142
7	"7-out20117"	.27102	348	936	1284
7	"7-out20118"	.13718	38	239	277
7	"7-out20119"	.16974	46	225	271
7	"7-out20120"	.20480	196	761	957
7	"7-out20121"	.89516	111	13	124
7	"7-out20122"	.22471	60	207	267
7	"7-out20123"	.33000	33	67	100
7	"7-out20124"	.54477	219	183	402
7	"7-out20125"	.16666	62	310	372
7	"7-out20126"	.28645	110	274	384
7	"7-out20127"	.28678	115	286	401
7	"7-out20128"	.24937	99	298	397
7	"7-out20129"	.19536	177	729	906
7	"7-out20130"	.21091	201	752	953
7	"7-out20131"	.13253	55	360	415
7	"7-out20132"	.26810	137	374	511
7	"7-out20133"	.15686	32	172	204
7	"7-out20134"	.16018	140	734	874
7	"7-out20135"	.70838	617	254	871
7	"7-out20136"	.23444	98	320	418
7	"7-out20137"	.15463	60	328	388
7	"7-out20138"	.25227	83	246	329
7	"7-out20139"	.94565	174	10	184
7	"7-out20140"	.69473	132	58	190
7	"7-out20141"	.30026	115	268	383
7	"7-out20142"	.23728	42	135	177
7	"7-out20143"	.35238	74	136	210
7	"7-out20144"	.19021	140	596	736
7	"7-out20145"	.19143	161	680	841
7	"7-out20146"	.12460	39	274	313
7	"7-out20147"	.30352	112	257	369
7	"7-out20148"	.39880	67	101	168
7	"7-out20149"	.86516	77	12	89
7	"7-out20150"	.25592	54	157	211
7	"7-out20151"	.13761	45	282	327
7	"7-out20152"	.90697	39	4	43
7	"7-out20153"	.88990	97	12	109
7	"7-out20154"	.90825	99	10	109
7	"7-out20155"	.84615	33	6	39
7	"7-out20156"	.88372	38	5	43
7	"7-out20157"	.84834	179	32	211
7	"7-out20158"	.17692	46	214	260
7	"7-out20159"	.75529	392	127	519
7	"7-out20160"	.18106	132	597	729
7	"7-out20161"	.27941	152	392	544
7	"7-out20162"	.24159	79	248	327
7	"7-out20163"	.14512	64	377	441
7	"7-out20164"	.78091	360	101	461
7	"7-out20165"	.35135	273	504	777
7	"7-out20166"	.15416	74	406	480
7	"7-out20167"	.34306	94	180	274
7	"7-out20168"	.62452	163	98	261
7	"7-out20169"	.73575	142	51	193
7	"7-out20170"	.19585	123	505	628
7	"7-out20171"	.42857	45	60	105
7	"7-out20172"	.19757	163	662	825
7	"7-out20173"	.40127	126	188	314
7	"7-out20174"	.33175	70	141	211
7	"7-out20175"	.22933	258	867	1125
7	"7-out20176"	.35933	152	271	423
7	"7-out20177"	.29468	122	292	414
7	"7-out20178"	.37243	127	214	341
7	"7-out20179"	.16990	70	342	412
7	"7-out20180"	.25751	60	173	233
7	"7-out20181"	.26359	63	176	239
7	"7-out20182"	.29924	913	2138	3051
7	"7-out20183"	.80000	196	49	245
7	"7-out20184"	.26254	68	191	259
7	"7-out20185"	.19333	87	363	450
7	"7-out20186"	.88167	380	51	431
7	"7-out20187"	.34038	161	312	473
7	"7-out20188"	.66666	74	37	111
7	"7-out20189"	.84126	53	10	63
7	"7-out20190"	.65277	47	25	72
7	"7-out20191"	.72641	77	29	106
7	"7-out20192"	.45569	36	43	79
7	"7-out20193"	.67968	87	41	128
7	"7-out20194"	.50918	194	187	381
7	"7-out20195"	.21079	125	468	593
7	"7-out20196"	.12885	230	1555	1785
7	"7-out20197"	.15412	127	697	824
7	"7-out20198"	.92105	455	39	494
7	"7-out20199"	.89583	129	15	144
7	"7-out20200"	.26555	111	307	418
7	"7-out20201"	.31220	719	1584	2303
7	"7-out20202"	.12121	12	87	99
7	"7-out20203"	.30308	157	361	518
7	"7-out20204"	.21818	24	86	110
7	"7-out20205"	.21311	39	144	183
7	"7-out20206"	.21000	21	79	100
7	"7-out20207"	.21556	108	393	501
7	"7-out20208"	.90313	317	34	351
7	"7-out20209"	.06030	12	187	199
7	"7-out20210"	.17487	135	637	772
7	"7-out20211"	.31565	125	271	396
7	"7-out20212"	.51145	67	64	131
7	"7-out20213"	.95180	316	16	332
7	"7-out20214"	.25375	152	447	599
7	"7-out20215"	.21014	87	327	414
7	"7-out20216"	.27033	113	305	418
7	"7-out20217"	.27120	307	825	1132
7	"7-out20218"	.10980	112	908	1020
7	"7-out20219"	.15937	164	865	1029
7	"7-out20220"	.25451	310	908	1218
7	"7-out20221"	.50825	154	149	303
7	"7-out20222"	.22969	82	275	357
7	"7-out20223"	.17786	217	1003	1220
7	"7-out20224"	.15862	46	244	290
7	"7-out20225"	.16357	203	1038	1241
7	"7-out20226"	.18933	174	745	919
7	"7-out20227"	.56000	56	44	100
7	"7-out20228"	.22868	59	199	258
7	"7-out20229"	.28535	339	849	1188
7	"7-out20230"	.70388	851	358	1209
7	"7-out20231"	.93000	186	14	200
7	"7-out20232"	.23942	215	683	898
7	"7-out20233"	.48387	45	48	93
7	"7-out20234"	.11920	18	133	151
7	"7-out20235"	.29596	66	157	223
7	"7-out20236"	.43162	101	133	234
7	"7-out20237"	.32812	42	86	128
7	"7-out20238"	.87962	95	13	108
7	"7-out20239"	.28666	43	107	150
7	"7-out20240"	.20985	98	369	467
7	"7-out20241"	.33333	44	88	132
7	"7-out20242"	.92517	136	11	147
7	"7-out20243"	.91244	198	19	217
7	"7-out20244"	.22522	75	258	333
7	"7-out20245"	.33606	41	81	122
7	"7-out20246"	.31724	46	99	145
7	"7-out20247"	.28000	77	198	275
7	"7-out20248"	.17886	22	101	123
7	"7-out20249"	.09745	23	213	236
7	"7-out20250"	.38730	122	193	315
7	"7-out20251"	.29109	85	207	292
7	"7-out20252"	.43478	50	65	115
7	"7-out20253"	.35897	28	50	78
7	"7-out20254"	.22556	427	1466	1893
7	"7-out20255"	.76877	389	117	506
7	"7-out20256"	.95168	650	33	683
7	"7-out20257"	.21062	428	1604	2032
7	"7-out20258"	.16676	282	1409	1691
7	"7-out20259"	.18423	194	859	1053
7	"7-out20260"	.26443	284	790	1074
7	"7-out20261"	.93049	415	31	446
7	"7-out20262"	.93049	415	31	446
7	"7-out20263"	.93382	127	9	136
7	"7-out20264"	.93250	373	27	400
7	"7-out20265"	.21020	272	1022	1294
7	"7-out20266"	.29319	896	2160	3056
7	"7-out20267"	.14153	46	279	325
7	"7-out20268"	.30459	53	121	174
7	"7-out20269"	.26178	50	141	191
7	"7-out20270"	.18181	12	54	66
7	"7-out20271"	.37500	57	95	152
7	"7-out20272"	.44236	142	179	321
7	"7-out20273"	.27504	162	427	589
7	"7-out20274"	.51196	107	102	209
7	"7-out20275"	.26315	65	182	247
7	"7-out20276"	.20459	187	727	914
7	"7-out20277"	.21951	54	192	246
7	"7-out20278"	.90839	238	24	262
7	"7-out20279"	.52822	131	117	248
7	"7-out20280"	.86274	44	7	51
7	"7-out20281"	.98136	158	3	161
7	"7-out20282"	.24137	133	418	551
7	"7-out20283"	.79710	55	14	69
7	"7-out20284"	.84861	583	104	687
7	"7-out20285"	.83333	90	18	108
7	"7-out20286"	.21556	36	131	167
7	"7-out20287"	.13140	118	780	898
7	"7-out20288"	.30232	65	150	215
7	"7-out20289"	.24154	50	157	207
7	"7-out20290"	.17049	52	253	305
7	"7-out20291"	.14732	33	191	224
7	"7-out20292"	.18303	41	183	224
7	"7-out20293"	.26484	58	161	219
7	"7-out20294"	.71818	158	62	220
7	"7-out20295"	.15068	44	248	292
7	"7-out20296"	.75909	167	53	220
7	"7-out20297"	.22966	48	161	209
7	"7-out20298"	.16055	35	183	218
7	"7-out20299"	.42654	90	121	211
7	"7-out20300"	.30875	67	150	217
7	"7-out20301"	.35409	216	394	610
7	"7-out20302"	.16097	66	344	410
7	"7-out20303"	.21510	225	821	1046
7	"7-out20304"	.22269	157	548	705
7	"7-out20305"	.60320	301	198	499
7	"7-out20306"	.56187	168	131	299
7	"7-out20307"	.21756	218	784	1002
7	"7-out20308"	.62100	272	166	438
7	"7-out20309"	.37942	118	193	311
7	"7-out20310"	.18482	212	935	1147
7	"7-out20311"	.20075	53	211	264
7	"7-out20312"	.13461	35	225	260
7	"7-out20313"	.17647	30	140	170
7	"7-out20314"	.68527	135	62	197
7	"7-out20315"	.94663	408	23	431
7	"7-out20316"	.32432	60	125	185
7	"7-out20317"	.21010	79	297	376
7	"7-out20318"	.20707	82	314	396
7	"7-out20319"	.94339	250	15	265
7	"7-out20320"	.96226	153	6	159
7	"7-out20321"	.84729	172	31	203
7	"7-out20322"	.64675	249	136	385
7	"7-out20323"	.17412	35	166	201
7	"7-out20324"	.17026	71	346	417
7	"7-out20325"	.16972	74	362	436
7	"7-out20326"	.13882	59	366	425
7	"7-out20327"	.47418	395	438	833
7	"7-out20328"	.54325	157	132	289
7	"7-out20329"	.36544	349	606	955
7	"7-out20330"	.89510	128	15	143
7	"7-out20331"	.33108	98	198	296
7	"7-out20332"	.94430	373	22	395
7	"7-out20333"	.84441	597	110	707
7	"7-out20334"	.95189	376	19	395
7	"7-out20335"	.24548	68	209	277
7	"7-out20336"	.28695	330	820	1150
7	"7-out20337"	.20408	20	78	98
7	"7-out20338"	.18851	174	749	923
7	"7-out20339"	.41786	262	365	627
7	"7-out20340"	.62573	428	256	684
7	"7-out20341"	.20426	115	448	563
7	"7-out20342"	.23856	73	233	306
7	"7-out20343"	.26262	26	73	99
7	"7-out20344"	.26371	173	483	656
7	"7-out20345"	.24242	24	75	99
7	"7-out20346"	.45890	134	158	292
7	"7-out20347"	.21219	87	323	410
7	"7-out20348"	.22433	118	408	526
7	"7-out20349"	.18309	65	290	355
7	"7-out20350"	.50417	181	178	359
7	"7-out20351"	.35754	256	460	716
7	"7-out20352"	.86842	66	10	76
7	"7-out20353"	.72891	1046	389	1435
7	"7-out20354"	.53687	364	314	678
7	"7-out20355"	.50505	200	196	396
7	"7-out20356"	.42063	53	73	126
7	"7-out20357"	.93600	117	8	125
7	"7-out20358"	.30846	612	1372	1984
7	"7-out20359"	.35567	207	375	582
7	"7-out20360"	.19211	151	635	786
7	"7-out20361"	.83253	174	35	209
7	"7-out20362"	.15894	24	127	151
7	"7-out20363"	.28246	124	315	439
7	"7-out20364"	.48598	104	110	214
7	"7-out20365"	.23496	168	547	715
7	"7-out20366"	.80341	188	46	234
7	"7-out20367"	.94029	189	12	201
7	"7-out20368"	.76305	380	118	498
7	"7-out20369"	.95189	376	19	395
7	"7-out20370"	.86800	388	59	447
7	"7-out20371"	.88489	246	32	278
7	"7-out20372"	.53937	137	117	254
7	"7-out20373"	.88043	81	11	92
7	"7-out20374"	.94073	1000	63	1063
7	"7-out20375"	.33471	81	161	242
7	"7-out20376"	.46808	110	125	235
7	"7-out20377"	.92328	349	29	378
7	"7-out20378"	.39786	224	339	563
7	"7-out20379"	.93069	94	7	101
7	"7-out20380"	.52650	149	134	283
7	"7-out20381"	.23992	274	868	1142
7	"7-out20382"	.34029	114	221	335
7	"7-out20383"	.44680	42	52	94
7	"7-out20384"	.80434	74	18	92
7	"7-out20385"	.35543	134	243	377
7	"7-out20386"	.37170	310	524	834
7	"7-out20387"	.33430	115	229	344
7	"7-out20388"	.30362	109	250	359
7	"7-out20389"	.21631	61	221	282
7	"7-out20390"	.36700	109	188	297
7	"7-out20391"	.25110	114	340	454
7	"7-out20392"	.29194	221	536	757
7	"7-out20393"	.33944	111	216	327
7	"7-out20394"	.28189	95	242	337
7	"7-out20395"	.26865	90	245	335
7	"7-out20396"	.77555	387	112	499
7	"7-out20397"	.31269	101	222	323
7	"7-out20398"	.90588	77	8	85
7	"7-out20399"	.53629	266	230	496
7	"7-out20400"	.92236	499	42	541
7	"7-out20401"	.21941	226	804	1030
7	"7-out20402"	.33333	29	58	87
7	"7-out20403"	.22307	29	101	130
7	"7-out20404"	.38078	107	174	281
7	"7-out20405"	.20824	101	384	485
7	"7-out20406"	.88653	836	107	943
7	"7-out20407"	.35444	291	530	821
7	"7-out20408"	.35763	103	185	288
7	"7-out20409"	.43502	77	100	177
7	"7-out20410"	.23255	40	132	172
7	"7-out20411"	.83798	450	87	537
7	"7-out20412"	.29208	144	349	493
8	"8-out1"	.95058	404	21	425
8	"8-out2"	.98305	638	11	649
8	"8-out3"	.27456	95	251	346
8	"8-out4"	.32768	116	238	354
8	"8-out5"	.31851	86	184	270
8	"8-out6"	.28106	95	243	338
8	"8-out7"	.72467	558	212	770
8	"8-out8"	.27460	173	457	630
8	"8-out9"	.30481	114	260	374
8	"8-out10"	.28644	560	1395	1955
8	"8-out11"	.94506	757	44	801
8	"8-out12"	.22983	758	2540	3298
8	"8-out13"	.19672	228	931	1159
8	"8-out14"	.23524	267	868	1135
8	"8-out15"	.85373	788	135	923
8	"8-out16"	.85252	792	137	929
8	"8-out17"	.21350	215	792	1007
8	"8-out18"	.17372	164	780	944
8	"8-out19"	.80665	751	180	931
8	"8-out20"	.85407	796	136	932
8	"8-out21"	.25401	395	1160	1555
8	"8-out22"	.31395	108	236	344
8	"8-out23"	.14800	37	213	250
8	"8-out24"	.33870	168	328	496
8	"8-out25"	.48789	383	402	785
8	"8-out26"	.68076	177	83	260
8	"8-out27"	.77483	585	170	755
8	"8-out28"	.26934	261	708	969
8	"8-out29"	.27642	102	267	369
8	"8-out30"	.18682	380	1654	2034
8	"8-out31"	.30631	359	813	1172
8	"8-out32"	.25698	92	266	358
8	"8-out33"	.98611	284	4	288
8	"8-out34"	.99418	342	2	344
8	"8-out35"	.60964	278	178	456
8	"8-out36"	.58916	522	364	886
8	"8-out37"	.64168	548	306	854
8	"8-out38"	.30303	260	598	858
8	"8-out39"	.19061	65	276	341
8	"8-out40"	.35779	156	280	436
8	"8-out41"	.12087	44	320	364
8	"8-out42"	.28078	114	292	406
8	"8-out43"	.68705	382	174	556
8	"8-out44"	.29540	135	322	457
8	"8-out45"	.69300	228	101	329
8	"8-out46"	.88282	776	103	879
8	"8-out47"	.14152	76	461	537
8	"8-out48"	.62944	496	292	788
8	"8-out49"	.22180	59	207	266
8	"8-out50"	.61415	269	169	438
8	"8-out51"	.65135	241	129	370
8	"8-out52"	.99365	313	2	315
8	"8-out53"	.27642	170	445	615
8	"8-out54"	.19207	126	530	656
8	"8-out55"	.28879	214	527	741
8	"8-out56"	.48584	309	327	636
8	"8-out57"	.28709	238	591	829
8	"8-out58"	.45020	217	265	482
8	"8-out59"	.36431	294	513	807
8	"8-out60"	.27576	206	541	747
8	"8-out61"	.36301	106	186	292
8	"8-out62"	.27916	134	346	480
8	"8-out63"	.23788	211	676	887
8	"8-out64"	.26639	662	1823	2485
8	"8-out65"	.21651	257	930	1187
8	"8-out66"	.15914	134	708	842
8	"8-out67"	.30258	269	620	889
8	"8-out68"	.22758	99	336	435
8	"8-out69"	.38537	311	496	807
8	"8-out70"	.22493	368	1268	1636
8	"8-out71"	.78072	324	91	415
8	"8-out72"	.17634	161	752	913
8	"8-out73"	.51470	175	165	340
8	"8-out74"	.47656	61	67	128
8	"8-out75"	.23697	141	454	595
8	"8-out76"	.85809	647	107	754
8	"8-out77"	.46108	468	547	1015
8	"8-out78"	.21321	171	631	802
8	"8-out79"	.22433	448	1549	1997
8	"8-out80"	.35145	459	847	1306
8	"8-out81"	.18563	354	1553	1907
8	"8-out82"	.48968	546	569	1115
8	"8-out83"	.12809	186	1266	1452
8	"8-out84"	.98039	600	12	612
8	"8-out85"	.24719	22	67	89
8	"8-out86"	.27178	393	1053	1446
8	"8-out87"	.36393	337	589	926
8	"8-out88"	.25000	34	102	136
8	"8-out89"	.16187	45	233	278
8	"8-out90"	.20458	116	451	567
8	"8-out91"	.97872	414	9	423
8	"8-out92"	.98216	881	16	897
8	"8-out93"	.44724	195	241	436
8	"8-out94"	.54444	98	82	180
8	"8-out95"	.99705	338	1	339
8	"8-out96"	.41059	186	267	453
8	"8-out97"	.28698	97	241	338
8	"8-out98"	.46737	788	898	1686
8	"8-out99"	.83606	255	50	305
8	"8-out100"	.30898	165	369	534
8	"8-out101"	.32720	178	366	544
8	"8-out102"	.24936	98	295	393
8	"8-out103"	.30769	172	387	559
8	"8-out104"	.93871	337	22	359
8	"8-out105"	.25925	49	140	189
8	"8-out106"	.18887	224	962	1186
8	"8-out107"	.42319	135	184	319
8	"8-out108"	.68995	158	71	229
8	"8-out109"	.97835	226	5	231
8	"8-out110"	.25634	192	557	749
8	"8-out111"	.31053	168	373	541
8	"8-out112"	.37323	53	89	142
8	"8-out113"	.24404	41	127	168
8	"8-out114"	.89090	147	18	165
8	"8-out115"	.89459	331	39	370
8	"8-out116"	.15745	282	1509	1791
8	"8-out117"	.22964	141	473	614
8	"8-out118"	.99487	971	5	976
8	"8-out119"	.34644	185	349	534
8	"8-out120"	.19747	47	191	238
8	"8-out121"	.99317	1018	7	1025
8	"8-out122"	.17745	74	343	417
8	"8-out123"	.33823	69	135	204
8	"8-out124"	.45974	177	208	385
8	"8-out125"	.24566	85	261	346
8	"8-out126"	.28199	119	303	422
8	"8-out127"	.20967	65	245	310
8	"8-out128"	.27872	359	929	1288
8	"8-out129"	.80901	754	178	932
8	"8-out130"	.18552	100	439	539
8	"8-out131"	.11670	109	825	934
8	"8-out132"	.82383	781	167	948
8	"8-out133"	.45140	483	587	1070
8	"8-out134"	.83351	776	155	931
8	"8-out135"	.32461	149	310	459
8	"8-out136"	.84763	790	142	932
8	"8-out137"	.81789	777	173	950
8	"8-out138"	.84315	801	149	950
8	"8-out139"	.28957	75	184	259
8	"8-out140"	.90571	317	33	350
8	"8-out141"	.68055	294	138	432
8	"8-out142"	.24737	1272	3870	5142
8	"8-out143"	.64750	169	92	261
8	"8-out144"	.43548	27	35	62
8	"8-out145"	.12917	58	391	449
8	"8-out146"	.98130	105	2	107
8	"8-out147"	.20752	386	1474	1860
8	"8-out148"	.44686	164	203	367
8	"8-out149"	.19692	461	1880	2341
8	"8-out150"	.28020	109	280	389
8	"8-out151"	.42452	90	122	212
8	"8-out152"	.23106	180	599	779
8	"8-out153"	.56907	276	209	485
8	"8-out154"	.26657	189	520	709
8	"8-out155"	.28374	267	674	941
8	"8-out156"	.28220	322	819	1141
8	"8-out157"	.35062	169	313	482
8	"8-out158"	.12222	55	395	450
8	"8-out159"	.24740	667	2029	2696
8	"8-out160"	.27220	95	254	349
8	"8-out161"	.41142	144	206	350
8	"8-out162"	.96747	238	8	246
8	"8-out163"	.31250	100	220	320
8	"8-out164"	.98684	75	1	76
8	"8-out165"	.25527	230	671	901
8	"8-out166"	.18202	81	364	445
8	"8-out167"	.36042	204	362	566
8	"8-out168"	.28185	188	479	667
8	"8-out169"	.62907	463	273	736
8	"8-out170"	.77450	79	23	102
8	"8-out171"	.62411	176	106	282
8	"8-out172"	.32315	307	643	950
8	"8-out173"	.27321	153	407	560
8	"8-out174"	.22376	113	392	505
8	"8-out175"	.37826	174	286	460
8	"8-out176"	.28600	280	699	979
8	"8-out177"	.26149	307	867	1174
8	"8-out178"	.12781	34	232	266
8	"8-out179"	.11217	35	277	312
8	"8-out180"	.97297	36	1	37
8	"8-out181"	.41900	388	538	926
8	"8-out182"	.27787	157	408	565
8	"8-out183"	.21111	76	284	360
8	"8-out184"	.36256	215	378	593
8	"8-out185"	.19000	19	81	100
8	"8-out186"	.97315	145	4	149
8	"8-out187"	.62616	134	80	214
8	"8-out188"	.29041	97	237	334
8	"8-out189"	.24203	76	238	314
8	"8-out190"	.23463	84	274	358
8	"8-out191"	.21522	311	1134	1445
8	"8-out192"	.22513	301	1036	1337
8	"8-out193"	.75162	1501	496	1997
8	"8-out194"	.28462	187	470	657
8	"8-out195"	.24127	470	1478	1948
8	"8-out196"	.33593	43	85	128
8	"8-out197"	.43384	141	184	325
8	"8-out198"	.20138	58	230	288
8	"8-out199"	.27343	633	1682	2315
8	"8-out200"	.25938	76	217	293
8	"8-out201"	.51724	75	70	145
8	"8-out202"	.22509	61	210	271
8	"8-out203"	.17411	74	351	425
8	"8-out204"	.37688	150	248	398
8	"8-out205"	.92818	1034	80	1114
8	"8-out206"	.95327	204	10	214
8	"8-out207"	.30056	107	249	356
8	"8-out208"	.39772	140	212	352
8	"8-out209"	.17796	63	291	354
8	"8-out210"	.48329	188	201	389
8	"8-out211"	.98364	421	7	428
8	"8-out212"	.99033	1025	10	1035
8	"8-out213"	.26693	134	368	502
8	"8-out214"	.25158	119	354	473
8	"8-out215"	.32448	330	687	1017
8	"8-out216"	.99641	278	1	279
8	"8-out217"	.99641	278	1	279
8	"8-out218"	.91584	185	17	202
8	"8-out219"	.99285	139	1	140
8	"8-out220"	.95940	260	11	271
8	"8-out221"	.13694	86	542	628
8	"8-out222"	.35281	163	299	462
8	"8-out223"	.89292	442	53	495
8	"8-out224"	.34453	82	156	238
8	"8-out225"	.38423	234	375	609
8	"8-out226"	.66666	250	125	375
8	"8-out227"	.90041	217	24	241
8	"8-out228"	.23205	139	460	599
8	"8-out229"	.14529	119	700	819
8	"8-out230"	.27517	500	1317	1817
8	"8-out231"	.91588	294	27	321
8	"8-out232"	.43492	137	178	315
8	"8-out233"	.86241	257	41	298
8	"8-out234"	.79245	252	66	318
8	"8-out235"	.90158	284	31	315
8	"8-out236"	.87539	274	39	313
8	"8-out237"	.93610	293	20	313
8	"8-out238"	.23148	75	249	324
8	"8-out239"	.86335	278	44	322
8	"8-out240"	.47021	150	169	319
8	"8-out241"	.84690	260	47	307
8	"8-out242"	.49838	154	155	309
8	"8-out243"	.73786	228	81	309
8	"8-out244"	.86241	257	41	298
8	"8-out245"	.88719	291	37	328
8	"8-out246"	.28938	90	221	311
8	"8-out247"	.35759	113	203	316
8	"8-out248"	.32258	100	210	310
8	"8-out249"	.29629	96	228	324
8	"8-out250"	.33977	123	239	362
8	"8-out251"	.88387	274	36	310
8	"8-out252"	.90415	283	30	313
8	"8-out253"	.89743	280	32	312
8	"8-out254"	.93589	292	20	312
8	"8-out255"	.92628	289	23	312
8	"8-out256"	.88461	276	36	312
8	"8-out257"	.91987	287	25	312
8	"8-out258"	.91666	286	26	312
8	"8-out259"	.85840	291	48	339
8	"8-out260"	.86513	263	41	304
8	"8-out261"	.33006	202	410	612
8	"8-out262"	.34387	87	166	253
8	"8-out263"	.25600	64	186	250
8	"8-out264"	.96978	353	11	364
8	"8-out265"	.97252	354	10	364
8	"8-out266"	.22551	76	261	337
8	"8-out267"	.22142	155	545	700
8	"8-out268"	.68354	486	225	711
8	"8-out269"	.51523	355	334	689
8	"8-out270"	.43416	122	159	281
8	"8-out271"	.30158	76	176	252
8	"8-out272"	.97022	391	12	403
8	"8-out273"	.25787	90	259	349
8	"8-out274"	.54268	178	150	328
8	"8-out275"	.80152	105	26	131
8	"8-out276"	.90954	543	54	597
8	"8-out277"	.61092	537	342	879
8	"8-out278"	.31050	204	453	657
8	"8-out279"	.41526	321	452	773
8	"8-out280"	.36631	137	237	374
8	"8-out281"	.95100	1281	66	1347
8	"8-out282"	.97611	1308	32	1340
8	"8-out283"	.26442	275	765	1040
8	"8-out284"	.20861	247	937	1184
8	"8-out285"	.38709	156	247	403
8	"8-out286"	.18139	78	352	430
8	"8-out287"	.32692	238	490	728
8	"8-out288"	.28135	323	825	1148
8	"8-out289"	.85468	794	135	929
8	"8-out290"	.85265	787	136	923
8	"8-out291"	.84516	786	144	930
8	"8-out292"	.15784	152	811	963
8	"8-out293"	.57264	536	400	936
8	"8-out294"	.22554	279	958	1237
8	"8-out295"	.81536	764	173	937
8	"8-out296"	.77052	732	218	950
8	"8-out297"	.22727	55	187	242
8	"8-out298"	.23311	145	477	622
8	"8-out299"	.52354	189	172	361
8	"8-out300"	.97191	173	5	178
8	"8-out301"	.19117	26	110	136
8	"8-out302"	.20850	103	391	494
8	"8-out303"	.26373	72	201	273
8	"8-out304"	.42025	166	229	395
8	"8-out305"	.19616	92	377	469
8	"8-out306"	.24222	226	707	933
8	"8-out307"	.89600	112	13	125
8	"8-out308"	.99476	190	1	191
8	"8-out309"	.19962	107	429	536
8	"8-out310"	.65560	158	83	241
8	"8-out311"	.39325	280	432	712
8	"8-out312"	.29419	238	571	809
8	"8-out313"	.33273	370	742	1112
8	"8-out314"	.30277	251	578	829
8	"8-out315"	.27570	244	641	885
8	"8-out316"	.17297	64	306	370
8	"8-out317"	.14666	22	128	150
8	"8-out318"	.30331	64	147	211
8	"8-out319"	.31828	134	287	421
8	"8-out320"	.93069	470	35	505
8	"8-out321"	.29045	70	171	241
8	"8-out322"	.14742	60	347	407
8	"8-out323"	.24848	82	248	330
8	"8-out324"	.40771	243	353	596
8	"8-out325"	.95707	379	17	396
8	"8-out326"	.17901	29	133	162
8	"8-out327"	.17948	56	256	312
8	"8-out328"	.30314	77	177	254
8	"8-out329"	.94845	368	20	388
8	"8-out330"	.24929	177	533	710
8	"8-out331"	.22938	89	299	388
8	"8-out332"	.32552	278	576	854
8	"8-out333"	.67407	91	44	135
8	"8-out334"	.44049	322	409	731
8	"8-out335"	.26041	75	213	288
8	"8-out336"	.15633	58	313	371
8	"8-out337"	.93584	744	51	795
8	"8-out338"	.92191	732	62	794
8	"8-out339"	.93081	740	55	795
8	"8-out340"	.84919	794	141	935
8	"8-out341"	.96004	913	38	951
8	"8-out342"	.95231	699	35	734
8	"8-out343"	.24245	707	2209	2916
8	"8-out344"	.80147	759	188	947
8	"8-out345"	.81894	778	172	950
8	"8-out346"	.84871	791	141	932
8	"8-out347"	.85149	797	139	936
8	"8-out348"	.33253	138	277	415
8	"8-out349"	.28179	195	497	692
8	"8-out350"	.21665	463	1674	2137
8	"8-out351"	.22574	114	391	505
8	"8-out352"	.18620	54	236	290
8	"8-out353"	.27855	100	259	359
8	"8-out354"	.54032	469	399	868
8	"8-out355"	.11494	70	539	609
8	"8-out356"	.27102	145	390	535
8	"8-out357"	.29759	136	321	457
8	"8-out358"	.99163	237	2	239
8	"8-out359"	.25271	186	550	736
8	"8-out360"	.30400	266	609	875
8	"8-out361"	.29069	250	610	860
8	"8-out362"	.18150	106	478	584
8	"8-out363"	.17519	89	419	508
8	"8-out364"	.32670	115	237	352
8	"8-out365"	.17500	77	363	440
8	"8-out366"	.33333	28	56	84
8	"8-out367"	.23440	124	405	529
8	"8-out368"	.17293	23	110	133
8	"8-out369"	.56537	160	123	283
8	"8-out370"	.98933	464	5	469
8	"8-out371"	.79285	111	29	140
8	"8-out372"	.24621	699	2140	2839
8	"8-out373"	.99191	859	7	866
8	"8-out374"	.44954	646	791	1437
8	"8-out375"	.53061	338	299	637
8	"8-out376"	.24633	521	1594	2115
8	"8-out377"	.77350	181	53	234
8	"8-out378"	.58823	150	105	255
8	"8-out379"	.46743	122	139	261
8	"8-out380"	.68098	222	104	326
8	"8-out381"	.33742	110	216	326
8	"8-out382"	.46052	175	205	380
8	"8-out383"	.36575	94	163	257
8	"8-out384"	.25765	101	291	392
8	"8-out385"	.17391	52	247	299
8	"8-out386"	.23655	66	213	279
8	"8-out387"	.28346	72	182	254
8	"8-out388"	.17692	23	107	130
8	"8-out389"	.37356	130	218	348
8	"8-out390"	.33827	114	223	337
8	"8-out391"	.91780	67	6	73
8	"8-out392"	.34567	28	53	81
8	"8-out393"	.23976	82	260	342
8	"8-out394"	.44029	177	225	402
8	"8-out395"	.96978	353	11	364
8	"8-out396"	.40677	216	315	531
8	"8-out397"	.26177	139	392	531
8	"8-out398"	.25000	138	414	552
8	"8-out399"	.23082	334	1113	1447
8	"8-out400"	.98863	87	1	88
8	"8-out401"	.32069	110	233	343
8	"8-out402"	.23598	101	327	428
8	"8-out403"	.39047	123	192	315
8	"8-out404"	.24906	200	603	803
8	"8-out405"	.21134	231	862	1093
8	"8-out406"	.22114	159	560	719
8	"8-out407"	.23376	90	295	385
8	"8-out408"	.55789	53	42	95
8	"8-out409"	.30757	199	448	647
8	"8-out410"	.37461	605	1010	1615
8	"8-out411"	.52747	48	43	91
8	"8-out412"	.42268	41	56	97
8	"8-out413"	.24675	57	174	231
8	"8-out414"	.98214	110	2	112
8	"8-out415"	.97435	114	3	117
8	"8-out416"	.31356	571	1250	1821
8	"8-out417"	.48489	289	307	596
8	"8-out418"	.23291	75	247	322
8	"8-out419"	.75675	112	36	148
8	"8-out420"	.28406	344	867	1211
8	"8-out421"	.36503	142	247	389
8	"8-out422"	.97841	136	3	139
8	"8-out423"	.17441	30	142	172
8	"8-out424"	.43950	287	366	653
8	"8-out425"	.50461	164	161	325
8	"8-out426"	.53887	201	172	373
8	"8-out427"	.57993	185	134	319
8	"8-out428"	.77903	275	78	353
8	"8-out429"	.20000	51	204	255
8	"8-out430"	.27167	959	2571	3530
8	"8-out431"	.47859	928	1011	1939
8	"8-out432"	.59257	1149	790	1939
8	"8-out433"	.33415	540	1076	1616
8	"8-out434"	.22371	300	1041	1341
8	"8-out435"	.24803	632	1916	2548
8	"8-out436"	.24675	38	116	154
8	"8-out437"	.99423	1553	9	1562
8	"8-out438"	.20551	149	576	725
8	"8-out439"	.50295	85	84	169
8	"8-out440"	.33216	95	191	286
8	"8-out441"	.23030	304	1016	1320
8	"8-out442"	.77393	760	222	982
8	"8-out443"	.17422	123	583	706
8	"8-out444"	.98275	627	11	638
8	"8-out445"	.98812	416	5	421
8	"8-out446"	.98728	854	11	865
8	"8-out447"	.98805	662	8	670
8	"8-out448"	.27756	146	380	526
8	"8-out449"	.17421	127	602	729
8	"8-out450"	.11669	79	598	677
8	"8-out451"	.32133	2143	4526	6669
8	"8-out452"	.32407	35	73	108
8	"8-out453"	.24189	194	608	802
8	"8-out454"	.99767	1285	3	1288
8	"8-out455"	.32835	132	270	402
8	"8-out456"	.39189	145	225	370
8	"8-out457"	.08620	30	318	348
8	"8-out458"	.18674	62	270	332
8	"8-out459"	.63782	199	113	312
8	"8-out460"	.92307	288	24	312
8	"8-out461"	.81847	257	57	314
8	"8-out462"	.86377	279	44	323
8	"8-out463"	.93294	320	23	343
8	"8-out464"	.52884	165	147	312
8	"8-out465"	.81089	253	59	312
8	"8-out466"	.25277	91	269	360
8	"8-out467"	.67845	211	100	311
8	"8-out468"	.64841	225	122	347
8	"8-out469"	.28295	88	223	311
8	"8-out470"	.37575	124	206	330
8	"8-out471"	.75157	239	79	318
8	"8-out472"	.57877	180	131	311
8	"8-out473"	.37254	133	224	357
8	"8-out474"	.81730	255	57	312
8	"8-out475"	.33123	105	212	317
8	"8-out476"	.85256	266	46	312
8	"8-out477"	.26875	86	234	320
8	"8-out478"	.85389	263	45	308
8	"8-out479"	.29393	97	233	330
8	"8-out480"	.90220	286	31	317
8	"8-out481"	.29126	90	219	309
8	"8-out482"	.62025	196	120	316
8	"8-out483"	.88291	279	37	316
8	"8-out484"	.71153	222	90	312
8	"8-out485"	.39130	135	210	345
8	"8-out486"	.76282	238	74	312
8	"8-out487"	.76923	240	72	312
8	"8-out488"	.83653	261	51	312
8	"8-out489"	.77521	269	78	347
8	"8-out490"	.26688	83	228	311
8	"8-out491"	.77884	243	69	312
8	"8-out492"	.47648	152	167	319
8	"8-out493"	.31978	118	251	369
8	"8-out494"	.80459	280	68	348
8	"8-out495"	.33116	102	206	308
8	"8-out496"	.79220	244	64	308
8	"8-out497"	.95625	306	14	320
8	"8-out498"	.83018	264	54	318
8	"8-out499"	.91091	317	31	348
8	"8-out500"	.89297	267	32	299
8	"8-out501"	.49337	149	153	302
8	"8-out502"	.85889	280	46	326
8	"8-out503"	.43548	135	175	310
8	"8-out504"	.83495	258	51	309
8	"8-out505"	.46774	145	165	310
8	"8-out506"	.79299	249	65	314
8	"8-out507"	.46178	145	169	314
8	"8-out508"	.46153	144	168	312
8	"8-out509"	.89808	282	32	314
8	"8-out510"	.78735	274	74	348
8	"8-out511"	.78205	244	68	312
8	"8-out512"	.93290	292	21	313
8	"8-out513"	.84810	268	48	316
8	"8-out514"	.61038	188	120	308
8	"8-out515"	.83601	260	51	311
8	"8-out516"	.25396	80	235	315
8	"8-out517"	.88853	279	35	314
8	"8-out518"	.38216	120	194	314
8	"8-out519"	.38216	120	194	314
8	"8-out520"	.60383	189	124	313
8	"8-out521"	.86624	272	42	314
8	"8-out522"	.61146	192	122	314
8	"8-out523"	.38216	120	194	314
8	"8-out524"	.57632	185	136	321
8	"8-out525"	.56386	181	140	321
8	"8-out526"	.69055	212	95	307
8	"8-out527"	.65273	203	108	311
8	"8-out528"	.40327	123	182	305
8	"8-out529"	.42765	133	178	311
8	"8-out530"	.28395	92	232	324
8	"8-out531"	.76073	248	78	326
8	"8-out532"	.89705	305	35	340
8	"8-out533"	.21543	67	244	311
8	"8-out534"	.79487	248	64	312
8	"8-out535"	.90384	282	30	312
8	"8-out536"	.88673	274	35	309
8	"8-out537"	.90778	315	32	347
8	"8-out538"	.42900	142	189	331
8	"8-out539"	.30128	94	218	312
8	"8-out540"	.26182	83	234	317
8	"8-out541"	.25961	81	231	312
8	"8-out542"	.59247	189	130	319
8	"8-out543"	.71521	221	88	309
8	"8-out544"	.79807	249	63	312
8	"8-out545"	.91318	284	27	311
8	"8-out546"	.85256	266	46	312
8	"8-out547"	.82903	257	53	310
8	"8-out548"	.83601	260	51	311
8	"8-out549"	.65189	206	110	316
8	"8-out550"	.37014	124	211	335
8	"8-out551"	.38387	119	191	310
8	"8-out552"	.61464	193	121	314
8	"8-out553"	.38305	113	182	295
8	"8-out554"	.65405	242	128	370
8	"8-out555"	.13583	105	668	773
8	"8-out556"	.25000	113	339	452
8	"8-out557"	.18622	73	319	392
8	"8-out558"	.26729	170	466	636
8	"8-out559"	.23935	208	661	869
8	"8-out560"	.25307	226	667	893
8	"8-out561"	.34267	159	305	464
8	"8-out562"	.98148	106	2	108
8	"8-out563"	.34822	647	1211	1858
8	"8-out564"	.19072	74	314	388
8	"8-out565"	.24704	355	1082	1437
8	"8-out566"	.96462	2263	83	2346
8	"8-out567"	.29891	55	129	184
8	"8-out568"	.16526	118	596	714
8	"8-out569"	.25090	278	830	1108
8	"8-out570"	.33766	624	1224	1848
8	"8-out571"	.55871	1161	917	2078
8	"8-out572"	.34567	84	159	243
8	"8-out573"	.33389	198	395	593
8	"8-out574"	.13300	27	176	203
8	"8-out575"	.31230	203	447	650
8	"8-out576"	.58701	226	159	385
8	"8-out577"	.41463	153	216	369
8	"8-out578"	.17783	69	319	388
8	"8-out579"	.88842	215	27	242
8	"8-out580"	.96978	353	11	364
8	"8-out581"	.44194	255	322	577
8	"8-out582"	.50485	156	153	309
8	"8-out583"	.60517	187	122	309
8	"8-out584"	.88745	276	35	311
8	"8-out585"	.87537	295	42	337
8	"8-out586"	.39616	124	189	313
8	"8-out587"	.36338	129	226	355
8	"8-out588"	.49068	158	164	322
8	"8-out589"	.34824	109	204	313
8	"8-out590"	.33860	107	209	316
8	"8-out591"	.34627	107	202	309
8	"8-out592"	.89677	278	32	310
8	"8-out593"	.88709	275	35	310
8	"8-out594"	.31410	98	214	312
8	"8-out595"	.77884	243	69	312
8	"8-out596"	.24687	79	241	320
8	"8-out597"	.27707	87	227	314
8	"8-out598"	.27388	86	228	314
8	"8-out599"	.51746	163	152	315
8	"8-out600"	.73520	236	85	321
8	"8-out601"	.63022	196	115	311
8	"8-out602"	.83606	255	50	305
8	"8-out603"	.80921	246	58	304
8	"8-out604"	.89137	279	34	313
8	"8-out605"	.82692	258	54	312
8	"8-out606"	.38032	116	189	305
8	"8-out607"	.36963	112	191	303
8	"8-out608"	.31790	103	221	324
8	"8-out609"	.89320	276	33	309
8	"8-out610"	.87579	275	39	314
8	"8-out611"	.31067	96	213	309
8	"8-out612"	.20937	67	253	320
8	"8-out613"	.30891	97	217	314
8	"8-out614"	.83841	275	53	328
8	"8-out615"	.86075	272	44	316
8	"8-out616"	.32087	103	218	321
8	"8-out617"	.32580	101	209	310
8	"8-out618"	.32721	107	220	327
8	"8-out619"	.80664	267	64	331
8	"8-out620"	.87781	273	38	311
8	"8-out621"	.32467	100	208	308
8	"8-out622"	.45189	155	188	343
8	"8-out623"	.40894	128	185	313
8	"8-out624"	.29607	98	233	331
8	"8-out625"	.37699	118	195	313
8	"8-out626"	.53291	170	149	319
8	"8-out627"	.81730	255	57	312
8	"8-out628"	.81789	256	57	313
8	"8-out629"	.32038	99	210	309
8	"8-out630"	.48553	151	160	311
8	"8-out631"	.34415	106	202	308
8	"8-out632"	.37942	118	193	311
8	"8-out633"	.79682	251	64	315
8	"8-out634"	.35256	110	202	312
8	"8-out635"	.24512	88	271	359
8	"8-out636"	.53074	164	145	309
8	"8-out637"	.67313	208	101	309
8	"8-out638"	.51592	162	152	314
8	"8-out639"	.37003	121	206	327
8	"8-out640"	.60655	185	120	305
8	"8-out641"	.36942	116	198	314
8	"8-out642"	.31102	79	175	254
8	"8-out643"	.24622	212	649	861
8	"8-out644"	.49833	150	151	301
8	"8-out645"	.99019	101	1	102
8	"8-out646"	.16483	90	456	546
8	"8-out647"	.30489	218	497	715
8	"8-out648"	.33383	221	441	662
8	"8-out649"	.34582	120	227	347
8	"8-out650"	.24207	290	908	1198
8	"8-out651"	.22017	155	549	704
8	"8-out652"	.37340	205	344	549
8	"8-out653"	.35521	276	501	777
8	"8-out654"	.25387	180	529	709
8	"8-out655"	.20891	75	284	359
8	"8-out656"	.21956	110	391	501
8	"8-out657"	.99567	230	1	231
8	"8-out658"	.84189	852	160	1012
8	"8-out659"	.25950	232	662	894
8	"8-out660"	.27142	95	255	350
8	"8-out661"	.30806	321	721	1042
8	"8-out662"	.30522	228	519	747
8	"8-out663"	.27716	352	918	1270
8	"8-out664"	.50570	133	130	263
8	"8-out665"	.23366	236	774	1010
8	"8-out666"	.61439	333	209	542
8	"8-out667"	.41802	283	394	677
8	"8-out668"	.87020	4767	711	5478
8	"8-out669"	.32226	165	347	512
8	"8-out670"	.42128	190	261	451
8	"8-out671"	.97091	14085	422	14507
8	"8-out672"	.78655	3534	959	4493
8	"8-out673"	.24303	157	489	646
8	"8-out674"	.99200	8317	67	8384
8	"8-out675"	.78087	980	275	1255
8	"8-out676"	.75265	426	140	566
8	"8-out677"	.99548	1765	8	1773
8	"8-out678"	.69550	3602	1577	5179
8	"8-out679"	.98155	2129	40	2169
8	"8-out680"	.97064	5488	166	5654
8	"8-out681"	.64721	244	133	377
8	"8-out682"	.56321	147	114	261
8	"8-out683"	.32222	29	61	90
8	"8-out684"	.41005	212	305	517
8	"8-out685"	.14128	77	468	545
8	"8-out686"	.19444	49	203	252
8	"8-out687"	.41865	211	293	504
8	"8-out688"	.72469	358	136	494
8	"8-out689"	.26582	42	116	158
8	"8-out690"	.69273	124	55	179
8	"8-out691"	.29787	42	99	141
8	"8-out692"	.33913	117	228	345
8	"8-out693"	.94845	92	5	97
8	"8-out694"	.21511	222	810	1032
8	"8-out695"	.26045	218	619	837
8	"8-out696"	.94301	513	31	544
8	"8-out697"	.23410	81	265	346
8	"8-out698"	.72097	416	161	577
8	"8-out699"	.74022	530	186	716
8	"8-out700"	.55813	168	133	301
8	"8-out701"	.55619	193	154	347
8	"8-out702"	.79245	252	66	318
8	"8-out703"	.73734	233	83	316
8	"8-out704"	.53495	176	153	329
8	"8-out705"	.88745	276	35	311
8	"8-out706"	.33333	103	206	309
8	"8-out707"	.19078	29	123	152
8	"8-out708"	.24100	201	633	834
8	"8-out709"	.97160	308	9	317
8	"8-out710"	.25914	85	243	328
8	"8-out711"	.43589	306	396	702
8	"8-out712"	.33333	64	128	192
8	"8-out713"	.90163	55	6	61
8	"8-out714"	.44954	98	120	218
8	"8-out715"	.36734	90	155	245
8	"8-out716"	.31439	83	181	264
8	"8-out717"	.29282	535	1292	1827
8	"8-out718"	.32079	290	614	904
8	"8-out719"	.47747	159	174	333
8	"8-out720"	.39896	308	464	772
8	"8-out721"	.31409	234	511	745
8	"8-out722"	.22123	25	88	113
8	"8-out723"	.42553	100	135	235
8	"8-out724"	.40763	790	1148	1938
8	"8-out725"	.31346	610	1336	1946
8	"8-out726"	.21282	438	1620	2058
8	"8-out727"	.23241	479	1582	2061
8	"8-out728"	.28753	270	669	939
8	"8-out729"	.16167	54	280	334
8	"8-out730"	.99401	166	1	167
8	"8-out731"	.20334	73	286	359
8	"8-out732"	.93750	15	1	16
8	"8-out733"	.21917	32	114	146
8	"8-out734"	.47904	743	808	1551
8	"8-out735"	.98269	284	5	289
8	"8-out736"	.20453	316	1229	1545
8	"8-out737"	.95962	309	13	322
8	"8-out738"	.94409	304	18	322
8	"8-out739"	.15750	63	337	400
8	"8-out740"	.33962	108	210	318
8	"8-out741"	.35668	112	202	314
8	"8-out742"	.46006	144	169	313
8	"8-out743"	.21913	71	253	324
8	"8-out744"	.85303	267	46	313
8	"8-out745"	.92727	306	24	330
8	"8-out746"	.38216	120	194	314
8	"8-out747"	.76615	249	76	325
8	"8-out748"	.92000	299	26	325
8	"8-out749"	.85483	265	45	310
8	"8-out750"	.26837	84	229	313
8	"8-out751"	.34504	108	205	313
8	"8-out752"	.88958	282	35	317
8	"8-out753"	.26498	84	233	317
8	"8-out754"	.77215	244	72	316
8	"8-out755"	.72756	227	85	312
8	"8-out756"	.79807	249	63	312
8	"8-out757"	.76527	238	73	311
8	"8-out758"	.84615	264	48	312
8	"8-out759"	.77884	243	69	312
8	"8-out760"	.89506	290	34	324
8	"8-out761"	.91194	290	28	318
8	"8-out762"	.84761	267	48	315
8	"8-out763"	.85256	266	46	312
8	"8-out764"	.70476	222	93	315
8	"8-out765"	.63492	200	115	315
8	"8-out766"	.27652	86	225	311
8	"8-out767"	.89719	288	33	321
8	"8-out768"	.90476	285	30	315
8	"8-out769"	.92698	292	23	315
8	"8-out770"	.56957	176	133	309
8	"8-out771"	.76699	237	72	309
8	"8-out772"	.88996	275	34	309
8	"8-out773"	.39873	126	190	316
8	"8-out774"	.49354	153	157	310
8	"8-out775"	.54071	166	141	307
8	"8-out776"	.24213	77	241	318
8	"8-out777"	.72668	226	85	311
8	"8-out778"	.87619	276	39	315
8	"8-out779"	.23322	73	240	313
8	"8-out780"	.86858	271	41	312
8	"8-out781"	.82622	252	53	305
8	"8-out782"	.31832	99	212	311
8	"8-out783"	.81904	258	57	315
8	"8-out784"	.31888	103	220	323
8	"8-out785"	.29032	90	220	310
8	"8-out786"	.32698	103	212	315
8	"8-out787"	.81433	250	57	307
8	"8-out788"	.81433	250	57	307
8	"8-out789"	.88178	276	37	313
8	"8-out790"	.52103	161	148	309
8	"8-out791"	.68152	214	100	314
8	"8-out792"	.89137	279	34	313
8	"8-out793"	.91384	297	28	325
8	"8-out794"	.84090	259	49	308
8	"8-out795"	.37500	117	195	312
8	"8-out796"	.80519	248	60	308
8	"8-out797"	.71382	222	89	311
8	"8-out798"	.77813	242	69	311
8	"8-out799"	.76507	241	74	315
8	"8-out800"	.39032	121	189	310
8	"8-out801"	.80000	252	63	315
8	"8-out802"	.40993	132	190	322
8	"8-out803"	.55710	200	159	359
8	"8-out804"	.91025	284	28	312
8	"8-out805"	.90127	283	31	314
8	"8-out806"	.16049	52	272	324
8	"8-out807"	.36908	117	200	317
8	"8-out808"	.33438	106	211	317
8	"8-out809"	.21052	68	255	323
8	"8-out810"	.26769	87	238	325
8	"8-out811"	.82580	256	54	310
8	"8-out812"	.72168	223	86	309
8	"8-out813"	.56875	182	138	320
8	"8-out814"	.87345	283	41	324
8	"8-out815"	.46625	152	174	326
8	"8-out816"	.79552	249	64	313
8	"8-out817"	.54516	169	141	310
8	"8-out818"	.40127	126	188	314
8	"8-out819"	.86994	301	45	346
8	"8-out820"	.71704	223	88	311
8	"8-out821"	.86538	270	42	312
8	"8-out822"	.87179	272	40	312
8	"8-out823"	.83870	260	50	310
8	"8-out824"	.66984	211	104	315
8	"8-out825"	.25391	81	238	319
8	"8-out826"	.28990	89	218	307
8	"8-out827"	.53918	172	147	319
8	"8-out828"	.95817	252	11	263
8	"8-out829"	.57096	177	133	310
8	"8-out830"	.61639	188	117	305
8	"8-out831"	.08496	13	140	153
8	"8-out832"	.24183	37	116	153
8	"8-out833"	.30897	93	208	301
8	"8-out834"	.31223	74	163	237
8	"8-out835"	.99069	213	2	215
8	"8-out836"	.24178	103	323	426
8	"8-out837"	.30069	172	400	572
8	"8-out838"	.28493	157	394	551
8	"8-out839"	.19205	116	488	604
8	"8-out840"	.58415	177	126	303
8	"8-out841"	.20695	125	479	604
8	"8-out842"	.78857	276	74	350
8	"8-out843"	.31102	158	350	508
8	"8-out844"	.26122	483	1366	1849
8	"8-out845"	.21589	258	937	1195
8	"8-out846"	.24655	161	492	653
8	"8-out847"	.26570	165	456	621
8	"8-out848"	.26363	174	486	660
8	"8-out849"	.43392	197	257	454
8	"8-out850"	.22063	154	544	698
8	"8-out851"	.33016	139	282	421
8	"8-out852"	.13917	54	334	388
8	"8-out853"	.33308	456	913	1369
8	"8-out854"	.12587	54	375	429
8	"8-out855"	.84120	392	74	466
8	"8-out856"	.37227	341	575	916
8	"8-out857"	.97602	692	17	709
8	"8-out858"	.28934	57	140	197
8	"8-out859"	.99037	3291	32	3323
8	"8-out860"	.98544	1219	18	1237
8	"8-out861"	.70305	4051	1711	5762
8	"8-out862"	.45141	1101	1338	2439
8	"8-out863"	.15625	55	297	352
8	"8-out864"	.28308	77	195	272
8	"8-out865"	.32361	211	441	652
8	"8-out866"	.27472	75	198	273
8	"8-out867"	.37213	195	329	524
8	"8-out868"	.29166	280	680	960
8	"8-out869"	.27405	131	347	478
8	"8-out870"	.32302	188	394	582
8	"8-out871"	.74153	241	84	325
8	"8-out872"	.12442	27	190	217
8	"8-out873"	.28571	88	220	308
8	"8-out874"	.98989	98	1	99
8	"8-out875"	.40546	341	500	841
8	"8-out876"	.39804	244	369	613
8	"8-out877"	.20183	22	87	109
8	"8-out878"	.23255	120	396	516
8	"8-out879"	.74500	298	102	400
8	"8-out880"	.31645	100	216	316
8	"8-out881"	.91275	272	26	298
8	"8-out882"	.80952	255	60	315
8	"8-out883"	.93478	258	18	276
8	"8-out884"	.55591	174	139	313
8	"8-out885"	.25925	140	400	540
8	"8-out886"	.37060	116	197	313
8	"8-out887"	.90797	296	30	326
8	"8-out888"	.40236	476	707	1183
8	"8-out889"	.44607	91	113	204
8	"8-out890"	.57619	242	178	420
8	"8-out891"	.33858	129	252	381
8	"8-out892"	.26616	107	295	402
8	"8-out893"	.18965	77	329	406
8	"8-out894"	.20588	105	405	510
8	"8-out895"	.70110	190	81	271
8	"8-out896"	.52012	168	155	323
8	"8-out897"	.25200	189	561	750
8	"8-out898"	.36579	154	267	421
8	"8-out899"	.25454	112	328	440
8	"8-out900"	.23926	39	124	163
8	"8-out901"	.98165	107	2	109
8	"8-out902"	.47651	71	78	149
8	"8-out903"	.99186	122	1	123
8	"8-out904"	.98963	191	2	193
8	"8-out905"	.16949	60	294	354
8	"8-out906"	.25000	93	279	372
8	"8-out907"	.14736	56	324	380
8	"8-out908"	.31034	108	240	348
8	"8-out909"	.65295	254	135	389
8	"8-out910"	.46089	878	1027	1905
8	"8-out911"	.17985	75	342	417
8	"8-out912"	.24574	159	488	647
8	"8-out913"	.19607	30	123	153
8	"8-out914"	.30701	175	395	570
8	"8-out915"	.24372	165	512	677
8	"8-out916"	.35738	208	374	582
8	"8-out917"	.27596	449	1178	1627
8	"8-out918"	.28193	373	950	1323
8	"8-out919"	.32539	41	85	126
8	"8-out920"	.32653	32	66	98
8	"8-out921"	.21929	50	178	228
8	"8-out922"	.96368	345	13	358
8	"8-out923"	.34121	101	195	296
8	"8-out924"	.34482	680	1292	1972
8	"8-out925"	.97082	1065	32	1097
8	"8-out926"	.50696	983	956	1939
8	"8-out927"	.32718	195	401	596
8	"8-out928"	.24574	520	1596	2116
8	"8-out929"	.21780	367	1318	1685
8	"8-out930"	.33639	183	361	544
8	"8-out931"	.31311	191	419	610
8	"8-out932"	.26738	496	1359	1855
8	"8-out933"	.25418	76	223	299
8	"8-out934"	.31439	83	181	264
8	"8-out935"	.19642	99	405	504
8	"8-out936"	.87993	513	70	583
8	"8-out937"	.46867	187	212	399
8	"8-out938"	.99061	211	2	213
8	"8-out939"	.29280	118	285	403
8	"8-out940"	.98653	293	4	297
8	"8-out941"	.15740	34	182	216
8	"8-out942"	.77272	68	20	88
8	"8-out943"	.21226	45	167	212
8	"8-out944"	.12037	26	190	216
8	"8-out945"	.15129	41	230	271
8	"8-out946"	.23849	114	364	478
8	"8-out947"	.77353	304	89	393
8	"8-out948"	.13664	22	139	161
8	"8-out949"	.77227	234	69	303
8	"8-out950"	.90705	283	29	312
8	"8-out951"	.88745	276	35	311
8	"8-out952"	.36562	117	203	320
8	"8-out953"	.60256	188	124	312
8	"8-out954"	.38338	120	193	313
8	"8-out955"	.91104	297	29	326
8	"8-out956"	.61046	525	335	860
8	"8-out957"	.21718	91	328	419
8	"8-out958"	.60115	208	138	346
8	"8-out959"	.74400	93	32	125
8	"8-out960"	.29602	82	195	277
8	"8-out961"	.30681	54	122	176
8	"8-out962"	.17872	42	193	235
8	"8-out963"	.12209	21	151	172
8	"8-out964"	.26000	104	296	400
8	"8-out965"	.21433	317	1162	1479
8	"8-out966"	.23032	79	264	343
8	"8-out967"	.82298	265	57	322
8	"8-out968"	.86666	286	44	330
8	"8-out969"	.96923	189	6	195
8	"8-out970"	.21942	61	217	278
8	"8-out971"	.34401	322	614	936
8	"8-out972"	.28823	392	968	1360
8	"8-out973"	.96428	54	2	56
8	"8-out974"	.53921	110	94	204
8	"8-out975"	.28260	208	528	736
8	"8-out976"	.27066	203	547	750
8	"8-out977"	.16250	65	335	400
8	"8-out978"	.26971	554	1500	2054
8	"8-out979"	.28054	62	159	221
8	"8-out980"	.18634	273	1192	1465
8	"8-out981"	.73831	158	56	214
8	"8-out982"	.93902	77	5	82
8	"8-out983"	.31063	73	162	235
8	"8-out984"	.35000	112	208	320
8	"8-out985"	.28512	69	173	242
8	"8-out986"	.28690	103	256	359
8	"8-out987"	.35533	366	664	1030
8	"8-out988"	.18060	54	245	299
8	"8-out989"	.29923	196	459	655
8	"8-out990"	.97556	479	12	491
8	"8-out991"	.16666	31	155	186
8	"8-out992"	.21466	120	439	559
8	"8-out993"	.25219	86	255	341
8	"8-out994"	.52976	267	237	504
8	"8-out995"	.21587	136	494	630
8	"8-out996"	.56514	347	267	614
8	"8-out997"	.36842	42	72	114
8	"8-out998"	.37404	49	82	131
8	"8-out999"	.96643	691	24	715
8	"8-out1000"	.59925	160	107	267
8	"8-out1001"	.97959	48	1	49
8	"8-out1002"	.99261	269	2	271
8	"8-out1003"	.90163	55	6	61
8	"8-out1004"	.52681	275	247	522
8	"8-out1005"	.98165	107	2	109
8	"8-out1006"	.20560	22	85	107
8	"8-out1007"	.16923	66	324	390
8	"8-out1008"	.44692	80	99	179
8	"8-out1009"	.21059	151	566	717
8	"8-out1010"	.39830	47	71	118
8	"8-out1011"	.27624	100	262	362
8	"8-out1012"	.24149	149	468	617
8	"8-out1013"	.26754	202	553	755
8	"8-out1014"	.15267	20	111	131
8	"8-out1015"	.22115	69	243	312
8	"8-out1016"	.37714	132	218	350
8	"8-out1017"	.45141	144	175	319
8	"8-out1018"	.30434	105	240	345
8	"8-out1019"	.20000	73	292	365
8	"8-out1020"	.31736	106	228	334
8	"8-out1021"	.21510	225	821	1046
8	"8-out1022"	.97727	387	9	396
8	"8-out1023"	.92857	780	60	840
8	"8-out1024"	.25550	58	169	227
8	"8-out1025"	.17936	113	517	630
8	"8-out1026"	.26217	70	197	267
8	"8-out1027"	.32236	49	103	152
8	"8-out1028"	.28087	373	955	1328
8	"8-out1029"	.19130	220	930	1150
8	"8-out1030"	.25633	91	264	355
8	"8-out1031"	.32646	95	196	291
8	"8-out1032"	.77142	135	40	175
8	"8-out1033"	.54268	89	75	164
8	"8-out1034"	.97297	72	2	74
8	"8-out1035"	.39320	324	500	824
8	"8-out1036"	.18843	88	379	467
8	"8-out1037"	.24003	265	839	1104
8	"8-out1038"	.78823	67	18	85
8	"8-out1039"	.27674	683	1785	2468
8	"8-out1040"	.23012	220	736	956
8	"8-out1041"	.93023	80	6	86
8	"8-out1042"	.23232	115	380	495
8	"8-out1043"	.27007	343	927	1270
8	"8-out1044"	.29702	90	213	303
8	"8-out1045"	.21965	114	405	519
8	"8-out1046"	.24905	197	594	791
8	"8-out1047"	.28314	126	319	445
8	"8-out1048"	.15400	73	401	474
8	"8-out1049"	.17045	30	146	176
8	"8-out1050"	.64189	95	53	148
8	"8-out1051"	.51741	104	97	201
8	"8-out1052"	.39357	98	151	249
8	"8-out1053"	.99782	459	1	460
8	"8-out1054"	.24594	167	512	679
8	"8-out1055"	.29427	108	259	367
8	"8-out1056"	.99711	346	1	347
8	"8-out1057"	.24872	146	441	587
8	"8-out1058"	.33823	276	540	816
8	"8-out1059"	.34191	186	358	544
8	"8-out1060"	.22456	128	442	570
8	"8-out1061"	.24761	182	553	735
8	"8-out1062"	.17688	75	349	424
8	"8-out1063"	.23798	99	317	416
8	"8-out1064"	.32347	164	343	507
8	"8-out1065"	.87878	29	4	33
8	"8-out1066"	.98654	220	3	223
8	"8-out1067"	.35276	351	644	995
8	"8-out1068"	.25000	88	264	352
8	"8-out1069"	.44055	63	80	143
8	"8-out1070"	.99130	114	1	115
8	"8-out1071"	.31266	116	255	371
8	"8-out1072"	.27090	149	401	550
8	"8-out1073"	.39910	89	134	223
8	"8-out1074"	.41579	716	1006	1722
8	"8-out1075"	.37394	89	149	238
8	"8-out1076"	.28089	175	448	623
8	"8-out1077"	.52200	261	239	500
8	"8-out1078"	.32217	77	162	239
8	"8-out1079"	.27260	419	1118	1537
8	"8-out1080"	.50930	438	422	860
8	"8-out1081"	.24031	124	392	516
8	"8-out1082"	.39849	53	80	133
8	"8-out1083"	.32822	107	219	326
8	"8-out1084"	.51752	192	179	371
8	"8-out1085"	.99186	122	1	123
8	"8-out1086"	.96581	113	4	117
8	"8-out1087"	.98290	115	2	117
8	"8-out1088"	.16262	114	587	701
8	"8-out1089"	.32100	217	459	676
8	"8-out1090"	.67380	283	137	420
8	"8-out1091"	.83108	123	25	148
8	"8-out1092"	.30419	348	796	1144
8	"8-out1093"	.69387	102	45	147
8	"8-out1094"	.41216	427	609	1036
8	"8-out1095"	.18901	117	502	619
8	"8-out1096"	.70515	287	120	407
8	"8-out1097"	.95541	300	14	314
8	"8-out1098"	.67586	98	47	145
8	"8-out1099"	.34836	255	477	732
8	"8-out1100"	.84659	149	27	176
8	"8-out1101"	.67962	437	206	643
8	"8-out1102"	.31045	294	653	947
8	"8-out1103"	.23666	71	229	300
8	"8-out1104"	.54226	712	601	1313
8	"8-out1105"	.18518	40	176	216
8	"8-out1106"	.52142	499	458	957
8	"8-out1107"	.27113	186	500	686
8	"8-out1108"	.38113	295	479	774
8	"8-out1109"	.21169	105	391	496
8	"8-out1110"	.20185	109	431	540
8	"8-out1111"	.22580	56	192	248
8	"8-out1112"	.98496	262	4	266
8	"8-out1113"	.28673	80	199	279
8	"8-out1114"	.93023	80	6	86
8	"8-out1115"	.21459	244	893	1137
8	"8-out1116"	.41538	216	304	520
8	"8-out1117"	.43333	208	272	480
8	"8-out1118"	.23452	125	408	533
8	"8-out1119"	.28823	98	242	340
8	"8-out1120"	.46601	48	55	103
8	"8-out1121"	.36629	263	455	718
8	"8-out1122"	.27155	126	338	464
8	"8-out1123"	.28055	101	259	360
8	"8-out1124"	.21095	77	288	365
8	"8-out1125"	.28055	101	259	360
8	"8-out1126"	.51717	256	239	495
8	"8-out1127"	.93093	337	25	362
8	"8-out1128"	.31448	356	776	1132
8	"8-out1129"	.26985	231	625	856
8	"8-out1130"	.75511	1181	383	1564
8	"8-out1131"	.24339	424	1318	1742
8	"8-out1132"	.66319	191	97	288
8	"8-out1133"	.16801	104	515	619
8	"8-out1134"	.82677	105	22	127
8	"8-out1135"	.95686	599	27	626
8	"8-out1136"	.92947	369	28	397
8	"8-out1137"	.16877	40	197	237
8	"8-out1138"	.58139	325	234	559
8	"8-out1139"	.31200	156	344	500
8	"8-out1140"	.17917	117	536	653
8	"8-out1141"	.30338	628	1442	2070
8	"8-out1142"	.33969	178	346	524
8	"8-out1143"	.90153	293	32	325
8	"8-out1144"	.25867	82	235	317
8	"8-out1145"	.25344	147	433	580
8	"8-out1146"	.75483	234	76	310
8	"8-out1147"	.31722	105	226	331
8	"8-out1148"	.52147	170	156	326
8	"8-out1149"	.63131	250	146	396
8	"8-out1150"	.53623	185	160	345
8	"8-out1151"	.90797	296	30	326
8	"8-out1152"	.42592	138	186	324
8	"8-out1153"	.53420	164	143	307
8	"8-out1154"	.55102	297	242	539
8	"8-out1155"	.25147	128	381	509
8	"8-out1156"	.51008	177	170	347
8	"8-out1157"	.80503	256	62	318
8	"8-out1158"	.28205	88	224	312
8	"8-out1159"	.45631	141	168	309
8	"8-out1160"	.78359	344	95	439
8	"8-out1161"	.29676	514	1218	1732
8	"8-out1162"	.27060	463	1248	1711
8	"8-out1163"	.34579	74	140	214
8	"8-out1164"	.95824	872	38	910
8	"8-out1165"	.80682	1324	317	1641
8	"8-out1166"	.32377	429	896	1325
8	"8-out1167"	.28623	389	970	1359
8	"8-out1168"	.27510	63	166	229
8	"8-out1169"	.31308	67	147	214
8	"8-out1170"	.68354	108	50	158
8	"8-out1171"	.35546	91	165	256
8	"8-out1172"	.60286	337	222	559
8	"8-out1173"	.71272	196	79	275
8	"8-out1174"	.28497	55	138	193
8	"8-out1175"	.35072	121	224	345
8	"8-out1176"	.28056	319	818	1137
8	"8-out1177"	.28381	128	323	451
8	"8-out1178"	.31707	39	84	123
8	"8-out1179"	.67745	5398	2570	7968
8	"8-out1180"	.34862	661	1235	1896
8	"8-out1181"	.30188	144	333	477
8	"8-out1182"	.40243	33	49	82
8	"8-out1183"	.99298	566	4	570
8	"8-out1184"	.88709	55	7	62
8	"8-out1185"	.65502	150	79	229
8	"8-out1186"	.34920	22	41	63
8	"8-out1187"	.22727	60	204	264
8	"8-out1188"	.52941	36	32	68
8	"8-out1189"	.83002	376	77	453
8	"8-out1190"	.20935	85	321	406
8	"8-out1191"	.96496	303	11	314
8	"8-out1192"	.76051	235	74	309
8	"8-out1193"	.35406	74	135	209
8	"8-out1194"	.77320	883	259	1142
8	"8-out1195"	.20652	38	146	184
8	"8-out1196"	.32195	283	596	879
8	"8-out1197"	.31927	106	226	332
8	"8-out1198"	.62609	427	255	682
8	"8-out1199"	.22400	196	679	875
8	"8-out1200"	.12063	38	277	315
8	"8-out1201"	.99105	443	4	447
8	"8-out1202"	.33262	156	313	469
8	"8-out1203"	.96000	264	11	275
8	"8-out1204"	.95762	226	10	236
8	"8-out1205"	.97637	124	3	127
8	"8-out1206"	.22568	58	199	257
8	"8-out1207"	.59523	125	85	210
8	"8-out1208"	.43589	136	176	312
8	"8-out1209"	.14349	32	191	223
8	"8-out1210"	.21554	61	222	283
8	"8-out1211"	.97266	854	24	878
8	"8-out1212"	.97152	853	25	878
8	"8-out1213"	.97146	783	23	806
8	"8-out1214"	.97152	853	25	878
8	"8-out1215"	.97486	737	19	756
8	"8-out1216"	.96896	718	23	741
8	"8-out1217"	.22820	123	416	539
8	"8-out1218"	.28867	153	377	530
8	"8-out1219"	.50526	96	94	190
8	"8-out1220"	.28229	118	300	418
8	"8-out1221"	.34634	142	268	410
8	"8-out1222"	.38372	132	212	344
8	"8-out1223"	.27889	222	574	796
8	"8-out1224"	.20437	168	654	822
8	"8-out1225"	.21334	179	660	839
8	"8-out1226"	.27351	253	672	925
8	"8-out1227"	.29498	341	815	1156
8	"8-out1228"	.33288	491	984	1475
8	"8-out1229"	.34291	477	914	1391
8	"8-out1230"	.21657	311	1125	1436
8	"8-out1231"	.23270	407	1342	1749
8	"8-out1232"	.99371	316	2	318
8	"8-out1233"	.19582	394	1618	2012
8	"8-out1234"	.20717	433	1657	2090
8	"8-out1235"	.97142	68	2	70
8	"8-out1236"	.40291	249	369	618
8	"8-out1237"	.25889	160	458	618
8	"8-out1238"	.98630	216	3	219
8	"8-out1239"	.54395	198	166	364
8	"8-out1240"	.19906	85	342	427
8	"8-out1241"	.56774	264	201	465
8	"8-out1242"	.27566	196	515	711
8	"8-out1243"	.98816	334	4	338
8	"8-out1244"	.11111	29	232	261
8	"8-out1245"	.61021	490	313	803
8	"8-out1246"	.28780	59	146	205
8	"8-out1247"	.25913	78	223	301
8	"8-out1248"	.46643	528	604	1132
8	"8-out1249"	.23745	71	228	299
8	"8-out1250"	.98240	335	6	341
8	"8-out1251"	.29161	247	600	847
8	"8-out1252"	.98718	1233	16	1249
8	"8-out1253"	.97300	721	20	741
8	"8-out1254"	.28914	253	622	875
8	"8-out1255"	.21314	120	443	563
8	"8-out1256"	.39037	73	114	187
8	"8-out1257"	.37081	343	582	925
8	"8-out1258"	.23235	79	261	340
8	"8-out1259"	.38312	1090	1755	2845
8	"8-out1260"	.33526	231	458	689
8	"8-out1261"	.41680	248	347	595
8	"8-out1262"	.22292	282	983	1265
8	"8-out1263"	.16103	81	422	503
8	"8-out1264"	.50357	282	278	560
8	"8-out1265"	.14828	78	448	526
8	"8-out1266"	.19024	39	166	205
8	"8-out1267"	.62068	144	88	232
8	"8-out1268"	.82448	202	43	245
8	"8-out1269"	.16622	63	316	379
8	"8-out1270"	.87517	631	90	721
8	"8-out1271"	.92491	271	22	293
8	"8-out1272"	.87551	422	60	482
8	"8-out1273"	.93814	455	30	485
8	"8-out1274"	.18246	102	457	559
8	"8-out1275"	.66081	113	58	171
8	"8-out1276"	.67441	116	56	172
8	"8-out1277"	.44917	190	233	423
8	"8-out1278"	.28750	253	627	880
8	"8-out1279"	.26086	144	408	552
8	"8-out1280"	.58493	365	259	624
8	"8-out1281"	.80993	375	88	463
8	"8-out1282"	.35947	110	196	306
8	"8-out1283"	.36893	76	130	206
8	"8-out1284"	.95081	58	3	61
8	"8-out1285"	.88513	131	17	148
8	"8-out1286"	.27500	66	174	240
8	"8-out1287"	.15837	35	186	221
8	"8-out1288"	.33731	113	222	335
8	"8-out1289"	.21549	267	972	1239
8	"8-out1290"	.63316	126	73	199
8	"8-out1291"	.53887	201	172	373
8	"8-out1292"	.35652	123	222	345
8	"8-out1293"	.74429	163	56	219
8	"8-out1294"	.31688	122	263	385
8	"8-out1295"	.24225	219	685	904
8	"8-out1296"	.34857	122	228	350
8	"8-out1297"	.48502	162	172	334
8	"8-out1298"	.26944	142	385	527
8	"8-out1299"	.21289	218	806	1024
8	"8-out1300"	.26612	392	1081	1473
8	"8-out1301"	.24903	258	778	1036
8	"8-out1302"	.29981	164	383	547
8	"8-out1303"	.20769	81	309	390
8	"8-out1304"	.40495	49	72	121
8	"8-out1305"	.23497	262	853	1115
8	"8-out1306"	.59443	620	423	1043
8	"8-out1307"	.72365	364	139	503
8	"8-out1308"	.17076	250	1214	1464
8	"8-out1309"	.16442	244	1240	1484
8	"8-out1310"	.40227	496	737	1233
8	"8-out1311"	.53293	712	624	1336
8	"8-out1312"	.41577	390	548	938
8	"8-out1313"	.57831	48	35	83
8	"8-out1314"	.32247	99	208	307
8	"8-out1315"	.69892	195	84	279
8	"8-out1316"	.26384	81	226	307
8	"8-out1317"	.30952	78	174	252
8	"8-out1318"	.26755	80	219	299
8	"8-out1319"	.15686	24	129	153
8	"8-out1320"	.34567	28	53	81
8	"8-out1321"	.36023	125	222	347
8	"8-out1322"	.41499	310	437	747
8	"8-out1323"	.82638	238	50	288
8	"8-out1324"	.99000	198	2	200
8	"8-out1325"	.28654	492	1225	1717
8	"8-out1326"	.15740	34	182	216
8	"8-out1327"	.62608	288	172	460
8	"8-out1328"	.20092	131	521	652
8	"8-out1329"	.20937	210	793	1003
8	"8-out1330"	.25974	493	1405	1898
8	"8-out1331"	.49019	250	260	510
8	"8-out1332"	.51910	163	151	314
8	"8-out1333"	.90032	280	31	311
8	"8-out1334"	.27484	130	343	473
8	"8-out1335"	.78797	249	67	316
8	"8-out1336"	.50828	184	178	362
8	"8-out1337"	.57053	182	137	319
8	"8-out1338"	.38834	120	189	309
8	"8-out1339"	.24262	74	231	305
8	"8-out1340"	.84848	280	50	330
8	"8-out1341"	.86942	273	41	314
8	"8-out1342"	.79288	245	64	309
8	"8-out1343"	.90536	928	97	1025
8	"8-out1344"	.40000	128	192	320
8	"8-out1345"	.97876	461	10	471
8	"8-out1346"	.33170	68	137	205
8	"8-out1347"	.87702	271	38	309
8	"8-out1348"	.83860	265	51	316
8	"8-out1349"	.84444	266	49	315
8	"8-out1350"	.65988	227	117	344
8	"8-out1351"	.33653	105	207	312
8	"8-out1352"	.25320	79	233	312
8	"8-out1353"	.32716	106	218	324
8	"8-out1354"	.27500	88	232	320
8	"8-out1355"	.27414	88	233	321
8	"8-out1356"	.18874	57	245	302
8	"8-out1357"	.37341	118	198	316
8	"8-out1358"	.11428	36	279	315
8	"8-out1359"	.33438	106	211	317
8	"8-out1360"	.36137	116	205	321
8	"8-out1361"	.32371	101	211	312
8	"8-out1362"	.33436	108	215	323
8	"8-out1363"	.25477	80	234	314
8	"8-out1364"	.27462	92	243	335
8	"8-out1365"	.55205	175	142	317
8	"8-out1366"	.93827	304	20	324
8	"8-out1367"	.94285	330	20	350
8	"8-out1368"	.57877	180	131	311
8	"8-out1369"	.90127	283	31	314
8	"8-out1370"	.89171	280	34	314
8	"8-out1371"	.94528	311	18	329
8	"8-out1372"	.93730	299	20	319
8	"8-out1373"	.94637	300	17	317
8	"8-out1374"	.25000	80	240	320
8	"8-out1375"	.40186	129	192	321
8	"8-out1376"	.60493	196	128	324
8	"8-out1377"	.13707	44	277	321
8	"8-out1378"	.99585	481	2	483
8	"8-out1379"	.57417	329	244	573
8	"8-out1380"	.39973	612	919	1531
8	"8-out1381"	.34693	119	224	343
8	"8-out1382"	.40350	92	136	228
8	"8-out1383"	.97354	184	5	189
8	"8-out1384"	.71045	503	205	708
8	"8-out1385"	.28326	66	167	233
8	"8-out1386"	.33272	362	726	1088
8	"8-out1387"	.77351	403	118	521
8	"8-out1388"	.19554	114	469	583
8	"8-out1389"	.65462	290	153	443
8	"8-out1390"	.24725	45	137	182
8	"8-out1391"	.97058	165	5	170
8	"8-out1392"	.98823	168	2	170
8	"8-out1393"	.37096	92	156	248
8	"8-out1394"	.09565	44	416	460
8	"8-out1395"	.41584	126	177	303
8	"8-out1396"	.67213	41	20	61
8	"8-out1397"	.88524	54	7	61
8	"8-out1398"	.86885	53	8	61
8	"8-out1399"	.88524	54	7	61
8	"8-out1400"	.88524	54	7	61
8	"8-out1401"	.80327	49	12	61
8	"8-out1402"	.86885	53	8	61
8	"8-out1403"	.49350	76	78	154
8	"8-out1404"	.29216	220	533	753
8	"8-out1405"	.61130	173	110	283
8	"8-out1406"	.39947	153	230	383
8	"8-out1407"	.29548	190	453	643
8	"8-out1408"	.29684	179	424	603
8	"8-out1409"	.38775	171	270	441
8	"8-out1410"	.65336	262	139	401
8	"8-out1411"	.60147	163	108	271
8	"8-out1412"	.19444	42	174	216
8	"8-out1413"	.33890	142	277	419
8	"8-out1414"	.21457	53	194	247
8	"8-out1415"	.17916	43	197	240
8	"8-out1416"	.99264	135	1	136
8	"8-out1417"	.26601	137	378	515
8	"8-out1418"	.42675	134	180	314
8	"8-out1419"	.70175	280	119	399
8	"8-out1420"	.23390	149	488	637
8	"8-out1421"	.52500	84	76	160
8	"8-out1422"	.24113	102	321	423
8	"8-out1423"	.36075	114	202	316
8	"8-out1424"	.72327	230	88	318
8	"8-out1425"	.27102	87	234	321
8	"8-out1426"	.98540	135	2	137
8	"8-out1427"	.40797	133	193	326
8	"8-out1428"	.10544	31	263	294
8	"8-out1429"	.23367	254	833	1087
8	"8-out1430"	.41854	167	232	399
8	"8-out1431"	.29090	112	273	385
8	"8-out1432"	.31428	209	456	665
8	"8-out1433"	.23323	153	503	656
8	"8-out1434"	.36813	275	472	747
8	"8-out1435"	.34466	142	270	412
8	"8-out1436"	.21686	36	130	166
8	"8-out1437"	.56905	1063	805	1868
8	"8-out1438"	.79041	264	70	334
8	"8-out1439"	.26088	665	1884	2549
8	"8-out1440"	.95978	525	22	547
8	"8-out1441"	.30034	173	403	576
8	"8-out1442"	.26720	66	181	247
8	"8-out1443"	.23540	121	393	514
8	"8-out1444"	.21414	327	1200	1527
8	"8-out1445"	.26606	352	971	1323
8	"8-out1446"	.43404	102	133	235
8	"8-out1447"	.24664	368	1124	1492
8	"8-out1448"	.99159	118	1	119
8	"8-out1449"	.14583	35	205	240
8	"8-out1450"	.32119	300	634	934
8	"8-out1451"	.27900	101	261	362
8	"8-out1452"	.17850	103	474	577
8	"8-out1453"	.51194	150	143	293
8	"8-out1454"	.33093	46	93	139
8	"8-out1455"	.38497	82	131	213
8	"8-out1456"	.28957	150	368	518
8	"8-out1457"	.24255	57	178	235
8	"8-out1458"	.22127	52	183	235
8	"8-out1459"	.56896	66	50	116
8	"8-out1460"	.32407	70	146	216
8	"8-out1461"	.74257	75	26	101
8	"8-out1462"	.27918	55	142	197
8	"8-out1463"	.31162	268	592	860
8	"8-out1464"	.22035	210	743	953
8	"8-out1465"	.37450	94	157	251
8	"8-out1466"	.72695	410	154	564
8	"8-out1467"	.24052	184	581	765
8	"8-out1468"	.37993	125	204	329
8	"8-out1469"	.32743	37	76	113
8	"8-out1470"	.38661	283	449	732
8	"8-out1471"	.46390	617	713	1330
8	"8-out1472"	.29733	190	449	639
8	"8-out1473"	.49749	298	301	599
8	"8-out1474"	.56680	140	107	247
8	"8-out1475"	.55870	138	109	247
8	"8-out1476"	.39211	169	262	431
8	"8-out1477"	.23722	65	209	274
8	"8-out1478"	.30206	190	439	629
8	"8-out1479"	.26984	170	460	630
8	"8-out1480"	.26988	95	257	352
8	"8-out1481"	.25625	41	119	160
8	"8-out1482"	.15472	95	519	614
8	"8-out1483"	.25528	145	423	568
8	"8-out1484"	.63809	268	152	420
8	"8-out1485"	.21343	197	726	923
8	"8-out1486"	.38138	254	412	666
8	"8-out1487"	.27125	67	180	247
8	"8-out1488"	.80882	165	39	204
8	"8-out1489"	.26644	81	223	304
8	"8-out1490"	.72043	536	208	744
8	"8-out1491"	.44630	453	562	1015
8	"8-out1492"	.50476	212	208	420
8	"8-out1493"	.99672	1218	4	1222
8	"8-out1494"	.40250	322	478	800
8	"8-out1495"	.37984	196	320	516
8	"8-out1496"	.48259	208	223	431
8	"8-out1497"	.41209	218	311	529
8	"8-out1498"	.35758	172	309	481
8	"8-out1499"	.20744	78	298	376
8	"8-out1500"	.22509	61	210	271
8	"8-out1501"	.31502	631	1372	2003
8	"8-out1502"	.96163	376	15	391
8	"8-out1503"	.68243	202	94	296
8	"8-out1504"	.28830	143	353	496
8	"8-out1505"	.73600	276	99	375
8	"8-out1506"	.45967	530	623	1153
8	"8-out1507"	.98857	1125	13	1138
8	"8-out1508"	.44370	67	84	151
8	"8-out1509"	.21126	270	1008	1278
8	"8-out1510"	.24708	127	387	514
8	"8-out1511"	.99056	105	1	106
8	"8-out1512"	.68686	204	93	297
8	"8-out1513"	.93877	276	18	294
8	"8-out1514"	.98666	1036	14	1050
8	"8-out1515"	.98681	1123	15	1138
8	"8-out1516"	.98587	1117	16	1133
8	"8-out1517"	.97882	416	9	425
8	"8-out1518"	.99275	411	3	414
8	"8-out1519"	.97685	422	10	432
8	"8-out1520"	.99300	426	3	429
8	"8-out1521"	.20985	98	369	467
8	"8-out1522"	.21616	123	446	569
8	"8-out1523"	.23333	98	322	420
8	"8-out1524"	.58426	52	37	89
8	"8-out1525"	.99655	289	1	290
8	"8-out1526"	.31875	153	327	480
8	"8-out1527"	.44747	115	142	257
8	"8-out1528"	.27826	128	332	460
8	"8-out1529"	.25870	156	447	603
8	"8-out1530"	.18791	84	363	447
8	"8-out1531"	.42195	173	237	410
8	"8-out1532"	.64851	262	142	404
8	"8-out1533"	.96515	277	10	287
8	"8-out1534"	.30674	400	904	1304
8	"8-out1535"	.37010	104	177	281
8	"8-out1536"	.57868	114	83	197
8	"8-out1537"	.33451	94	187	281
8	"8-out1538"	.41764	142	198	340
8	"8-out1539"	.98850	172	2	174
8	"8-out1540"	.24054	159	502	661
8	"8-out1541"	.83425	151	30	181
8	"8-out1542"	.86585	142	22	164
8	"8-out1543"	.98026	149	3	152
8	"8-out1544"	.65993	196	101	297
8	"8-out1545"	.26829	88	240	328
8	"8-out1546"	.34051	158	306	464
8	"8-out1547"	.98989	196	2	198
8	"8-out1548"	.36015	479	851	1330
8	"8-out1549"	.37244	711	1198	1909
8	"8-out1550"	.21171	94	350	444
8	"8-out1551"	.25806	112	322	434
8	"8-out1552"	.24025	111	351	462
8	"8-out1553"	.51954	1475	1364	2839
8	"8-out1554"	.27152	164	440	604
8	"8-out1555"	.58444	526	374	900
8	"8-out1556"	.83091	172	35	207
8	"8-out1557"	.25229	110	326	436
8	"8-out1558"	.36341	149	261	410
8	"8-out1559"	.10563	15	127	142
8	"8-out1560"	.95238	220	11	231
8	"8-out1561"	.38693	154	244	398
8	"8-out1562"	.33195	161	324	485
8	"8-out1563"	.66297	299	152	451
8	"8-out1564"	.92580	287	23	310
8	"8-out1565"	.60377	224	147	371
8	"8-out1566"	.24542	67	206	273
8	"8-out1567"	.46341	190	220	410
8	"8-out1568"	.52570	317	286	603
8	"8-out1569"	.30864	100	224	324
8	"8-out1570"	.71446	583	233	816
8	"8-out1571"	.38235	247	399	646
8	"8-out1572"	.16876	107	527	634
8	"8-out1573"	.33201	84	169	253
8	"8-out1574"	.45774	130	154	284
8	"8-out1575"	.39130	198	308	506
8	"8-out1576"	.34915	206	384	590
8	"8-out1577"	.43956	80	102	182
8	"8-out1578"	.49721	357	361	718
8	"8-out1579"	.33536	110	218	328
8	"8-out1580"	.29595	95	226	321
8	"8-out1581"	.77600	97	28	125
8	"8-out1582"	.82121	418	91	509
8	"8-out1583"	.25906	300	858	1158
8	"8-out1584"	.40512	79	116	195
8	"8-out1585"	.37986	166	271	437
8	"8-out1586"	.25961	135	385	520
8	"8-out1587"	.31775	136	292	428
8	"8-out1588"	.67741	210	100	310
8	"8-out1589"	.27317	56	149	205
8	"8-out1590"	.89123	295	36	331
8	"8-out1591"	.25477	40	117	157
8	"8-out1592"	.71604	174	69	243
8	"8-out1593"	.91943	582	51	633
8	"8-out1594"	.98275	627	11	638
8	"8-out1595"	.99556	898	4	902
8	"8-out1596"	.34210	39	75	114
8	"8-out1597"	.57258	71	53	124
8	"8-out1598"	.70370	57	24	81
8	"8-out1599"	.41825	110	153	263
8	"8-out1600"	.99180	242	2	244
8	"8-out1601"	.99045	415	4	419
8	"8-out1602"	.20532	131	507	638
8	"8-out1603"	.20307	198	777	975
8	"8-out1604"	.34263	221	424	645
8	"8-out1605"	.36567	358	621	979
8	"8-out1606"	.26930	265	719	984
8	"8-out1607"	.26604	286	789	1075
8	"8-out1608"	.98347	476	8	484
8	"8-out1609"	.30196	138	319	457
8	"8-out1610"	.40047	837	1253	2090
8	"8-out1611"	.51086	141	135	276
8	"8-out1612"	.28019	58	149	207
8	"8-out1613"	.96875	93	3	96
8	"8-out1614"	.56108	124	97	221
8	"8-out1615"	.20315	103	404	507
8	"8-out1616"	.16519	75	379	454
8	"8-out1617"	.27421	235	622	857
8	"8-out1618"	.78242	374	104	478
8	"8-out1619"	.27272	72	192	264
8	"8-out1620"	.98666	74	1	75
8	"8-out1621"	.21571	173	629	802
8	"8-out1622"	.40711	206	300	506
8	"8-out1623"	.99548	441	2	443
8	"8-out1624"	.17955	137	626	763
8	"8-out1625"	.37380	508	851	1359
8	"8-out1626"	.14788	84	484	568
8	"8-out1627"	.26279	113	317	430
8	"8-out1628"	.25830	70	201	271
8	"8-out1629"	.16776	102	506	608
8	"8-out1630"	.24814	634	1921	2555
8	"8-out1631"	.99428	348	2	350
8	"8-out1632"	.97560	360	9	369
8	"8-out1633"	.99428	348	2	350
8	"8-out1634"	.99457	367	2	369
8	"8-out1635"	.99457	367	2	369
8	"8-out1636"	.50934	109	105	214
8	"8-out1637"	.96200	481	19	500
8	"8-out1638"	.34693	68	128	196
8	"8-out1639"	.96363	159	6	165
8	"8-out1640"	.13087	78	518	596
8	"8-out1641"	.31687	154	332	486
8	"8-out1642"	.13594	59	375	434
8	"8-out1643"	.39647	180	274	454
8	"8-out1644"	.61181	145	92	237
8	"8-out1645"	.14084	20	122	142
8	"8-out1646"	.31088	60	133	193
8	"8-out1647"	.99565	917	4	921
8	"8-out1648"	.28890	349	859	1208
8	"8-out1649"	.29708	112	265	377
8	"8-out1650"	.21106	309	1155	1464
8	"8-out1651"	.30310	117	269	386
8	"8-out1652"	.32140	808	1706	2514
8	"8-out1653"	.24607	47	144	191
8	"8-out1654"	.92553	174	14	188
8	"8-out1655"	.54022	235	200	435
8	"8-out1656"	.95934	236	10	246
8	"8-out1657"	.82471	367	78	445
8	"8-out1658"	.51807	172	160	332
8	"8-out1659"	.31404	190	415	605
8	"8-out1660"	.28537	119	298	417
8	"8-out1661"	.21780	115	413	528
8	"8-out1662"	.27440	416	1100	1516
8	"8-out1663"	.26842	102	278	380
8	"8-out1664"	.31547	106	230	336
8	"8-out1665"	.17357	134	638	772
8	"8-out1666"	.25284	178	526	704
8	"8-out1667"	.28389	134	338	472
8	"8-out1668"	.96235	767	30	797
8	"8-out1669"	.29166	112	272	384
8	"8-out1670"	.73239	156	57	213
8	"8-out1671"	.15958	199	1048	1247
8	"8-out1672"	.99346	152	1	153
8	"8-out1673"	.26133	121	342	463
8	"8-out1674"	.59110	412	285	697
8	"8-out1675"	.26570	55	152	207
8	"8-out1676"	.22247	97	339	436
8	"8-out1677"	.99672	1218	4	1222
8	"8-out1678"	.99428	348	2	350
8	"8-out1679"	.38202	68	110	178
8	"8-out1680"	.20789	79	301	380
8	"8-out1681"	.20351	81	317	398
8	"8-out1682"	.19422	74	307	381
8	"8-out1683"	.30324	131	301	432
8	"8-out1684"	.29649	110	261	371
8	"8-out1685"	.35156	135	249	384
8	"8-out1686"	.26839	62	169	231
8	"8-out1687"	.98529	67	1	68
8	"8-out1688"	.99082	108	1	109
8	"8-out1689"	.27839	750	1944	2694
8	"8-out1690"	.40932	158	228	386
8	"8-out1691"	.28148	228	582	810
8	"8-out1692"	.98393	245	4	249
8	"8-out1693"	.22380	47	163	210
8	"8-out1694"	.17692	69	321	390
8	"8-out1695"	.22976	159	533	692
8	"8-out1696"	.47925	439	477	916
8	"8-out1697"	.71653	182	72	254
8	"8-out1698"	.31152	281	621	902
8	"8-out1699"	.18120	135	610	745
8	"8-out1700"	.83870	416	80	496
8	"8-out1701"	.22625	81	277	358
8	"8-out1702"	.29194	482	1169	1651
8	"8-out1703"	.27647	1295	3389	4684
8	"8-out1704"	.68285	239	111	350
8	"8-out1705"	.53112	128	113	241
8	"8-out1706"	.34913	81	151	232
8	"8-out1707"	.22744	121	411	532
8	"8-out1708"	.92000	69	6	75
8	"8-out1709"	.20083	288	1146	1434
8	"8-out1710"	.97826	450	10	460
8	"8-out1711"	.98769	321	4	325
8	"8-out1712"	.19411	99	411	510
8	"8-out1713"	.97196	104	3	107
8	"8-out1714"	.41496	61	86	147
8	"8-out1715"	.78027	451	127	578
8	"8-out1716"	.73899	235	83	318
8	"8-out1717"	.22222	116	406	522
8	"8-out1718"	.25946	370	1056	1426
8	"8-out1719"	.98053	554	11	565
8	"8-out1720"	.42187	135	185	320
8	"8-out1721"	.24347	168	522	690
8	"8-out1722"	.27107	119	320	439
8	"8-out1723"	.48533	182	193	375
8	"8-out1724"	.19325	86	359	445
8	"8-out1725"	.23711	23	74	97
8	"8-out1726"	.24561	154	473	627
8	"8-out1727"	.40638	191	279	470
8	"8-out1728"	.18299	99	442	541
8	"8-out1729"	.24006	139	440	579
8	"8-out1730"	.15827	22	117	139
8	"8-out1731"	.98810	831	10	841
8	"8-out1732"	.36053	243	431	674
8	"8-out1733"	.24875	50	151	201
8	"8-out1734"	.22628	563	1925	2488
8	"8-out1735"	.26666	636	1749	2385
8	"8-out1736"	.34057	94	182	276
8	"8-out1737"	.18137	74	334	408
8	"8-out1738"	.10077	26	232	258
8	"8-out1739"	.88599	544	70	614
8	"8-out1740"	.51379	1080	1022	2102
8	"8-out1741"	.13970	114	702	816
8	"8-out1742"	.35294	66	121	187
8	"8-out1743"	.24101	161	507	668
8	"8-out1744"	.28827	290	716	1006
8	"8-out1745"	.69343	95	42	137
8	"8-out1746"	.11566	48	367	415
8	"8-out1747"	.93150	204	15	219
8	"8-out1748"	.24266	91	284	375
8	"8-out1749"	.29829	105	247	352
8	"8-out1750"	.16406	21	107	128
8	"8-out1751"	.26210	92	259	351
8	"8-out1752"	.95705	780	35	815
8	"8-out1753"	.37098	312	529	841
8	"8-out1754"	.21481	58	212	270
8	"8-out1755"	.53505	145	126	271
8	"8-out1756"	.90255	778	84	862
8	"8-out1757"	.12149	52	376	428
8	"8-out1758"	.17348	123	586	709
8	"8-out1759"	.33827	114	223	337
8	"8-out1760"	.63333	114	66	180
8	"8-out1761"	.96875	93	3	96
8	"8-out1762"	.68525	344	158	502
8	"8-out1763"	.27327	411	1093	1504
8	"8-out1764"	.12738	107	733	840
8	"8-out1765"	.56132	476	372	848
8	"8-out1766"	.22627	155	530	685
8	"8-out1767"	.90253	676	73	749
8	"8-out1768"	.39111	273	425	698
8	"8-out1769"	.21069	134	502	636
8	"8-out1770"	.30555	154	350	504
8	"8-out1771"	.92000	69	6	75
8	"8-out1772"	.44937	1043	1278	2321
8	"8-out1773"	.65313	177	94	271
8	"8-out1774"	.24008	224	709	933
8	"8-out1775"	.23692	77	248	325
8	"8-out1776"	.53352	183	160	343
8	"8-out1777"	.98535	1144	17	1161
8	"8-out1778"	.28658	141	351	492
8	"8-out1779"	.18936	57	244	301
8	"8-out1780"	.25866	321	920	1241
8	"8-out1781"	.99748	396	1	397
8	"8-out1782"	.41592	141	198	339
8	"8-out1783"	.98913	273	3	276
8	"8-out1784"	.34453	1015	1931	2946
8	"8-out1785"	.42005	155	214	369
8	"8-out1786"	.27382	181	480	661
8	"8-out1787"	.25782	140	403	543
8	"8-out1788"	.21717	43	155	198
8	"8-out1789"	.78260	144	40	184
8	"8-out1790"	.14285	60	360	420
8	"8-out1791"	.43459	103	134	237
8	"8-out1792"	.45588	124	148	272
8	"8-out1793"	.26582	105	290	395
8	"8-out1794"	.11792	25	187	212
8	"8-out1795"	.99333	149	1	150
8	"8-out1796"	.22935	100	336	436
8	"8-out1797"	.30537	142	323	465
8	"8-out1798"	.21153	44	164	208
8	"8-out1799"	.25821	55	158	213
8	"8-out1800"	.38714	283	448	731
8	"8-out1801"	.68037	794	373	1167
8	"8-out1802"	.40572	241	353	594
8	"8-out1803"	.18181	100	450	550
8	"8-out1804"	.21298	82	303	385
8	"8-out1805"	.20982	363	1367	1730
8	"8-out1806"	.24561	28	86	114
8	"8-out1807"	.12876	77	521	598
8	"8-out1808"	.43450	272	354	626
8	"8-out1809"	.27541	317	834	1151
8	"8-out1810"	.24398	284	880	1164
8	"8-out1811"	.25468	163	477	640
8	"8-out1812"	.32705	278	572	850
8	"8-out1813"	.33969	89	173	262
8	"8-out1814"	.20869	48	182	230
8	"8-out1815"	.25737	96	277	373
8	"8-out1816"	.27423	116	307	423
8	"8-out1817"	.40779	670	973	1643
8	"8-out1818"	.28070	64	164	228
8	"8-out1819"	.27899	178	460	638
8	"8-out1820"	.99684	1263	4	1267
8	"8-out1821"	.54863	141	116	257
8	"8-out1822"	.40406	278	410	688
8	"8-out1823"	.58369	408	291	699
8	"8-out1824"	.13832	48	299	347
8	"8-out1825"	.28904	124	305	429
8	"8-out1826"	.20719	167	639	806
8	"8-out1827"	.79687	51	13	64
8	"8-out1828"	.15755	49	262	311
8	"8-out1829"	.35726	413	743	1156
8	"8-out1830"	.22694	187	637	824
8	"8-out1831"	.28595	171	427	598
8	"8-out1832"	.24151	121	380	501
8	"8-out1833"	.19065	102	433	535
8	"8-out1834"	.04093	7	164	171
8	"8-out1835"	.17862	117	538	655
8	"8-out1836"	.46493	179	206	385
8	"8-out1837"	.26645	85	234	319
8	"8-out1838"	.99408	168	1	169
8	"8-out1839"	.30017	175	408	583
8	"8-out1840"	.83333	150	30	180
8	"8-out1841"	.75000	123	41	164
8	"8-out1842"	.95897	187	8	195
8	"8-out1843"	.58555	154	109	263
8	"8-out1844"	.26881	175	476	651
8	"8-out1845"	.31578	102	221	323
8	"8-out1846"	.18548	46	202	248
8	"8-out1847"	.15282	46	255	301
8	"8-out1848"	.98764	1439	18	1457
8	"8-out1849"	.97979	97	2	99
8	"8-out1850"	.26329	99	277	376
8	"8-out1851"	.15053	98	553	651
8	"8-out1852"	.32352	165	345	510
8	"8-out1853"	.31613	870	1882	2752
8	"8-out1854"	.26760	152	416	568
8	"8-out1855"	.14285	10	60	70
8	"8-out1856"	.22368	170	590	760
8	"8-out1857"	.97530	79	2	81
8	"8-out1858"	.98275	114	2	116
8	"8-out1859"	.98979	97	1	98
8	"8-out1860"	.26190	132	372	504
8	"8-out1861"	.34790	382	716	1098
8	"8-out1862"	.21751	77	277	354
8	"8-out1863"	.66728	359	179	538
8	"8-out1864"	.23608	318	1029	1347
8	"8-out1865"	.29090	176	429	605
8	"8-out1866"	.92363	641	53	694
8	"8-out1867"	.25495	90	263	353
8	"8-out1868"	.48717	114	120	234
8	"8-out1869"	.38147	140	227	367
8	"8-out1870"	.67924	180	85	265
8	"8-out1871"	.29090	48	117	165
8	"8-out1872"	.22950	140	470	610
8	"8-out1873"	.31884	220	470	690
8	"8-out1874"	.42676	169	227	396
8	"8-out1875"	.38297	126	203	329
8	"8-out1876"	.50833	183	177	360
8	"8-out1877"	.52542	186	168	354
8	"8-out1878"	.27091	136	366	502
8	"8-out1879"	.69975	571	245	816
8	"8-out1880"	.46025	110	129	239
8	"8-out1881"	.30633	87	197	284
8	"8-out1882"	.27972	80	206	286
8	"8-out1883"	.36494	354	616	970
8	"8-out1884"	.98511	331	5	336
8	"8-out1885"	.69780	127	55	182
8	"8-out1886"	.16447	25	127	152
8	"8-out1887"	.91747	378	34	412
8	"8-out1888"	.79276	570	149	719
8	"8-out1889"	.30101	208	483	691
8	"8-out1890"	.32763	230	472	702
8	"8-out1891"	.70981	976	399	1375
8	"8-out1892"	.53454	704	613	1317
8	"8-out1893"	.48081	376	406	782
8	"8-out1894"	.94957	452	24	476
8	"8-out1895"	.95833	276	12	288
8	"8-out1896"	.92000	69	6	75
8	"8-out1897"	.12315	50	356	406
8	"8-out1898"	.48474	143	152	295
8	"8-out1899"	.38187	257	416	673
8	"8-out1900"	.14754	27	156	183
8	"8-out1901"	.57407	93	69	162
8	"8-out1902"	.98730	311	4	315
8	"8-out1903"	.47967	177	192	369
8	"8-out1904"	.96969	416	13	429
8	"8-out1905"	.36992	337	574	911
8	"8-out1906"	.22246	103	360	463
8	"8-out1907"	.32571	57	118	175
8	"8-out1908"	.54285	285	240	525
8	"8-out1909"	.09322	33	321	354
8	"8-out1910"	.11692	38	287	325
8	"8-out1911"	.72121	119	46	165
8	"8-out1912"	.15114	159	893	1052
8	"8-out1913"	.12241	71	509	580
8	"8-out1914"	.25441	144	422	566
8	"8-out1915"	.39325	70	108	178
8	"8-out1916"	.21000	126	474	600
8	"8-out1917"	.98713	307	4	311
8	"8-out1918"	.48518	131	139	270
8	"8-out1919"	.39024	96	150	246
8	"8-out1920"	.28406	148	373	521
8	"8-out1921"	.23756	258	828	1086
8	"8-out1922"	.29321	229	552	781
8	"8-out1923"	.31704	331	713	1044
8	"8-out1924"	.22322	223	776	999
8	"8-out1925"	.39106	70	109	179
8	"8-out1926"	.40243	396	588	984
8	"8-out1927"	.52413	228	207	435
8	"8-out1928"	.25399	143	420	563
8	"8-out1929"	.34574	65	123	188
8	"8-out1930"	.76428	107	33	140
8	"8-out1931"	.30434	35	80	115
8	"8-out1932"	.21206	116	431	547
8	"8-out1933"	.19784	92	373	465
8	"8-out1934"	.31158	363	802	1165
8	"8-out1935"	.28205	22	56	78
8	"8-out1936"	.26788	146	399	545
8	"8-out1937"	.31965	187	398	585
8	"8-out1938"	.36067	343	608	951
8	"8-out1939"	.31091	282	625	907
8	"8-out1940"	.99337	450	3	453
8	"8-out1941"	.29608	257	611	868
8	"8-out1942"	.41938	424	587	1011
8	"8-out1943"	.97297	468	13	481
8	"8-out1944"	.28016	137	352	489
8	"8-out1945"	.51301	749	711	1460
8	"8-out1946"	.99575	704	3	707
8	"8-out1947"	.99224	128	1	129
8	"8-out1948"	.43612	734	949	1683
8	"8-out1949"	.29285	164	396	560
8	"8-out1950"	.99686	1271	4	1275
8	"8-out1951"	.42682	245	329	574
8	"8-out1952"	.13661	25	158	183
8	"8-out1953"	.25781	231	665	896
8	"8-out1954"	.13562	83	529	612
8	"8-out1955"	.37325	187	314	501
8	"8-out1956"	.98500	394	6	400
8	"8-out1957"	.29927	164	384	548
8	"8-out1958"	.58378	216	154	370
8	"8-out1959"	.33198	82	165	247
8	"8-out1960"	.31000	62	138	200
8	"8-out1961"	.38929	211	331	542
8	"8-out1962"	.28765	191	473	664
8	"8-out1963"	.29928	208	487	695
8	"8-out1964"	.45327	194	234	428
8	"8-out1965"	.31592	127	275	402
8	"8-out1966"	.20000	29	116	145
8	"8-out1967"	.32541	178	369	547
8	"8-out1968"	.47960	929	1008	1937
8	"8-out1969"	.28934	57	140	197
8	"8-out1970"	.40750	315	458	773
8	"8-out1971"	.22183	189	663	852
8	"8-out1972"	.18539	165	725	890
8	"8-out1973"	.18683	159	692	851
8	"8-out1974"	.18673	107	466	573
8	"8-out1975"	.15133	102	572	674
8	"8-out1976"	.22259	134	468	602
8	"8-out1977"	.99155	939	8	947
8	"8-out1978"	.47713	240	263	503
8	"8-out1979"	.24875	199	601	800
8	"8-out1980"	.33860	107	209	316
8	"8-out1981"	.45798	109	129	238
8	"8-out1982"	.90983	333	33	366
8	"8-out1983"	.26929	150	407	557
8	"8-out1984"	.17906	65	298	363
8	"8-out1985"	.20197	82	324	406
8	"8-out1986"	.36591	146	253	399
8	"8-out1987"	.24637	51	156	207
8	"8-out1988"	.24852	168	508	676
8	"8-out1989"	.26058	197	559	756
8	"8-out1990"	.21978	80	284	364
8	"8-out1991"	.28697	553	1374	1927
8	"8-out1992"	.10826	38	313	351
8	"8-out1993"	.37231	191	322	513
8	"8-out1994"	.42088	133	183	316
8	"8-out1995"	.26567	178	492	670
8	"8-out1996"	.19696	39	159	198
8	"8-out1997"	.14843	95	545	640
8	"8-out1998"	.99518	1241	6	1247
8	"8-out1999"	.24834	711	2152	2863
8	"8-out2000"	.22679	171	583	754
8	"8-out2001"	.26000	65	185	250
8	"8-out2002"	.37106	354	600	954
8	"8-out2003"	.10781	109	902	1011
8	"8-out2004"	.26832	227	619	846
8	"8-out2005"	.99043	518	5	523
8	"8-out2006"	.31921	98	209	307
8	"8-out2007"	.26492	395	1096	1491
8	"8-out2008"	.32179	372	784	1156
8	"8-out2009"	.26272	191	536	727
8	"8-out2010"	.61849	107	66	173
8	"8-out2011"	.27922	129	333	462
8	"8-out2012"	.31930	895	1908	2803
8	"8-out2013"	.31687	154	332	486
8	"8-out2014"	.19375	31	129	160
8	"8-out2015"	.47899	57	62	119
8	"8-out2016"	.98766	881	11	892
8	"8-out2017"	.62260	617	374	991
8	"8-out2018"	.20820	203	772	975
8	"8-out2019"	.16022	87	456	543
8	"8-out2020"	.18346	91	405	496
8	"8-out2021"	.15060	75	423	498
8	"8-out2022"	.21361	91	335	426
8	"8-out2023"	.25378	369	1085	1454
8	"8-out2024"	.34939	145	270	415
8	"8-out2025"	.39080	68	106	174
8	"8-out2026"	.51142	403	385	788
8	"8-out2027"	.37628	330	547	877
8	"8-out2028"	.14772	39	225	264
8	"8-out2029"	.16784	166	823	989
8	"8-out2030"	.32061	42	89	131
8	"8-out2031"	.65730	117	61	178
8	"8-out2032"	.33476	78	155	233
8	"8-out2033"	.25753	94	271	365
8	"8-out2034"	.26638	126	347	473
8	"8-out2035"	.16842	192	948	1140
8	"8-out2036"	.40863	246	356	602
8	"8-out2037"	.99111	558	5	563
8	"8-out2038"	.44836	178	219	397
8	"8-out2039"	.94328	316	19	335
8	"8-out2040"	.35408	182	332	514
8	"8-out2041"	.37837	98	161	259
8	"8-out2042"	.96938	380	12	392
8	"8-out2043"	.34693	102	192	294
8	"8-out2044"	.35019	90	167	257
8	"8-out2045"	.43582	146	189	335
8	"8-out2046"	.26271	186	522	708
8	"8-out2047"	.30270	224	516	740
8	"8-out2048"	.38888	140	220	360
8	"8-out2049"	.42897	151	201	352
8	"8-out2050"	.41388	161	228	389
8	"8-out2051"	.99259	134	1	135
8	"8-out2052"	.36283	41	72	113
8	"8-out2053"	.14450	238	1409	1647
8	"8-out2054"	.94339	300	18	318
8	"8-out2055"	.23452	72	235	307
8	"8-out2056"	.44668	155	192	347
8	"8-out2057"	.27939	240	619	859
8	"8-out2058"	.49854	171	172	343
8	"8-out2059"	.95859	301	13	314
8	"8-out2060"	.75078	238	79	317
8	"8-out2061"	.72580	90	34	124
8	"8-out2062"	.40589	179	262	441
8	"8-out2063"	.43413	145	189	334
8	"8-out2064"	.27450	42	111	153
8	"8-out2065"	.29117	99	241	340
8	"8-out2066"	.29145	174	423	597
8	"8-out2067"	.26346	406	1135	1541
8	"8-out2068"	.23783	303	971	1274
8	"8-out2069"	.40761	214	311	525
8	"8-out2070"	.44029	118	150	268
8	"8-out2071"	.95588	65	3	68
8	"8-out2072"	.22696	133	453	586
8	"8-out2073"	.19270	74	310	384
8	"8-out2074"	.34011	117	227	344
8	"8-out2075"	.95762	226	10	236
8	"8-out2076"	.85964	98	16	114
8	"8-out2077"	.72881	86	32	118
8	"8-out2078"	.18686	37	161	198
8	"8-out2079"	.43478	80	104	184
8	"8-out2080"	.98773	161	2	163
8	"8-out2081"	.36571	64	111	175
8	"8-out2082"	.98863	174	2	176
8	"8-out2083"	.27740	167	435	602
8	"8-out2084"	.27500	22	58	80
8	"8-out2085"	.16788	69	342	411
8	"8-out2086"	.09919	37	336	373
8	"8-out2087"	.49096	163	169	332
8	"8-out2088"	.71556	239	95	334
8	"8-out2089"	.78012	259	73	332
8	"8-out2090"	.93835	137	9	146
8	"8-out2091"	.39714	195	296	491
8	"8-out2092"	.16766	112	556	668
8	"8-out2093"	.49868	189	190	379
8	"8-out2094"	.13397	56	362	418
8	"8-out2095"	.89071	326	40	366
8	"8-out2096"	.38148	103	167	270
8	"8-out2097"	.33152	61	123	184
8	"8-out2098"	.37272	82	138	220
8	"8-out2099"	.37010	406	691	1097
8	"8-out2100"	.31054	368	817	1185
8	"8-out2101"	.73220	216	79	295
8	"8-out2102"	.30984	277	617	894
8	"8-out2103"	.41882	178	247	425
8	"8-out2104"	.30496	43	98	141
8	"8-out2105"	.25728	53	153	206
8	"8-out2106"	.38350	558	897	1455
8	"8-out2107"	.32417	59	123	182
8	"8-out2108"	.90196	138	15	153
8	"8-out2109"	.24644	104	318	422
8	"8-out2110"	.64383	94	52	146
8	"8-out2111"	.29931	217	508	725
8	"8-out2112"	.24177	169	530	699
8	"8-out2113"	.44736	204	252	456
8	"8-out2114"	.96805	394	13	407
8	"8-out2115"	.27935	157	405	562
8	"8-out2116"	.25877	118	338	456
8	"8-out2117"	.42093	189	260	449
8	"8-out2118"	.40540	210	308	518
8	"8-out2119"	.29335	225	542	767
8	"8-out2120"	.34951	144	268	412
8	"8-out2121"	.22222	100	350	450
8	"8-out2122"	.93473	401	28	429
8	"8-out2123"	.82624	2078	437	2515
8	"8-out2124"	.97928	520	11	531
8	"8-out2125"	.26567	89	246	335
8	"8-out2126"	.27194	127	340	467
8	"8-out2127"	.27464	39	103	142
8	"8-out2128"	.79402	505	131	636
8	"8-out2129"	.40764	192	279	471
8	"8-out2130"	.99799	498	1	499
8	"8-out2131"	.19953	85	341	426
8	"8-out2132"	.87936	277	38	315
8	"8-out2133"	.28846	90	222	312
8	"8-out2134"	.89389	278	33	311
8	"8-out2135"	.25641	150	435	585
8	"8-out2136"	.23883	107	341	448
8	"8-out2137"	.36305	114	200	314
8	"8-out2138"	.25449	85	249	334
8	"8-out2139"	.24390	80	248	328
8	"8-out2140"	.80817	257	61	318
8	"8-out2141"	.84761	445	80	525
8	"8-out2142"	.23685	590	1901	2491
8	"8-out2143"	.38535	121	193	314
8	"8-out2144"	.25159	79	235	314
8	"8-out2145"	.88311	272	36	308
8	"8-out2146"	.91042	620	61	681
8	"8-out2147"	.97945	286	6	292
8	"8-out2148"	.99310	576	4	580
8	"8-out2149"	.25245	77	228	305
8	"8-out2150"	.96727	266	9	275
8	"8-out2151"	.16385	107	546	653
8	"8-out2152"	.28571	74	185	259
8	"8-out2153"	.31304	108	237	345
8	"8-out2154"	.16756	62	308	370
8	"8-out2155"	.75396	190	62	252
8	"8-out2156"	.97122	135	4	139
8	"8-out2157"	.34360	223	426	649
8	"8-out2158"	.29729	88	208	296
8	"8-out2159"	.24770	81	246	327
8	"8-out2160"	.97979	194	4	198
8	"8-out2161"	.21649	147	532	679
8	"8-out2162"	.21500	172	628	800
8	"8-out2163"	.71618	270	107	377
8	"8-out2164"	.20766	130	496	626
8	"8-out2165"	.27083	91	245	336
8	"8-out2166"	.54798	177	146	323
8	"8-out2167"	.27438	377	997	1374
8	"8-out2168"	.35808	217	389	606
8	"8-out2169"	.21782	132	474	606
8	"8-out2170"	.97256	390	11	401
8	"8-out2171"	.24179	81	254	335
8	"8-out2172"	.76829	126	38	164
8	"8-out2173"	.33994	360	699	1059
8	"8-out2174"	.11221	68	538	606
8	"8-out2175"	.33949	257	500	757
8	"8-out2176"	.29145	116	282	398
8	"8-out2177"	.27659	117	306	423
8	"8-out2178"	.37431	137	229	366
8	"8-out2179"	.24060	96	303	399
8	"8-out2180"	.24077	150	473	623
8	"8-out2181"	.44006	279	355	634
8	"8-out2182"	.40370	218	322	540
8	"8-out2183"	.22191	81	284	365
8	"8-out2184"	.23456	133	434	567
8	"8-out2185"	.22318	154	536	690
8	"8-out2186"	.50400	126	124	250
8	"8-out2187"	.28946	574	1409	1983
8	"8-out2188"	.46021	347	407	754
8	"8-out2189"	.66987	209	103	312
8	"8-out2190"	.22576	170	583	753
8	"8-out2191"	.96969	128	4	132
8	"8-out2192"	.36154	504	890	1394
8	"8-out2193"	.48414	168	179	347
8	"8-out2194"	.20652	38	146	184
8	"8-out2195"	.45821	159	188	347
8	"8-out2196"	.42508	122	165	287
8	"8-out2197"	.34839	239	447	686
8	"8-out2198"	.22875	70	236	306
8	"8-out2199"	.24664	276	843	1119
8	"8-out2200"	.43701	451	581	1032
8	"8-out2201"	.23432	71	232	303
8	"8-out2202"	.99319	146	1	147
8	"8-out2203"	.30180	67	155	222
8	"8-out2204"	.52968	116	103	219
8	"8-out2205"	.99264	135	1	136
8	"8-out2206"	.75847	179	57	236
8	"8-out2207"	.58450	415	295	710
8	"8-out2208"	.57675	665	488	1153
8	"8-out2209"	.38507	898	1434	2332
8	"8-out2210"	.27658	809	2116	2925
8	"8-out2211"	.33333	159	318	477
8	"8-out2212"	.24911	140	422	562
8	"8-out2213"	.16446	237	1204	1441
8	"8-out2214"	.27402	231	612	843
8	"8-out2215"	.33865	191	373	564
8	"8-out2216"	.71101	342	139	481
8	"8-out2217"	.32574	186	385	571
8	"8-out2218"	.17342	77	367	444
8	"8-out2219"	.99409	1178	7	1185
8	"8-out2220"	.20919	91	344	435
8	"8-out2221"	.13194	19	125	144
8	"8-out2222"	.53691	80	69	149
8	"8-out2223"	.35862	52	93	145
8	"8-out2224"	.29545	52	124	176
8	"8-out2225"	.75531	142	46	188
8	"8-out2226"	.24812	165	500	665
8	"8-out2227"	.34539	229	434	663
8	"8-out2228"	.16452	77	391	468
8	"8-out2229"	.26168	252	711	963
8	"8-out2230"	.18110	161	728	889
8	"8-out2231"	.29650	263	624	887
8	"8-out2232"	.21902	297	1059	1356
8	"8-out2233"	.24437	76	235	311
8	"8-out2234"	.33333	181	362	543
8	"8-out2235"	.82058	311	68	379
8	"8-out2236"	.24175	88	276	364
8	"8-out2237"	.20543	68	263	331
8	"8-out2238"	.25619	124	360	484
8	"8-out2239"	.98406	247	4	251
8	"8-out2240"	.63235	43	25	68
8	"8-out2241"	.41292	147	209	356
8	"8-out2242"	.94855	756	41	797
8	"8-out2243"	.91729	732	66	798
8	"8-out2244"	.84210	784	147	931
8	"8-out2245"	.91486	720	67	787
8	"8-out2246"	.11059	48	386	434
8	"8-out2247"	.27876	298	771	1069
8	"8-out2248"	.85135	819	143	962
8	"8-out2249"	.83667	794	155	949
8	"8-out2250"	.22004	180	638	818
8	"8-out2251"	.62280	497	301	798
8	"8-out2252"	.28906	74	182	256
8	"8-out2253"	.27428	96	254	350
8	"8-out2254"	.32446	122	254	376
8	"8-out2255"	.26306	156	437	593
8	"8-out2256"	.17391	60	285	345
8	"8-out2257"	.99456	366	2	368
8	"8-out2258"	.86095	452	73	525
8	"8-out2259"	.34573	223	422	645
8	"8-out2260"	.30635	159	360	519
8	"8-out2261"	.24087	99	312	411
8	"8-out2262"	.55272	739	598	1337
8	"8-out2263"	.31444	455	992	1447
8	"8-out2264"	.54122	256	217	473
8	"8-out2265"	.30256	118	272	390
8	"8-out2266"	.34801	79	148	227
8	"8-out2267"	.98009	394	8	402
8	"8-out2268"	.99186	732	6	738
8	"8-out2269"	.34734	281	528	809
8	"8-out2270"	.81250	481	111	592
8	"8-out2271"	.37558	240	399	639
8	"8-out2272"	.24356	142	441	583
8	"8-out2273"	.35827	383	686	1069
8	"8-out2274"	.38649	206	327	533
8	"8-out2275"	.23350	138	453	591
8	"8-out2276"	.21659	261	944	1205
8	"8-out2277"	.24590	210	644	854
8	"8-out2278"	.16715	57	284	341
8	"8-out2279"	.37697	763	1261	2024
8	"8-out2280"	.21250	136	504	640
8	"8-out2281"	.47058	168	189	357
8	"8-out2282"	.34772	1160	2176	3336
8	"8-out2283"	.23253	406	1340	1746
8	"8-out2284"	.34329	356	681	1037
8	"8-out2285"	.12918	54	364	418
8	"8-out2286"	.60310	427	281	708
8	"8-out2287"	.58241	106	76	182
8	"8-out2288"	.26732	81	222	303
8	"8-out2289"	.26923	35	95	130
8	"8-out2290"	.20259	78	307	385
8	"8-out2291"	.15740	68	364	432
8	"8-out2292"	.23892	178	567	745
8	"8-out2293"	.28226	339	862	1201
8	"8-out2294"	.29264	199	481	680
8	"8-out2295"	.26666	52	143	195
8	"8-out2296"	.99185	731	6	737
8	"8-out2297"	.32187	103	217	320
8	"8-out2298"	.72834	185	69	254
8	"8-out2299"	.42938	225	299	524
8	"8-out2300"	.54066	113	96	209
8	"8-out2301"	.90716	342	35	377
8	"8-out2302"	.23076	63	210	273
8	"8-out2303"	.15757	52	278	330
8	"8-out2304"	.20954	79	298	377
8	"8-out2305"	.64021	121	68	189
8	"8-out2306"	.81786	1410	314	1724
8	"8-out2307"	.08695	34	357	391
8	"8-out2308"	.18444	83	367	450
8	"8-out2309"	.50684	185	180	365
8	"8-out2310"	.92955	739	56	795
8	"8-out2311"	.92055	730	63	793
8	"8-out2312"	.27153	145	389	534
8	"8-out2313"	.94500	756	44	800
8	"8-out2314"	.93350	744	53	797
8	"8-out2315"	.36029	196	348	544
8	"8-out2316"	.85329	791	136	927
8	"8-out2317"	.92912	721	55	776
8	"8-out2318"	.82421	783	167	950
8	"8-out2319"	.83047	774	158	932
8	"8-out2320"	.83905	782	150	932
8	"8-out2321"	.53333	448	392	840
8	"8-out2322"	.83740	788	153	941
8	"8-out2323"	.27459	134	354	488
8	"8-out2324"	.61084	631	402	1033
8	"8-out2325"	.39438	506	777	1283
8	"8-out2326"	.35064	54	100	154
8	"8-out2327"	.99492	196	1	197
8	"8-out2328"	.35809	135	242	377
8	"8-out2329"	.22275	139	485	624
8	"8-out2330"	.30705	553	1248	1801
8	"8-out2331"	.31268	212	466	678
8	"8-out2332"	.15025	58	328	386
8	"8-out2333"	.37996	220	359	579
8	"8-out2334"	.20235	86	339	425
8	"8-out2335"	.24217	116	363	479
8	"8-out2336"	.52647	179	161	340
8	"8-out2337"	.29248	494	1195	1689
8	"8-out2338"	.28514	144	361	505
8	"8-out2339"	.93984	750	48	798
8	"8-out2340"	.53023	228	202	430
8	"8-out2341"	.82736	786	164	950
8	"8-out2342"	.17270	162	776	938
8	"8-out2343"	.81415	863	197	1060
8	"8-out2344"	.84871	791	141	932
8	"8-out2345"	.31077	124	275	399
8	"8-out2346"	.14914	105	599	704
8	"8-out2347"	.83016	787	161	948
8	"8-out2348"	.90954	724	72	796
8	"8-out2349"	.33884	205	400	605
8	"8-out2350"	.96517	388	14	402
8	"8-out2351"	.16480	59	299	358
8	"8-out2352"	.95187	178	9	187
8	"8-out2353"	.70422	200	84	284
8	"8-out2354"	.32183	224	472	696
8	"8-out2355"	.18918	49	210	259
8	"8-out2356"	.26996	169	457	626
8	"8-out2357"	.57792	89	65	154
8	"8-out2358"	.32448	318	662	980
8	"8-out2359"	.33746	109	214	323
8	"8-out2360"	.94776	127	7	134
8	"8-out2361"	.14487	113	667	780
8	"8-out2362"	.95767	181	8	189
8	"8-out2363"	.69696	2247	977	3224
8	"8-out2364"	.38069	351	571	922
8	"8-out2365"	.25128	49	146	195
8	"8-out2366"	.17827	64	295	359
8	"8-out2367"	.22448	44	152	196
8	"8-out2368"	.36908	234	400	634
8	"8-out2369"	.62000	248	152	400
8	"8-out2370"	.53488	207	180	387
8	"8-out2371"	.68584	727	333	1060
8	"8-out2372"	.23170	57	189	246
8	"8-out2373"	.33313	572	1145	1717
8	"8-out2374"	.98261	1187	21	1208
8	"8-out2375"	.30978	307	684	991
8	"8-out2376"	.98473	129	2	131
8	"8-out2377"	.18849	59	254	313
8	"8-out2378"	.22186	69	242	311
8	"8-out2379"	.80368	262	64	326
8	"8-out2380"	.91000	91	9	100
8	"8-out2381"	.23205	97	321	418
8	"8-out2382"	.28464	76	191	267
8	"8-out2383"	.94329	366	22	388
8	"8-out2384"	.30056	159	370	529
8	"8-out2385"	.24333	356	1107	1463
8	"8-out2386"	.26003	136	387	523
8	"8-out2387"	.24886	437	1319	1756
8	"8-out2388"	.23063	128	427	555
8	"8-out2389"	.77571	460	133	593
8	"8-out2390"	.74580	311	106	417
8	"8-out2391"	.13110	145	961	1106
8	"8-out2392"	.10047	21	188	209
8	"8-out2393"	.19965	115	461	576
8	"8-out2394"	.31663	177	382	559
8	"8-out2395"	.30199	212	490	702
8	"8-out2396"	.19387	76	316	392
8	"8-out2397"	.22872	86	290	376
8	"8-out2398"	.31040	176	391	567
8	"8-out2399"	.24820	311	942	1253
8	"8-out2400"	.94845	368	20	388
8	"8-out2401"	.50757	134	130	264
8	"8-out2402"	.86065	105	17	122
8	"8-out2403"	.32459	99	206	305
8	"8-out2404"	.31099	116	257	373
8	"8-out2405"	.23324	87	286	373
8	"8-out2406"	.34121	303	585	888
8	"8-out2407"	.24310	141	439	580
8	"8-out2408"	.95717	961	43	1004
8	"8-out2409"	.19861	201	811	1012
8	"8-out2410"	.82730	412	86	498
8	"8-out2411"	.21182	86	320	406
8	"8-out2412"	.21448	77	282	359
8	"8-out2413"	.18333	143	637	780
8	"8-out2414"	.31756	188	404	592
8	"8-out2415"	.16441	85	432	517
8	"8-out2416"	.47734	158	173	331
8	"8-out2417"	.40517	235	345	580
8	"8-out2418"	.39857	224	338	562
8	"8-out2419"	.94852	258	14	272
8	"8-out2420"	.30232	91	210	301
8	"8-out2421"	.56569	620	476	1096
8	"8-out2422"	.32908	671	1368	2039
8	"8-out2423"	.30876	310	694	1004
8	"8-out2424"	.22309	85	296	381
8	"8-out2425"	.29780	394	929	1323
8	"8-out2426"	.97737	432	10	442
8	"8-out2427"	.49689	160	162	322
8	"8-out2428"	.27993	332	854	1186
8	"8-out2429"	.26859	65	177	242
8	"8-out2430"	.22164	215	755	970
8	"8-out2431"	.27925	105	271	376
8	"8-out2432"	.19718	224	912	1136
8	"8-out2433"	.32931	164	334	498
8	"8-out2434"	.99367	157	1	158
8	"8-out2435"	.53571	315	273	588
8	"8-out2436"	.31473	220	479	699
8	"8-out2437"	.97435	342	9	351
8	"8-out2438"	.98601	846	12	858
8	"8-out2439"	.99843	3837	6	3843
8	"8-out2440"	.17853	183	842	1025
8	"8-out2441"	.21374	308	1133	1441
8	"8-out2442"	.31308	201	441	642
8	"8-out2443"	.29450	134	321	455
8	"8-out2444"	.25000	98	294	392
8	"8-out2445"	.44444	192	240	432
8	"8-out2446"	.32934	110	224	334
8	"8-out2447"	.87272	96	14	110
8	"8-out2448"	.75280	67	22	89
8	"8-out2449"	.89130	82	10	92
8	"8-out2450"	.31692	103	222	325
8	"8-out2451"	.31499	229	498	727
8	"8-out2452"	.34939	116	216	332
8	"8-out2453"	.28796	146	361	507
8	"8-out2454"	.19889	36	145	181
8	"8-out2455"	.68741	508	231	739
8	"8-out2456"	.53225	33	29	62
8	"8-out2457"	.99460	369	2	371
8	"8-out2458"	.17342	124	591	715
8	"8-out2459"	.31284	168	369	537
8	"8-out2460"	.27860	112	290	402
8	"8-out2461"	.28817	117	289	406
8	"8-out2462"	.30708	39	88	127
8	"8-out2463"	.23983	59	187	246
8	"8-out2464"	.28194	214	545	759
8	"8-out2465"	.34757	415	779	1194
8	"8-out2466"	.47348	125	139	264
8	"8-out2467"	.20359	34	133	167
8	"8-out2468"	.17413	101	479	580
8	"8-out2469"	.33988	173	336	509
8	"8-out2470"	.49315	108	111	219
8	"8-out2471"	.38617	229	364	593
8	"8-out2472"	.56923	185	140	325
8	"8-out2473"	.18475	63	278	341
8	"8-out2474"	.27454	137	362	499
8	"8-out2475"	.91820	449	40	489
8	"8-out2476"	.86749	419	64	483
8	"8-out2477"	.97157	581	17	598
8	"8-out2478"	.17052	81	394	475
8	"8-out2479"	.71676	620	245	865
8	"8-out2480"	.33707	60	118	178
8	"8-out2481"	.68421	143	66	209
8	"8-out2482"	.28708	209	519	728
8	"8-out2483"	.40240	268	398	666
8	"8-out2484"	.89173	313	38	351
8	"8-out2485"	.14615	57	333	390
8	"8-out2486"	.23677	94	303	397
8	"8-out2487"	.45340	180	217	397
8	"8-out2488"	.21551	25	91	116
8	"8-out2489"	.49347	227	233	460
8	"8-out2490"	.42525	165	223	388
8	"8-out2491"	.31603	207	448	655
8	"8-out2492"	.15319	108	597	705
8	"8-out2493"	.40707	92	134	226
8	"8-out2494"	.39175	76	118	194
8	"8-out2495"	.30594	108	245	353
8	"8-out2496"	.36048	239	424	663
8	"8-out2497"	.46802	161	183	344
8	"8-out2498"	.62537	414	248	662
8	"8-out2499"	.48091	63	68	131
8	"8-out2500"	.64253	142	79	221
8	"8-out2501"	.99404	167	1	168
8	"8-out2502"	.16398	51	260	311
8	"8-out2503"	.17134	61	295	356
8	"8-out2504"	.28070	64	164	228
8	"8-out2505"	.68973	867	390	1257
8	"8-out2506"	.27323	294	782	1076
8	"8-out2507"	.23281	105	346	451
8	"8-out2508"	.32903	153	312	465
8	"8-out2509"	.41970	196	271	467
8	"8-out2510"	.69756	286	124	410
8	"8-out2511"	.97991	439	9	448
8	"8-out2512"	.18633	30	131	161
8	"8-out2513"	.43916	148	189	337
8	"8-out2514"	.15248	43	239	282
8	"8-out2515"	.54761	23	19	42
8	"8-out2516"	.37142	182	308	490
8	"8-out2517"	.21623	325	1178	1503
8	"8-out2518"	.25916	99	283	382
8	"8-out2519"	.28156	165	421	586
8	"8-out2520"	.16190	136	704	840
8	"8-out2521"	.19082	79	335	414
8	"8-out2522"	.39163	206	320	526
8	"8-out2523"	.21212	35	130	165
8	"8-out2524"	.99180	121	1	122
8	"8-out2525"	.30459	106	242	348
8	"8-out2526"	.29019	148	362	510
8	"8-out2527"	.10396	21	181	202
8	"8-out2528"	.14193	88	532	620
8	"8-out2529"	.40878	242	350	592
8	"8-out2530"	.35752	133	239	372
8	"8-out2531"	.46865	299	339	638
8	"8-out2532"	.23460	282	920	1202
8	"8-out2533"	.21319	42	155	197
8	"8-out2534"	.45415	213	256	469
8	"8-out2535"	.98135	579	11	590
8	"8-out2536"	.39810	547	827	1374
8	"8-out2537"	.15168	54	302	356
8	"8-out2538"	.54005	1045	890	1935
8	"8-out2539"	.37567	139	231	370
8	"8-out2540"	.22609	175	599	774
8	"8-out2541"	.24236	127	397	524
8	"8-out2542"	.47557	146	161	307
8	"8-out2543"	.41860	144	200	344
8	"8-out2544"	.34926	95	177	272
8	"8-out2545"	.21105	168	628	796
8	"8-out2546"	.18695	43	187	230
8	"8-out2547"	.16778	50	248	298
8	"8-out2548"	.25381	133	391	524
8	"8-out2549"	.20998	122	459	581
8	"8-out2550"	.13604	97	616	713
8	"8-out2551"	.36817	1673	2871	4544
8	"8-out2552"	.23220	137	453	590
8	"8-out2553"	.97058	99	3	102
8	"8-out2554"	.31351	116	254	370
8	"8-out2555"	.24390	160	496	656
8	"8-out2556"	.39622	231	352	583
8	"8-out2557"	.29547	385	918	1303
8	"8-out2558"	.41713	370	517	887
8	"8-out2559"	.97333	146	4	150
8	"8-out2560"	.36070	637	1129	1766
8	"8-out2561"	.11608	57	434	491
8	"8-out2562"	.98742	157	2	159
8	"8-out2563"	.28025	88	226	314
8	"8-out2564"	.97907	234	5	239
8	"8-out2565"	.19599	137	562	699
8	"8-out2566"	.15631	151	815	966
8	"8-out2567"	.28184	177	451	628
8	"8-out2568"	.23056	86	287	373
8	"8-out2569"	.41176	196	280	476
8	"8-out2570"	.39772	70	106	176
8	"8-out2571"	.53156	160	141	301
8	"8-out2572"	.20297	164	644	808
8	"8-out2573"	.26039	144	409	553
8	"8-out2574"	.24681	213	650	863
8	"8-out2575"	.14986	110	624	734
8	"8-out2576"	.22485	76	262	338
8	"8-out2577"	.50516	538	527	1065
8	"8-out2578"	.54983	1026	840	1866
8	"8-out2579"	.38282	214	345	559
8	"8-out2580"	.25525	182	531	713
8	"8-out2581"	.28205	242	616	858
8	"8-out2582"	.98958	190	2	192
8	"8-out2583"	.25714	144	416	560
8	"8-out2584"	.27335	199	529	728
8	"8-out2585"	.68085	96	45	141
8	"8-out2586"	.52830	196	175	371
8	"8-out2587"	.97435	114	3	117
8	"8-out2588"	.99186	122	1	123
8	"8-out2589"	.98387	122	2	124
8	"8-out2590"	.97540	119	3	122
8	"8-out2591"	.97560	120	3	123
8	"8-out2592"	.31981	71	151	222
8	"8-out2593"	.31343	63	138	201
8	"8-out2594"	.38167	150	243	393
8	"8-out2595"	.56279	121	94	215
8	"8-out2596"	.25635	222	644	866
8	"8-out2597"	.39473	75	115	190
8	"8-out2598"	.26751	84	230	314
8	"8-out2599"	.97727	129	3	132
8	"8-out2600"	.46794	73	83	156
8	"8-out2601"	.21848	182	651	833
8	"8-out2602"	.29390	241	579	820
8	"8-out2603"	.48662	491	518	1009
8	"8-out2604"	.39017	135	211	346
8	"8-out2605"	.51445	178	168	346
8	"8-out2606"	.94812	329	18	347
8	"8-out2607"	.46296	150	174	324
8	"8-out2608"	.24875	400	1208	1608
8	"8-out2609"	.96178	302	12	314
8	"8-out2610"	.34839	293	548	841
8	"8-out2611"	.46118	404	472	876
8	"8-out2612"	.59459	198	135	333
8	"8-out2613"	.25698	331	957	1288
8	"8-out2614"	.21990	137	486	623
8	"8-out2615"	.99489	2145	11	2156
8	"8-out2616"	.28119	320	818	1138
8	"8-out2617"	.43388	105	137	242
8	"8-out2618"	.22759	127	431	558
8	"8-out2619"	.47483	217	240	457
8	"8-out2620"	.18939	50	214	264
8	"8-out2621"	.20637	110	423	533
8	"8-out2622"	.35801	324	581	905
8	"8-out2623"	.28497	110	276	386
8	"8-out2624"	.44324	246	309	555
8	"8-out2625"	.68000	85	40	125
8	"8-out2626"	.13987	87	535	622
8	"8-out2627"	.75914	643	204	847
8	"8-out2628"	.17956	58	265	323
8	"8-out2629"	.20876	81	307	388
8	"8-out2630"	.83908	146	28	174
8	"8-out2631"	.09836	6	55	61
8	"8-out2632"	.37600	94	156	250
8	"8-out2633"	.30808	183	411	594
8	"8-out2634"	.64434	279	154	433
8	"8-out2635"	.27094	262	705	967
8	"8-out2636"	.52966	125	111	236
8	"8-out2637"	.34312	257	492	749
8	"8-out2638"	.36480	85	148	233
8	"8-out2639"	.19634	172	704	876
8	"8-out2640"	.30735	71	160	231
8	"8-out2641"	.22361	89	309	398
8	"8-out2642"	.97038	426	13	439
8	"8-out2643"	.52061	101	93	194
8	"8-out2644"	.93026	587	44	631
8	"8-out2645"	.27623	129	338	467
8	"8-out2646"	.42908	841	1119	1960
8	"8-out2647"	.28362	272	687	959
8	"8-out2648"	.32307	63	132	195
8	"8-out2649"	.93063	161	12	173
8	"8-out2650"	.58653	122	86	208
8	"8-out2651"	.74834	113	38	151
8	"8-out2652"	.56976	98	74	172
8	"8-out2653"	.32015	243	516	759
8	"8-out2654"	.18771	388	1679	2067
8	"8-out2655"	.31720	118	254	372
8	"8-out2656"	.25396	112	329	441
8	"8-out2657"	.64408	523	289	812
8	"8-out2658"	.20081	98	390	488
8	"8-out2659"	.29283	94	227	321
8	"8-out2660"	.33773	179	351	530
8	"8-out2661"	.32769	252	517	769
8	"8-out2662"	.36624	230	398	628
8	"8-out2663"	.29921	190	445	635
8	"8-out2664"	.19689	76	310	386
8	"8-out2665"	.14057	44	269	313
8	"8-out2666"	.67456	313	151	464
8	"8-out2667"	.36173	225	397	622
8	"8-out2668"	.25614	1178	3421	4599
8	"8-out2669"	.21208	365	1356	1721
8	"8-out2670"	.95967	119	5	124
8	"8-out2671"	.98260	113	2	115
8	"8-out2672"	.99107	111	1	112
8	"8-out2673"	.27615	66	173	239
8	"8-out2674"	.98373	121	2	123
8	"8-out2675"	.26217	70	197	267
8	"8-out2676"	.26497	115	319	434
8	"8-out2677"	.14000	70	430	500
8	"8-out2678"	.40214	150	223	373
8	"8-out2679"	.75150	375	124	499
8	"8-out2680"	.94648	283	16	299
8	"8-out2681"	.88307	574	76	650
8	"8-out2682"	.35515	217	394	611
8	"8-out2683"	.35256	275	505	780
8	"8-out2684"	.16184	28	145	173
8	"8-out2685"	.98857	779	9	788
8	"8-out2686"	.28548	177	443	620
8	"8-out2687"	.25166	151	449	600
8	"8-out2688"	.35724	244	439	683
8	"8-out2689"	.98113	156	3	159
8	"8-out2690"	.26362	208	581	789
8	"8-out2691"	.13913	48	297	345
8	"8-out2692"	.35816	274	491	765
8	"8-out2693"	.40036	217	325	542
8	"8-out2694"	.15447	19	104	123
8	"8-out2695"	.22492	148	510	658
8	"8-out2696"	.99130	114	1	115
8	"8-out2697"	.98260	113	2	115
8	"8-out2698"	.16788	69	342	411
8	"8-out2699"	.26605	87	240	327
8	"8-out2700"	.27133	283	760	1043
8	"8-out2701"	.27172	297	796	1093
8	"8-out2702"	.23590	410	1328	1738
8	"8-out2703"	.99058	1052	10	1062
8	"8-out2704"	.99011	1202	12	1214
8	"8-out2705"	.19365	61	254	315
8	"8-out2706"	.21762	516	1855	2371
8	"8-out2707"	.90291	186	20	206
8	"8-out2708"	.37931	286	468	754
8	"8-out2709"	.21273	137	507	644
8	"8-out2710"	.30366	116	266	382
8	"8-out2711"	.22906	93	313	406
8	"8-out2712"	.14014	59	362	421
8	"8-out2713"	.97804	579	13	592
8	"8-out2714"	.36879	104	178	282
8	"8-out2715"	.21815	137	491	628
8	"8-out2716"	.95508	404	19	423
8	"8-out2717"	.60759	96	62	158
8	"8-out2718"	.14705	85	493	578
8	"8-out2719"	.43548	81	105	186
8	"8-out2720"	.87596	113	16	129
8	"8-out2721"	.91549	65	6	71
8	"8-out2722"	.19026	168	715	883
8	"8-out2723"	.25781	33	95	128
8	"8-out2724"	.39939	131	197	328
8	"8-out2725"	.35526	27	49	76
8	"8-out2726"	.37815	45	74	119
8	"8-out2727"	.32221	425	894	1319
8	"8-out2728"	.33925	344	670	1014
8	"8-out2729"	.80000	100	25	125
8	"8-out2730"	.20241	67	264	331
8	"8-out2731"	.19339	41	171	212
8	"8-out2732"	.20430	38	148	186
8	"8-out2733"	.22368	34	118	152
8	"8-out2734"	.56578	86	66	152
8	"8-out2735"	.24914	364	1097	1461
8	"8-out2736"	.24568	185	568	753
8	"8-out2737"	.47195	244	273	517
8	"8-out2738"	.29607	151	359	510
8	"8-out2739"	.20043	93	371	464
8	"8-out2740"	.13245	40	262	302
8	"8-out2741"	.25084	148	442	590
8	"8-out2742"	.26996	240	649	889
8	"8-out2743"	.45555	123	147	270
8	"8-out2744"	.34320	197	377	574
8	"8-out2745"	.20625	231	889	1120
8	"8-out2746"	.14056	105	642	747
8	"8-out2747"	.79568	701	180	881
8	"8-out2748"	.98324	176	3	179
8	"8-out2749"	.16182	39	202	241
8	"8-out2750"	.23076	69	230	299
8	"8-out2751"	.32946	482	981	1463
8	"8-out2752"	.22400	112	388	500
8	"8-out2753"	.26254	361	1014	1375
8	"8-out2754"	.26289	209	586	795
8	"8-out2755"	.30064	279	649	928
8	"8-out2756"	.31367	234	512	746
8	"8-out2757"	.86319	448	71	519
8	"8-out2758"	.27023	394	1064	1458
8	"8-out2759"	.27362	194	515	709
8	"8-out2760"	.28947	44	108	152
8	"8-out2761"	.18673	76	331	407
8	"8-out2762"	.97345	110	3	113
8	"8-out2763"	.34548	180	341	521
8	"8-out2764"	.25365	52	153	205
8	"8-out2765"	.20983	64	241	305
8	"8-out2766"	.26477	233	647	880
8	"8-out2767"	.29673	100	237	337
8	"8-out2768"	.14209	80	483	563
8	"8-out2769"	.33700	367	722	1089
8	"8-out2770"	.37373	37	62	99
8	"8-out2771"	.51190	43	41	84
8	"8-out2772"	.83164	410	83	493
8	"8-out2773"	.99136	574	5	579
8	"8-out2774"	.26376	230	642	872
8	"8-out2775"	.45930	79	93	172
8	"8-out2776"	.61437	94	59	153
8	"8-out2777"	.94674	160	9	169
8	"8-out2778"	.87735	93	13	106
8	"8-out2779"	.36168	455	803	1258
8	"8-out2780"	.61971	132	81	213
8	"8-out2781"	.28991	69	169	238
8	"8-out2782"	.21093	274	1025	1299
8	"8-out2783"	.44376	217	272	489
8	"8-out2784"	.28759	262	649	911
8	"8-out2785"	.21904	69	246	315
8	"8-out2786"	.16901	120	590	710
8	"8-out2787"	.19571	73	300	373
8	"8-out2788"	.35114	138	255	393
8	"8-out2789"	.98293	288	5	293
8	"8-out2790"	.14912	68	388	456
8	"8-out2791"	.23631	82	265	347
8	"8-out2792"	.34146	42	81	123
8	"8-out2793"	.58260	67	48	115
8	"8-out2794"	.38800	194	306	500
8	"8-out2795"	.74811	1886	635	2521
8	"8-out2796"	.61279	182	115	297
8	"8-out2797"	.22482	221	762	983
8	"8-out2798"	.36842	343	588	931
8	"8-out2799"	.27819	37	96	133
8	"8-out2800"	.38194	55	89	144
8	"8-out2801"	.18198	101	454	555
8	"8-out2802"	.15238	16	89	105
8	"8-out2803"	.33333	86	172	258
8	"8-out2804"	.21164	40	149	189
8	"8-out2805"	.27586	80	210	290
8	"8-out2806"	.47619	150	165	315
8	"8-out2807"	.35046	75	139	214
8	"8-out2808"	.98148	53	1	54
8	"8-out2809"	.29545	117	279	396
8	"8-out2810"	.29841	151	355	506
8	"8-out2811"	.33151	182	367	549
8	"8-out2812"	.21917	32	114	146
8	"8-out2813"	.32424	214	446	660
8	"8-out2814"	.35881	338	604	942
8	"8-out2815"	.26266	197	553	750
8	"8-out2816"	.22244	113	395	508
8	"8-out2817"	.46222	312	363	675
8	"8-out2818"	.40530	107	157	264
8	"8-out2819"	.35897	28	50	78
8	"8-out2820"	.21325	74	273	347
8	"8-out2821"	.46935	268	303	571
8	"8-out2822"	.23664	381	1229	1610
8	"8-out2823"	.59656	139	94	233
8	"8-out2824"	.43243	144	189	333
8	"8-out2825"	.96250	231	9	240
8	"8-out2826"	.87974	139	19	158
8	"8-out2827"	.43150	126	166	292
8	"8-out2828"	.35323	142	260	402
8	"8-out2829"	.29574	139	331	470
8	"8-out2830"	.27222	398	1064	1462
8	"8-out2831"	.93917	386	25	411
8	"8-out2832"	.21842	211	755	966
8	"8-out2833"	.33149	60	121	181
8	"8-out2834"	.27479	230	607	837
8	"8-out2835"	.29901	395	926	1321
8	"8-out2836"	.33043	114	231	345
8	"8-out2837"	.53460	224	195	419
8	"8-out2838"	.22151	346	1216	1562
8	"8-out2839"	.68750	88	40	128
8	"8-out2840"	.27675	181	473	654
8	"8-out2841"	.75925	779	247	1026
8	"8-out2842"	.15717	80	429	509
8	"8-out2843"	.21949	250	889	1139
8	"8-out2844"	.32450	49	102	151
8	"8-out2845"	.34112	73	141	214
8	"8-out2846"	.72508	211	80	291
8	"8-out2847"	.37288	66	111	177
8	"8-out2848"	.26308	191	535	726
8	"8-out2849"	.95876	93	4	97
8	"8-out2850"	.39257	148	229	377
8	"8-out2851"	.35238	487	895	1382
8	"8-out2852"	.16819	55	272	327
8	"8-out2853"	.53790	149	128	277
8	"8-out2854"	.18269	38	170	208
8	"8-out2855"	.67951	282	133	415
8	"8-out2856"	.31818	161	345	506
8	"8-out2857"	.37844	316	519	835
8	"8-out2858"	.35164	128	236	364
8	"8-out2859"	.27253	127	339	466
8	"8-out2860"	.46179	139	162	301
8	"8-out2861"	.31954	896	1908	2804
8	"8-out2862"	.38202	68	110	178
8	"8-out2863"	.30191	346	800	1146
8	"8-out2864"	.14016	67	411	478
8	"8-out2865"	.18965	154	658	812
8	"8-out2866"	.93418	440	31	471
8	"8-out2867"	.38209	431	697	1128
8	"8-out2868"	.99118	225	2	227
8	"8-out2869"	.98976	387	4	391
8	"8-out2870"	.99180	363	3	366
8	"8-out2871"	.10955	39	317	356
8	"8-out2872"	.30338	412	946	1358
8	"8-out2873"	.18269	76	340	416
8	"8-out2874"	.18934	32	137	169
8	"8-out2875"	.21666	117	423	540
8	"8-out2876"	.23006	150	502	652
8	"8-out2877"	.18650	47	205	252
8	"8-out2878"	.23989	89	282	371
8	"8-out2879"	.98540	135	2	137
8	"8-out2880"	.13378	118	764	882
8	"8-out2881"	.26804	234	639	873
8	"8-out2882"	.20263	77	303	380
8	"8-out2883"	.63953	110	62	172
8	"8-out2884"	.66545	183	92	275
8	"8-out2885"	.38559	273	435	708
8	"8-out2886"	.63225	741	431	1172
8	"8-out2887"	.30864	175	392	567
8	"8-out2888"	.31034	180	400	580
8	"8-out2889"	.38494	624	997	1621
8	"8-out2890"	.24216	224	701	925
8	"8-out2891"	.17831	74	341	415
8	"8-out2892"	.24380	236	732	968
8	"8-out2893"	.98947	94	1	95
8	"8-out2894"	.23892	658	2096	2754
8	"8-out2895"	.15526	59	321	380
8	"8-out2896"	.98344	297	5	302
8	"8-out2897"	.27479	302	797	1099
8	"8-out2898"	.25701	119	344	463
8	"8-out2899"	.63504	395	227	622
8	"8-out2900"	.96946	254	8	262
8	"8-out2901"	.74021	416	146	562
8	"8-out2902"	.36040	142	252	394
8	"8-out2903"	.24154	150	471	621
8	"8-out2904"	.34610	262	495	757
8	"8-out2905"	.41809	268	373	641
8	"8-out2906"	.39169	217	337	554
8	"8-out2907"	.27470	164	433	597
8	"8-out2908"	.23039	188	628	816
8	"8-out2909"	.63239	203	118	321
8	"8-out2910"	.86614	220	34	254
8	"8-out2911"	.41263	444	632	1076
8	"8-out2912"	.17891	56	257	313
8	"8-out2913"	.32661	308	635	943
8	"8-out2914"	.32579	72	149	221
8	"8-out2915"	.42629	214	288	502
8	"8-out2916"	.20350	58	227	285
8	"8-out2917"	.98854	259	3	262
8	"8-out2918"	.49655	288	292	580
8	"8-out2919"	.24681	155	473	628
8	"8-out2920"	.34117	58	112	170
8	"8-out2921"	.28608	438	1093	1531
8	"8-out2922"	.56768	260	198	458
8	"8-out2923"	.42953	512	680	1192
8	"8-out2924"	.27777	140	364	504
8	"8-out2925"	.21782	66	237	303
8	"8-out2926"	.59666	1108	749	1857
8	"8-out2927"	.41463	34	48	82
8	"8-out2928"	.33402	323	644	967
8	"8-out2929"	.49603	125	127	252
8	"8-out2930"	.25571	123	358	481
8	"8-out2931"	.50393	64	63	127
8	"8-out2932"	.74132	235	82	317
8	"8-out2933"	.41853	131	182	313
8	"8-out2934"	.92604	288	23	311
8	"8-out2935"	.94578	314	18	332
8	"8-out2936"	.41791	140	195	335
8	"8-out2937"	.28253	89	226	315
8	"8-out2938"	.42361	244	332	576
8	"8-out2939"	.35093	113	209	322
8	"8-out2940"	.33855	108	211	319
8	"8-out2941"	.27564	86	226	312
8	"8-out2942"	.61554	301	188	489
8	"8-out2943"	.79182	213	56	269
8	"8-out2944"	.43870	136	174	310
8	"8-out2945"	.78387	243	67	310
8	"8-out2946"	.64873	205	111	316
8	"8-out2947"	.31402	103	225	328
8	"8-out2948"	.37910	127	208	335
8	"8-out2949"	.63437	203	117	320
8	"8-out2950"	.85897	268	44	312
8	"8-out2951"	.86562	277	43	320
8	"8-out2952"	.78864	250	67	317
8	"8-out2953"	.89062	285	35	320
8	"8-out2954"	.91509	291	27	318
8	"8-out2955"	.89473	289	34	323
8	"8-out2956"	.87702	271	38	309
8	"8-out2957"	.38064	118	192	310
8	"8-out2958"	.39498	126	193	319
8	"8-out2959"	.34795	119	223	342
8	"8-out2960"	.28980	91	223	314
8	"8-out2961"	.31888	103	220	323
8	"8-out2962"	.21406	70	257	327
8	"8-out2963"	.35220	112	206	318
8	"8-out2964"	.89285	275	33	308
8	"8-out2965"	.61538	200	125	325
8	"8-out2966"	.62305	200	121	321
8	"8-out2967"	.37728	103	170	273
8	"8-out2968"	.23504	169	550	719
8	"8-out2969"	.99175	1444	12	1456
8	"8-out2970"	.31788	247	530	777
8	"8-out2971"	.23122	157	522	679
8	"8-out2972"	.18677	144	627	771
8	"8-out2973"	.19259	156	654	810
8	"8-out2974"	.58730	111	78	189
8	"8-out2975"	.25068	92	275	367
8	"8-out2976"	.32427	167	348	515
8	"8-out2977"	.22580	455	1560	2015
8	"8-out2978"	.33795	854	1673	2527
8	"8-out2979"	.29241	81	196	277
8	"8-out2980"	.23563	123	399	522
8	"8-out2981"	.73143	591	217	808
8	"8-out2982"	.26785	435	1189	1624
8	"8-out2983"	.13017	44	294	338
8	"8-out2984"	.99115	112	1	113
8	"8-out2985"	.42526	202	273	475
8	"8-out2986"	.34379	230	439	669
8	"8-out2987"	.30886	467	1045	1512
8	"8-out2988"	.99193	123	1	124
8	"8-out2989"	.39453	101	155	256
8	"8-out2990"	.46645	299	342	641
8	"8-out2991"	.27500	286	754	1040
8	"8-out2992"	.29552	185	441	626
8	"8-out2993"	.38210	2823	4565	7388
8	"8-out2994"	.16414	65	331	396
8	"8-out2995"	.60732	232	150	382
8	"8-out2996"	.34575	269	509	778
8	"8-out2997"	.42215	141	193	334
8	"8-out2998"	.27393	226	599	825
8	"8-out2999"	.27945	185	477	662
8	"8-out3000"	.88544	943	122	1065
8	"8-out3001"	.35495	197	358	555
8	"8-out3002"	.26011	180	512	692
8	"8-out3003"	.21879	156	557	713
8	"8-out3004"	.18975	163	696	859
8	"8-out3005"	.15384	52	286	338
8	"8-out3006"	.30020	148	345	493
8	"8-out3007"	.17178	123	593	716
8	"8-out3008"	.99655	1448	5	1453
8	"8-out3009"	.19828	923	3732	4655
8	"8-out3010"	.19449	113	468	581
8	"8-out3011"	.99487	194	1	195
8	"8-out3012"	.31818	245	525	770
8	"8-out3013"	.27716	528	1377	1905
8	"8-out3014"	.17296	279	1334	1613
8	"8-out3015"	.35069	303	561	864
8	"8-out3016"	.18055	65	295	360
8	"8-out3017"	.16058	22	115	137
8	"8-out3018"	.29600	37	88	125
8	"8-out3019"	.98989	98	1	99
8	"8-out3020"	.99180	121	1	122
8	"8-out3021"	.99166	119	1	120
8	"8-out3022"	.26037	138	392	530
8	"8-out3023"	.30912	1175	2626	3801
8	"8-out3024"	.99071	320	3	323
8	"8-out3025"	.62096	154	94	248
8	"8-out3026"	.92007	1393	121	1514
8	"8-out3027"	.29694	253	599	852
8	"8-out3028"	.30909	85	190	275
8	"8-out3029"	.96022	169	7	176
8	"8-out3030"	.29216	194	470	664
8	"8-out3031"	.31299	318	698	1016
8	"8-out3032"	.44699	662	819	1481
8	"8-out3033"	.16937	73	358	431
8	"8-out3034"	.13289	141	920	1061
8	"8-out3035"	.98275	228	4	232
8	"8-out3036"	.92021	173	15	188
8	"8-out3037"	.98360	300	5	305
8	"8-out3038"	.99230	387	3	390
8	"8-out3039"	.65753	384	200	584
8	"8-out3040"	.24509	25	77	102
8	"8-out3041"	.40526	77	113	190
8	"8-out3042"	.93589	146	10	156
8	"8-out3043"	.28647	699	1741	2440
8	"8-out3044"	.99071	747	7	754
8	"8-out3045"	.35054	319	591	910
8	"8-out3046"	.65702	318	166	484
8	"8-out3047"	.32487	128	266	394
8	"8-out3048"	.24214	185	579	764
8	"8-out3049"	.70689	41	17	58
8	"8-out3050"	.62569	112	67	179
8	"8-out3051"	.31553	65	141	206
8	"8-out3052"	.87785	769	107	876
8	"8-out3053"	.98823	1512	18	1530
8	"8-out3054"	.20468	131	509	640
8	"8-out3055"	.23582	466	1510	1976
8	"8-out3056"	.32285	154	323	477
8	"8-out3057"	.27191	121	324	445
8	"8-out3058"	.27106	312	839	1151
8	"8-out3059"	.21472	245	896	1141
8	"8-out3060"	.43776	204	262	466
8	"8-out3061"	.42737	818	1096	1914
8	"8-out3062"	.20036	220	878	1098
8	"8-out3063"	.26294	66	185	251
8	"8-out3064"	.29333	154	371	525
8	"8-out3065"	.69560	601	263	864
8	"8-out3066"	.69676	409	178	587
8	"8-out3067"	.74930	269	90	359
8	"8-out3068"	.18367	18	80	98
8	"8-out3069"	.31554	810	1757	2567
8	"8-out3070"	.38500	231	369	600
8	"8-out3071"	.22809	492	1665	2157
8	"8-out3072"	.24691	240	732	972
8	"8-out3073"	.86511	186	29	215
8	"8-out3074"	.39447	314	482	796
8	"8-out3075"	.28158	78	199	277
8	"8-out3076"	.74663	333	113	446
8	"8-out3077"	.36363	64	112	176
8	"8-out3078"	.32258	200	420	620
8	"8-out3079"	.28670	166	413	579
8	"8-out3080"	.34945	159	296	455
8	"8-out3081"	.28764	149	369	518
8	"8-out3082"	.63013	92	54	146
8	"8-out3083"	.52473	244	221	465
8	"8-out3084"	.27032	818	2208	3026
8	"8-out3085"	.25603	53	154	207
8	"8-out3086"	.21075	98	367	465
8	"8-out3087"	.97959	96	2	98
8	"8-out3088"	.99564	457	2	459
8	"8-out3089"	.28846	45	111	156
8	"8-out3090"	.47385	444	493	937
8	"8-out3091"	.15151	40	224	264
8	"8-out3092"	.25900	230	658	888
8	"8-out3093"	.13414	33	213	246
8	"8-out3094"	.35576	111	201	312
8	"8-out3095"	.99649	284	1	285
8	"8-out3096"	.21246	75	278	353
8	"8-out3097"	.49940	836	838	1674
8	"8-out3098"	.28706	455	1130	1585
8	"8-out3099"	.69802	920	398	1318
8	"8-out3100"	.99304	714	5	719
8	"8-out3101"	.20737	298	1139	1437
8	"8-out3102"	.47305	711	792	1503
8	"8-out3103"	.79916	191	48	239
8	"8-out3104"	.36949	344	587	931
8	"8-out3105"	.30199	273	631	904
8	"8-out3106"	.93064	416	31	447
8	"8-out3107"	.30500	61	139	200
8	"8-out3108"	.18000	126	574	700
8	"8-out3109"	.29072	580	1415	1995
8	"8-out3110"	.35887	89	159	248
8	"8-out3111"	.36630	300	519	819
8	"8-out3112"	.22321	50	174	224
8	"8-out3113"	.22013	234	829	1063
8	"8-out3114"	.19101	34	144	178
8	"8-out3115"	.32327	257	538	795
8	"8-out3116"	.40080	198	296	494
8	"8-out3117"	.35540	263	477	740
8	"8-out3118"	.67741	168	80	248
8	"8-out3119"	.90308	205	22	227
8	"8-out3120"	.22222	46	161	207
8	"8-out3121"	.99009	1100	11	1111
8	"8-out3122"	.22452	130	449	579
8	"8-out3123"	.29405	277	665	942
8	"8-out3124"	.28395	529	1334	1863
8	"8-out3125"	.42129	273	375	648
8	"8-out3126"	.30452	229	523	752
8	"8-out3127"	.80582	83	20	103
8	"8-out3128"	.56264	247	192	439
8	"8-out3129"	.27167	47	126	173
8	"8-out3130"	.20908	198	749	947
8	"8-out3131"	.38019	119	194	313
8	"8-out3132"	.43865	851	1089	1940
8	"8-out3133"	.29220	251	608	859
8	"8-out3134"	.29616	332	789	1121
8	"8-out3135"	.99367	157	1	158
8	"8-out3136"	.41436	150	212	362
8	"8-out3137"	.31177	270	596	866
8	"8-out3138"	.17836	94	433	527
8	"8-out3139"	.28647	108	269	377
8	"8-out3140"	.98619	857	12	869
8	"8-out3141"	.20759	164	626	790
8	"8-out3142"	.25632	365	1059	1424
8	"8-out3143"	.22803	257	870	1127
8	"8-out3144"	.26369	544	1519	2063
8	"8-out3145"	.28129	182	465	647
8	"8-out3146"	.94871	111	6	117
8	"8-out3147"	.94871	111	6	117
8	"8-out3148"	.40350	437	646	1083
8	"8-out3149"	.27528	147	387	534
8	"8-out3150"	.27467	192	507	699
8	"8-out3151"	.26907	194	527	721
8	"8-out3152"	.20746	150	573	723
8	"8-out3153"	.27102	261	702	963
8	"8-out3154"	.13664	22	139	161
8	"8-out3155"	.76923	70	21	91
8	"8-out3156"	.99159	118	1	119
8	"8-out3157"	.96581	113	4	117
8	"8-out3158"	.28767	42	104	146
8	"8-out3159"	.55219	201	163	364
8	"8-out3160"	.98302	2780	48	2828
8	"8-out3161"	.98529	201	3	204
8	"8-out3162"	.10930	114	929	1043
8	"8-out3163"	.35665	790	1425	2215
8	"8-out3164"	.27513	52	137	189
8	"8-out3165"	.83787	615	119	734
8	"8-out3166"	.34689	614	1156	1770
8	"8-out3167"	.17097	172	834	1006
8	"8-out3168"	.20628	210	808	1018
8	"8-out3169"	.15318	142	785	927
8	"8-out3170"	.77002	375	112	487
8	"8-out3171"	.96279	207	8	215
8	"8-out3172"	.59826	551	370	921
8	"8-out3173"	.40178	135	201	336
8	"8-out3174"	.39140	173	269	442
8	"8-out3175"	.30590	316	717	1033
8	"8-out3176"	.24324	180	560	740
8	"8-out3177"	.26760	266	728	994
8	"8-out3178"	.21250	255	945	1200
8	"8-out3179"	.28901	50	123	173
8	"8-out3180"	.98360	300	5	305
8	"8-out3181"	.99656	290	1	291
8	"8-out3182"	.82994	654	134	788
8	"8-out3183"	.99884	5201	6	5207
8	"8-out3184"	.37908	58	95	153
8	"8-out3185"	.30076	1407	3271	4678
8	"8-out3186"	.22174	208	730	938
8	"8-out3187"	.49149	954	987	1941
8	"8-out3188"	.32534	421	873	1294
8	"8-out3189"	.35606	47	85	132
8	"8-out3190"	.67134	766	375	1141
8	"8-out3191"	.19152	244	1030	1274
8	"8-out3192"	.28604	369	921	1290
8	"8-out3193"	.41062	340	488	828
8	"8-out3194"	.98809	83	1	84
8	"8-out3195"	.32663	569	1173	1742
8	"8-out3196"	.12984	134	898	1032
8	"8-out3197"	.31223	74	163	237
8	"8-out3198"	.23144	53	176	229
8	"8-out3199"	.34598	310	586	896
8	"8-out3200"	.26824	261	712	973
8	"8-out3201"	.99755	408	1	409
8	"8-out3202"	.29069	100	244	344
8	"8-out3203"	.98979	970	10	980
8	"8-out3204"	.19083	200	848	1048
8	"8-out3205"	.73630	215	77	292
8	"8-out3206"	.15942	22	116	138
8	"8-out3207"	.32017	146	310	456
8	"8-out3208"	.99013	301	3	304
8	"8-out3209"	.29675	557	1320	1877
8	"8-out3210"	.32238	108	227	335
8	"8-out3211"	.39344	72	111	183
8	"8-out3212"	.27565	137	360	497
8	"8-out3213"	.46835	37	42	79
8	"8-out3214"	.99489	195	1	196
8	"8-out3215"	.64444	203	112	315
8	"8-out3216"	.29925	202	473	675
8	"8-out3217"	.54620	266	221	487
8	"8-out3218"	.34653	175	330	505
8	"8-out3219"	.69407	363	160	523
8	"8-out3220"	.54088	172	146	318
8	"8-out3221"	.78807	119	32	151
8	"8-out3222"	.72641	231	87	318
8	"8-out3223"	.24104	74	233	307
8	"8-out3224"	.29220	90	218	308
8	"8-out3225"	.37430	67	112	179
8	"8-out3226"	.91318	284	27	311
8	"8-out3227"	.26976	58	157	215
8	"8-out3228"	.77165	98	29	127
8	"8-out3229"	.98734	156	2	158
8	"8-out3230"	.61612	191	119	310
8	"8-out3231"	.26315	85	238	323
8	"8-out3232"	.60759	192	124	316
8	"8-out3233"	.64024	210	118	328
8	"8-out3234"	.90353	281	30	311
8	"8-out3235"	.89644	277	32	309
8	"8-out3236"	.38141	119	193	312
8	"8-out3237"	.82950	253	52	305
8	"8-out3238"	.86858	271	41	312
8	"8-out3239"	.89776	281	32	313
8	"8-out3240"	.88498	277	36	313
8	"8-out3241"	.42628	133	179	312
8	"8-out3242"	.80448	251	61	312
8	"8-out3243"	.24290	77	240	317
8	"8-out3244"	.36305	114	200	314
8	"8-out3245"	.30448	95	217	312
8	"8-out3246"	.34049	111	215	326
8	"8-out3247"	.36513	111	193	304
8	"8-out3248"	.36708	116	200	316
8	"8-out3249"	.42628	133	179	312
8	"8-out3250"	.83180	272	55	327
8	"8-out3251"	.58466	183	130	313
8	"8-out3252"	.51875	166	154	320
8	"8-out3253"	.88942	185	23	208
8	"8-out3254"	.18969	92	393	485
8	"8-out3255"	.28000	77	198	275
8	"8-out3256"	.21057	219	821	1040
8	"8-out3257"	.27559	681	1790	2471
8	"8-out3258"	.27124	616	1655	2271
8	"8-out3259"	.45923	169	199	368
8	"8-out3260"	.39243	560	867	1427
8	"8-out3261"	.26426	88	245	333
8	"8-out3262"	.29925	360	843	1203
8	"8-out3263"	.52881	156	139	295
8	"8-out3264"	.18689	174	757	931
8	"8-out3265"	.26359	417	1165	1582
8	"8-out3266"	.10126	8	71	79
8	"8-out3267"	.88172	492	66	558
8	"8-out3268"	.22783	311	1054	1365
8	"8-out3269"	.16666	58	290	348
8	"8-out3270"	.98773	161	2	163
8	"8-out3271"	.25287	22	65	87
8	"8-out3272"	.87195	143	21	164
8	"8-out3273"	.50138	181	180	361
8	"8-out3274"	.13372	23	149	172
8	"8-out3275"	.29545	104	248	352
8	"8-out3276"	.29640	206	489	695
8	"8-out3277"	.23734	75	241	316
8	"8-out3278"	.98019	198	4	202
8	"8-out3279"	.34819	164	307	471
8	"8-out3280"	.15979	62	326	388
8	"8-out3281"	.26470	99	275	374
8	"8-out3282"	.35087	120	222	342
8	"8-out3283"	.38983	138	216	354
8	"8-out3284"	.08042	30	343	373
8	"8-out3285"	.31280	452	993	1445
8	"8-out3286"	.34646	255	481	736
8	"8-out3287"	.35169	249	459	708
8	"8-out3288"	.36820	271	465	736
8	"8-out3289"	.24714	65	198	263
8	"8-out3290"	.99371	474	3	477
8	"8-out3291"	.38515	327	522	849
8	"8-out3292"	.99737	759	2	761
8	"8-out3293"	.39949	157	236	393
8	"8-out3294"	.22647	154	526	680
8	"8-out3295"	.18009	114	519	633
8	"8-out3296"	.22237	161	563	724
8	"8-out3297"	.28708	209	519	728
8	"8-out3298"	.20945	31	117	148
8	"8-out3299"	.99238	391	3	394
8	"8-out3300"	.15942	22	116	138
8	"8-out3301"	.38265	150	242	392
8	"8-out3302"	.76386	482	149	631
8	"8-out3303"	.43633	281	363	644
8	"8-out3304"	.38743	148	234	382
8	"8-out3305"	.34501	256	486	742
8	"8-out3306"	.32579	216	447	663
8	"8-out3307"	.20370	99	387	486
8	"8-out3308"	.26054	173	491	664
8	"8-out3309"	.31081	92	204	296
8	"8-out3310"	.33870	84	164	248
8	"8-out3311"	.96685	671	23	694
8	"8-out3312"	.98870	525	6	531
8	"8-out3313"	.44144	49	62	111
8	"8-out3314"	.17091	67	325	392
8	"8-out3315"	.26984	119	322	441
8	"8-out3316"	.58219	85	61	146
8	"8-out3317"	.98198	109	2	111
8	"8-out3318"	.26548	30	83	113
8	"8-out3319"	.63157	60	35	95
8	"8-out3320"	.91715	310	28	338
8	"8-out3321"	.21138	26	97	123
8	"8-out3322"	.97286	466	13	479
8	"8-out3323"	.21284	116	429	545
8	"8-out3324"	.47900	251	273	524
8	"8-out3325"	.67343	398	193	591
8	"8-out3326"	.92682	152	12	164
8	"8-out3327"	.92682	152	12	164
8	"8-out3328"	.95121	156	8	164
8	"8-out3329"	.29258	347	839	1186
8	"8-out3330"	.38828	537	846	1383
8	"8-out3331"	.30343	115	264	379
8	"8-out3332"	.27390	106	281	387
8	"8-out3333"	.35284	211	387	598
8	"8-out3334"	.21172	130	484	614
8	"8-out3335"	.78000	156	44	200
8	"8-out3336"	.31383	220	481	701
8	"8-out3337"	.27329	88	234	322
8	"8-out3338"	.48800	183	192	375
8	"8-out3339"	.65187	661	353	1014
8	"8-out3340"	.50872	175	169	344
8	"8-out3341"	.32493	129	268	397
8	"8-out3342"	.22416	154	533	687
8	"8-out3343"	.17473	65	307	372
8	"8-out3344"	.20698	77	295	372
8	"8-out3345"	.99141	231	2	233
8	"8-out3346"	.36532	335	582	917
8	"8-out3347"	.29143	364	885	1249
8	"8-out3348"	.16666	78	390	468
8	"8-out3349"	.46818	103	117	220
8	"8-out3350"	.96078	49	2	51
8	"8-out3351"	.24421	116	359	475
8	"8-out3352"	.84120	890	168	1058
8	"8-out3353"	.43676	297	383	680
8	"8-out3354"	.26829	77	210	287
8	"8-out3355"	.98750	316	4	320
8	"8-out3356"	.96721	59	2	61
8	"8-out3357"	.11904	15	111	126
8	"8-out3358"	.22306	294	1024	1318
8	"8-out3359"	.51093	327	313	640
8	"8-out3360"	.37126	261	442	703
8	"8-out3361"	.94827	55	3	58
8	"8-out3362"	.32722	232	477	709
8	"8-out3363"	.99431	175	1	176
8	"8-out3364"	.26463	104	289	393
8	"8-out3365"	.22881	27	91	118
8	"8-out3366"	.44610	149	185	334
8	"8-out3367"	.99593	245	1	246
8	"8-out3368"	.62711	74	44	118
8	"8-out3369"	.21818	36	129	165
8	"8-out3370"	.46218	110	128	238
8	"8-out3371"	.15544	30	163	193
8	"8-out3372"	.40096	83	124	207
8	"8-out3373"	.24242	40	125	165
8	"8-out3374"	.24202	258	808	1066
8	"8-out3375"	.98859	260	3	263
8	"8-out3376"	.99065	106	1	107
8	"8-out3377"	.98816	167	2	169
8	"8-out3378"	.44086	41	52	93
8	"8-out3379"	.52475	53	48	101
8	"8-out3380"	.34157	373	719	1092
8	"8-out3381"	.72140	246	95	341
8	"8-out3382"	.27540	767	2018	2785
8	"8-out3383"	.41935	52	72	124
8	"8-out3384"	.99497	594	3	597
8	"8-out3385"	.38769	271	428	699
8	"8-out3386"	.23419	100	327	427
8	"8-out3387"	.98347	119	2	121
8	"8-out3388"	.99462	185	1	186
8	"8-out3389"	.45689	106	126	232
8	"8-out3390"	.24074	234	738	972
8	"8-out3391"	.14285	23	138	161
8	"8-out3392"	.71951	118	46	164
8	"8-out3393"	.34505	363	689	1052
8	"8-out3394"	.24489	36	111	147
8	"8-out3395"	.19943	142	570	712
8	"8-out3396"	.36420	409	714	1123
8	"8-out3397"	.27885	273	706	979
8	"8-out3398"	.99162	355	3	358
8	"8-out3399"	.25958	88	251	339
8	"8-out3400"	.43946	98	125	223
8	"8-out3401"	.29024	128	313	441
8	"8-out3402"	.20152	132	523	655
8	"8-out3403"	.99270	272	2	274
8	"8-out3404"	.97159	513	15	528
8	"8-out3405"	.21474	67	245	312
8	"8-out3406"	.96792	513	17	530
8	"8-out3407"	.63192	194	113	307
8	"8-out3408"	.49295	70	72	142
8	"8-out3409"	.23086	359	1196	1555
8	"8-out3410"	.32308	473	991	1464
8	"8-out3411"	.65835	528	274	802
8	"8-out3412"	.40566	129	189	318
8	"8-out3413"	.35326	254	465	719
8	"8-out3414"	.96981	514	16	530
8	"8-out3415"	.41947	224	310	534
8	"8-out3416"	.99590	243	1	244
8	"8-out3417"	.97560	240	6	246
8	"8-out3418"	.45081	110	134	244
8	"8-out3419"	.98802	330	4	334
8	"8-out3420"	.93089	229	17	246
8	"8-out3421"	.28378	294	742	1036
8	"8-out3422"	.26906	127	345	472
8	"8-out3423"	.20416	98	382	480
8	"8-out3424"	.29719	658	1556	2214
8	"8-out3425"	.33119	361	729	1090
8	"8-out3426"	.22775	215	729	944
8	"8-out3427"	.25241	235	696	931
8	"8-out3428"	.35010	160	297	457
8	"8-out3429"	.39220	624	967	1591
8	"8-out3430"	.41312	107	152	259
8	"8-out3431"	.28978	244	598	842
8	"8-out3432"	.17103	163	790	953
8	"8-out3433"	.24478	645	1990	2635
8	"8-out3434"	.21086	687	2571	3258
8	"8-out3435"	.29012	235	575	810
8	"8-out3436"	.92209	580	49	629
8	"8-out3437"	.29864	904	2123	3027
8	"8-out3438"	.29976	125	292	417
8	"8-out3439"	.37529	161	268	429
8	"8-out3440"	.40252	223	331	554
8	"8-out3441"	.63304	295	171	466
8	"8-out3442"	.18085	34	154	188
8	"8-out3443"	.40606	67	98	165
8	"8-out3444"	.22500	36	124	160
8	"8-out3445"	.25157	40	119	159
8	"8-out3446"	.23037	135	451	586
8	"8-out3447"	.33415	272	542	814
8	"8-out3448"	.25641	30	87	117
8	"8-out3449"	.85877	675	111	786
8	"8-out3450"	.27924	74	191	265
8	"8-out3451"	.25337	75	221	296
8	"8-out3452"	.64276	484	269	753
8	"8-out3453"	.31233	119	262	381
8	"8-out3454"	.99124	906	8	914
8	"8-out3455"	.27308	343	913	1256
8	"8-out3456"	.98892	625	7	632
8	"8-out3457"	.41845	254	353	607
8	"8-out3458"	.24098	361	1137	1498
8	"8-out3459"	.25157	120	357	477
8	"8-out3460"	.36251	265	466	731
8	"8-out3461"	.85885	286	47	333
8	"8-out3462"	.20582	106	409	515
8	"8-out3463"	.14187	62	375	437
8	"8-out3464"	.31168	48	106	154
8	"8-out3465"	.29362	106	255	361
8	"8-out3466"	.25650	207	600	807
8	"8-out3467"	.25661	262	759	1021
8	"8-out3468"	.39219	231	358	589
8	"8-out3469"	.55164	235	191	426
8	"8-out3470"	.94348	384	23	407
8	"8-out3471"	.31279	66	145	211
8	"8-out3472"	.80449	358	87	445
8	"8-out3473"	.26726	89	244	333
8	"8-out3474"	.19101	51	216	267
8	"8-out3475"	.30569	118	268	386
8	"8-out3476"	.63285	393	228	621
8	"8-out3477"	.97435	532	14	546
8	"8-out3478"	.23131	65	216	281
8	"8-out3479"	.45118	171	208	379
8	"8-out3480"	.39455	174	267	441
8	"8-out3481"	.23676	313	1009	1322
8	"8-out3482"	.47470	122	135	257
8	"8-out3483"	.99141	693	6	699
8	"8-out3484"	.26649	105	289	394
8	"8-out3485"	.31947	292	622	914
8	"8-out3486"	.50859	296	286	582
8	"8-out3487"	.35336	194	355	549
8	"8-out3488"	.23448	34	111	145
8	"8-out3489"	.20415	59	230	289
8	"8-out3490"	.18688	57	248	305
8	"8-out3491"	.66463	218	110	328
8	"8-out3492"	.57500	230	170	400
8	"8-out3493"	.98556	683	10	693
8	"8-out3494"	.98556	683	10	693
8	"8-out3495"	.98839	596	7	603
8	"8-out3496"	.98324	587	10	597
8	"8-out3497"	.99302	427	3	430
8	"8-out3498"	.31207	318	701	1019
8	"8-out3499"	.32008	145	308	453
8	"8-out3500"	.32525	161	334	495
8	"8-out3501"	.18478	17	75	92
8	"8-out3502"	.29000	29	71	100
8	"8-out3503"	.29870	138	324	462
8	"8-out3504"	.25634	101	293	394
8	"8-out3505"	.23863	105	335	440
8	"8-out3506"	.23893	108	344	452
8	"8-out3507"	.99555	672	3	675
8	"8-out3508"	.46400	116	134	250
8	"8-out3509"	.55188	117	95	212
8	"8-out3510"	.99242	131	1	132
8	"8-out3511"	.28526	91	228	319
8	"8-out3512"	.93297	348	25	373
8	"8-out3513"	.40483	134	197	331
8	"8-out3514"	.37194	350	591	941
8	"8-out3515"	.20416	196	764	960
8	"8-out3516"	.48407	152	162	314
8	"8-out3517"	.39800	199	301	500
8	"8-out3518"	.22340	63	219	282
8	"8-out3519"	.81941	422	93	515
8	"8-out3520"	.12777	46	314	360
8	"8-out3521"	.55431	199	160	359
8	"8-out3522"	.28608	109	272	381
8	"8-out3523"	.31034	117	260	377
8	"8-out3524"	.27887	99	256	355
8	"8-out3525"	.47058	176	198	374
8	"8-out3526"	.91847	169	15	184
8	"8-out3527"	.46869	262	297	559
8	"8-out3528"	.56221	244	190	434
8	"8-out3529"	.29723	129	305	434
8	"8-out3530"	.47465	206	228	434
8	"8-out3531"	.62395	224	135	359
8	"8-out3532"	.15254	54	300	354
8	"8-out3533"	.30882	210	470	680
8	"8-out3534"	.98556	683	10	693
8	"8-out3535"	.23174	200	663	863
8	"8-out3536"	.24512	151	465	616
8	"8-out3537"	.38218	266	430	696
8	"8-out3538"	.24380	118	366	484
8	"8-out3539"	.28539	129	323	452
8	"8-out3540"	.20671	80	307	387
8	"8-out3541"	.75548	448	145	593
8	"8-out3542"	.59579	255	173	428
8	"8-out3543"	.26535	108	299	407
8	"8-out3544"	.31899	89	190	279
8	"8-out3545"	.43333	312	408	720
8	"8-out3546"	.99367	314	2	316
8	"8-out3547"	.22101	61	215	276
8	"8-out3548"	.99069	426	4	430
8	"8-out3549"	.29600	259	616	875
8	"8-out3550"	.81736	819	183	1002
8	"8-out3551"	.38251	853	1377	2230
8	"8-out3552"	.97520	118	3	121
8	"8-out3553"	.31742	133	286	419
8	"8-out3554"	.99750	400	1	401
8	"8-out3555"	.98997	395	4	399
8	"8-out3556"	.38926	116	182	298
8	"8-out3557"	.64356	65	36	101
8	"8-out3558"	.19497	163	673	836
8	"8-out3559"	.15259	150	833	983
8	"8-out3560"	.27067	36	97	133
8	"8-out3561"	.29089	345	841	1186
8	"8-out3562"	.13609	23	146	169
8	"8-out3563"	.19076	256	1086	1342
8	"8-out3564"	.20689	198	759	957
8	"8-out3565"	.31680	396	854	1250
8	"8-out3566"	.33285	230	461	691
8	"8-out3567"	.62429	221	133	354
8	"8-out3568"	.40857	181	262	443
8	"8-out3569"	.44230	69	87	156
8	"8-out3570"	.43137	660	870	1530
8	"8-out3571"	.54615	71	59	130
8	"8-out3572"	.34841	231	432	663
8	"8-out3573"	.99264	135	1	136
8	"8-out3574"	.84226	566	106	672
8	"8-out3575"	.37891	133	218	351
8	"8-out3576"	.29353	295	710	1005
8	"8-out3577"	.21182	154	573	727
8	"8-out3578"	.20930	297	1122	1419
8	"8-out3579"	.17547	93	437	530
8	"8-out3580"	.27754	131	341	472
8	"8-out3581"	.27001	145	392	537
8	"8-out3582"	.55056	49	40	89
8	"8-out3583"	.67619	142	68	210
8	"8-out3584"	.28255	1137	2887	4024
8	"8-out3585"	.94827	110	6	116
8	"8-out3586"	.49717	88	89	177
8	"8-out3587"	.22411	1002	3469	4471
8	"8-out3588"	.38075	91	148	239
8	"8-out3589"	.30711	164	370	534
8	"8-out3590"	.21731	118	425	543
8	"8-out3591"	.99123	905	8	913
8	"8-out3592"	.93557	334	23	357
8	"8-out3593"	.14423	30	178	208
8	"8-out3594"	.13073	77	512	589
8	"8-out3595"	.36666	209	361	570
8	"8-out3596"	.99315	580	4	584
8	"8-out3597"	.52631	40	36	76
8	"8-out3598"	.98952	189	2	191
8	"8-out3599"	.98962	477	5	482
8	"8-out3600"	.98750	553	7	560
8	"8-out3601"	.99284	694	5	699
8	"8-out3602"	.99856	697	1	698
8	"8-out3603"	.99489	585	3	588
8	"8-out3604"	.99848	660	1	661
8	"8-out3605"	.98775	242	3	245
8	"8-out3606"	.44444	116	145	261
8	"8-out3607"	.19209	68	286	354
8	"8-out3608"	.37020	164	279	443
8	"8-out3609"	.99591	244	1	245
8	"8-out3610"	.35749	217	390	607
8	"8-out3611"	.16271	48	247	295
8	"8-out3612"	.32102	113	239	352
8	"8-out3613"	.16621	61	306	367
8	"8-out3614"	.10263	39	341	380
8	"8-out3615"	.97435	532	14	546
8	"8-out3616"	.17777	48	222	270
8	"8-out3617"	.31328	250	548	798
8	"8-out3618"	.24497	134	413	547
8	"8-out3619"	.92372	109	9	118
8	"8-out3620"	.31399	92	201	293
8	"8-out3621"	.98014	2221	45	2266
8	"8-out3622"	.29481	125	299	424
8	"8-out3623"	.26506	22	61	83
8	"8-out3624"	.15413	41	225	266
8	"8-out3625"	.29433	78	187	265
8	"8-out3626"	.94495	309	18	327
8	"8-out3627"	.22727	445	1513	1958
8	"8-out3628"	.27480	72	190	262
8	"8-out3629"	.19637	195	798	993
8	"8-out3630"	.33428	352	701	1053
8	"8-out3631"	.08917	14	143	157
8	"8-out3632"	.32539	82	170	252
8	"8-out3633"	.56683	335	256	591
8	"8-out3634"	.69772	337	146	483
8	"8-out3635"	.99337	300	2	302
8	"8-out3636"	.99337	300	2	302
8	"8-out3637"	.09126	46	458	504
8	"8-out3638"	.17317	71	339	410
8	"8-out3639"	.97908	515	11	526
8	"8-out3640"	.22043	82	290	372
8	"8-out3641"	.25828	148	425	573
8	"8-out3642"	.27924	148	382	530
8	"8-out3643"	.64788	92	50	142
8	"8-out3644"	.21126	30	112	142
8	"8-out3645"	.27113	263	707	970
8	"8-out3646"	.97468	154	4	158
8	"8-out3647"	.26190	110	310	420
8	"8-out3648"	.07826	27	318	345
8	"8-out3649"	.17816	62	286	348
8	"8-out3650"	.20116	172	683	855
8	"8-out3651"	.81780	395	88	483
8	"8-out3652"	.78636	519	141	660
8	"8-out3653"	.88250	2336	311	2647
8	"8-out3654"	.16981	54	264	318
8	"8-out3655"	.34013	100	194	294
8	"8-out3656"	.34567	196	371	567
8	"8-out3657"	.15315	51	282	333
8	"8-out3658"	.98924	552	6	558
8	"8-out3659"	.14340	226	1350	1576
8	"8-out3660"	.76614	973	297	1270
8	"8-out3661"	.86279	327	52	379
8	"8-out3662"	.11749	45	338	383
8	"8-out3663"	.64691	1561	852	2413
8	"8-out3664"	.30075	120	279	399
8	"8-out3665"	.28097	254	650	904
8	"8-out3666"	.94827	110	6	116
8	"8-out3667"	.32416	165	344	509
8	"8-out3668"	.39928	224	337	561
8	"8-out3669"	.32738	165	339	504
8	"8-out3670"	.35672	122	220	342
8	"8-out3671"	.33514	123	244	367
8	"8-out3672"	.51296	356	338	694
8	"8-out3673"	.13508	67	429	496
8	"8-out3674"	.21359	22	81	103
8	"8-out3675"	.17211	121	582	703
8	"8-out3676"	.96060	317	13	330
8	"8-out3677"	.47320	521	580	1101
8	"8-out3678"	.35708	426	767	1193
8	"8-out3679"	.17963	187	854	1041
8	"8-out3680"	.27102	116	312	428
8	"8-out3681"	.37209	160	270	430
8	"8-out3682"	.54746	173	143	316
8	"8-out3683"	.26373	72	201	273
8	"8-out3684"	.22934	161	541	702
8	"8-out3685"	.34636	124	234	358
8	"8-out3686"	.22916	55	185	240
8	"8-out3687"	.25475	67	196	263
8	"8-out3688"	.47626	321	353	674
8	"8-out3689"	.76814	434	131	565
8	"8-out3690"	.28138	1170	2988	4158
8	"8-out3691"	.51977	92	85	177
8	"8-out3692"	.34443	1065	2027	3092
8	"8-out3693"	.31005	111	247	358
8	"8-out3694"	.30348	61	140	201
8	"8-out3695"	.42153	642	881	1523
8	"8-out3696"	.30939	168	375	543
8	"8-out3697"	.27878	46	119	165
8	"8-out3698"	.33125	106	214	320
8	"8-out3699"	.12131	148	1072	1220
8	"8-out3700"	.30310	127	292	419
8	"8-out3701"	.33145	176	355	531
8	"8-out3702"	.37060	116	197	313
8	"8-out3703"	.40983	325	468	793
8	"8-out3704"	.24319	125	389	514
8	"8-out3705"	.39393	78	120	198
8	"8-out3706"	.28846	30	74	104
8	"8-out3707"	.35146	168	310	478
8	"8-out3708"	.25895	253	724	977
8	"8-out3709"	.19791	19	77	96
8	"8-out3710"	.22174	155	544	699
8	"8-out3711"	.98349	417	7	424
8	"8-out3712"	.96954	191	6	197
8	"8-out3713"	.84748	589	106	695
8	"8-out3714"	.21467	158	578	736
8	"8-out3715"	.27450	56	148	204
8	"8-out3716"	.29377	406	976	1382
8	"8-out3717"	.12671	74	510	584
8	"8-out3718"	.21118	34	127	161
8	"8-out3719"	.97033	229	7	236
8	"8-out3720"	.59633	130	88	218
8	"8-out3721"	.07799	28	331	359
8	"8-out3722"	.20563	168	649	817
8	"8-out3723"	.62389	282	170	452
8	"8-out3724"	.20991	254	956	1210
8	"8-out3725"	.33890	223	435	658
8	"8-out3726"	.27701	341	890	1231
8	"8-out3727"	.46017	52	61	113
8	"8-out3728"	.77836	439	125	564
8	"8-out3729"	.34734	157	295	452
8	"8-out3730"	.32107	96	203	299
8	"8-out3731"	.17791	145	670	815
8	"8-out3732"	.28125	252	644	896
8	"8-out3733"	.24987	492	1477	1969
8	"8-out3734"	.44444	116	145	261
8	"8-out3735"	.44744	596	736	1332
8	"8-out3736"	.30750	254	572	826
8	"8-out3737"	.29822	303	713	1016
8	"8-out3738"	.33812	259	507	766
8	"8-out3739"	.28633	327	815	1142
8	"8-out3740"	.30578	74	168	242
8	"8-out3741"	.33109	246	497	743
8	"8-out3742"	.37325	187	314	501
8	"8-out3743"	.84000	294	56	350
8	"8-out3744"	.65986	194	100	294
8	"8-out3745"	.21875	63	225	288
8	"8-out3746"	.46473	257	296	553
8	"8-out3747"	.29050	156	381	537
8	"8-out3748"	.17902	99	454	553
8	"8-out3749"	.24448	144	445	589
8	"8-out3750"	.99438	177	1	178
8	"8-out3751"	.38450	263	421	684
8	"8-out3752"	.97546	159	4	163
8	"8-out3753"	.48241	96	103	199
8	"8-out3754"	.76666	207	63	270
8	"8-out3755"	.60555	218	142	360
8	"8-out3756"	.10353	41	355	396
8	"8-out3757"	.29230	95	230	325
8	"8-out3758"	.98564	206	3	209
8	"8-out3759"	.36410	71	124	195
8	"8-out3760"	.29503	95	227	322
8	"8-out3761"	.28495	214	537	751
8	"8-out3762"	.17768	43	199	242
8	"8-out3763"	.28082	41	105	146
8	"8-out3764"	.22029	165	584	749
8	"8-out3765"	.47698	114	125	239
8	"8-out3766"	.61250	147	93	240
8	"8-out3767"	.22429	48	166	214
8	"8-out3768"	.24778	56	170	226
8	"8-out3769"	.53725	137	118	255
8	"8-out3770"	.20487	42	163	205
8	"8-out3771"	.36619	78	135	213
8	"8-out3772"	.45798	109	129	238
8	"8-out3773"	.26754	61	167	228
8	"8-out3774"	.99473	378	2	380
8	"8-out3775"	.24590	75	230	305
8	"8-out3776"	.98734	78	1	79
8	"8-out3777"	.98734	78	1	79
8	"8-out3778"	.98591	140	2	142
8	"8-out3779"	.25925	91	260	351
8	"8-out3780"	.61682	66	41	107
8	"8-out3781"	.50384	131	129	260
8	"8-out3782"	.30169	213	493	706
8	"8-out3783"	.17105	91	441	532
8	"8-out3784"	.36658	147	254	401
8	"8-out3785"	.20208	97	383	480
8	"8-out3786"	.93617	88	6	94
8	"8-out3787"	.29798	812	1913	2725
8	"8-out3788"	.35294	24	44	68
8	"8-out3789"	.29374	230	553	783
8	"8-out3790"	.34365	111	212	323
8	"8-out3791"	.21981	71	252	323
8	"8-out3792"	.23984	242	767	1009
8	"8-out3793"	.22684	289	985	1274
8	"8-out3794"	.52649	308	277	585
8	"8-out3795"	.15358	184	1014	1198
8	"8-out3796"	.25099	63	188	251
8	"8-out3797"	.98947	94	1	95
8	"8-out3798"	.16071	27	141	168
8	"8-out3799"	.24925	84	253	337
8	"8-out3800"	.13971	108	665	773
8	"8-out3801"	.15782	116	619	735
8	"8-out3802"	.29666	89	211	300
8	"8-out3803"	.21290	66	244	310
8	"8-out3804"	.99120	338	3	341
8	"8-out3805"	.69387	68	30	98
8	"8-out3806"	.33103	48	97	145
8	"8-out3807"	.53608	52	45	97
8	"8-out3808"	.97014	65	2	67
8	"8-out3809"	.26661	317	872	1189
8	"8-out3810"	.27366	555	1473	2028
8	"8-out3811"	.98630	72	1	73
8	"8-out3812"	.26333	158	442	600
8	"8-out3813"	.44783	176	217	393
8	"8-out3814"	.59210	180	124	304
8	"8-out3815"	.21540	165	601	766
8	"8-out3816"	.15068	55	310	365
8	"8-out3817"	.23866	621	1981	2602
8	"8-out3818"	.47713	814	892	1706
8	"8-out3819"	.25672	124	359	483
8	"8-out3820"	.17171	221	1066	1287
8	"8-out3821"	.30056	159	370	529
8	"8-out3822"	.31276	147	323	470
8	"8-out3823"	.86060	142	23	165
8	"8-out3824"	.61855	120	74	194
8	"8-out3825"	.98437	63	1	64
8	"8-out3826"	.23134	186	618	804
8	"8-out3827"	.98571	69	1	70
8	"8-out3828"	.29035	313	765	1078
8	"8-out3829"	.80952	136	32	168
8	"8-out3830"	.83333	70	14	84
8	"8-out3831"	.35353	140	256	396
8	"8-out3832"	.15934	87	459	546
8	"8-out3833"	.17543	70	329	399
8	"8-out3834"	.15087	172	968	1140
8	"8-out3835"	.14348	131	782	913
8	"8-out3836"	.23736	202	649	851
8	"8-out3837"	.35675	330	595	925
8	"8-out3838"	.80000	80	20	100
8	"8-out3839"	.31921	196	418	614
8	"8-out3840"	.49474	847	865	1712
8	"8-out3841"	.58571	41	29	70
8	"8-out3842"	.40699	326	475	801
8	"8-out3843"	.30387	282	646	928
8	"8-out3844"	.93834	761	50	811
8	"8-out3845"	.35744	84	151	235
8	"8-out3846"	.33239	354	711	1065
8	"8-out3847"	.14526	69	406	475
8	"8-out3848"	.21577	145	527	672
8	"8-out3849"	.34320	139	266	405
8	"8-out3850"	.36163	460	812	1272
8	"8-out3851"	.20542	106	410	516
8	"8-out3852"	.22613	45	154	199
8	"8-out3853"	.28028	155	398	553
8	"8-out3854"	.89010	243	30	273
8	"8-out3855"	.74683	118	40	158
8	"8-out3856"	.21074	255	955	1210
8	"8-out3857"	.98717	77	1	78
8	"8-out3858"	.50287	262	259	521
8	"8-out3859"	.98924	92	1	93
8	"8-out3860"	.42120	147	202	349
8	"8-out3861"	.99718	354	1	355
8	"8-out3862"	.38742	191	302	493
8	"8-out3863"	.30576	318	722	1040
8	"8-out3864"	.99157	942	8	950
8	"8-out3865"	.31940	107	228	335
8	"8-out3866"	.29957	281	657	938
8	"8-out3867"	.26751	126	345	471
8	"8-out3868"	.52155	121	111	232
8	"8-out3869"	.33876	291	568	859
8	"8-out3870"	.34891	209	390	599
8	"8-out3871"	.54000	324	276	600
8	"8-out3872"	.26756	198	542	740
8	"8-out3873"	.94680	89	5	94
8	"8-out3874"	.34894	216	403	619
8	"8-out3875"	.39441	325	499	824
8	"8-out3876"	.30455	314	717	1031
8	"8-out3877"	.23495	121	394	515
8	"8-out3878"	.36296	147	258	405
8	"8-out3879"	.25966	262	747	1009
8	"8-out3880"	.32501	521	1082	1603
8	"8-out3881"	.26886	57	155	212
8	"8-out3882"	.36253	120	211	331
8	"8-out3883"	.60946	206	132	338
8	"8-out3884"	.67628	211	101	312
8	"8-out3885"	.19098	233	987	1220
8	"8-out3886"	.72717	685	257	942
8	"8-out3887"	.52853	389	347	736
8	"8-out3888"	.22611	168	575	743
8	"8-out3889"	.59930	685	458	1143
8	"8-out3890"	.25454	98	287	385
8	"8-out3891"	.36933	106	181	287
8	"8-out3892"	.58236	251	180	431
8	"8-out3893"	.29693	416	985	1401
8	"8-out3894"	.35051	136	252	388
8	"8-out3895"	.26598	208	574	782
8	"8-out3896"	.75657	230	74	304
8	"8-out3897"	.45954	284	334	618
8	"8-out3898"	.36134	172	304	476
8	"8-out3899"	.25379	117	344	461
8	"8-out3900"	.31304	144	316	460
8	"8-out3901"	.12352	21	149	170
8	"8-out3902"	.25819	63	181	244
8	"8-out3903"	.21212	84	312	396
8	"8-out3904"	.25292	108	319	427
8	"8-out3905"	.19292	120	502	622
8	"8-out3906"	.04402	14	304	318
8	"8-out3907"	.60903	472	303	775
8	"8-out3908"	.40625	247	361	608
8	"8-out3909"	.43933	105	134	239
8	"8-out3910"	.67987	223	105	328
8	"8-out3911"	.73948	826	291	1117
8	"8-out3912"	.41071	115	165	280
8	"8-out3913"	.32242	325	683	1008
8	"8-out3914"	.20783	191	728	919
8	"8-out3915"	.27052	313	844	1157
8	"8-out3916"	.74711	582	197	779
8	"8-out3917"	.22455	503	1737	2240
8	"8-out3918"	.28984	451	1105	1556
8	"8-out3919"	.30820	233	523	756
8	"8-out3920"	.23460	80	261	341
8	"8-out3921"	.39142	137	213	350
8	"8-out3922"	.60330	146	96	242
8	"8-out3923"	.25100	249	743	992
8	"8-out3924"	.16712	121	603	724
8	"8-out3925"	.98630	72	1	73
8	"8-out3926"	.36827	267	458	725
8	"8-out3927"	.30407	97	222	319
8	"8-out3928"	.95407	644	31	675
8	"8-out3929"	.65975	477	246	723
8	"8-out3930"	.98611	71	1	72
8	"8-out3931"	.34891	209	390	599
8	"8-out3932"	.45865	355	419	774
8	"8-out3933"	.65658	304	159	463
8	"8-out3934"	.89820	300	34	334
8	"8-out3935"	.41463	204	288	492
8	"8-out3936"	.37925	234	383	617
8	"8-out3937"	.28767	84	208	292
8	"8-out3938"	.35655	87	157	244
8	"8-out3939"	.52631	100	90	190
8	"8-out3940"	.74509	76	26	102
8	"8-out3941"	.26315	75	210	285
8	"8-out3942"	.26853	268	730	998
8	"8-out3943"	.99253	133	1	134
8	"8-out3944"	.73812	544	193	737
8	"8-out3945"	.80342	703	172	875
8	"8-out3946"	.24840	78	236	314
8	"8-out3947"	.17791	58	268	326
8	"8-out3948"	.23008	130	435	565
8	"8-out3949"	.17362	79	376	455
8	"8-out3950"	.21752	278	1000	1278
8	"8-out3951"	.15394	119	654	773
8	"8-out3952"	.28571	138	345	483
8	"8-out3953"	.25138	182	542	724
8	"8-out3954"	.66465	440	222	662
8	"8-out3955"	.99072	961	9	970
8	"8-out3956"	.61454	448	281	729
8	"8-out3957"	.96808	91	3	94
8	"8-out3958"	.86419	210	33	243
8	"8-out3959"	.76757	393	119	512
8	"8-out3960"	.98989	196	2	198
8	"8-out3961"	.24933	373	1123	1496
8	"8-out3962"	.33892	647	1262	1909
8	"8-out3963"	.45033	272	332	604
8	"8-out3964"	.19329	75	313	388
8	"8-out3965"	.99090	218	2	220
8	"8-out3966"	.93548	522	36	558
8	"8-out3967"	.18862	63	271	334
8	"8-out3968"	.98461	64	1	65
8	"8-out3969"	.21135	67	250	317
8	"8-out3970"	.16973	120	587	707
8	"8-out3971"	.98319	351	6	357
8	"8-out3972"	.98742	157	2	159
8	"8-out3973"	.26660	281	773	1054
8	"8-out3974"	.32567	85	176	261
8	"8-out3975"	.21238	72	267	339
8	"8-out3976"	.18742	149	646	795
8	"8-out3977"	.36610	391	677	1068
8	"8-out3978"	.99228	900	7	907
8	"8-out3979"	.98581	139	2	141
8	"8-out3980"	.86524	122	19	141
8	"8-out3981"	.27308	207	551	758
8	"8-out3982"	.32804	62	127	189
8	"8-out3983"	.52287	80	73	153
8	"8-out3984"	.46078	47	55	102
8	"8-out3985"	.50000	41	41	82
8	"8-out3986"	.98863	87	1	88
8	"8-out3987"	.37662	29	48	77
8	"8-out3988"	.41004	98	141	239
8	"8-out3989"	.42084	109	150	259
8	"8-out3990"	.43731	150	193	343
8	"8-out3991"	.44550	233	290	523
8	"8-out3992"	.27272	30	80	110
8	"8-out3993"	.72972	189	70	259
8	"8-out3994"	.39662	94	143	237
8	"8-out3995"	.32978	155	315	470
8	"8-out3996"	.36777	331	569	900
8	"8-out3997"	.26863	191	520	711
8	"8-out3998"	.25000	199	597	796
8	"8-out3999"	.20925	113	427	540
8	"8-out4000"	.52552	350	316	666
8	"8-out4001"	.35340	223	408	631
8	"8-out4002"	.26901	237	644	881
8	"8-out4003"	.90447	606	64	670
8	"8-out4004"	.23400	128	419	547
8	"8-out4005"	.57482	242	179	421
8	"8-out4006"	.27796	82	213	295
8	"8-out4007"	.35974	613	1091	1704
8	"8-out4008"	.91625	186	17	203
8	"8-out4009"	.65151	86	46	132
8	"8-out4010"	.17620	117	547	664
8	"8-out4011"	.57142	128	96	224
8	"8-out4012"	.40606	67	98	165
8	"8-out4013"	.42888	196	261	457
8	"8-out4014"	.97448	191	5	196
8	"8-out4015"	.99549	221	1	222
8	"8-out4016"	.54054	120	102	222
8	"8-out4017"	.75384	147	48	195
8	"8-out4018"	.18367	36	160	196
8	"8-out4019"	.35011	146	271	417
8	"8-out4020"	.86607	97	15	112
8	"8-out4021"	.31136	189	418	607
8	"8-out4022"	.17880	27	124	151
8	"8-out4023"	.34714	176	331	507
8	"8-out4024"	.36439	348	607	955
8	"8-out4025"	.35380	144	263	407
8	"8-out4026"	.21708	122	440	562
8	"8-out4027"	.49446	134	137	271
8	"8-out4028"	.43034	139	184	323
8	"8-out4029"	.22316	131	456	587
8	"8-out4030"	.28697	130	323	453
8	"8-out4031"	.52360	244	222	466
8	"8-out4032"	.27761	93	242	335
8	"8-out4033"	.32500	130	270	400
8	"8-out4034"	.25359	229	674	903
8	"8-out4035"	.36402	170	297	467
8	"8-out4036"	.33474	79	157	236
8	"8-out4037"	.15000	27	153	180
8	"8-out4038"	.92446	257	21	278
8	"8-out4039"	.80000	148	37	185
8	"8-out4040"	.25906	50	143	193
8	"8-out4041"	.32804	62	127	189
8	"8-out4042"	.27590	426	1118	1544
8	"8-out4043"	.21142	174	649	823
8	"8-out4044"	.13333	24	156	180
8	"8-out4045"	.18828	135	582	717
8	"8-out4046"	.23574	186	603	789
8	"8-out4047"	.51470	245	231	476
8	"8-out4048"	.13740	54	339	393
8	"8-out4049"	.28540	131	328	459
8	"8-out4050"	.23076	108	360	468
8	"8-out4051"	.47194	143	160	303
8	"8-out4052"	.30208	58	134	192
8	"8-out4053"	.27310	133	354	487
8	"8-out4054"	.21522	410	1495	1905
8	"8-out4055"	.30152	218	505	723
8	"8-out4056"	.16863	100	493	593
8	"8-out4057"	.22857	184	621	805
8	"8-out4058"	.58695	54	38	92
8	"8-out4059"	.19827	184	744	928
8	"8-out4060"	.16580	64	322	386
8	"8-out4061"	.36734	144	248	392
8	"8-out4062"	.24179	140	439	579
8	"8-out4063"	.98809	83	1	84
8	"8-out4064"	.49295	70	72	142
8	"8-out4065"	.99559	226	1	227
8	"8-out4066"	.30648	274	620	894
8	"8-out4067"	.58143	739	532	1271
8	"8-out4068"	.93604	161	11	172
8	"8-out4069"	.30661	218	493	711
8	"8-out4070"	.88804	817	103	920
8	"8-out4071"	.40310	52	77	129
8	"8-out4072"	.57894	66	48	114
8	"8-out4073"	.99385	647	4	651
8	"8-out4074"	.18203	75	337	412
8	"8-out4075"	.19531	100	412	512
8	"8-out4076"	.44252	231	291	522
8	"8-out4077"	.83180	544	110	654
8	"8-out4078"	.30167	54	125	179
8	"8-out4079"	.99576	235	1	236
8	"8-out4080"	.97800	489	11	500
8	"8-out4081"	.22376	113	392	505
8	"8-out4082"	.28070	128	328	456
8	"8-out4083"	.21528	169	616	785
8	"8-out4084"	.06500	13	187	200
8	"8-out4085"	.51239	62	59	121
8	"8-out4086"	.25000	47	141	188
8	"8-out4087"	.28368	80	202	282
8	"8-out4088"	.16666	9	45	54
8	"8-out4089"	.20348	140	548	688
8	"8-out4090"	.21114	72	269	341
8	"8-out4091"	.24563	225	691	916
8	"8-out4092"	.37873	228	374	602
8	"8-out4093"	.40845	87	126	213
8	"8-out4094"	.47297	105	117	222
8	"8-out4095"	.33047	77	156	233
8	"8-out4096"	.92397	158	13	171
8	"8-out4097"	.43781	88	113	201
8	"8-out4098"	.31567	143	310	453
8	"8-out4099"	.24630	200	612	812
8	"8-out4100"	.30882	42	94	136
8	"8-out4101"	.13942	87	537	624
8	"8-out4102"	.71052	297	121	418
8	"8-out4103"	.84761	178	32	210
8	"8-out4104"	.34920	66	123	189
8	"8-out4105"	.23648	70	226	296
8	"8-out4106"	.47350	286	318	604
8	"8-out4107"	.36740	248	427	675
8	"8-out4108"	.98095	103	2	105
8	"8-out4109"	.83397	216	43	259
8	"8-out4110"	.82242	88	19	107
8	"8-out4111"	.19834	96	388	484
8	"8-out4112"	.67101	514	252	766
8	"8-out4113"	.30816	253	568	821
8	"8-out4114"	.20936	152	574	726
8	"8-out4115"	.21851	144	515	659
8	"8-out4116"	.58181	320	230	550
8	"8-out4117"	.44444	228	285	513
8	"8-out4118"	.20994	38	143	181
8	"8-out4119"	.99230	129	1	130
8	"8-out4120"	.19917	96	386	482
8	"8-out4121"	.85202	357	62	419
8	"8-out4122"	.48627	124	131	255
8	"8-out4123"	.09523	8	76	84
8	"8-out4124"	.35371	81	148	229
8	"8-out4125"	.69444	175	77	252
8	"8-out4126"	.98630	144	2	146
8	"8-out4127"	.25222	85	252	337
8	"8-out4128"	.31318	171	375	546
8	"8-out4129"	.37123	222	376	598
8	"8-out4130"	.32867	235	480	715
8	"8-out4131"	.97241	141	4	145
8	"8-out4132"	.19228	329	1382	1711
8	"8-out4133"	.20479	171	664	835
8	"8-out4134"	.26096	125	354	479
8	"8-out4135"	.26190	55	155	210
8	"8-out4136"	.29207	59	143	202
8	"8-out4137"	.35944	78	139	217
8	"8-out4138"	.25775	108	311	419
8	"8-out4139"	.18218	45	202	247
8	"8-out4140"	.99616	260	1	261
8	"8-out4141"	.31914	255	544	799
8	"8-out4142"	.47826	396	432	828
8	"8-out4143"	.44756	239	295	534
8	"8-out4144"	.36579	154	267	421
8	"8-out4145"	.39181	67	104	171
8	"8-out4146"	.22200	113	396	509
8	"8-out4147"	.83050	98	20	118
8	"8-out4148"	.98901	270	3	273
8	"8-out4149"	.29901	61	143	204
8	"8-out4150"	.82477	466	99	565
8	"8-out4151"	.12648	32	221	253
8	"8-out4152"	.16123	351	1826	2177
8	"8-out4153"	.13128	128	847	975
8	"8-out4154"	.98582	487	7	494
8	"8-out4155"	.25287	22	65	87
8	"8-out4156"	.91542	368	34	402
8	"8-out4157"	.40551	103	151	254
8	"8-out4158"	.26298	81	227	308
8	"8-out4159"	.34782	184	345	529
8	"8-out4160"	.22840	238	804	1042
8	"8-out4161"	.28864	267	658	925
8	"8-out4162"	.23121	120	399	519
8	"8-out4163"	.20876	386	1463	1849
8	"8-out4164"	.44088	179	227	406
8	"8-out4165"	.22484	219	755	974
8	"8-out4166"	.94093	462	29	491
8	"8-out4167"	.57042	81	61	142
8	"8-out4168"	.32087	146	309	455
8	"8-out4169"	.20283	86	338	424
8	"8-out4170"	.28165	109	278	387
8	"8-out4171"	.18877	74	318	392
8	"8-out4172"	.74624	397	135	532
8	"8-out4173"	.21474	236	863	1099
8	"8-out4174"	.32828	130	266	396
8	"8-out4175"	.09489	13	124	137
8	"8-out4176"	.24899	62	187	249
8	"8-out4177"	.41520	213	300	513
8	"8-out4178"	.31966	1255	2671	3926
8	"8-out4179"	.77872	183	52	235
8	"8-out4180"	.22784	54	183	237
8	"8-out4181"	.18906	204	875	1079
8	"8-out4182"	.33333	65	130	195
8	"8-out4183"	.97551	478	12	490
8	"8-out4184"	.26345	93	260	353
8	"8-out4185"	.98395	184	3	187
8	"8-out4186"	.25056	1217	3640	4857
8	"8-out4187"	.12044	43	314	357
8	"8-out4188"	.92039	370	32	402
8	"8-out4189"	.18832	129	556	685
8	"8-out4190"	.42756	121	162	283
8	"8-out4191"	.38586	71	113	184
8	"8-out4192"	.77379	992	290	1282
8	"8-out4193"	.42857	51	68	119
8	"8-out4194"	.99137	115	1	116
8	"8-out4195"	.97235	633	18	651
8	"8-out4196"	.24861	135	408	543
8	"8-out4197"	.31740	392	843	1235
8	"8-out4198"	.24883	107	323	430
8	"8-out4199"	.22988	120	402	522
8	"8-out4200"	.41603	1422	1996	3418
8	"8-out4201"	.26307	161	451	612
8	"8-out4202"	.27264	301	803	1104
8	"8-out4203"	.34380	361	689	1050
8	"8-out4204"	.32258	350	735	1085
8	"8-out4205"	.99586	722	3	725
8	"8-out4206"	.81896	95	21	116
8	"8-out4207"	.91111	205	20	225
8	"8-out4208"	.97648	623	15	638
8	"8-out4209"	.40495	147	216	363
8	"8-out4210"	.99595	492	2	494
8	"8-out4211"	.23273	91	300	391
8	"8-out4212"	.76162	131	41	172
8	"8-out4213"	.33309	472	945	1417
8	"8-out4214"	.18671	208	906	1114
8	"8-out4215"	.65945	122	63	185
8	"8-out4216"	.13894	137	849	986
8	"8-out4217"	.28930	184	452	636
8	"8-out4218"	.38812	85	134	219
8	"8-out4219"	.38535	121	193	314
8	"8-out4220"	.32857	69	141	210
8	"8-out4221"	.97198	347	10	357
8	"8-out4222"	.27619	29	76	105
8	"8-out4223"	.91554	683	63	746
8	"8-out4224"	.19921	51	205	256
8	"8-out4225"	.49212	1499	1547	3046
8	"8-out4226"	.98666	74	1	75
8	"8-out4227"	.23529	76	247	323
8	"8-out4228"	.51902	382	354	736
8	"8-out4229"	.41845	526	731	1257
8	"8-out4230"	.83919	501	96	597
8	"8-out4231"	.32222	58	122	180
8	"8-out4232"	.33753	107	210	317
8	"8-out4233"	.23318	52	171	223
8	"8-out4234"	.20820	203	772	975
8	"8-out4235"	.49000	245	255	500
8	"8-out4236"	.50209	240	238	478
8	"8-out4237"	.39887	71	107	178
8	"8-out4238"	.88000	110	15	125
8	"8-out4239"	.26620	423	1166	1589
8	"8-out4240"	.53963	177	151	328
8	"8-out4241"	.21330	109	402	511
8	"8-out4242"	.35160	186	343	529
8	"8-out4243"	.75319	412	135	547
8	"8-out4244"	.24375	39	121	160
8	"8-out4245"	.45064	703	857	1560
8	"8-out4246"	.24404	123	381	504
8	"8-out4247"	.58986	128	89	217
8	"8-out4248"	.25646	129	374	503
8	"8-out4249"	.10679	22	184	206
8	"8-out4250"	.49074	53	55	108
8	"8-out4251"	.25000	73	219	292
8	"8-out4252"	.50818	590	571	1161
8	"8-out4253"	.26373	96	268	364
8	"8-out4254"	.28338	174	440	614
8	"8-out4255"	.27491	80	211	291
8	"8-out4256"	.39082	179	279	458
8	"8-out4257"	.20270	120	472	592
8	"8-out4258"	.99310	144	1	145
8	"8-out4259"	.23845	191	610	801
8	"8-out4260"	.21608	86	312	398
8	"8-out4261"	.13009	99	662	761
8	"8-out4262"	.20675	251	963	1214
8	"8-out4263"	.30845	124	278	402
8	"8-out4264"	.40041	193	289	482
8	"8-out4265"	.32911	52	106	158
8	"8-out4266"	.31672	89	192	281
8	"8-out4267"	.24719	176	536	712
8	"8-out4268"	.95906	492	21	513
8	"8-out4269"	.99310	144	1	145
8	"8-out4270"	.15714	22	118	140
8	"8-out4271"	.44320	398	500	898
8	"8-out4272"	.30193	109	252	361
8	"8-out4273"	.42168	70	96	166
8	"8-out4274"	.22206	153	536	689
8	"8-out4275"	.17041	106	516	622
8	"8-out4276"	.24330	100	311	411
8	"8-out4277"	.58510	55	39	94
8	"8-out4278"	.19090	105	445	550
8	"8-out4279"	.98765	80	1	81
8	"8-out4280"	.27467	64	169	233
8	"8-out4281"	.32012	202	429	631
8	"8-out4282"	.48859	150	157	307
8	"8-out4283"	.59798	238	160	398
8	"8-out4284"	.38080	123	200	323
8	"8-out4285"	.24507	87	268	355
8	"8-out4286"	.39310	228	352	580
8	"8-out4287"	.33689	126	248	374
8	"8-out4288"	.14171	53	321	374
8	"8-out4289"	.16666	63	315	378
8	"8-out4290"	.23888	215	685	900
8	"8-out4291"	.23287	170	560	730
8	"8-out4292"	.99377	479	3	482
8	"8-out4293"	.96603	768	27	795
8	"8-out4294"	.14649	46	268	314
8	"8-out4295"	.82051	96	21	117
8	"8-out4296"	.34540	124	235	359
8	"8-out4297"	.59016	36	25	61
8	"8-out4298"	.29257	67	162	229
8	"8-out4299"	.33812	188	368	556
8	"8-out4300"	.78651	420	114	534
8	"8-out4301"	.45345	151	182	333
8	"8-out4302"	.36612	227	393	620
8	"8-out4303"	.08239	22	245	267
8	"8-out4304"	.22772	69	234	303
8	"8-out4305"	.31671	324	699	1023
8	"8-out4306"	.36259	475	835	1310
8	"8-out4307"	.31926	121	258	379
8	"8-out4308"	.34013	100	194	294
8	"8-out4309"	.50793	64	62	126
8	"8-out4310"	.65686	67	35	102
8	"8-out4311"	.90494	476	50	526
8	"8-out4312"	.49858	1236	1243	2479
8	"8-out4313"	.20042	94	375	469
8	"8-out4314"	.35631	398	719	1117
8	"8-out4315"	.19000	38	162	200
8	"8-out4316"	.20235	86	339	425
8	"8-out4317"	.67286	181	88	269
8	"8-out4318"	.86296	233	37	270
8	"8-out4319"	.28426	112	282	394
8	"8-out4320"	.18181	34	153	187
8	"8-out4321"	.21810	106	380	486
8	"8-out4322"	.39583	152	232	384
8	"8-out4323"	.24666	74	226	300
8	"8-out4324"	.25333	38	112	150
8	"8-out4325"	.88480	530	69	599
8	"8-out4326"	.34914	368	686	1054
8	"8-out4327"	.28698	161	400	561
8	"8-out4328"	.22658	196	669	865
8	"8-out4329"	.61752	465	288	753
8	"8-out4330"	.53731	144	124	268
8	"8-out4331"	.41810	194	270	464
8	"8-out4332"	.33707	90	177	267
8	"8-out4333"	.73154	218	80	298
8	"8-out4334"	.28929	219	538	757
8	"8-out4335"	.41708	249	348	597
8	"8-out4336"	.35329	59	108	167
8	"8-out4337"	.49820	278	280	558
8	"8-out4338"	.99230	129	1	130
8	"8-out4339"	.35428	124	226	350
8	"8-out4340"	.99261	269	2	271
8	"8-out4341"	.99152	117	1	118
8	"8-out4342"	.33128	216	436	652
8	"8-out4343"	.59917	145	97	242
8	"8-out4344"	.92105	70	6	76
8	"8-out4345"	.99462	185	1	186
8	"8-out4346"	.48031	61	66	127
8	"8-out4347"	.25000	35	105	140
8	"8-out4348"	.38781	719	1135	1854
8	"8-out4349"	.99551	222	1	223
8	"8-out4350"	.62849	2003	1184	3187
8	"8-out4351"	.26935	167	453	620
8	"8-out4352"	.28658	47	117	164
8	"8-out4353"	.47157	141	158	299
8	"8-out4354"	.41897	106	147	253
8	"8-out4355"	.31566	411	891	1302
8	"8-out4356"	.55345	88	71	159
8	"8-out4357"	.10443	40	343	383
8	"8-out4358"	.24894	59	178	237
8	"8-out4359"	.50997	179	172	351
8	"8-out4360"	.50680	149	145	294
8	"8-out4361"	.34545	57	108	165
8	"8-out4362"	.25405	47	138	185
8	"8-out4363"	.49478	474	484	958
8	"8-out4364"	.99019	202	2	204
8	"8-out4365"	.28925	70	172	242
8	"8-out4366"	.29454	81	194	275
8	"8-out4367"	.40909	153	221	374
8	"8-out4368"	.44303	420	528	948
8	"8-out4369"	.42608	49	66	115
8	"8-out4370"	.35353	35	64	99
8	"8-out4371"	.43965	102	130	232
8	"8-out4372"	.28273	95	241	336
8	"8-out4373"	.25648	89	258	347
8	"8-out4374"	.98918	183	2	185
8	"8-out4375"	.19035	150	638	788
8	"8-out4376"	.83859	691	133	824
8	"8-out4377"	.16091	70	365	435
8	"8-out4378"	.25316	120	354	474
8	"8-out4379"	.58091	140	101	241
8	"8-out4380"	.33730	85	167	252
8	"8-out4381"	.22937	203	682	885
8	"8-out4382"	.70157	134	57	191
8	"8-out4383"	.13258	59	386	445
8	"8-out4384"	.90845	258	26	284
8	"8-out4385"	.58862	352	246	598
8	"8-out4386"	.20805	62	236	298
8	"8-out4387"	.42045	74	102	176
8	"8-out4388"	.94696	1500	84	1584
8	"8-out4389"	.99433	351	2	353
8	"8-out4390"	.99551	222	1	223
8	"8-out4391"	.21694	64	231	295
8	"8-out4392"	.27636	532	1393	1925
8	"8-out4393"	.51009	480	461	941
8	"8-out4394"	.45846	149	176	325
8	"8-out4395"	.64837	378	205	583
8	"8-out4396"	.36184	55	97	152
8	"8-out4397"	.24495	85	262	347
8	"8-out4398"	.43877	129	165	294
8	"8-out4399"	.46753	72	82	154
8	"8-out4400"	.96791	181	6	187
8	"8-out4401"	.35742	183	329	512
8	"8-out4402"	.24632	134	410	544
8	"8-out4403"	.33400	167	333	500
8	"8-out4404"	.37796	923	1519	2442
8	"8-out4405"	.90173	468	51	519
8	"8-out4406"	.99705	339	1	340
8	"8-out4407"	.16694	99	494	593
8	"8-out4408"	.30538	51	116	167
8	"8-out4409"	.28947	33	81	114
8	"8-out4410"	.24355	170	528	698
8	"8-out4411"	.96511	83	3	86
8	"8-out4412"	.99447	180	1	181
8	"8-out4413"	.35474	243	442	685
8	"8-out4414"	.98518	133	2	135
8	"8-out4415"	.17256	78	374	452
8	"8-out4416"	.28134	386	986	1372
8	"8-out4417"	.55234	153	124	277
8	"8-out4418"	.21382	99	364	463
8	"8-out4419"	.32937	111	226	337
8	"8-out4420"	.92705	305	24	329
8	"8-out4421"	.99230	387	3	390
8	"8-out4422"	.36037	271	481	752
8	"8-out4423"	.76428	428	132	560
8	"8-out4424"	.92233	380	32	412
8	"8-out4425"	.25000	99	297	396
8	"8-out4426"	.99253	399	3	402
8	"8-out4427"	.99115	112	1	113
8	"8-out4428"	.35958	105	187	292
8	"8-out4429"	.32592	44	91	135
8	"8-out4430"	.20400	51	199	250
8	"8-out4431"	.99386	162	1	163
8	"8-out4432"	.30990	172	383	555
8	"8-out4433"	.35245	172	316	488
8	"8-out4434"	.44527	419	522	941
8	"8-out4435"	.21008	25	94	119
8	"8-out4436"	.32794	142	291	433
8	"8-out4437"	.89491	264	31	295
8	"8-out4438"	.27906	96	248	344
8	"8-out4439"	.36678	106	183	289
8	"8-out4440"	.21501	169	617	786
8	"8-out4441"	.25915	92	263	355
8	"8-out4442"	.97445	763	20	783
8	"8-out4443"	.22134	56	197	253
8	"8-out4444"	.31176	347	766	1113
8	"8-out4445"	.99644	280	1	281
8	"8-out4446"	.30531	178	405	583
8	"8-out4447"	.15929	36	190	226
8	"8-out4448"	.30084	142	330	472
8	"8-out4449"	.25454	56	164	220
8	"8-out4450"	.43161	142	187	329
8	"8-out4451"	.52492	179	162	341
8	"8-out4452"	.24011	85	269	354
8	"8-out4453"	.33233	222	446	668
8	"8-out4454"	.39171	331	514	845
8	"8-out4455"	.41239	153	218	371
8	"8-out4456"	.42264	112	153	265
8	"8-out4457"	.12135	25	181	206
8	"8-out4458"	.23113	49	163	212
8	"8-out4459"	.33465	506	1006	1512
8	"8-out4460"	.33564	873	1728	2601
8	"8-out4461"	.47126	123	138	261
8	"8-out4462"	.24832	37	112	149
8	"8-out4463"	.30472	316	721	1037
8	"8-out4464"	.12068	14	102	116
8	"8-out4465"	.29018	204	499	703
8	"8-out4466"	.21379	124	456	580
8	"8-out4467"	.45092	294	358	652
8	"8-out4468"	.35267	79	145	224
8	"8-out4469"	.12195	25	180	205
8	"8-out4470"	.33233	221	444	665
8	"8-out4471"	.41717	68	95	163
8	"8-out4472"	.32689	474	976	1450
8	"8-out4473"	.93513	173	12	185
8	"8-out4474"	.14349	32	191	223
8	"8-out4475"	.36891	197	337	534
8	"8-out4476"	.42692	111	149	260
8	"8-out4477"	.17010	33	161	194
8	"8-out4478"	.54755	213	176	389
8	"8-out4479"	.33836	112	219	331
8	"8-out4480"	.40000	40	60	100
8	"8-out4481"	.53846	133	114	247
8	"8-out4482"	.63366	128	74	202
8	"8-out4483"	.13888	50	310	360
8	"8-out4484"	.09206	29	286	315
8	"8-out4485"	.20408	20	78	98
8	"8-out4486"	.17824	59	272	331
8	"8-out4487"	.32666	49	101	150
8	"8-out4488"	.37011	161	274	435
8	"8-out4489"	.78225	291	81	372
8	"8-out4490"	.38969	295	462	757
8	"8-out4491"	.40056	141	211	352
8	"8-out4492"	.22451	163	563	726
8	"8-out4493"	.23188	64	212	276
8	"8-out4494"	.20297	41	161	202
8	"8-out4495"	.67857	247	117	364
8	"8-out4496"	.25000	84	252	336
8	"8-out4497"	.42023	216	298	514
8	"8-out4498"	.38060	467	760	1227
8	"8-out4499"	.30769	80	180	260
8	"8-out4500"	.19393	96	399	495
8	"8-out4501"	.36752	129	222	351
8	"8-out4502"	.20000	61	244	305
8	"8-out4503"	.34063	171	331	502
8	"8-out4504"	.52513	188	170	358
8	"8-out4505"	.57246	79	59	138
8	"8-out4506"	.32268	101	212	313
8	"8-out4507"	.34715	67	126	193
8	"8-out4508"	.29334	516	1243	1759
8	"8-out4509"	.17505	73	344	417
8	"8-out4510"	.26241	111	312	423
8	"8-out4511"	.35144	485	895	1380
8	"8-out4512"	.51345	229	217	446
8	"8-out4513"	.21523	195	711	906
8	"8-out4514"	.37901	224	367	591
8	"8-out4515"	.90601	482	50	532
8	"8-out4516"	.34306	94	180	274
8	"8-out4517"	.25490	39	114	153
8	"8-out4518"	.47643	91	100	191
8	"8-out4519"	.21513	54	197	251
8	"8-out4520"	.33473	319	634	953
8	"8-out4521"	.28963	95	233	328
8	"8-out4522"	.29257	268	648	916
8	"8-out4523"	.28148	76	194	270
8	"8-out4524"	.25316	80	236	316
8	"8-out4525"	.38916	158	248	406
8	"8-out4526"	.98872	263	3	266
8	"8-out4527"	.33928	76	148	224
8	"8-out4528"	.29192	141	342	483
8	"8-out4529"	.48072	212	229	441
8	"8-out4530"	.15671	21	113	134
8	"8-out4531"	.99082	108	1	109
8	"8-out4532"	.28009	121	311	432
8	"8-out4533"	.56077	203	159	362
8	"8-out4534"	.43154	602	793	1395
8	"8-out4535"	.39807	207	313	520
8	"8-out4536"	.30571	107	243	350
8	"8-out4537"	.23127	71	236	307
8	"8-out4538"	.58536	120	85	205
8	"8-out4539"	.38147	140	227	367
8	"8-out4540"	.16806	40	198	238
8	"8-out4541"	.21399	52	191	243
8	"8-out4542"	.17032	31	151	182
8	"8-out4543"	.34934	160	298	458
8	"8-out4544"	.13596	31	197	228
8	"8-out4545"	.29477	79	189	268
8	"8-out4546"	.20721	178	681	859
8	"8-out4547"	.18902	31	133	164
8	"8-out4548"	.33838	67	131	198
8	"8-out4549"	.32321	149	312	461
8	"8-out4550"	.11309	19	149	168
8	"8-out4551"	.34215	181	348	529
8	"8-out4552"	.24056	357	1127	1484
8	"8-out4553"	.76504	267	82	349
8	"8-out4554"	.15942	22	116	138
8	"8-out4555"	.36149	291	514	805
8	"8-out4556"	.17125	87	421	508
8	"8-out4557"	.70289	97	41	138
8	"8-out4558"	.20834	609	2314	2923
8	"8-out4559"	.33009	68	138	206
8	"8-out4560"	.65562	99	52	151
8	"8-out4561"	.47684	587	644	1231
8	"8-out4562"	.41884	240	333	573
8	"8-out4563"	.30723	208	469	677
8	"8-out4564"	.98775	484	6	490
8	"8-out4565"	.86742	1217	186	1403
8	"8-out4566"	.36601	56	97	153
8	"8-out4567"	.76760	109	33	142
8	"8-out4568"	.60891	123	79	202
8	"8-out4569"	.30626	132	299	431
8	"8-out4570"	.24920	156	470	626
8	"8-out4571"	.17630	183	855	1038
8	"8-out4572"	.23239	231	763	994
8	"8-out4573"	.43928	123	157	280
8	"8-out4574"	.20762	98	374	472
8	"8-out4575"	.19387	38	158	196
8	"8-out4576"	.58661	149	105	254
8	"8-out4577"	.14705	60	348	408
8	"8-out4578"	.16528	120	606	726
8	"8-out4579"	.32926	81	165	246
8	"8-out4580"	.23742	439	1410	1849
8	"8-out4581"	.68271	241	112	353
8	"8-out4582"	.98809	83	1	84
8	"8-out4583"	.35672	61	110	171
8	"8-out4584"	.85029	284	50	334
8	"8-out4585"	.21107	61	228	289
8	"8-out4586"	.34782	88	165	253
8	"8-out4587"	.98642	218	3	221
8	"8-out4588"	.81542	296	67	363
8	"8-out4589"	.37078	231	392	623
8	"8-out4590"	.36196	354	624	978
8	"8-out4591"	.50177	141	140	281
8	"8-out4592"	.99173	360	3	363
8	"8-out4593"	.29113	23	56	79
8	"8-out4594"	.38683	94	149	243
8	"8-out4595"	.54594	202	168	370
8	"8-out4596"	.35915	51	91	142
8	"8-out4597"	.15961	83	437	520
8	"8-out4598"	.22151	175	615	790
8	"8-out4599"	.25259	195	577	772
8	"8-out4600"	.25717	233	673	906
8	"8-out4601"	.41246	139	198	337
8	"8-out4602"	.15174	139	777	916
8	"8-out4603"	.35207	144	265	409
8	"8-out4604"	.59216	257	177	434
8	"8-out4605"	.33264	161	323	484
8	"8-out4606"	.24752	75	228	303
8	"8-out4607"	.34579	111	210	321
8	"8-out4608"	.39285	143	221	364
8	"8-out4609"	.17647	93	434	527
8	"8-out4610"	.28700	95	236	331
8	"8-out4611"	.95388	393	19	412
8	"8-out4612"	.13580	22	140	162
8	"8-out4613"	.46907	91	103	194
8	"8-out4614"	.34134	71	137	208
8	"8-out4615"	.24912	143	431	574
8	"8-out4616"	.98561	137	2	139
8	"8-out4617"	.76271	225	70	295
8	"8-out4618"	.25498	230	672	902
8	"8-out4619"	.13126	55	364	419
8	"8-out4620"	.29170	292	709	1001
8	"8-out4621"	.15705	79	424	503
8	"8-out4622"	.17901	29	133	162
8	"8-out4623"	.39800	80	121	201
8	"8-out4624"	.33156	125	252	377
8	"8-out4625"	.21192	64	238	302
8	"8-out4626"	.33760	316	620	936
8	"8-out4627"	.99315	290	2	292
8	"8-out4628"	.62403	161	97	258
8	"8-out4629"	.98653	293	4	297
8	"8-out4630"	.54347	300	252	552
8	"8-out4631"	.45328	393	474	867
8	"8-out4632"	.40952	86	124	210
8	"8-out4633"	.47132	337	378	715
8	"8-out4634"	.99736	379	1	380
8	"8-out4635"	.27124	150	403	553
8	"8-out4636"	.61126	228	145	373
8	"8-out4637"	.75781	388	124	512
8	"8-out4638"	.55384	144	116	260
8	"8-out4639"	.71978	411	160	571
8	"8-out4640"	.32291	31	65	96
8	"8-out4641"	.26804	26	71	97
8	"8-out4642"	.29133	37	90	127
8	"8-out4643"	.42756	121	162	283
8	"8-out4644"	.24661	91	278	369
8	"8-out4645"	.97894	93	2	95
8	"8-out4646"	.25757	17	49	66
8	"8-out4647"	.39698	79	120	199
8	"8-out4648"	.79862	349	88	437
8	"8-out4649"	.18456	122	539	661
8	"8-out4650"	.27083	65	175	240
8	"8-out4651"	.17187	22	106	128
8	"8-out4652"	.22988	60	201	261
8	"8-out4653"	.36636	122	211	333
8	"8-out4654"	.59568	442	300	742
8	"8-out4655"	.14035	24	147	171
8	"8-out4656"	.42127	99	136	235
8	"8-out4657"	.21603	97	352	449
8	"8-out4658"	.25460	152	445	597
8	"8-out4659"	.69430	134	59	193
8	"8-out4660"	.39903	83	125	208
8	"8-out4661"	.24474	128	395	523
8	"8-out4662"	.71228	1676	677	2353
8	"8-out4663"	.41385	920	1303	2223
8	"8-out4664"	.37037	170	289	459
8	"8-out4665"	.24458	79	244	323
8	"8-out4666"	.24597	107	328	435
8	"8-out4667"	.88281	113	15	128
8	"8-out4668"	.33968	107	208	315
8	"8-out4669"	.28823	49	121	170
8	"8-out4670"	.24719	396	1206	1602
8	"8-out4671"	.22812	146	494	640
8	"8-out4672"	.23486	322	1049	1371
8	"8-out4673"	.19316	113	472	585
8	"8-out4674"	.29019	74	181	255
8	"8-out4675"	.28601	137	342	479
8	"8-out4676"	.46181	127	148	275
8	"8-out4677"	.23411	70	229	299
8	"8-out4678"	.21706	234	844	1078
8	"8-out4679"	.97706	213	5	218
8	"8-out4680"	.31914	105	224	329
8	"8-out4681"	.90797	148	15	163
8	"8-out4682"	.20286	85	334	419
8	"8-out4683"	.22708	223	759	982
8	"8-out4684"	.20524	47	182	229
8	"8-out4685"	.15607	86	465	551
8	"8-out4686"	.15607	86	465	551
8	"8-out4687"	.19587	19	78	97
8	"8-out4688"	.41516	115	162	277
8	"8-out4689"	.36531	217	377	594
8	"8-out4690"	.51151	755	721	1476
8	"8-out4691"	.99240	392	3	395
8	"8-out4692"	.33707	90	177	267
8	"8-out4693"	.44635	649	805	1454
8	"8-out4694"	.58202	628	451	1079
8	"8-out4695"	.21232	93	345	438
8	"8-out4696"	.33333	31	62	93
8	"8-out4697"	.29104	78	190	268
8	"8-out4698"	.45036	245	299	544
8	"8-out4699"	.33271	179	359	538
8	"8-out4700"	.15783	134	715	849
8	"8-out4701"	.89176	379	46	425
8	"8-out4702"	.97802	89	2	91
8	"8-out4703"	.45210	354	429	783
8	"8-out4704"	.63660	240	137	377
8	"8-out4705"	.29003	192	470	662
8	"8-out4706"	.22112	67	236	303
8	"8-out4707"	.21963	85	302	387
8	"8-out4708"	.77272	221	65	286
8	"8-out4709"	.29501	272	650	922
8	"8-out4710"	.50898	170	164	334
8	"8-out4711"	.35802	58	104	162
8	"8-out4712"	.99074	107	1	108
8	"8-out4713"	.35042	41	76	117
8	"8-out4714"	.17268	153	733	886
8	"8-out4715"	.35937	46	82	128
8	"8-out4716"	.35008	404	750	1154
8	"8-out4717"	.47910	321	349	670
8	"8-out4718"	.20000	36	144	180
8	"8-out4719"	.26101	160	453	613
8	"8-out4720"	.31447	417	909	1326
8	"8-out4721"	.45140	497	604	1101
8	"8-out4722"	.74015	188	66	254
8	"8-out4723"	.56043	153	120	273
8	"8-out4724"	.48923	159	166	325
8	"8-out4725"	.42500	85	115	200
8	"8-out4726"	.27126	169	454	623
8	"8-out4727"	.46200	152	177	329
8	"8-out4728"	.45005	428	523	951
8	"8-out4729"	.98888	89	1	90
8	"8-out4730"	.99305	143	1	144
8	"8-out4731"	.83898	1162	223	1385
8	"8-out4732"	.89130	82	10	92
8	"8-out4733"	.38541	37	59	96
8	"8-out4734"	.35263	67	123	190
8	"8-out4735"	.23809	85	272	357
8	"8-out4736"	.23655	110	355	465
8	"8-out4737"	.26944	97	263	360
8	"8-out4738"	.49322	182	187	369
8	"8-out4739"	.39356	159	245	404
8	"8-out4740"	.97177	241	7	248
8	"8-out4741"	.39661	117	178	295
8	"8-out4742"	.95290	344	17	361
8	"8-out4743"	.35847	518	927	1445
8	"8-out4744"	.17153	47	227	274
8	"8-out4745"	.98924	92	1	93
8	"8-out4746"	.13414	22	142	164
8	"8-out4747"	.41095	90	129	219
8	"8-out4748"	.32432	120	250	370
8	"8-out4749"	.17796	42	194	236
8	"8-out4750"	.65343	247	131	378
8	"8-out4751"	.99171	359	3	362
8	"8-out4752"	.12213	16	115	131
8	"8-out4753"	.52095	87	80	167
8	"8-out4754"	.99218	127	1	128
8	"8-out4755"	.38352	298	479	777
8	"8-out4756"	.28174	557	1420	1977
8	"8-out4757"	.95081	290	15	305
8	"8-out4758"	.49054	389	404	793
8	"8-out4759"	.18333	121	539	660
8	"8-out4760"	.15463	60	328	388
8	"8-out4761"	.17816	62	286	348
8	"8-out4762"	.24796	305	925	1230
8	"8-out4763"	.23940	96	305	401
8	"8-out4764"	.17366	124	590	714
8	"8-out4765"	.22152	142	499	641
8	"8-out4766"	.36725	83	143	226
8	"8-out4767"	.14814	88	506	594
8	"8-out4768"	.22796	75	254	329
8	"8-out4769"	.32330	129	270	399
8	"8-out4770"	.78321	224	62	286
8	"8-out4771"	.66666	100	50	150
8	"8-out4772"	.47328	62	69	131
8	"8-out4773"	.23684	54	174	228
8	"8-out4774"	.50000	83	83	166
8	"8-out4775"	.24941	106	319	425
8	"8-out4776"	.11401	48	373	421
8	"8-out4777"	.21482	229	837	1066
8	"8-out4778"	.27765	123	320	443
8	"8-out4779"	.18777	86	372	458
8	"8-out4780"	.26424	51	142	193
8	"8-out4781"	.16577	62	312	374
8	"8-out4782"	.24938	609	1833	2442
8	"8-out4783"	.27521	131	345	476
8	"8-out4784"	.27569	338	888	1226
8	"8-out4785"	.23417	111	363	474
8	"8-out4786"	.99047	624	6	630
8	"8-out4787"	.99240	392	3	395
8	"8-out4788"	.98529	67	1	68
8	"8-out4789"	.28159	479	1222	1701
8	"8-out4790"	.64047	326	183	509
8	"8-out4791"	.27946	83	214	297
8	"8-out4792"	.77755	388	111	499
8	"8-out4793"	.17337	56	267	323
8	"8-out4794"	.24384	99	307	406
8	"8-out4795"	.39548	210	321	531
8	"8-out4796"	.22720	147	500	647
8	"8-out4797"	.15263	29	161	190
8	"8-out4798"	.33064	82	166	248
8	"8-out4799"	.99130	228	2	230
8	"8-out4800"	.36879	156	267	423
8	"8-out4801"	.54790	183	151	334
8	"8-out4802"	.98451	763	12	775
8	"8-out4803"	.32608	255	527	782
8	"8-out4804"	.13109	43	285	328
8	"8-out4805"	.30944	95	212	307
8	"8-out4806"	.98965	287	3	290
8	"8-out4807"	.26825	158	431	589
8	"8-out4808"	.16320	118	605	723
8	"8-out4809"	.28205	165	420	585
8	"8-out4810"	.39403	119	183	302
8	"8-out4811"	.24873	98	296	394
8	"8-out4812"	.27533	508	1337	1845
8	"8-out4813"	.49785	348	351	699
8	"8-out4814"	.33193	238	479	717
8	"8-out4815"	.22324	219	762	981
8	"8-out4816"	.47701	83	91	174
8	"8-out4817"	.24502	234	721	955
8	"8-out4818"	.32394	46	96	142
8	"8-out4819"	.93939	31	2	33
8	"8-out4820"	.17865	77	354	431
8	"8-out4821"	.23809	30	96	126
8	"8-out4822"	.04918	6	116	122
8	"8-out4823"	.99621	263	1	264
8	"8-out4824"	.94791	273	15	288
8	"8-out4825"	.79264	237	62	299
8	"8-out4826"	.64285	135	75	210
8	"8-out4827"	.47082	573	644	1217
8	"8-out4828"	.51687	291	272	563
8	"8-out4829"	.39542	380	581	961
8	"8-out4830"	.18390	48	213	261
8	"8-out4831"	.21376	59	217	276
8	"8-out4832"	.97425	757	20	777
8	"8-out4833"	.39910	89	134	223
8	"8-out4834"	.85588	291	49	340
8	"8-out4835"	.66438	97	49	146
8	"8-out4836"	.32402	232	484	716
8	"8-out4837"	.11627	30	228	258
8	"8-out4838"	.78330	394	109	503
8	"8-out4839"	.41228	47	67	114
8	"8-out4840"	.40229	245	364	609
8	"8-out4841"	.86550	695	108	803
8	"8-out4842"	.29532	303	723	1026
8	"8-out4843"	.24855	129	390	519
8	"8-out4844"	.97498	1988	51	2039
8	"8-out4845"	.95192	297	15	312
8	"8-out4846"	.35240	154	283	437
8	"8-out4847"	.97815	403	9	412
8	"8-out4848"	.37070	162	275	437
8	"8-out4849"	.73548	342	123	465
8	"8-out4850"	.55612	109	87	196
8	"8-out4851"	.64942	113	61	174
8	"8-out4852"	.25824	47	135	182
8	"8-out4853"	.52475	53	48	101
8	"8-out4854"	.40284	170	252	422
8	"8-out4855"	.76434	373	115	488
8	"8-out4856"	.82449	1663	354	2017
8	"8-out4857"	.25000	76	228	304
8	"8-out4858"	.98257	282	5	287
8	"8-out4859"	.28279	194	492	686
8	"8-out4860"	.18600	93	407	500
8	"8-out4861"	.31919	158	337	495
8	"8-out4862"	.21739	55	198	253
8	"8-out4863"	.37905	152	249	401
8	"8-out4864"	.11560	20	153	173
8	"8-out4865"	.26315	40	112	152
8	"8-out4866"	.27966	33	85	118
8	"8-out4867"	.27350	32	85	117
8	"8-out4868"	.29059	102	249	351
8	"8-out4869"	.17703	37	172	209
8	"8-out4870"	.47286	61	68	129
8	"8-out4871"	.98484	195	3	198
8	"8-out4872"	.52205	71	65	136
8	"8-out4873"	.18864	93	400	493
8	"8-out4874"	.99019	101	1	102
8	"8-out4875"	.71634	596	236	832
8	"8-out4876"	.33156	187	377	564
8	"8-out4877"	.11560	20	153	173
8	"8-out4878"	.20703	53	203	256
8	"8-out4879"	.29963	166	388	554
8	"8-out4880"	.99539	216	1	217
8	"8-out4881"	.40972	59	85	144
8	"8-out4882"	.77749	304	87	391
8	"8-out4883"	.32704	468	963	1431
8	"8-out4884"	.27953	336	866	1202
8	"8-out4885"	.81329	318	73	391
8	"8-out4886"	.42456	121	164	285
8	"8-out4887"	.51120	251	240	491
8	"8-out4888"	.12883	42	284	326
8	"8-out4889"	.75722	262	84	346
8	"8-out4890"	.96987	161	5	166
8	"8-out4891"	.96296	520	20	540
8	"8-out4892"	.25000	47	141	188
8	"8-out4893"	.38541	37	59	96
8	"8-out4894"	.42551	597	806	1403
8	"8-out4895"	.35531	194	352	546
8	"8-out4896"	.36526	286	497	783
8	"8-out4897"	.37742	505	833	1338
8	"8-out4898"	.27169	191	512	703
8	"8-out4899"	.65644	107	56	163
8	"8-out4900"	.98536	202	3	205
8	"8-out4901"	.29210	111	269	380
8	"8-out4902"	.35795	596	1069	1665
8	"8-out4903"	.79166	190	50	240
8	"8-out4904"	.27038	63	170	233
8	"8-out4905"	.30693	62	140	202
8	"8-out4906"	.96363	159	6	165
8	"8-out4907"	.56053	125	98	223
8	"8-out4908"	.99009	100	1	101
8	"8-out4909"	.23290	126	415	541
8	"8-out4910"	.30617	124	281	405
8	"8-out4911"	.98913	91	1	92
8	"8-out4912"	.32258	80	168	248
8	"8-out4913"	.35042	82	152	234
8	"8-out4914"	.31838	71	152	223
8	"8-out4915"	.18497	32	141	173
8	"8-out4916"	.38815	59	93	152
8	"8-out4917"	.34534	115	218	333
8	"8-out4918"	.84076	264	50	314
8	"8-out4919"	.58888	53	37	90
8	"8-out4920"	.28070	16	41	57
8	"8-out4921"	.99610	511	2	513
8	"8-out4922"	.19730	190	773	963
8	"8-out4923"	.24409	124	384	508
8	"8-out4924"	.43037	68	90	158
8	"8-out4925"	.93076	484	36	520
8	"8-out4926"	.98591	490	7	497
8	"8-out4927"	.91886	453	40	493
8	"8-out4928"	.18003	92	419	511
8	"8-out4929"	.30334	263	604	867
8	"8-out4930"	.39328	199	307	506
8	"8-out4931"	.53677	270	233	503
8	"8-out4932"	.33475	157	312	469
8	"8-out4933"	.29473	168	402	570
8	"8-out4934"	.39636	109	166	275
8	"8-out4935"	.98571	69	1	70
8	"8-out4936"	.36641	144	249	393
8	"8-out4937"	.46979	70	79	149
8	"8-out4938"	.12737	114	781	895
8	"8-out4939"	.22565	241	827	1068
8	"8-out4940"	.26262	26	73	99
8	"8-out4941"	.67164	45	22	67
8	"8-out4942"	.33684	32	63	95
8	"8-out4943"	.36619	26	45	71
8	"8-out4944"	.59322	175	120	295
8	"8-out4945"	.25949	41	117	158
8	"8-out4946"	.21130	86	321	407
8	"8-out4947"	.26016	160	455	615
8	"8-out4948"	.54333	326	274	600
8	"8-out4949"	.89857	567	64	631
8	"8-out4950"	.24686	138	421	559
8	"8-out4951"	.28256	128	325	453
8	"8-out4952"	.34808	118	221	339
8	"8-out4953"	.55939	259	204	463
8	"8-out4954"	.14035	48	294	342
8	"8-out4955"	.47692	341	374	715
8	"8-out4956"	.36129	280	495	775
8	"8-out4957"	.40476	170	250	420
8	"8-out4958"	.16913	57	280	337
8	"8-out4959"	.55780	386	306	692
8	"8-out4960"	.64835	118	64	182
8	"8-out4961"	.08174	30	337	367
8	"8-out4962"	.70502	337	141	478
8	"8-out4963"	.73903	354	125	479
8	"8-out4964"	.16842	48	237	285
8	"8-out4965"	.27810	47	122	169
8	"8-out4966"	.62804	515	305	820
8	"8-out4967"	.19170	37	156	193
8	"8-out4968"	.22365	121	420	541
8	"8-out4969"	.17017	89	434	523
8	"8-out4970"	.23750	38	122	160
8	"8-out4971"	.33823	46	90	136
8	"8-out4972"	.97701	85	2	87
8	"8-out4973"	.21739	15	54	69
8	"8-out4974"	.17105	13	63	76
8	"8-out4975"	.98207	548	10	558
8	"8-out4976"	.17841	81	373	454
8	"8-out4977"	.34949	173	322	495
8	"8-out4978"	.23566	222	720	942
8	"8-out4979"	.15540	115	625	740
8	"8-out4980"	.20061	130	518	648
8	"8-out4981"	.18539	33	145	178
8	"8-out4982"	.23118	43	143	186
8	"8-out4983"	.30962	296	660	956
8	"8-out4984"	.30508	396	902	1298
8	"8-out4985"	.19480	30	124	154
8	"8-out4986"	.98571	69	1	70
8	"8-out4987"	.54098	33	28	61
8	"8-out4988"	.38805	26	41	67
8	"8-out4989"	.22702	84	286	370
8	"8-out4990"	.25071	88	263	351
8	"8-out4991"	.53953	464	396	860
8	"8-out4992"	.86763	1547	236	1783
8	"8-out4993"	.75548	482	156	638
8	"8-out4994"	.24398	142	440	582
8	"8-out4995"	.34153	111	214	325
8	"8-out4996"	.17666	53	247	300
8	"8-out4997"	.99468	374	2	376
8	"8-out4998"	.98461	64	1	65
8	"8-out4999"	.99076	751	7	758
8	"8-out5000"	.35519	65	118	183
8	"8-out5001"	.28433	118	297	415
8	"8-out5002"	.05882	6	96	102
8	"8-out5003"	.40650	50	73	123
8	"8-out5004"	.98484	65	1	66
8	"8-out5005"	.17948	14	64	78
8	"8-out5006"	.99358	155	1	156
8	"8-out5007"	.30630	34	77	111
8	"8-out5008"	.99324	147	1	148
8	"8-out5009"	.36708	145	250	395
8	"8-out5010"	.25735	140	404	544
8	"8-out5011"	.84943	378	67	445
8	"8-out5012"	.49538	161	164	325
8	"8-out5013"	.36013	215	382	597
8	"8-out5014"	.20370	44	172	216
8	"8-out5015"	.34807	181	339	520
8	"8-out5016"	.15151	35	196	231
8	"8-out5017"	.44790	675	832	1507
8	"8-out5018"	.39495	188	288	476
8	"8-out5019"	.19695	285	1162	1447
8	"8-out5020"	.19069	123	522	645
8	"8-out5021"	.14285	37	222	259
8	"8-out5022"	.19849	79	319	398
8	"8-out5023"	.22448	22	76	98
8	"8-out5024"	.29453	329	788	1117
8	"8-out5025"	.45398	74	89	163
8	"8-out5026"	.97520	236	6	242
8	"8-out5027"	.34908	133	248	381
8	"8-out5028"	.33149	180	363	543
8	"8-out5029"	.99047	416	4	420
8	"8-out5030"	.21088	124	464	588
8	"8-out5031"	.52142	146	134	280
8	"8-out5032"	.26548	30	83	113
8	"8-out5033"	.27972	207	533	740
8	"8-out5034"	.96236	716	28	744
8	"8-out5035"	.97942	476	10	486
8	"8-out5036"	.96718	560	19	579
8	"8-out5037"	.88872	599	75	674
8	"8-out5038"	.21860	94	336	430
8	"8-out5039"	.20909	299	1131	1430
8	"8-out5040"	.62980	410	241	651
8	"8-out5041"	.46264	161	187	348
8	"8-out5042"	.22335	88	306	394
8	"8-out5043"	.98974	193	2	195
8	"8-out5044"	.96850	369	12	381
8	"8-out5045"	.38161	137	222	359
8	"8-out5046"	.57551	362	267	629
8	"8-out5047"	.30088	34	79	113
8	"8-out5048"	.98159	160	3	163
8	"8-out5049"	.26883	207	563	770
8	"8-out5050"	.23250	93	307	400
8	"8-out5051"	.38249	389	628	1017
8	"8-out5052"	.79432	112	29	141
8	"8-out5053"	.45841	248	293	541
8	"8-out5054"	.98578	416	6	422
8	"8-out5055"	.26674	223	613	836
8	"8-out5056"	.99298	849	6	855
8	"8-out5057"	.99270	136	1	137
8	"8-out5058"	.29705	202	478	680
8	"8-out5059"	.29867	339	796	1135
8	"8-out5060"	.26134	144	407	551
8	"8-out5061"	.49777	112	113	225
8	"8-out5062"	.48300	199	213	412
8	"8-out5063"	.30591	119	270	389
8	"8-out5064"	.85751	325	54	379
8	"8-out5065"	.19748	220	894	1114
8	"8-out5066"	.36615	119	206	325
8	"8-out5067"	.61948	267	164	431
8	"8-out5068"	.39943	141	212	353
8	"8-out5069"	.29714	52	123	175
8	"8-out5070"	.57416	120	89	209
8	"8-out5071"	.45161	84	102	186
8	"8-out5072"	.30722	51	115	166
8	"8-out5073"	.97101	134	4	138
8	"8-out5074"	.32512	198	411	609
8	"8-out5075"	.37104	305	517	822
8	"8-out5076"	.10756	27	224	251
8	"8-out5077"	.24000	114	361	475
8	"8-out5078"	.36096	418	740	1158
8	"8-out5079"	.30344	220	505	725
8	"8-out5080"	.31808	146	313	459
8	"8-out5081"	.38461	95	152	247
8	"8-out5082"	.84325	425	79	504
8	"8-out5083"	.50970	105	101	206
8	"8-out5084"	.96060	317	13	330
8	"8-out5085"	.52109	420	386	806
8	"8-out5086"	.57328	309	230	539
8	"8-out5087"	.88765	1035	131	1166
8	"8-out5088"	.16247	71	366	437
8	"8-out5089"	.24152	278	873	1151
8	"8-out5090"	.25212	148	439	587
8	"8-out5091"	.55616	203	162	365
8	"8-out5092"	.32539	123	255	378
8	"8-out5093"	.25163	192	571	763
8	"8-out5094"	.93636	309	21	330
8	"8-out5095"	.19112	168	711	879
8	"8-out5096"	.22834	116	392	508
8	"8-out5097"	.28658	141	351	492
8	"8-out5098"	.21868	693	2476	3169
8	"8-out5099"	.49696	410	415	825
8	"8-out5100"	.34035	194	376	570
8	"8-out5101"	.26422	130	362	492
8	"8-out5102"	.07630	38	460	498
8	"8-out5103"	.28867	153	377	530
8	"8-out5104"	.90500	181	19	200
8	"8-out5105"	.27956	52	134	186
8	"8-out5106"	.25519	86	251	337
8	"8-out5107"	.14173	54	327	381
8	"8-out5108"	.99180	121	1	122
8	"8-out5109"	.25557	126	367	493
8	"8-out5110"	.39158	363	564	927
8	"8-out5111"	.59617	623	422	1045
8	"8-out5112"	.22929	144	484	628
8	"8-out5113"	.17158	122	589	711
8	"8-out5114"	.76595	144	44	188
8	"8-out5115"	.30978	114	254	368
8	"8-out5116"	.35000	161	299	460
8	"8-out5117"	.62903	273	161	434
8	"8-out5118"	.32333	97	203	300
8	"8-out5119"	.27878	92	238	330
8	"8-out5120"	.95086	329	17	346
8	"8-out5121"	.36604	138	239	377
8	"8-out5122"	.22749	187	635	822
8	"8-out5123"	.67525	131	63	194
8	"8-out5124"	.30878	436	976	1412
8	"8-out5125"	.57923	106	77	183
8	"8-out5126"	.95522	192	9	201
8	"8-out5127"	.63069	1508	883	2391
8	"8-out5128"	.25000	107	321	428
8	"8-out5129"	.17021	64	312	376
8	"8-out5130"	.21282	156	577	733
8	"8-out5131"	.29205	526	1275	1801
8	"8-out5132"	.43251	141	185	326
8	"8-out5133"	.26699	161	442	603
8	"8-out5134"	.40000	146	219	365
8	"8-out5135"	.97047	493	15	508
8	"8-out5136"	.12016	59	432	491
8	"8-out5137"	.36363	136	238	374
8	"8-out5138"	.22218	647	2265	2912
8	"8-out5139"	.78774	527	142	669
8	"8-out5140"	.27122	246	661	907
8	"8-out5141"	.98096	567	11	578
8	"8-out5142"	.87873	500	69	569
8	"8-out5143"	.69364	120	53	173
8	"8-out5144"	.24629	166	508	674
8	"8-out5145"	.69879	116	50	166
8	"8-out5146"	.59752	193	130	323
8	"8-out5147"	.18566	443	1943	2386
8	"8-out5148"	.37298	185	311	496
8	"8-out5149"	.36643	107	185	292
8	"8-out5150"	.30916	81	181	262
8	"8-out5151"	.55455	676	543	1219
8	"8-out5152"	.92280	526	44	570
8	"8-out5153"	.65625	147	77	224
8	"8-out5154"	.98876	88	1	89
8	"8-out5155"	.19961	105	421	526
8	"8-out5156"	.98230	222	4	226
8	"8-out5157"	.50196	128	127	255
8	"8-out5158"	.88888	216	27	243
8	"8-out5159"	.46678	253	289	542
8	"8-out5160"	.20588	70	270	340
8	"8-out5161"	.28521	1051	2634	3685
8	"8-out5162"	.19630	808	3308	4116
8	"8-out5163"	.23615	1092	3532	4624
8	"8-out5164"	.18984	882	3764	4646
8	"8-out5165"	.29888	188	441	629
8	"8-out5166"	.47590	1669	1838	3507
8	"8-out5167"	.16472	99	502	601
8	"8-out5168"	.28076	146	374	520
8	"8-out5169"	.14117	48	292	340
8	"8-out5170"	.52584	234	211	445
8	"8-out5171"	.24579	117	359	476
8	"8-out5172"	.64000	208	117	325
8	"8-out5173"	.96124	248	10	258
8	"8-out5174"	.27361	197	523	720
8	"8-out5175"	.22473	149	514	663
8	"8-out5176"	.80000	512	128	640
8	"8-out5177"	.35768	142	255	397
8	"8-out5178"	.39808	125	189	314
8	"8-out5179"	.23353	78	256	334
8	"8-out5180"	.22804	148	501	649
8	"8-out5181"	.39823	270	408	678
8	"8-out5182"	.20405	151	589	740
8	"8-out5183"	.99606	253	1	254
8	"8-out5184"	.51757	162	151	313
8	"8-out5185"	.33545	158	313	471
8	"8-out5186"	.32894	175	357	532
8	"8-out5187"	.28037	90	231	321
8	"8-out5188"	.17757	76	352	428
8	"8-out5189"	.80174	368	91	459
8	"8-out5190"	.37837	84	138	222
8	"8-out5191"	.31574	383	830	1213
8	"8-out5192"	.43902	756	966	1722
8	"8-out5193"	.21823	237	849	1086
8	"8-out5194"	.17073	91	442	533
8	"8-out5195"	.90045	398	44	442
8	"8-out5196"	.19196	43	181	224
8	"8-out5197"	.40707	414	603	1017
8	"8-out5198"	.73558	740	266	1006
8	"8-out5199"	.66060	327	168	495
8	"8-out5200"	.49565	171	174	345
8	"8-out5201"	.98327	1764	30	1794
8	"8-out5202"	.20223	416	1641	2057
8	"8-out5203"	.23263	432	1425	1857
8	"8-out5204"	.90243	333	36	369
8	"8-out5205"	.30821	90	202	292
8	"8-out5206"	.38117	247	401	648
8	"8-out5207"	.24177	125	392	517
8	"8-out5208"	.98662	295	4	299
8	"8-out5209"	.23600	312	1010	1322
8	"8-out5210"	.49418	170	174	344
8	"8-out5211"	.79341	265	69	334
8	"8-out5212"	.25558	103	300	403
8	"8-out5213"	.22540	110	378	488
8	"8-out5214"	.27370	127	337	464
8	"8-out5215"	.30747	218	491	709
8	"8-out5216"	.99303	285	2	287
8	"8-out5217"	.19107	137	580	717
8	"8-out5218"	.29974	116	271	387
8	"8-out5219"	.32561	225	466	691
8	"8-out5220"	.07165	23	298	321
8	"8-out5221"	.24330	200	622	822
8	"8-out5222"	.21800	46	165	211
8	"8-out5223"	.31788	336	721	1057
8	"8-out5224"	.22250	87	304	391
8	"8-out5225"	.11576	47	359	406
8	"8-out5226"	.37768	88	145	233
8	"8-out5227"	.25170	37	110	147
8	"8-out5228"	.43010	80	106	186
8	"8-out5229"	.14847	68	390	458
8	"8-out5230"	.97549	637	16	653
8	"8-out5231"	.37179	116	196	312
8	"8-out5232"	.58482	131	93	224
8	"8-out5233"	.17921	50	229	279
8	"8-out5234"	.25519	221	645	866
8	"8-out5235"	.22155	220	773	993
8	"8-out5236"	.63706	904	515	1419
8	"8-out5237"	.99449	361	2	363
8	"8-out5238"	.31803	201	431	632
8	"8-out5239"	.35330	171	313	484
8	"8-out5240"	.39903	83	125	208
8	"8-out5241"	.49291	174	179	353
8	"8-out5242"	.29242	224	542	766
8	"8-out5243"	.13669	57	360	417
8	"8-out5244"	.77294	160	47	207
8	"8-out5245"	.39748	95	144	239
8	"8-out5246"	.19014	54	230	284
8	"8-out5247"	.17788	37	171	208
8	"8-out5248"	.21802	179	642	821
8	"8-out5249"	.99696	329	1	330
8	"8-out5250"	.33945	388	755	1143
8	"8-out5251"	.28918	131	322	453
8	"8-out5252"	.52402	229	208	437
8	"8-out5253"	.28686	142	353	495
8	"8-out5254"	.17100	217	1052	1269
8	"8-out5255"	.19469	22	91	113
8	"8-out5256"	.16985	80	391	471
8	"8-out5257"	.15944	103	543	646
8	"8-out5258"	.90960	161	16	177
8	"8-out5259"	.98639	145	2	147
8	"8-out5260"	.50627	242	236	478
8	"8-out5261"	.16241	121	624	745
8	"8-out5262"	.30864	250	560	810
8	"8-out5263"	.92760	205	16	221
8	"8-out5264"	.87037	94	14	108
8	"8-out5265"	.59633	195	132	327
8	"8-out5266"	.27114	125	336	461
8	"8-out5267"	.23239	33	109	142
8	"8-out5268"	.24436	130	402	532
8	"8-out5269"	.98876	88	1	89
8	"8-out5270"	.25680	264	764	1028
8	"8-out5271"	.40129	124	185	309
8	"8-out5272"	.83366	421	84	505
8	"8-out5273"	.28000	98	252	350
8	"8-out5274"	.71244	166	67	233
8	"8-out5275"	.81428	171	39	210
8	"8-out5276"	.89260	374	45	419
8	"8-out5277"	.55918	274	216	490
8	"8-out5278"	.85263	324	56	380
8	"8-out5279"	.54705	93	77	170
8	"8-out5280"	.22222	54	189	243
8	"8-out5281"	.39261	574	888	1462
8	"8-out5282"	.50724	105	102	207
8	"8-out5283"	.29629	64	152	216
8	"8-out5284"	.22014	59	209	268
8	"8-out5285"	.24570	286	878	1164
8	"8-out5286"	.49032	76	79	155
8	"8-out5287"	.39336	83	128	211
8	"8-out5288"	.23783	44	141	185
8	"8-out5289"	.20446	119	463	582
8	"8-out5290"	.45370	49	59	108
8	"8-out5291"	.13180	46	303	349
8	"8-out5292"	.15044	68	384	452
8	"8-out5293"	.98876	88	1	89
8	"8-out5294"	.22222	32	112	144
8	"8-out5295"	.92246	464	39	503
8	"8-out5296"	.64064	599	336	935
8	"8-out5297"	.18577	47	206	253
8	"8-out5298"	.24081	59	186	245
8	"8-out5299"	.30303	260	598	858
8	"8-out5300"	.57750	190	139	329
8	"8-out5301"	.25899	72	206	278
8	"8-out5302"	.23875	69	220	289
8	"8-out5303"	.48241	96	103	199
8	"8-out5304"	.03550	6	163	169
8	"8-out5305"	.09340	17	165	182
8	"8-out5306"	.99193	123	1	124
8	"8-out5307"	.56551	82	63	145
8	"8-out5308"	.22580	35	120	155
8	"8-out5309"	.99659	1463	5	1468
8	"8-out5310"	.26102	71	201	272
8	"8-out5311"	.35355	169	309	478
8	"8-out5312"	.30049	61	142	203
8	"8-out5313"	.43096	1080	1426	2506
8	"8-out5314"	.26363	58	162	220
8	"8-out5315"	.29713	695	1644	2339
8	"8-out5316"	.10379	82	708	790
8	"8-out5317"	.38482	142	227	369
8	"8-out5318"	.24657	54	165	219
8	"8-out5319"	.18272	146	653	799
8	"8-out5320"	.35164	288	531	819
8	"8-out5321"	.27795	174	452	626
8	"8-out5322"	.37359	133	223	356
8	"8-out5323"	.18292	60	268	328
8	"8-out5324"	.26271	93	261	354
8	"8-out5325"	.40064	125	187	312
8	"8-out5326"	.18831	58	250	308
8	"8-out5327"	.27624	50	131	181
8	"8-out5328"	.90885	349	35	384
8	"8-out5329"	.24832	37	112	149
8	"8-out5330"	.83157	395	80	475
8	"8-out5331"	.36148	107	189	296
8	"8-out5332"	.25000	134	402	536
8	"8-out5333"	.24914	73	220	293
8	"8-out5334"	.23893	81	258	339
8	"8-out5335"	.96202	76	3	79
8	"8-out5336"	.31861	166	355	521
8	"8-out5337"	.33752	188	369	557
8	"8-out5338"	.28919	83	204	287
8	"8-out5339"	.61861	206	127	333
8	"8-out5340"	.26694	126	346	472
8	"8-out5341"	.32700	155	319	474
8	"8-out5342"	.21985	31	110	141
8	"8-out5343"	.16791	90	446	536
8	"8-out5344"	.42531	205	277	482
8	"8-out5345"	.18079	96	435	531
8	"8-out5346"	.32677	166	342	508
8	"8-out5347"	.42071	260	358	618
8	"8-out5348"	.96350	396	15	411
8	"8-out5349"	.31595	103	223	326
8	"8-out5350"	.22381	109	378	487
8	"8-out5351"	.15003	188	1065	1253
8	"8-out5352"	.31026	130	289	419
8	"8-out5353"	.39393	52	80	132
8	"8-out5354"	.59442	277	189	466
8	"8-out5355"	.60560	324	211	535
8	"8-out5356"	.30687	116	262	378
8	"8-out5357"	.25865	299	857	1156
8	"8-out5358"	.28496	271	680	951
8	"8-out5359"	.40756	97	141	238
8	"8-out5360"	.26533	173	479	652
8	"8-out5361"	.24390	60	186	246
8	"8-out5362"	.17857	45	207	252
8	"8-out5363"	.22587	110	377	487
8	"8-out5364"	.31666	513	1107	1620
8	"8-out5365"	.21150	239	891	1130
8	"8-out5366"	.16773	183	908	1091
8	"8-out5367"	.12871	13	88	101
8	"8-out5368"	.99487	194	1	195
8	"8-out5369"	.99526	210	1	211
8	"8-out5370"	.31887	272	581	853
8	"8-out5371"	.27167	47	126	173
8	"8-out5372"	.22902	202	680	882
8	"8-out5373"	.18217	611	2743	3354
8	"8-out5374"	.35426	158	288	446
8	"8-out5375"	.96061	561	23	584
8	"8-out5376"	.99367	157	1	158
8	"8-out5377"	.23809	30	96	126
8	"8-out5378"	.96825	305	10	315
8	"8-out5379"	.30334	290	666	956
8	"8-out5380"	.50447	282	277	559
8	"8-out5381"	.23477	185	603	788
8	"8-out5382"	.30744	95	214	309
8	"8-out5383"	.46666	147	168	315
8	"8-out5384"	.26717	70	192	262
8	"8-out5385"	.77641	632	182	814
8	"8-out5386"	.14739	51	295	346
8	"8-out5387"	.45119	208	253	461
8	"8-out5388"	.14171	71	430	501
8	"8-out5389"	.97197	1214	35	1249
8	"8-out5390"	.19123	48	203	251
8	"8-out5391"	.98888	89	1	90
8	"8-out5392"	.77136	334	99	433
8	"8-out5393"	.42158	336	461	797
8	"8-out5394"	.81818	198	44	242
8	"8-out5395"	.22596	94	322	416
8	"8-out5396"	.17415	31	147	178
8	"8-out5397"	.71914	507	198	705
8	"8-out5398"	.27407	111	294	405
8	"8-out5399"	.47126	123	138	261
8	"8-out5400"	.25629	112	325	437
8	"8-out5401"	.33333	42	84	126
8	"8-out5402"	.81818	198	44	242
8	"8-out5403"	.30973	280	624	904
8	"8-out5404"	.27600	207	543	750
8	"8-out5405"	.31606	775	1677	2452
8	"8-out5406"	.40143	112	167	279
8	"8-out5407"	.50321	235	232	467
8	"8-out5408"	.55989	444	349	793
8	"8-out5409"	.21344	127	468	595
8	"8-out5410"	.45400	306	368	674
8	"8-out5411"	.91803	168	15	183
8	"8-out5412"	.17369	136	647	783
8	"8-out5413"	.96116	198	8	206
8	"8-out5414"	.21839	38	136	174
8	"8-out5415"	.99317	291	2	293
8	"8-out5416"	.12280	35	250	285
8	"8-out5417"	.36348	217	380	597
8	"8-out5418"	.74763	791	267	1058
8	"8-out5419"	.42975	52	69	121
8	"8-out5420"	.98958	95	1	96
8	"8-out5421"	.99206	125	1	126
8	"8-out5422"	.20960	48	181	229
8	"8-out5423"	.33017	209	424	633
8	"8-out5424"	.22256	146	510	656
8	"8-out5425"	.29671	659	1562	2221
8	"8-out5426"	.25360	211	621	832
8	"8-out5427"	.23299	185	609	794
8	"8-out5428"	.27261	226	603	829
8	"8-out5429"	.25000	175	525	700
8	"8-out5430"	.28070	192	492	684
8	"8-out5431"	.26237	355	998	1353
8	"8-out5432"	.26429	305	849	1154
8	"8-out5433"	.97807	223	5	228
8	"8-out5434"	.76485	309	95	404
8	"8-out5435"	.17032	31	151	182
8	"8-out5436"	.17014	57	278	335
8	"8-out5437"	.32981	250	508	758
8	"8-out5438"	.27859	95	246	341
8	"8-out5439"	.40865	387	560	947
8	"8-out5440"	.88425	466	61	527
8	"8-out5441"	.44393	194	243	437
8	"8-out5442"	.99676	1233	4	1237
8	"8-out5443"	.78319	289	80	369
8	"8-out5444"	.76923	280	84	364
8	"8-out5445"	.23584	75	243	318
8	"8-out5446"	.23691	163	525	688
8	"8-out5447"	.64872	229	124	353
8	"8-out5448"	.15019	38	215	253
8	"8-out5449"	.67510	160	77	237
8	"8-out5450"	.34693	51	96	147
8	"8-out5451"	.39344	72	111	183
8	"8-out5452"	.27859	95	246	341
8	"8-out5453"	.32558	70	145	215
8	"8-out5454"	.24521	64	197	261
8	"8-out5455"	.20912	165	624	789
8	"8-out5456"	.26059	332	942	1274
8	"8-out5457"	.24371	97	301	398
8	"8-out5458"	.24700	103	314	417
8	"8-out5459"	.23386	192	629	821
8	"8-out5460"	.24663	165	504	669
8	"8-out5461"	.22608	293	1003	1296
8	"8-out5462"	.45517	457	547	1004
8	"8-out5463"	.10015	128	1150	1278
8	"8-out5464"	.30252	144	332	476
8	"8-out5465"	.19659	208	850	1058
8	"8-out5466"	.79691	620	158	778
8	"8-out5467"	.28357	511	1291	1802
8	"8-out5468"	.96812	243	8	251
8	"8-out5469"	.69690	338	147	485
8	"8-out5470"	.37452	197	329	526
8	"8-out5471"	.98661	516	7	523
8	"8-out5472"	.98293	576	10	586
8	"8-out5473"	.41836	41	57	98
8	"8-out5474"	.98816	167	2	169
8	"8-out5475"	.98979	97	1	98
8	"8-out5476"	.42748	112	150	262
8	"8-out5477"	.99697	1976	6	1982
8	"8-out5478"	.46177	151	176	327
8	"8-out5479"	.50969	184	177	361
8	"8-out5480"	.29896	58	136	194
8	"8-out5481"	.29850	40	94	134
8	"8-out5482"	.99462	185	1	186
8	"8-out5483"	.31043	357	793	1150
8	"8-out5484"	.33090	91	184	275
8	"8-out5485"	.37801	313	515	828
8	"8-out5486"	.16206	129	667	796
8	"8-out5487"	.98176	700	13	713
8	"8-out5488"	.34160	812	1565	2377
8	"8-out5489"	.44234	211	266	477
8	"8-out5490"	.29464	198	474	672
8	"8-out5491"	.24835	151	457	608
8	"8-out5492"	.20743	173	661	834
8	"8-out5493"	.23622	120	388	508
8	"8-out5494"	.13909	95	588	683
8	"8-out5495"	.83783	124	24	148
8	"8-out5496"	.19823	90	364	454
8	"8-out5497"	.23605	55	178	233
8	"8-out5498"	.28437	91	229	320
8	"8-out5499"	.24975	250	751	1001
8	"8-out5500"	.94620	299	17	316
8	"8-out5501"	.38461	100	160	260
8	"8-out5502"	.99719	1423	4	1427
8	"8-out5503"	.95427	480	23	503
8	"8-out5504"	.99290	140	1	141
8	"8-out5505"	.30695	446	1007	1453
8	"8-out5506"	.52613	151	136	287
8	"8-out5507"	.97457	115	3	118
8	"8-out5508"	.23076	48	160	208
8	"8-out5509"	.83636	92	18	110
8	"8-out5510"	.28551	207	518	725
8	"8-out5511"	.20134	60	238	298
8	"8-out5512"	.42452	90	122	212
8	"8-out5513"	.24302	122	380	502
8	"8-out5514"	.98837	85	1	86
8	"8-out5515"	.23434	131	428	559
8	"8-out5516"	.38483	137	219	356
8	"8-out5517"	.32008	145	308	453
8	"8-out5518"	.38107	149	242	391
8	"8-out5519"	.56804	288	219	507
8	"8-out5520"	.24812	99	300	399
8	"8-out5521"	.37665	513	849	1362
8	"8-out5522"	.28930	92	226	318
8	"8-out5523"	.30413	125	286	411
8	"8-out5524"	.23734	286	919	1205
8	"8-out5525"	.43650	110	142	252
8	"8-out5526"	.47084	533	599	1132
8	"8-out5527"	.77263	367	108	475
8	"8-out5528"	.91591	305	28	333
8	"8-out5529"	.28571	70	175	245
8	"8-out5530"	.30180	67	155	222
8	"8-out5531"	.33475	236	469	705
8	"8-out5532"	.26896	78	212	290
8	"8-out5533"	.17687	104	484	588
8	"8-out5534"	.30236	179	413	592
8	"8-out5535"	.36508	847	1473	2320
8	"8-out5536"	.30273	564	1299	1863
8	"8-out5537"	.19451	149	617	766
8	"8-out5538"	.65333	343	182	525
8	"8-out5539"	.99340	452	3	455
8	"8-out5540"	.99312	289	2	291
8	"8-out5541"	.19565	99	407	506
8	"8-out5542"	.16151	47	244	291
8	"8-out5543"	.17708	68	316	384
8	"8-out5544"	.28252	152	386	538
8	"8-out5545"	.92492	308	25	333
8	"8-out5546"	.41498	371	523	894
8	"8-out5547"	.55106	232	189	421
8	"8-out5548"	.32327	225	471	696
8	"8-out5549"	.38674	910	1443	2353
8	"8-out5550"	.32400	324	676	1000
8	"8-out5551"	.29116	122	297	419
8	"8-out5552"	.21142	74	276	350
8	"8-out5553"	.23834	271	866	1137
8	"8-out5554"	.23115	46	153	199
8	"8-out5555"	.56626	47	36	83
8	"8-out5556"	.26190	33	93	126
8	"8-out5557"	.57250	229	171	400
8	"8-out5558"	.38518	104	166	270
8	"8-out5559"	.97105	369	11	380
8	"8-out5560"	.26917	186	505	691
8	"8-out5561"	.28101	111	284	395
8	"8-out5562"	.28194	139	354	493
8	"8-out5563"	.22049	510	1803	2313
8	"8-out5564"	.28846	240	592	832
8	"8-out5565"	.21266	94	348	442
8	"8-out5566"	.22147	33	116	149
8	"8-out5567"	.24832	37	112	149
8	"8-out5568"	.27669	412	1077	1489
8	"8-out5569"	.43317	94	123	217
8	"8-out5570"	.31664	234	505	739
8	"8-out5571"	.31422	159	347	506
8	"8-out5572"	.39221	282	437	719
8	"8-out5573"	.29028	236	577	813
8	"8-out5574"	.36130	254	449	703
8	"8-out5575"	.24057	166	524	690
8	"8-out5576"	.32352	55	115	170
8	"8-out5577"	.29196	207	502	709
8	"8-out5578"	.26353	297	830	1127
8	"8-out5579"	.31407	87	190	277
8	"8-out5580"	.32751	338	694	1032
8	"8-out5581"	.25363	157	462	619
8	"8-out5582"	.76950	217	65	282
8	"8-out5583"	.23229	164	542	706
8	"8-out5584"	.44573	115	143	258
8	"8-out5585"	.29301	109	263	372
8	"8-out5586"	.35748	222	399	621
8	"8-out5587"	.29326	183	441	624
8	"8-out5588"	.10408	28	241	269
8	"8-out5589"	.15226	37	206	243
8	"8-out5590"	.58536	72	51	123
8	"8-out5591"	.49488	145	148	293
8	"8-out5592"	.27551	27	71	98
8	"8-out5593"	.98400	123	2	125
8	"8-out5594"	.50555	91	89	180
8	"8-out5595"	.43362	49	64	113
8	"8-out5596"	.22522	500	1720	2220
8	"8-out5597"	.33726	372	731	1103
8	"8-out5598"	.22314	108	376	484
8	"8-out5599"	.75454	83	27	110
8	"8-out5600"	.15480	124	677	801
8	"8-out5601"	.12993	102	683	785
8	"8-out5602"	.20638	446	1715	2161
8	"8-out5603"	.29878	98	230	328
8	"8-out5604"	.21511	74	270	344
8	"8-out5605"	.27070	85	229	314
8	"8-out5606"	.24615	64	196	260
8	"8-out5607"	.15078	125	704	829
8	"8-out5608"	.45425	144	173	317
8	"8-out5609"	.21045	165	619	784
8	"8-out5610"	.49645	70	71	141
8	"8-out5611"	.21249	398	1475	1873
8	"8-out5612"	.40221	109	162	271
8	"8-out5613"	.15719	94	504	598
8	"8-out5614"	.28571	56	140	196
8	"8-out5615"	.23287	34	112	146
8	"8-out5616"	.77952	99	28	127
8	"8-out5617"	.29133	148	360	508
8	"8-out5618"	.27508	340	896	1236
8	"8-out5619"	.94383	1025	61	1086
8	"8-out5620"	.27038	126	340	466
8	"8-out5621"	.95683	399	18	417
8	"8-out5622"	.38995	163	255	418
8	"8-out5623"	.22196	291	1020	1311
8	"8-out5624"	.99137	115	1	116
8	"8-out5625"	.99145	116	1	117
8	"8-out5626"	.99849	665	1	666
8	"8-out5627"	.31987	301	640	941
8	"8-out5628"	.99849	665	1	666
8	"8-out5629"	.35625	57	103	160
8	"8-out5630"	.17610	28	131	159
8	"8-out5631"	.25314	141	416	557
8	"8-out5632"	.99404	167	1	168
8	"8-out5633"	.22580	154	528	682
8	"8-out5634"	.35784	730	1310	2040
8	"8-out5635"	.23466	486	1585	2071
8	"8-out5636"	.41041	197	283	480
8	"8-out5637"	.25327	116	342	458
8	"8-out5638"	.47902	217	236	453
8	"8-out5639"	.36764	175	301	476
8	"8-out5640"	.31250	75	165	240
8	"8-out5641"	.97419	151	4	155
8	"8-out5642"	.47852	401	437	838
8	"8-out5643"	.65797	227	118	345
8	"8-out5644"	.13870	62	385	447
8	"8-out5645"	.24865	139	420	559
8	"8-out5646"	.39285	77	119	196
8	"8-out5647"	.20661	50	192	242
8	"8-out5648"	.35446	123	224	347
8	"8-out5649"	.88888	104	13	117
8	"8-out5650"	.97142	34	1	35
8	"8-out5651"	.32377	79	165	244
8	"8-out5652"	.13526	84	537	621
8	"8-out5653"	.20612	74	285	359
8	"8-out5654"	.23708	101	325	426
8	"8-out5655"	.40969	186	268	454
8	"8-out5656"	.18817	105	453	558
8	"8-out5657"	.21069	67	251	318
8	"8-out5658"	.19352	233	971	1204
8	"8-out5659"	.26557	503	1391	1894
8	"8-out5660"	.31196	73	161	234
8	"8-out5661"	.59905	127	85	212
8	"8-out5662"	.21913	71	253	324
8	"8-out5663"	.74141	410	143	553
8	"8-out5664"	.28421	108	272	380
8	"8-out5665"	.49624	198	201	399
8	"8-out5666"	.55319	208	168	376
8	"8-out5667"	.28970	197	483	680
8	"8-out5668"	.66666	186	93	279
8	"8-out5669"	.17408	180	854	1034
8	"8-out5670"	.96571	169	6	175
8	"8-out5671"	.47148	124	139	263
8	"8-out5672"	.84651	182	33	215
8	"8-out5673"	.36197	476	839	1315
8	"8-out5674"	.26740	96	263	359
8	"8-out5675"	.40989	116	167	283
8	"8-out5676"	.89032	276	34	310
8	"8-out5677"	.16835	200	988	1188
8	"8-out5678"	.99570	232	1	233
8	"8-out5679"	.26760	95	260	355
8	"8-out5680"	.29530	132	315	447
8	"8-out5681"	.32258	50	105	155
8	"8-out5682"	.17021	72	351	423
8	"8-out5683"	.26546	236	653	889
8	"8-out5684"	.41144	302	432	734
8	"8-out5685"	.89393	177	21	198
8	"8-out5686"	.35992	194	345	539
8	"8-out5687"	.39590	116	177	293
8	"8-out5688"	.28995	205	502	707
8	"8-out5689"	.28093	168	430	598
8	"8-out5690"	.25957	61	174	235
8	"8-out5691"	.99428	174	1	175
8	"8-out5692"	.15606	103	557	660
8	"8-out5693"	.13867	90	559	649
8	"8-out5694"	.35686	91	164	255
8	"8-out5695"	.12790	22	150	172
8	"8-out5696"	.29159	177	430	607
8	"8-out5697"	.88817	413	52	465
8	"8-out5698"	.95673	398	18	416
8	"8-out5699"	.40943	217	313	530
8	"8-out5700"	.42142	59	81	140
8	"8-out5701"	.40490	132	194	326
8	"8-out5702"	.99137	115	1	116
8	"8-out5703"	.99090	109	1	110
8	"8-out5704"	.22086	127	448	575
8	"8-out5705"	.28448	33	83	116
8	"8-out5706"	.99700	665	2	667
8	"8-out5707"	.34097	119	230	349
8	"8-out5708"	.50000	159	159	318
8	"8-out5709"	.98850	172	2	174
8	"8-out5710"	.29246	198	479	677
8	"8-out5711"	.40060	264	395	659
8	"8-out5712"	.35042	123	228	351
8	"8-out5713"	.20908	838	3170	4008
8	"8-out5714"	.94190	454	28	482
8	"8-out5715"	.36434	47	82	129
8	"8-out5716"	.19571	146	600	746
8	"8-out5717"	.44954	49	60	109
8	"8-out5718"	.99193	492	4	496
8	"8-out5719"	.17207	53	255	308
8	"8-out5720"	.98956	474	5	479
8	"8-out5721"	.13888	95	589	684
8	"8-out5722"	.29885	26	61	87
8	"8-out5723"	.99438	177	1	178
8	"8-out5724"	.62105	59	36	95
8	"8-out5725"	.22086	127	448	575
8	"8-out5726"	.34237	164	315	479
8	"8-out5727"	.23561	86	279	365
8	"8-out5728"	.99849	665	1	666
8	"8-out5729"	.95374	433	21	454
8	"8-out5730"	.24470	127	392	519
8	"8-out5731"	.36818	81	139	220
8	"8-out5732"	.36015	188	334	522
8	"8-out5733"	.18390	64	284	348
8	"8-out5734"	.52019	219	202	421
8	"8-out5735"	.94205	634	39	673
8	"8-out5736"	.64944	176	95	271
8	"8-out5737"	.48466	237	252	489
8	"8-out5738"	.96261	103	4	107
8	"8-out5739"	.40594	205	300	505
8	"8-out5740"	.98701	152	2	154
8	"8-out5741"	.78877	295	79	374
8	"8-out5742"	.98538	337	5	342
8	"8-out5743"	.22072	115	406	521
8	"8-out5744"	.27883	191	494	685
8	"8-out5745"	.26687	170	467	637
8	"8-out5746"	.29646	201	477	678
8	"8-out5747"	.19964	114	457	571
8	"8-out5748"	.23504	55	179	234
8	"8-out5749"	.33496	479	951	1430
8	"8-out5750"	.24665	1199	3662	4861
8	"8-out5751"	.63777	3083	1751	4834
8	"8-out5752"	.27443	146	386	532
8	"8-out5753"	.33636	370	730	1100
8	"8-out5754"	.32792	182	373	555
8	"8-out5755"	.25041	300	898	1198
8	"8-out5756"	.17341	107	510	617
8	"8-out5757"	.92857	390	30	420
8	"8-out5758"	.97038	426	13	439
8	"8-out5759"	.50229	329	326	655
8	"8-out5760"	.19230	110	462	572
8	"8-out5761"	.97883	185	4	189
8	"8-out5762"	.36263	264	464	728
8	"8-out5763"	.31336	136	298	434
8	"8-out5764"	.65363	468	248	716
8	"8-out5765"	.95673	398	18	416
8	"8-out5766"	.40798	286	415	701
8	"8-out5767"	.15730	14	75	89
8	"8-out5768"	.32195	349	735	1084
8	"8-out5769"	.30081	148	344	492
8	"8-out5770"	.17969	377	1721	2098
8	"8-out5771"	.33136	112	226	338
8	"8-out5772"	.57485	288	213	501
8	"8-out5773"	.89733	673	77	750
8	"8-out5774"	.49868	189	190	379
8	"8-out5775"	.59234	263	181	444
8	"8-out5776"	.26688	166	456	622
8	"8-out5777"	.68982	278	125	403
8	"8-out5778"	.36095	318	563	881
8	"8-out5779"	.20881	90	341	431
8	"8-out5780"	.99640	277	1	278
8	"8-out5781"	.99645	281	1	282
8	"8-out5782"	.99280	276	2	278
8	"8-out5783"	.87978	161	22	183
8	"8-out5784"	.23166	698	2315	3013
8	"8-out5785"	.25195	549	1630	2179
8	"8-out5786"	.63105	508	297	805
8	"8-out5787"	.27204	216	578	794
8	"8-out5788"	.57971	360	261	621
8	"8-out5789"	.21396	144	529	673
8	"8-out5790"	.37333	112	188	300
8	"8-out5791"	.95683	399	18	417
8	"8-out5792"	.76044	273	86	359
8	"8-out5793"	.99849	665	1	666
8	"8-out5794"	.17073	21	102	123
8	"8-out5795"	.12815	61	415	476
8	"8-out5796"	.24185	245	768	1013
8	"8-out5797"	.24357	360	1118	1478
8	"8-out5798"	.77138	496	147	643
8	"8-out5799"	.98761	319	4	323
8	"8-out5800"	.30797	166	373	539
8	"8-out5801"	.93155	980	72	1052
8	"8-out5802"	.30094	96	223	319
8	"8-out5803"	.13884	84	521	605
8	"8-out5804"	.29571	76	181	257
8	"8-out5805"	.36504	188	327	515
8	"8-out5806"	.25507	176	514	690
8	"8-out5807"	.16444	37	188	225
8	"8-out5808"	.39183	96	149	245
8	"8-out5809"	.64822	164	89	253
8	"8-out5810"	.68992	178	80	258
8	"8-out5811"	.10648	23	193	216
8	"8-out5812"	.29957	426	996	1422
8	"8-out5813"	.77037	208	62	270
8	"8-out5814"	.25032	190	569	759
8	"8-out5815"	.21071	59	221	280
8	"8-out5816"	.61952	368	226	594
8	"8-out5817"	.20394	31	121	152
8	"8-out5818"	.23383	47	154	201
8	"8-out5819"	.26540	56	155	211
8	"8-out5820"	.25601	117	340	457
8	"8-out5821"	.47979	190	206	396
8	"8-out5822"	.26770	155	424	579
8	"8-out5823"	.38983	184	288	472
8	"8-out5824"	.71206	183	74	257
8	"8-out5825"	.16724	96	478	574
8	"8-out5826"	.99375	318	2	320
8	"8-out5827"	.19961	315	1263	1578
8	"8-out5828"	.33053	236	478	714
8	"8-out5829"	.17425	88	417	505
8	"8-out5830"	.23966	203	644	847
8	"8-out5831"	.21220	73	271	344
8	"8-out5832"	.45157	3119	3788	6907
8	"8-out5833"	.34710	84	158	242
8	"8-out5834"	.24844	160	484	644
8	"8-out5835"	.36936	123	210	333
8	"8-out5836"	.99845	646	1	647
8	"8-out5837"	.20578	128	494	622
8	"8-out5838"	.14912	51	291	342
8	"8-out5839"	.46770	181	206	387
8	"8-out5840"	.20792	21	80	101
8	"8-out5841"	.30566	81	184	265
8	"8-out5842"	.43333	78	102	180
8	"8-out5843"	.61142	107	68	175
8	"8-out5844"	.19979	197	789	986
8	"8-out5845"	.23003	121	405	526
8	"8-out5846"	.25252	300	888	1188
8	"8-out5847"	.23287	187	616	803
8	"8-out5848"	.38121	69	112	181
8	"8-out5849"	.32608	60	124	184
8	"8-out5850"	.37905	304	498	802
8	"8-out5851"	.57344	203	151	354
8	"8-out5852"	.86294	170	27	197
8	"8-out5853"	.94350	167	10	177
8	"8-out5854"	.92156	517	44	561
8	"8-out5855"	.40572	510	747	1257
8	"8-out5856"	.26824	125	341	466
8	"8-out5857"	.27521	131	345	476
8	"8-out5858"	.59484	323	220	543
8	"8-out5859"	.37218	182	307	489
8	"8-out5860"	.38116	348	565	913
8	"8-out5861"	.26593	242	668	910
8	"8-out5862"	.16226	123	635	758
8	"8-out5863"	.35028	186	345	531
8	"8-out5864"	.27001	226	611	837
8	"8-out5865"	.15673	50	269	319
8	"8-out5866"	.38921	729	1144	1873
8	"8-out5867"	.31541	88	191	279
8	"8-out5868"	.99485	1934	10	1944
8	"8-out5869"	.29446	101	242	343
8	"8-out5870"	.22043	82	290	372
8	"8-out5871"	.38390	124	199	323
8	"8-out5872"	.92215	154	13	167
8	"8-out5873"	.20441	37	144	181
8	"8-out5874"	.42174	574	787	1361
8	"8-out5875"	.32315	180	377	557
8	"8-out5876"	.28491	51	128	179
8	"8-out5877"	.46236	86	100	186
8	"8-out5878"	.43844	260	333	593
8	"8-out5879"	.49029	202	210	412
8	"8-out5880"	.38948	511	801	1312
8	"8-out5881"	.16847	31	153	184
8	"8-out5882"	.48031	366	396	762
8	"8-out5883"	.39608	324	494	818
8	"8-out5884"	.64184	181	101	282
8	"8-out5885"	.30914	213	476	689
8	"8-out5886"	.34174	298	574	872
8	"8-out5887"	.94039	142	9	151
8	"8-out5888"	.12727	14	96	110
8	"8-out5889"	.25700	514	1486	2000
8	"8-out5890"	.25179	492	1462	1954
8	"8-out5891"	.22357	607	2108	2715
8	"8-out5892"	.28408	823	2074	2897
8	"8-out5893"	.24747	147	447	594
8	"8-out5894"	.38117	417	677	1094
8	"8-out5895"	.23108	168	559	727
8	"8-out5896"	.45283	168	203	371
8	"8-out5897"	.34554	66	125	191
8	"8-out5898"	.18761	197	853	1050
8	"8-out5899"	.22057	178	629	807
8	"8-out5900"	.28571	24	60	84
8	"8-out5901"	.23219	75	248	323
8	"8-out5902"	.08735	38	397	435
8	"8-out5903"	.21869	131	468	599
8	"8-out5904"	.30077	117	272	389
8	"8-out5905"	.22960	228	765	993
8	"8-out5906"	.18677	96	418	514
8	"8-out5907"	.86192	206	33	239
8	"8-out5908"	.82162	304	66	370
8	"8-out5909"	.22005	79	280	359
8	"8-out5910"	.41009	333	479	812
8	"8-out5911"	.86588	297	46	343
8	"8-out5912"	.18823	64	276	340
8	"8-out5913"	.34602	300	567	867
8	"8-out5914"	.35304	197	361	558
8	"8-out5915"	.52336	56	51	107
8	"8-out5916"	.38095	168	273	441
8	"8-out5917"	.49152	58	60	118
8	"8-out5918"	.33859	579	1131	1710
8	"8-out5919"	.20920	627	2370	2997
8	"8-out5920"	.28079	212	543	755
8	"8-out5921"	.28095	1282	3281	4563
8	"8-out5922"	.24060	64	202	266
8	"8-out5923"	.95950	308	13	321
8	"8-out5924"	.15738	82	439	521
8	"8-out5925"	.24861	45	136	181
8	"8-out5926"	.29943	106	248	354
8	"8-out5927"	.51948	160	148	308
8	"8-out5928"	.33037	223	452	675
8	"8-out5929"	.32432	252	525	777
8	"8-out5930"	.25872	393	1126	1519
8	"8-out5931"	.30201	180	416	596
8	"8-out5932"	.21540	316	1151	1467
8	"8-out5933"	.34769	476	893	1369
8	"8-out5934"	.31318	57	125	182
8	"8-out5935"	.32289	722	1514	2236
8	"8-out5936"	.87500	175	25	200
8	"8-out5937"	.96256	180	7	187
8	"8-out5938"	.27669	241	630	871
8	"8-out5939"	.27586	112	294	406
8	"8-out5940"	.24237	310	969	1279
8	"8-out5941"	.74347	513	177	690
8	"8-out5942"	.93863	1499	98	1597
8	"8-out5943"	.58442	533	379	912
8	"8-out5944"	.21243	328	1216	1544
8	"8-out5945"	.22235	187	654	841
8	"8-out5946"	.84401	303	56	359
8	"8-out5947"	.94864	314	17	331
8	"8-out5948"	.19897	39	157	196
8	"8-out5949"	.38235	78	126	204
8	"8-out5950"	.39106	70	109	179
8	"8-out5951"	.63691	314	179	493
8	"8-out5952"	.29629	176	418	594
8	"8-out5953"	.19819	44	178	222
8	"8-out5954"	.93984	250	16	266
8	"8-out5955"	.98066	355	7	362
8	"8-out5956"	.98066	355	7	362
8	"8-out5957"	.28244	111	282	393
8	"8-out5958"	.93972	343	22	365
8	"8-out5959"	.28000	84	216	300
8	"8-out5960"	.27314	236	628	864
8	"8-out5961"	.25311	142	419	561
8	"8-out5962"	.98663	812	11	823
8	"8-out5963"	.26345	93	260	353
8	"8-out5964"	.76211	346	108	454
8	"8-out5965"	.15555	42	228	270
8	"8-out5966"	.13496	44	282	326
8	"8-out5967"	.23779	112	359	471
8	"8-out5968"	.23070	290	967	1257
8	"8-out5969"	.37982	128	209	337
8	"8-out5970"	.37550	187	311	498
8	"8-out5971"	.24752	125	380	505
8	"8-out5972"	.98615	997	14	1011
8	"8-out5973"	.88755	221	28	249
8	"8-out5974"	.43617	205	265	470
8	"8-out5975"	.64170	317	177	494
8	"8-out5976"	.97348	257	7	264
8	"8-out5977"	.10659	42	352	394
8	"8-out5978"	.16077	150	783	933
8	"8-out5979"	.89438	542	64	606
8	"8-out5980"	.82822	135	28	163
8	"8-out5981"	.27329	88	234	322
8	"8-out5982"	.35876	174	311	485
8	"8-out5983"	.97391	336	9	345
8	"8-out5984"	.28213	90	229	319
8	"8-out5985"	.54095	284	241	525
8	"8-out5986"	.21501	106	387	493
8	"8-out5987"	.30792	202	454	656
8	"8-out5988"	.91637	1567	143	1710
8	"8-out5989"	.18246	179	802	981
8	"8-out5990"	.35491	148	269	417
8	"8-out5991"	.29947	286	669	955
8	"8-out5992"	.19138	80	338	418
8	"8-out5993"	.25769	134	386	520
8	"8-out5994"	.13861	14	87	101
8	"8-out5995"	.33644	144	284	428
8	"8-out5996"	.19655	285	1165	1450
8	"8-out5997"	.99586	482	2	484
8	"8-out5998"	.35959	356	634	990
8	"8-out5999"	.93267	471	34	505
8	"8-out6000"	.25358	106	312	418
8	"8-out6001"	.24444	88	272	360
8	"8-out6002"	.29487	368	880	1248
8	"8-out6003"	.30708	78	176	254
8	"8-out6004"	.13184	130	856	986
8	"8-out6005"	.17869	151	694	845
8	"8-out6006"	.21985	93	330	423
8	"8-out6007"	.25240	105	311	416
8	"8-out6008"	.68911	133	60	193
8	"8-out6009"	.95229	499	25	524
8	"8-out6010"	.96202	152	6	158
8	"8-out6011"	.67469	56	27	83
8	"8-out6012"	.23722	181	582	763
8	"8-out6013"	.60739	263	170	433
8	"8-out6014"	.24489	84	259	343
8	"8-out6015"	.29263	151	365	516
8	"8-out6016"	.99027	815	8	823
8	"8-out6017"	.26749	172	471	643
8	"8-out6018"	.47761	128	140	268
8	"8-out6019"	.34920	154	287	441
8	"8-out6020"	.23195	180	596	776
8	"8-out6021"	.24766	186	565	751
8	"8-out6022"	.26878	93	253	346
8	"8-out6023"	.95404	602	29	631
8	"8-out6024"	.45248	200	242	442
8	"8-out6025"	.23943	34	108	142
8	"8-out6026"	.37078	99	168	267
8	"8-out6027"	.99661	294	1	295
8	"8-out6028"	.72815	150	56	206
8	"8-out6029"	.22699	74	252	326
8	"8-out6030"	.86382	425	67	492
8	"8-out6031"	.24863	228	689	917
8	"8-out6032"	.47222	204	228	432
8	"8-out6033"	.32878	241	492	733
8	"8-out6034"	.35472	210	382	592
8	"8-out6035"	.28961	159	390	549
8	"8-out6036"	.33165	198	399	597
8	"8-out6037"	.27482	191	504	695
8	"8-out6038"	.30841	231	518	749
8	"8-out6039"	.31608	171	370	541
8	"8-out6040"	.19230	70	294	364
8	"8-out6041"	.99145	116	1	117
8	"8-out6042"	.99145	116	1	117
8	"8-out6043"	.07142	11	143	154
8	"8-out6044"	.21775	130	467	597
8	"8-out6045"	.21232	186	690	876
8	"8-out6046"	.21115	193	721	914
8	"8-out6047"	.16233	75	387	462
8	"8-out6048"	.37372	219	367	586
8	"8-out6049"	.27777	20	52	72
8	"8-out6050"	.97101	67	2	69
8	"8-out6051"	.38670	128	203	331
8	"8-out6052"	.23563	361	1171	1532
8	"8-out6053"	.32426	155	323	478
8	"8-out6054"	.21621	88	319	407
8	"8-out6055"	.32792	101	207	308
8	"8-out6056"	.81720	304	68	372
8	"8-out6057"	.34032	146	283	429
8	"8-out6058"	.15659	57	307	364
8	"8-out6059"	.23600	59	191	250
8	"8-out6060"	.22355	112	389	501
8	"8-out6061"	.41758	190	265	455
8	"8-out6062"	.57555	259	191	450
8	"8-out6063"	.19565	144	592	736
8	"8-out6064"	.24516	114	351	465
8	"8-out6065"	.98767	561	7	568
8	"8-out6066"	.99310	144	1	145
8	"8-out6067"	.99310	144	1	145
8	"8-out6068"	.94676	249	14	263
8	"8-out6069"	.98859	260	3	263
8	"8-out6070"	.97718	257	6	263
8	"8-out6071"	.98113	104	2	106
8	"8-out6072"	.98113	104	2	106
8	"8-out6073"	.93627	191	13	204
8	"8-out6074"	.21959	186	661	847
8	"8-out6075"	.92920	105	8	113
8	"8-out6076"	.95238	100	5	105
8	"8-out6077"	.33333	264	528	792
8	"8-out6078"	.36170	136	240	376
8	"8-out6079"	.39010	355	555	910
8	"8-out6080"	.93478	86	6	92
8	"8-out6081"	.19000	38	162	200
8	"8-out6082"	.70135	155	66	221
8	"8-out6083"	.76847	156	47	203
8	"8-out6084"	.37219	83	140	223
8	"8-out6085"	.14418	31	184	215
8	"8-out6086"	.23319	111	365	476
8	"8-out6087"	.29951	62	145	207
8	"8-out6088"	.57475	419	310	729
8	"8-out6089"	.94117	48	3	51
8	"8-out6090"	.94847	405	22	427
8	"8-out6091"	.32470	276	574	850
8	"8-out6092"	.88009	734	100	834
8	"8-out6093"	.55793	130	103	233
8	"8-out6094"	.30026	112	261	373
8	"8-out6095"	.15463	30	164	194
8	"8-out6096"	.55182	394	320	714
8	"8-out6097"	.33031	73	148	221
8	"8-out6098"	.18565	44	193	237
8	"8-out6099"	.36866	80	137	217
8	"8-out6100"	.81690	174	39	213
8	"8-out6101"	.86956	220	33	253
8	"8-out6102"	.21717	177	638	815
8	"8-out6103"	.64705	231	126	357
8	"8-out6104"	.37184	177	299	476
8	"8-out6105"	.14578	64	375	439
8	"8-out6106"	.86412	566	89	655
8	"8-out6107"	.94193	876	54	930
8	"8-out6108"	.38497	82	131	213
8	"8-out6109"	.29773	92	217	309
8	"8-out6110"	.35775	332	596	928
8	"8-out6111"	.10344	21	182	203
8	"8-out6112"	.33203	85	171	256
8	"8-out6113"	.96774	90	3	93
8	"8-out6114"	.29129	97	236	333
8	"8-out6115"	.09259	20	196	216
8	"8-out6116"	.14691	31	180	211
8	"8-out6117"	.26288	51	143	194
8	"8-out6118"	.27853	61	158	219
8	"8-out6119"	.47087	97	109	206
8	"8-out6120"	.16826	35	173	208
8	"8-out6121"	.79527	202	52	254
8	"8-out6122"	.82283	209	45	254
8	"8-out6123"	.73631	148	53	201
8	"8-out6124"	.98994	197	2	199
8	"8-out6125"	.37434	213	356	569
8	"8-out6126"	.31250	60	132	192
8	"8-out6127"	.73217	462	169	631
8	"8-out6128"	.32121	159	336	495
8	"8-out6129"	.34756	456	856	1312
8	"8-out6130"	.20348	152	595	747
8	"8-out6131"	.38732	165	261	426
8	"8-out6132"	.89826	362	41	403
8	"8-out6133"	.21241	65	241	306
8	"8-out6134"	.25550	487	1419	1906
8	"8-out6135"	.28571	162	405	567
8	"8-out6136"	.50485	104	102	206
8	"8-out6137"	.65217	120	64	184
8	"8-out6138"	.19572	55	226	281
8	"8-out6139"	.97011	779	24	803
8	"8-out6140"	.45994	465	546	1011
8	"8-out6141"	.34615	72	136	208
8	"8-out6142"	.29754	97	229	326
8	"8-out6143"	.23052	74	247	321
8	"8-out6144"	.24821	104	315	419
8	"8-out6145"	.26591	284	784	1068
8	"8-out6146"	.24844	279	844	1123
8	"8-out6147"	.31666	152	328	480
8	"8-out6148"	.07232	23	295	318
8	"8-out6149"	.45875	228	269	497
8	"8-out6150"	.99479	191	1	192
8	"8-out6151"	.26706	399	1095	1494
8	"8-out6152"	.31202	288	635	923
8	"8-out6153"	.24476	421	1299	1720
8	"8-out6154"	.29110	193	470	663
8	"8-out6155"	.13636	9	57	66
8	"8-out6156"	.98833	593	7	600
8	"8-out6157"	.32131	98	207	305
8	"8-out6158"	.33928	114	222	336
8	"8-out6159"	.27027	90	243	333
8	"8-out6160"	.27247	97	259	356
8	"8-out6161"	.16800	63	312	375
8	"8-out6162"	.33684	128	252	380
8	"8-out6163"	.61281	220	139	359
8	"8-out6164"	.38442	153	245	398
8	"8-out6165"	.17973	94	429	523
8	"8-out6166"	.21276	60	222	282
8	"8-out6167"	.34876	113	211	324
8	"8-out6168"	.23048	62	207	269
8	"8-out6169"	.30283	96	221	317
8	"8-out6170"	.18941	68	291	359
8	"8-out6171"	.30788	125	281	406
8	"8-out6172"	.42533	225	304	529
8	"8-out6173"	.32800	123	252	375
8	"8-out6174"	.23923	100	318	418
8	"8-out6175"	.14663	122	710	832
8	"8-out6176"	.78939	551	147	698
8	"8-out6177"	.85042	506	89	595
8	"8-out6178"	.98989	392	4	396
8	"8-out6179"	.97804	401	9	410
8	"8-out6180"	.18781	37	160	197
8	"8-out6181"	.97096	535	16	551
8	"8-out6182"	.73875	345	122	467
8	"8-out6183"	.35121	275	508	783
8	"8-out6184"	.84435	217	40	257
8	"8-out6185"	.22082	70	247	317
8	"8-out6186"	.95614	109	5	114
8	"8-out6187"	.25839	177	508	685
8	"8-out6188"	.25901	79	226	305
8	"8-out6189"	.72916	140	52	192
8	"8-out6190"	.19689	165	673	838
8	"8-out6191"	.40163	294	438	732
8	"8-out6192"	.14965	22	125	147
8	"8-out6193"	.30303	90	207	297
8	"8-out6194"	.27150	101	271	372
8	"8-out6195"	.14189	21	127	148
8	"8-out6196"	.97552	279	7	286
8	"8-out6197"	.29739	160	378	538
8	"8-out6198"	.31288	51	112	163
8	"8-out6199"	.21890	257	917	1174
8	"8-out6200"	.98260	113	2	115
8	"8-out6201"	.36220	46	81	127
8	"8-out6202"	.33208	177	356	533
8	"8-out6203"	.33764	235	461	696
8	"8-out6204"	.43073	171	226	397
8	"8-out6205"	.21810	159	570	729
8	"8-out6206"	.88829	167	21	188
8	"8-out6207"	.41780	122	170	292
8	"8-out6208"	.42696	76	102	178
8	"8-out6209"	.21875	28	100	128
8	"8-out6210"	.18320	72	321	393
8	"8-out6211"	.17631	67	313	380
8	"8-out6212"	.43918	130	166	296
8	"8-out6213"	.62926	258	152	410
8	"8-out6214"	.23859	136	434	570
8	"8-out6215"	.26807	178	486	664
8	"8-out6216"	.29428	103	247	350
8	"8-out6217"	.50000	78	78	156
8	"8-out6218"	.38064	177	288	465
8	"8-out6219"	.17829	46	212	258
8	"8-out6220"	.98571	414	6	420
8	"8-out6221"	.77173	142	42	184
8	"8-out6222"	.23809	30	96	126
8	"8-out6223"	.28366	99	250	349
8	"8-out6224"	.30379	96	220	316
8	"8-out6225"	.98989	196	2	198
8	"8-out6226"	.25448	71	208	279
8	"8-out6227"	.27109	106	285	391
8	"8-out6228"	.46173	181	211	392
8	"8-out6229"	.26740	96	263	359
8	"8-out6230"	.35135	208	384	592
8	"8-out6231"	.21862	54	193	247
8	"8-out6232"	.99346	152	1	153
8	"8-out6233"	.38020	73	119	192
8	"8-out6234"	.99683	629	2	631
8	"8-out6235"	.98775	242	3	245
8	"8-out6236"	.71489	168	67	235
8	"8-out6237"	.54187	110	93	203
8	"8-out6238"	.46521	107	123	230
8	"8-out6239"	.28424	193	486	679
8	"8-out6240"	.35021	83	154	237
8	"8-out6241"	.56363	124	96	220
8	"8-out6242"	.37653	215	356	571
8	"8-out6243"	.99342	151	1	152
8	"8-out6244"	.99705	339	1	340
8	"8-out6245"	.32575	86	178	264
8	"8-out6246"	.87401	333	48	381
8	"8-out6247"	.12709	38	261	299
8	"8-out6248"	.79080	344	91	435
8	"8-out6249"	.25462	55	161	216
8	"8-out6250"	.69921	179	77	256
8	"8-out6251"	.25093	134	400	534
8	"8-out6252"	.16906	235	1155	1390
8	"8-out6253"	.25283	379	1120	1499
8	"8-out6254"	.16541	22	111	133
8	"8-out6255"	.30868	430	963	1393
8	"8-out6256"	.27397	200	530	730
8	"8-out6257"	.84803	865	155	1020
8	"8-out6258"	.82471	287	61	348
8	"8-out6259"	.21138	26	97	123
8	"8-out6260"	.80392	246	60	306
8	"8-out6261"	.91262	94	9	103
8	"8-out6262"	.42968	55	73	128
8	"8-out6263"	.19877	65	262	327
8	"8-out6264"	.44174	91	115	206
8	"8-out6265"	.43414	89	116	205
8	"8-out6266"	.41747	86	120	206
8	"8-out6267"	.28191	106	270	376
8	"8-out6268"	.21621	152	551	703
8	"8-out6269"	.34887	247	461	708
8	"8-out6270"	.88852	271	34	305
8	"8-out6271"	.38947	185	290	475
8	"8-out6272"	.31777	320	687	1007
8	"8-out6273"	.30028	106	247	353
8	"8-out6274"	.94170	210	13	223
8	"8-out6275"	.66891	99	49	148
8	"8-out6276"	.30835	214	480	694
8	"8-out6277"	.40727	112	163	275
8	"8-out6278"	.22482	96	331	427
8	"8-out6279"	.88957	145	18	163
8	"8-out6280"	.36238	158	278	436
8	"8-out6281"	.21996	130	461	591
8	"8-out6282"	.36601	489	847	1336
8	"8-out6283"	.79716	169	43	212
8	"8-out6284"	.32460	186	387	573
8	"8-out6285"	.21867	171	611	782
8	"8-out6286"	.31680	230	496	726
8	"8-out6287"	.16666	25	125	150
8	"8-out6288"	.98421	187	3	190
8	"8-out6289"	.27317	56	149	205
8	"8-out6290"	.29501	77	184	261
8	"8-out6291"	.78260	90	25	115
8	"8-out6292"	.30612	45	102	147
8	"8-out6293"	.51724	375	350	725
8	"8-out6294"	.86290	321	51	372
8	"8-out6295"	.88679	188	24	212
8	"8-out6296"	.70689	41	17	58
8	"8-out6297"	.98260	113	2	115
8	"8-out6298"	.56030	223	175	398
8	"8-out6299"	.96721	118	4	122
8	"8-out6300"	.99523	209	1	210
8	"8-out6301"	.34146	70	135	205
8	"8-out6302"	.49508	302	308	610
8	"8-out6303"	.29807	93	219	312
8	"8-out6304"	.31050	68	151	219
8	"8-out6305"	.29493	64	153	217
8	"8-out6306"	.99539	216	1	217
8	"8-out6307"	.99310	144	1	145
8	"8-out6308"	.87591	120	17	137
8	"8-out6309"	.96610	57	2	59
8	"8-out6310"	.99621	263	1	264
8	"8-out6311"	.99176	241	2	243
8	"8-out6312"	.99489	195	1	196
8	"8-out6313"	.30597	41	93	134
8	"8-out6314"	.24508	212	653	865
8	"8-out6315"	.26226	123	346	469
8	"8-out6316"	.97833	587	13	600
8	"8-out6317"	.73792	504	179	683
8	"8-out6318"	.13365	164	1063	1227
8	"8-out6319"	.85542	142	24	166
8	"8-out6320"	.35720	434	781	1215
8	"8-out6321"	.31235	139	306	445
8	"8-out6322"	.76425	201	62	263
8	"8-out6323"	.86829	178	27	205
8	"8-out6324"	.40869	47	68	115
8	"8-out6325"	.24137	91	286	377
8	"8-out6326"	.21922	130	463	593
8	"8-out6327"	.21229	38	141	179
8	"8-out6328"	.18930	223	955	1178
8	"8-out6329"	.60824	59	38	97
8	"8-out6330"	.99395	493	3	496
8	"8-out6331"	.31097	102	226	328
8	"8-out6332"	.29743	58	137	195
8	"8-out6333"	.23492	187	609	796
8	"8-out6334"	.12260	32	229	261
8	"8-out6335"	.38235	104	168	272
8	"8-out6336"	.21453	363	1329	1692
8	"8-out6337"	.26847	109	297	406
8	"8-out6338"	.69151	269	120	389
8	"8-out6339"	.94418	203	12	215
8	"8-out6340"	.89361	168	20	188
8	"8-out6341"	.97058	132	4	136
8	"8-out6342"	.20817	56	213	269
8	"8-out6343"	.79906	171	43	214
8	"8-out6344"	.96059	195	8	203
8	"8-out6345"	.98461	128	2	130
8	"8-out6346"	.98945	469	5	474
8	"8-out6347"	.98945	469	5	474
8	"8-out6348"	.98529	469	7	476
8	"8-out6349"	.99367	471	3	474
8	"8-out6350"	.43134	289	381	670
8	"8-out6351"	.65361	985	522	1507
8	"8-out6352"	.99547	220	1	221
8	"8-out6353"	.99547	220	1	221
8	"8-out6354"	.87980	366	50	416
8	"8-out6355"	.95145	294	15	309
8	"8-out6356"	.51994	730	674	1404
8	"8-out6357"	.18476	148	653	801
8	"8-out6358"	.74107	166	58	224
8	"8-out6359"	.99450	181	1	182
8	"8-out6360"	.15834	149	792	941
8	"8-out6361"	.94202	130	8	138
8	"8-out6362"	.36771	246	423	669
8	"8-out6363"	.96652	462	16	478
8	"8-out6364"	.15876	67	355	422
8	"8-out6365"	.27003	283	765	1048
8	"8-out6366"	.33870	105	205	310
8	"8-out6367"	.98863	174	2	176
8	"8-out6368"	.84776	284	51	335
8	"8-out6369"	.89906	383	43	426
8	"8-out6370"	.30982	571	1272	1843
8	"8-out6371"	.60857	213	137	350
8	"8-out6372"	.46212	122	142	264
8	"8-out6373"	.18699	23	100	123
8	"8-out6374"	.44719	343	424	767
8	"8-out6375"	.39601	139	212	351
8	"8-out6376"	.23700	114	367	481
8	"8-out6377"	.24040	119	376	495
8	"8-out6378"	.29453	124	297	421
8	"8-out6379"	.21182	240	893	1133
8	"8-out6380"	.23584	75	243	318
8	"8-out6381"	.99038	103	1	104
8	"8-out6382"	.30712	168	379	547
8	"8-out6383"	.99047	104	1	105
8	"8-out6384"	.29545	195	465	660
8	"8-out6385"	.39153	222	345	567
8	"8-out6386"	.99210	377	3	380
8	"8-out6387"	.30912	349	780	1129
8	"8-out6388"	.21573	96	349	445
8	"8-out6389"	.26199	71	200	271
8	"8-out6390"	.24892	116	350	466
8	"8-out6391"	.27864	214	554	768
8	"8-out6392"	.07435	29	361	390
8	"8-out6393"	.31531	245	532	777
8	"8-out6394"	.34928	73	136	209
8	"8-out6395"	.31007	240	534	774
8	"8-out6396"	.86507	327	51	378
8	"8-out6397"	.52448	257	233	490
8	"8-out6398"	.98299	636	11	647
8	"8-out6399"	.15873	140	742	882
8	"8-out6400"	.18702	49	213	262
8	"8-out6401"	.98919	1739	19	1758
8	"8-out6402"	.25385	148	435	583
8	"8-out6403"	.39622	63	96	159
8	"8-out6404"	.31051	127	282	409
8	"8-out6405"	.42192	127	174	301
8	"8-out6406"	.75198	567	187	754
8	"8-out6407"	.29813	48	113	161
8	"8-out6408"	.15384	8	44	52
8	"8-out6409"	.32150	154	325	479
8	"8-out6410"	.21322	129	476	605
8	"8-out6411"	.28344	214	541	755
8	"8-out6412"	.33480	152	302	454
8	"8-out6413"	.46511	200	230	430
8	"8-out6414"	.30107	112	260	372
8	"8-out6415"	.48911	337	352	689
8	"8-out6416"	.73042	653	241	894
8	"8-out6417"	.99582	477	2	479
8	"8-out6418"	.32248	228	479	707
8	"8-out6419"	.99410	506	3	509
8	"8-out6420"	.28736	298	739	1037
8	"8-out6421"	.98744	472	6	478
8	"8-out6422"	.63131	125	73	198
8	"8-out6423"	.28518	458	1148	1606
8	"8-out6424"	.42857	81	108	189
8	"8-out6425"	.99612	4112	16	4128
8	"8-out6426"	.54471	335	280	615
8	"8-out6427"	.14977	34	193	227
8	"8-out6428"	.57446	54	40	94
8	"8-out6429"	.23248	156	515	671
8	"8-out6430"	.25370	137	403	540
8	"8-out6431"	.19379	25	104	129
8	"8-out6432"	.34490	159	302	461
8	"8-out6433"	.42031	240	331	571
8	"8-out6434"	.27222	98	262	360
8	"8-out6435"	.34470	101	192	293
8	"8-out6436"	.92193	248	21	269
8	"8-out6437"	.92732	319	25	344
8	"8-out6438"	.98314	350	6	356
8	"8-out6439"	.93863	413	27	440
8	"8-out6440"	.22147	66	232	298
8	"8-out6441"	.28209	156	397	553
8	"8-out6442"	.18734	74	321	395
8	"8-out6443"	.95522	576	27	603
8	"8-out6444"	.25311	61	180	241
8	"8-out6445"	.22978	54	181	235
8	"8-out6446"	.21478	247	903	1150
8	"8-out6447"	.30932	292	652	944
8	"8-out6448"	.29171	229	556	785
8	"8-out6449"	.61971	176	108	284
8	"8-out6450"	.44067	286	363	649
8	"8-out6451"	.81451	202	46	248
8	"8-out6452"	.28953	368	903	1271
8	"8-out6453"	.21897	30	107	137
8	"8-out6454"	.18265	139	622	761
8	"8-out6455"	.38862	82	129	211
8	"8-out6456"	.29317	73	176	249
8	"8-out6457"	.27515	268	706	974
8	"8-out6458"	.32616	349	721	1070
8	"8-out6459"	.41954	219	303	522
8	"8-out6460"	.17470	163	770	933
8	"8-out6461"	.45348	78	94	172
8	"8-out6462"	.89175	173	21	194
8	"8-out6463"	.28170	331	844	1175
8	"8-out6464"	.38339	194	312	506
8	"8-out6465"	.21010	79	297	376
8	"8-out6466"	.45853	94	111	205
8	"8-out6467"	.22935	100	336	436
8	"8-out6468"	.47519	182	201	383
8	"8-out6469"	.19868	121	488	609
8	"8-out6470"	1.00000	969	0	969
8	"8-out6471"	.99876	811	1	812
8	"8-out6472"	.99725	1455	4	1459
8	"8-out6473"	.19681	136	555	691
8	"8-out6474"	.12787	89	607	696
8	"8-out6475"	.48529	297	315	612
8	"8-out6476"	.23076	198	660	858
8	"8-out6477"	.32236	49	103	152
8	"8-out6478"	.34375	220	420	640
8	"8-out6479"	.81818	90	20	110
8	"8-out6480"	.50187	134	133	267
8	"8-out6481"	.44813	108	133	241
8	"8-out6482"	.99669	302	1	303
8	"8-out6483"	.12895	57	385	442
8	"8-out6484"	.97777	264	6	270
8	"8-out6485"	.34042	96	186	282
8	"8-out6486"	.98862	1738	20	1758
8	"8-out6487"	.36678	106	183	289
8	"8-out6488"	.50794	735	712	1447
8	"8-out6489"	.20638	84	323	407
8	"8-out6490"	.30434	175	400	575
8	"8-out6491"	.46319	151	175	326
8	"8-out6492"	.44600	285	354	639
8	"8-out6493"	.72115	75	29	104
8	"8-out6494"	.40484	117	172	289
8	"8-out6495"	.27667	70	183	253
8	"8-out6496"	.32258	110	231	341
8	"8-out6497"	.97656	125	3	128
8	"8-out6498"	.24100	134	422	556
8	"8-out6499"	.39464	118	181	299
8	"8-out6500"	.23092	227	756	983
8	"8-out6501"	.27786	506	1315	1821
8	"8-out6502"	.28784	116	287	403
8	"8-out6503"	.17623	132	617	749
8	"8-out6504"	.30936	426	951	1377
8	"8-out6505"	.98181	432	8	440
8	"8-out6506"	.99326	295	2	297
8	"8-out6507"	.28277	289	733	1022
8	"8-out6508"	.21703	107	386	493
8	"8-out6509"	.52678	236	212	448
8	"8-out6510"	.18132	101	456	557
8	"8-out6511"	.99248	396	3	399
8	"8-out6512"	.79685	506	129	635
8	"8-out6513"	.99019	202	2	204
8	"8-out6514"	.22662	80	273	353
8	"8-out6515"	.36830	172	295	467
8	"8-out6516"	.59523	125	85	210
8	"8-out6517"	.92086	128	11	139
8	"8-out6518"	.18343	62	276	338
8	"8-out6519"	.27443	73	193	266
8	"8-out6520"	.85299	499	86	585
8	"8-out6521"	.77559	197	57	254
8	"8-out6522"	.20385	222	867	1089
8	"8-out6523"	.26157	113	319	432
8	"8-out6524"	.24166	203	637	840
8	"8-out6525"	.85365	70	12	82
8	"8-out6526"	.13939	46	284	330
8	"8-out6527"	.36411	138	241	379
8	"8-out6528"	.25760	1093	3150	4243
8	"8-out6529"	.91907	477	42	519
8	"8-out6530"	.98465	385	6	391
8	"8-out6531"	.22434	914	3160	4074
8	"8-out6532"	.86857	152	23	175
8	"8-out6533"	.24050	38	120	158
8	"8-out6534"	.25468	353	1033	1386
8	"8-out6535"	.39808	125	189	314
8	"8-out6536"	.43650	385	497	882
8	"8-out6537"	.40873	103	149	252
8	"8-out6538"	.19708	149	607	756
8	"8-out6539"	.31921	98	209	307
8	"8-out6540"	.21782	22	79	101
8	"8-out6541"	.36032	89	158	247
8	"8-out6542"	.35699	176	317	493
8	"8-out6543"	.30705	74	167	241
8	"8-out6544"	.18649	174	759	933
8	"8-out6545"	.35531	167	303	470
8	"8-out6546"	.75129	145	48	193
8	"8-out6547"	.27771	253	658	911
8	"8-out6548"	.28649	1258	3133	4391
8	"8-out6549"	.42371	1072	1458	2530
8	"8-out6550"	.30794	186	418	604
8	"8-out6551"	.42925	179	238	417
8	"8-out6552"	.20800	78	297	375
8	"8-out6553"	.48286	155	166	321
8	"8-out6554"	.32862	93	190	283
8	"8-out6555"	.28835	109	269	378
8	"8-out6556"	.36385	449	785	1234
8	"8-out6557"	.35637	165	298	463
8	"8-out6558"	.51305	275	261	536
8	"8-out6559"	.18532	48	211	259
8	"8-out6560"	.95238	160	8	168
8	"8-out6561"	.99481	192	1	193
8	"8-out6562"	.40243	99	147	246
8	"8-out6563"	.14925	70	399	469
8	"8-out6564"	.27312	124	330	454
8	"8-out6565"	.20029	137	547	684
8	"8-out6566"	.23396	270	884	1154
8	"8-out6567"	.24055	172	543	715
8	"8-out6568"	.08267	21	233	254
8	"8-out6569"	.15191	91	508	599
8	"8-out6570"	.29591	58	138	196
8	"8-out6571"	.53363	119	104	223
8	"8-out6572"	.80769	105	25	130
8	"8-out6573"	.32989	544	1105	1649
8	"8-out6574"	.22440	171	591	762
8	"8-out6575"	.66257	108	55	163
8	"8-out6576"	.16299	37	190	227
8	"8-out6577"	.42602	167	225	392
8	"8-out6578"	.31941	910	1939	2849
8	"8-out6579"	.18811	76	328	404
8	"8-out6580"	.37326	296	497	793
8	"8-out6581"	.36858	237	406	643
8	"8-out6582"	.30671	242	547	789
8	"8-out6583"	.27334	161	428	589
8	"8-out6584"	.26509	202	560	762
8	"8-out6585"	.29769	362	854	1216
8	"8-out6586"	.54016	733	624	1357
8	"8-out6587"	.93884	261	17	278
8	"8-out6588"	.17600	88	412	500
8	"8-out6589"	.98913	91	1	92
8	"8-out6590"	.20333	61	239	300
8	"8-out6591"	.47880	192	209	401
8	"8-out6592"	.33070	42	85	127
8	"8-out6593"	.32054	117	248	365
8	"8-out6594"	.91111	205	20	225
8	"8-out6595"	.14423	15	89	104
8	"8-out6596"	.31847	100	214	314
8	"8-out6597"	.19931	58	233	291
8	"8-out6598"	.99595	1725	7	1732
8	"8-out6599"	.28064	419	1074	1493
8	"8-out6600"	.47682	144	158	302
8	"8-out6601"	.28187	42	107	149
8	"8-out6602"	.56306	125	97	222
8	"8-out6603"	.32797	408	836	1244
8	"8-out6604"	.29429	397	952	1349
8	"8-out6605"	.24765	343	1042	1385
8	"8-out6606"	.28447	229	576	805
8	"8-out6607"	.40544	253	371	624
8	"8-out6608"	.23788	211	676	887
8	"8-out6609"	.20872	67	254	321
8	"8-out6610"	.23327	129	424	553
8	"8-out6611"	.28453	173	435	608
8	"8-out6612"	.32658	387	798	1185
8	"8-out6613"	.43407	214	279	493
8	"8-out6614"	.69382	562	248	810
8	"8-out6615"	.15968	202	1063	1265
8	"8-out6616"	.35381	501	915	1416
8	"8-out6617"	.87332	1634	237	1871
8	"8-out6618"	.99653	576	2	578
8	"8-out6619"	.57868	228	166	394
8	"8-out6620"	.47129	156	175	331
8	"8-out6621"	.54400	68	57	125
8	"8-out6622"	.29614	361	858	1219
8	"8-out6623"	.23544	186	604	790
8	"8-out6624"	.26823	114	311	425
8	"8-out6625"	.31541	352	764	1116
8	"8-out6626"	.28614	95	237	332
8	"8-out6627"	.98958	1045	11	1056
8	"8-out6628"	.78857	138	37	175
8	"8-out6629"	.26596	229	632	861
8	"8-out6630"	.33766	156	306	462
8	"8-out6631"	.38026	397	647	1044
8	"8-out6632"	.23022	163	545	708
8	"8-out6633"	.89797	3864	439	4303
8	"8-out6634"	.64864	120	65	185
8	"8-out6635"	.28873	41	101	142
8	"8-out6636"	.60869	266	171	437
8	"8-out6637"	.20276	88	346	434
8	"8-out6638"	.26808	604	1649	2253
8	"8-out6639"	.28163	138	352	490
8	"8-out6640"	.38736	141	223	364
8	"8-out6641"	.16976	219	1071	1290
8	"8-out6642"	.24394	413	1280	1693
8	"8-out6643"	.26575	291	804	1095
8	"8-out6644"	.30612	345	782	1127
8	"8-out6645"	.99071	320	3	323
8	"8-out6646"	.13442	41	264	305
8	"8-out6647"	.17744	129	598	727
8	"8-out6648"	.31614	233	504	737
8	"8-out6649"	.20054	148	590	738
8	"8-out6650"	.30432	577	1319	1896
8	"8-out6651"	.99333	149	1	150
8	"8-out6652"	.37297	712	1197	1909
8	"8-out6653"	.29017	455	1113	1568
8	"8-out6654"	.99313	1736	12	1748
8	"8-out6655"	.98698	531	7	538
8	"8-out6656"	.98640	1741	24	1765
8	"8-out6657"	.54335	94	79	173
8	"8-out6658"	.99122	113	1	114
8	"8-out6659"	.13095	55	365	420
8	"8-out6660"	.21196	163	606	769
8	"8-out6661"	.77267	1227	361	1588
8	"8-out6662"	.38849	439	691	1130
8	"8-out6663"	.19095	38	161	199
8	"8-out6664"	.21645	50	181	231
8	"8-out6665"	.15415	228	1251	1479
8	"8-out6666"	.30756	386	869	1255
8	"8-out6667"	.22050	157	555	712
8	"8-out6668"	.98860	781	9	790
8	"8-out6669"	.48210	256	275	531
8	"8-out6670"	.25581	33	96	129
8	"8-out6671"	.37704	115	190	305
8	"8-out6672"	.18494	145	639	784
8	"8-out6673"	.26530	52	144	196
8	"8-out6674"	.25183	103	306	409
8	"8-out6675"	.26028	310	881	1191
8	"8-out6676"	.37288	396	666	1062
8	"8-out6677"	.40206	117	174	291
8	"8-out6678"	.23020	314	1050	1364
8	"8-out6679"	.97666	293	7	300
8	"8-out6680"	.62516	487	292	779
8	"8-out6681"	.22569	253	868	1121
8	"8-out6682"	.32758	95	195	290
8	"8-out6683"	.31051	127	282	409
8	"8-out6684"	.30612	150	340	490
8	"8-out6685"	.34415	742	1414	2156
8	"8-out6686"	.34319	116	222	338
8	"8-out6687"	.23305	251	826	1077
8	"8-out6688"	.35426	79	144	223
8	"8-out6689"	.16836	33	163	196
8	"8-out6690"	.31106	298	660	958
8	"8-out6691"	.37264	158	266	424
8	"8-out6692"	.20689	402	1541	1943
8	"8-out6693"	.27730	226	589	815
8	"8-out6694"	.54206	393	332	725
8	"8-out6695"	.92815	478	37	515
8	"8-out6696"	.94680	267	15	282
8	"8-out6697"	.31304	108	237	345
8	"8-out6698"	.47037	127	143	270
8	"8-out6699"	.43771	390	501	891
8	"8-out6700"	.14511	101	595	696
8	"8-out6701"	.09467	80	765	845
8	"8-out6702"	.31218	305	672	977
8	"8-out6703"	.31541	264	573	837
8	"8-out6704"	.13465	129	829	958
8	"8-out6705"	.27763	221	575	796
8	"8-out6706"	.26657	406	1117	1523
8	"8-out6707"	.37894	252	413	665
8	"8-out6708"	.47254	241	269	510
8	"8-out6709"	.23125	111	369	480
8	"8-out6710"	.22967	113	379	492
8	"8-out6711"	.28185	73	186	259
8	"8-out6712"	.46416	136	157	293
8	"8-out6713"	.28074	121	310	431
8	"8-out6714"	.34502	118	224	342
8	"8-out6715"	.45173	117	142	259
8	"8-out6716"	.31789	151	324	475
8	"8-out6717"	.39096	355	553	908
8	"8-out6718"	.25842	322	924	1246
8	"8-out6719"	.90506	143	15	158
8	"8-out6720"	.48911	472	493	965
8	"8-out6721"	.96932	158	5	163
8	"8-out6722"	.37170	310	524	834
8	"8-out6723"	.24937	199	599	798
8	"8-out6724"	.29948	174	407	581
8	"8-out6725"	.48003	565	612	1177
8	"8-out6726"	.30746	103	232	335
8	"8-out6727"	.40060	133	199	332
8	"8-out6728"	.98484	130	2	132
8	"8-out6729"	.38556	219	349	568
8	"8-out6730"	.36488	212	369	581
8	"8-out6731"	.33183	74	149	223
8	"8-out6732"	.41206	239	341	580
8	"8-out6733"	.21511	37	135	172
8	"8-out6734"	.57026	349	263	612
8	"8-out6735"	.96929	221	7	228
8	"8-out6736"	.16798	106	525	631
8	"8-out6737"	.27155	189	507	696
8	"8-out6738"	.98928	277	3	280
8	"8-out6739"	.92727	153	12	165
8	"8-out6740"	.21951	54	192	246
8	"8-out6741"	.48467	174	185	359
8	"8-out6742"	.44979	112	137	249
8	"8-out6743"	.98395	368	6	374
8	"8-out6744"	.42384	128	174	302
8	"8-out6745"	.16755	63	313	376
8	"8-out6746"	.23579	195	632	827
8	"8-out6747"	.67431	470	227	697
8	"8-out6748"	.57926	190	138	328
8	"8-out6749"	.96257	463	18	481
8	"8-out6750"	.35887	281	502	783
8	"8-out6751"	.22894	212	714	926
8	"8-out6752"	.93589	73	5	78
8	"8-out6753"	.22826	21	71	92
8	"8-out6754"	.41758	38	53	91
8	"8-out6755"	.19712	151	615	766
8	"8-out6756"	.83076	108	22	130
8	"8-out6757"	.98947	94	1	95
8	"8-out6758"	.98181	54	1	55
8	"8-out6759"	.30734	205	462	667
8	"8-out6760"	.94915	56	3	59
8	"8-out6761"	.98591	70	1	71
8	"8-out6762"	.99029	102	1	103
8	"8-out6763"	.98484	130	2	132
8	"8-out6764"	.97647	83	2	85
8	"8-out6765"	.95698	89	4	93
8	"8-out6766"	.21647	113	409	522
8	"8-out6767"	.24561	98	301	399
8	"8-out6768"	.26500	106	294	400
8	"8-out6769"	.81862	167	37	204
8	"8-out6770"	.86238	188	30	218
8	"8-out6771"	.87404	229	33	262
8	"8-out6772"	.23747	308	989	1297
8	"8-out6773"	.87437	348	50	398
8	"8-out6774"	.92045	162	14	176
8	"8-out6775"	.26509	496	1375	1871
8	"8-out6776"	.99029	102	1	103
8	"8-out6777"	.32456	148	308	456
8	"8-out6778"	.34955	273	508	781
8	"8-out6779"	.42745	109	146	255
8	"8-out6780"	.95867	116	5	121
8	"8-out6781"	.39805	164	248	412
8	"8-out6782"	.29805	107	252	359
8	"8-out6783"	.29430	93	223	316
8	"8-out6784"	.30917	256	572	828
8	"8-out6785"	.57836	262	191	453
8	"8-out6786"	.71743	358	141	499
8	"8-out6787"	.75593	350	113	463
8	"8-out6788"	.22937	303	1018	1321
8	"8-out6789"	.37681	78	129	207
8	"8-out6790"	.37527	173	288	461
8	"8-out6791"	.86486	64	10	74
8	"8-out6792"	.96428	54	2	56
8	"8-out6793"	.17891	56	257	313
8	"8-out6794"	.23796	89	285	374
8	"8-out6795"	.26080	332	941	1273
8	"8-out6796"	.20567	239	923	1162
8	"8-out6797"	.13375	42	272	314
8	"8-out6798"	.39032	121	189	310
8	"8-out6799"	.27887	99	256	355
8	"8-out6800"	.46808	132	150	282
8	"8-out6801"	.84792	552	99	651
8	"8-out6802"	.35532	70	127	197
8	"8-out6803"	.98191	380	7	387
8	"8-out6804"	.43561	159	206	365
8	"8-out6805"	.27735	441	1149	1590
8	"8-out6806"	.20437	84	327	411
8	"8-out6807"	.46494	683	786	1469
8	"8-out6808"	.28542	141	353	494
8	"8-out6809"	.28787	38	94	132
8	"8-out6810"	.75483	117	38	155
8	"8-out6811"	.52871	267	238	505
8	"8-out6812"	.25785	435	1252	1687
8	"8-out6813"	.47092	664	746	1410
8	"8-out6814"	.32862	256	523	779
8	"8-out6815"	.28019	232	596	828
8	"8-out6816"	.75139	674	223	897
8	"8-out6817"	.28255	115	292	407
8	"8-out6818"	.19696	26	106	132
8	"8-out6819"	.36170	374	660	1034
8	"8-out6820"	.35665	209	377	586
8	"8-out6821"	.17729	292	1355	1647
8	"8-out6822"	.27304	77	205	282
8	"8-out6823"	.34629	187	353	540
8	"8-out6824"	.80952	68	16	84
8	"8-out6825"	.32663	65	134	199
8	"8-out6826"	.33333	117	234	351
8	"8-out6827"	.27631	63	165	228
8	"8-out6828"	.26086	60	170	230
8	"8-out6829"	.18976	215	918	1133
8	"8-out6830"	.46333	1112	1288	2400
8	"8-out6831"	.15330	174	961	1135
8	"8-out6832"	.32352	66	138	204
8	"8-out6833"	.12427	43	303	346
8	"8-out6834"	.79577	113	29	142
8	"8-out6835"	.15331	155	856	1011
8	"8-out6836"	.31917	511	1090	1601
8	"8-out6837"	.25194	324	962	1286
8	"8-out6838"	.42222	133	182	315
8	"8-out6839"	.33151	182	367	549
8	"8-out6840"	.29481	125	299	424
8	"8-out6841"	.28861	142	350	492
8	"8-out6842"	.97487	388	10	398
8	"8-out6843"	.17570	81	380	461
8	"8-out6844"	.96845	307	10	317
8	"8-out6845"	.49014	199	207	406
8	"8-out6846"	.47313	273	304	577
8	"8-out6847"	.30742	178	401	579
8	"8-out6848"	.29090	144	351	495
8	"8-out6849"	.09714	17	158	175
8	"8-out6850"	.30421	101	231	332
8	"8-out6851"	.17857	20	92	112
8	"8-out6852"	.26811	37	101	138
8	"8-out6853"	.76397	123	38	161
8	"8-out6854"	.21461	141	516	657
8	"8-out6855"	.31380	241	527	768
8	"8-out6856"	.41495	222	313	535
8	"8-out6857"	.25433	88	258	346
8	"8-out6858"	.12544	71	495	566
8	"8-out6859"	.96352	317	12	329
8	"8-out6860"	.81570	509	115	624
8	"8-out6861"	.79746	378	96	474
8	"8-out6862"	.22875	105	354	459
8	"8-out6863"	.38990	85	133	218
8	"8-out6864"	.16000	24	126	150
8	"8-out6865"	.95175	217	11	228
8	"8-out6866"	.84162	186	35	221
8	"8-out6867"	.17183	72	347	419
8	"8-out6868"	.12618	40	277	317
8	"8-out6869"	.28450	235	591	826
8	"8-out6870"	.50310	162	160	322
8	"8-out6871"	.20246	279	1099	1378
8	"8-out6872"	.32132	446	942	1388
8	"8-out6873"	.20071	281	1119	1400
8	"8-out6874"	.87735	186	26	212
8	"8-out6875"	.94017	110	7	117
8	"8-out6876"	.23880	16	51	67
8	"8-out6877"	.61961	259	159	418
8	"8-out6878"	.30052	513	1194	1707
8	"8-out6879"	.28891	568	1398	1966
8	"8-out6880"	.96747	1190	40	1230
8	"8-out6881"	.21716	124	447	571
8	"8-out6882"	.27734	71	185	256
8	"8-out6883"	.47402	73	81	154
8	"8-out6884"	.39773	2071	3136	5207
8	"8-out6885"	.89444	161	19	180
8	"8-out6886"	.43269	135	177	312
8	"8-out6887"	.29752	108	255	363
8	"8-out6888"	.13937	40	247	287
8	"8-out6889"	.63855	212	120	332
8	"8-out6890"	.42687	108	145	253
8	"8-out6891"	.61484	348	218	566
8	"8-out6892"	.10795	19	157	176
8	"8-out6893"	.27192	93	249	342
8	"8-out6894"	.42679	172	231	403
8	"8-out6895"	.26978	225	609	834
8	"8-out6896"	.17610	56	262	318
8	"8-out6897"	.27363	55	146	201
8	"8-out6898"	.91724	399	36	435
8	"8-out6899"	.55066	288	235	523
8	"8-out6900"	.35514	76	138	214
8	"8-out6901"	.98349	298	5	303
8	"8-out6902"	.47019	71	80	151
8	"8-out6903"	.65693	90	47	137
8	"8-out6904"	.28260	104	264	368
8	"8-out6905"	.31958	124	264	388
8	"8-out6906"	.80714	113	27	140
8	"8-out6907"	.39655	46	70	116
8	"8-out6908"	.25581	33	96	129
8	"8-out6909"	.44174	182	230	412
8	"8-out6910"	.22715	87	296	383
8	"8-out6911"	.29328	83	200	283
8	"8-out6912"	.60820	267	172	439
8	"8-out6913"	.51264	223	212	435
8	"8-out6914"	.97500	468	12	480
8	"8-out6915"	.99509	203	1	204
8	"8-out6916"	.37204	173	292	465
8	"8-out6917"	.19305	100	418	518
8	"8-out6918"	.11494	60	462	522
8	"8-out6919"	.17919	62	284	346
8	"8-out6920"	.84427	759	140	899
8	"8-out6921"	.44615	116	144	260
8	"8-out6922"	.35918	88	157	245
8	"8-out6923"	.79661	235	60	295
8	"8-out6924"	.30805	130	292	422
8	"8-out6925"	.46766	188	214	402
8	"8-out6926"	.88431	344	45	389
8	"8-out6927"	.37728	103	170	273
8	"8-out6928"	.77876	176	50	226
8	"8-out6929"	.97368	111	3	114
8	"8-out6930"	.35984	380	676	1056
8	"8-out6931"	.27539	282	742	1024
8	"8-out6932"	.20103	155	616	771
8	"8-out6933"	.63783	118	67	185
8	"8-out6934"	.29550	250	596	846
8	"8-out6935"	.68702	180	82	262
8	"8-out6936"	.41988	283	391	674
8	"8-out6937"	.17553	33	155	188
8	"8-out6938"	.31364	154	337	491
8	"8-out6939"	.98148	53	1	54
8	"8-out6940"	.90447	445	47	492
8	"8-out6941"	.30867	434	972	1406
8	"8-out6942"	.35249	515	946	1461
8	"8-out6943"	.19200	245	1031	1276
8	"8-out6944"	.93225	289	21	310
8	"8-out6945"	.26240	566	1591	2157
8	"8-out6946"	.21333	176	649	825
8	"8-out6947"	.15916	99	523	622
8	"8-out6948"	.36956	204	348	552
8	"8-out6949"	.98439	631	10	641
8	"8-out6950"	.28209	167	425	592
8	"8-out6951"	.25250	101	299	400
8	"8-out6952"	.45454	115	138	253
8	"8-out6953"	.41095	90	129	219
8	"8-out6954"	.98400	369	6	375
8	"8-out6955"	.36280	119	209	328
8	"8-out6956"	.98850	86	1	87
8	"8-out6957"	.93929	294	19	313
8	"8-out6958"	.62124	269	164	433
8	"8-out6959"	.92857	260	20	280
8	"8-out6960"	.31961	132	281	413
8	"8-out6961"	.22392	73	253	326
8	"8-out6962"	.37684	153	253	406
8	"8-out6963"	.37317	128	215	343
8	"8-out6964"	.38628	107	170	277
8	"8-out6965"	.39087	197	307	504
8	"8-out6966"	.79955	726	182	908
8	"8-out6967"	.94979	227	12	239
8	"8-out6968"	.27636	152	398	550
8	"8-out6969"	.95495	106	5	111
8	"8-out6970"	.21568	22	80	102
8	"8-out6971"	.39869	61	92	153
8	"8-out6972"	.30528	254	578	832
8	"8-out6973"	.25806	64	184	248
8	"8-out6974"	.94230	637	39	676
8	"8-out6975"	.50781	65	63	128
8	"8-out6976"	.97102	1307	39	1346
8	"8-out6977"	.58371	129	92	221
8	"8-out6978"	.55251	121	98	219
8	"8-out6979"	.40196	123	183	306
8	"8-out6980"	.98181	216	4	220
8	"8-out6981"	.20170	71	281	352
8	"8-out6982"	.58593	150	106	256
8	"8-out6983"	.09090	24	240	264
8	"8-out6984"	.29296	75	181	256
8	"8-out6985"	.86157	361	58	419
8	"8-out6986"	.32994	65	132	197
8	"8-out6987"	.25590	65	189	254
8	"8-out6988"	.29073	91	222	313
8	"8-out6989"	.90252	250	27	277
8	"8-out6990"	.62202	209	127	336
8	"8-out6991"	.31019	143	318	461
8	"8-out6992"	.42142	236	324	560
8	"8-out6993"	.30635	159	360	519
8	"8-out6994"	.97857	137	3	140
8	"8-out6995"	.23647	118	381	499
8	"8-out6996"	.30882	105	235	340
8	"8-out6997"	.93396	297	21	318
8	"8-out6998"	.60718	558	361	919
8	"8-out6999"	.10502	23	196	219
8	"8-out7000"	.72587	331	125	456
8	"8-out7001"	.16146	119	618	737
8	"8-out7002"	.35638	67	121	188
8	"8-out7003"	.41970	115	159	274
8	"8-out7004"	.94594	140	8	148
8	"8-out7005"	.30256	177	408	585
8	"8-out7006"	.48616	123	130	253
8	"8-out7007"	.18181	76	342	418
8	"8-out7008"	.98791	327	4	331
8	"8-out7009"	.19917	48	193	241
8	"8-out7010"	.96739	178	6	184
8	"8-out7011"	.95478	359	17	376
8	"8-out7012"	.21296	46	170	216
8	"8-out7013"	.87089	371	55	426
8	"8-out7014"	.91975	298	26	324
8	"8-out7015"	.32698	206	424	630
8	"8-out7016"	.98326	470	8	478
8	"8-out7017"	.40543	388	569	957
8	"8-out7018"	.99367	471	3	474
8	"8-out7019"	.91899	329	29	358
8	"8-out7020"	.96803	212	7	219
8	"8-out7021"	.23863	189	603	792
8	"8-out7022"	.33769	413	810	1223
8	"8-out7023"	.97126	169	5	174
8	"8-out7024"	.34276	109	209	318
8	"8-out7025"	.27241	79	211	290
8	"8-out7026"	.32666	98	202	300
8	"8-out7027"	.12970	31	208	239
8	"8-out7028"	.16304	45	231	276
8	"8-out7029"	.38991	232	363	595
8	"8-out7030"	.82692	258	54	312
8	"8-out7031"	.98757	477	6	483
8	"8-out7032"	.99582	477	2	479
8	"8-out7033"	.99367	471	3	474
8	"8-out7034"	.98529	469	7	476
8	"8-out7035"	.22251	85	297	382
8	"8-out7036"	.98535	471	7	478
8	"8-out7037"	.98675	149	2	151
8	"8-out7038"	.99547	220	1	221
8	"8-out7039"	.99547	220	1	221
8	"8-out7040"	.98105	466	9	475
8	"8-out7041"	.41891	93	129	222
8	"8-out7042"	.33119	569	1149	1718
8	"8-out7043"	.29520	80	191	271
8	"8-out7044"	.41588	89	125	214
8	"8-out7045"	.33137	339	684	1023
8	"8-out7046"	.30010	280	653	933
8	"8-out7047"	.29032	135	330	465
8	"8-out7048"	.39788	226	342	568
8	"8-out7049"	.46511	60	69	129
8	"8-out7050"	.24170	51	160	211
8	"8-out7051"	.17124	162	784	946
8	"8-out7052"	.27288	158	421	579
8	"8-out7053"	.61904	117	72	189
8	"8-out7054"	.98098	258	5	263
8	"8-out7055"	.72626	329	124	453
8	"8-out7056"	.23251	718	2370	3088
8	"8-out7057"	.42727	47	63	110
8	"8-out7058"	.19491	46	190	236
8	"8-out7059"	.44927	217	266	483
8	"8-out7060"	.25877	59	169	228
8	"8-out7061"	.79110	409	108	517
8	"8-out7062"	.22198	208	729	937
8	"8-out7063"	.14209	134	809	943
8	"8-out7064"	.22944	120	403	523
8	"8-out7065"	.18510	87	383	470
8	"8-out7066"	.16988	88	430	518
8	"8-out7067"	.90062	290	32	322
8	"8-out7068"	.14677	91	529	620
8	"8-out7069"	.90537	354	37	391
8	"8-out7070"	.19672	36	147	183
8	"8-out7071"	.98095	103	2	105
8	"8-out7072"	.99047	104	1	105
8	"8-out7073"	.23686	230	741	971
8	"8-out7074"	.25910	192	549	741
8	"8-out7075"	.27469	203	536	739
8	"8-out7076"	.77378	431	126	557
8	"8-out7077"	.24875	50	151	201
8	"8-out7078"	.19444	49	203	252
8	"8-out7079"	.38039	97	158	255
8	"8-out7080"	.23735	61	196	257
8	"8-out7081"	.16402	31	158	189
8	"8-out7082"	.93838	198	13	211
8	"8-out7083"	.99397	165	1	166
8	"8-out7084"	.98795	164	2	166
8	"8-out7085"	.29016	363	888	1251
8	"8-out7086"	.32460	1016	2114	3130
8	"8-out7087"	.97212	279	8	287
8	"8-out7088"	.62802	363	215	578
8	"8-out7089"	.18181	66	297	363
8	"8-out7090"	.22532	105	361	466
8	"8-out7091"	.88328	280	37	317
8	"8-out7092"	.26659	261	718	979
8	"8-out7093"	.91482	290	27	317
8	"8-out7094"	.36447	238	415	653
8	"8-out7095"	.24798	338	1025	1363
8	"8-out7096"	.70093	150	64	214
8	"8-out7097"	.36319	150	263	413
8	"8-out7098"	.42340	445	606	1051
8	"8-out7099"	.50000	182	182	364
8	"8-out7100"	.31433	342	746	1088
8	"8-out7101"	.19230	30	126	156
8	"8-out7102"	.91954	480	42	522
8	"8-out7103"	.26970	65	176	241
8	"8-out7104"	.71638	293	116	409
8	"8-out7105"	.20906	249	942	1191
8	"8-out7106"	.40694	129	188	317
8	"8-out7107"	.99047	104	1	105
8	"8-out7108"	.58706	118	83	201
8	"8-out7109"	.19306	668	2792	3460
8	"8-out7110"	.10551	65	551	616
8	"8-out7111"	.92356	145	12	157
8	"8-out7112"	.35164	224	413	637
8	"8-out7113"	.60185	130	86	216
8	"8-out7114"	.23706	284	914	1198
8	"8-out7115"	.24532	118	363	481
8	"8-out7116"	.26842	630	1717	2347
8	"8-out7117"	.30725	377	850	1227
8	"8-out7118"	.63487	233	134	367
8	"8-out7119"	.23430	56	183	239
8	"8-out7120"	.97154	239	7	246
8	"8-out7121"	.47606	179	197	376
8	"8-out7122"	.27272	93	248	341
8	"8-out7123"	.35951	563	1003	1566
8	"8-out7124"	.38700	137	217	354
8	"8-out7125"	.36075	456	808	1264
8	"8-out7126"	.97212	279	8	287
8	"8-out7127"	.29840	168	395	563
8	"8-out7128"	.26192	280	789	1069
8	"8-out7129"	.30581	426	967	1393
8	"8-out7130"	.19620	31	127	158
8	"8-out7131"	.42886	208	277	485
8	"8-out7132"	.33709	179	352	531
8	"8-out7133"	.25344	92	271	363
8	"8-out7134"	.31500	63	137	200
8	"8-out7135"	.82644	100	21	121
8	"8-out7136"	.27352	93	247	340
8	"8-out7137"	.36710	471	812	1283
8	"8-out7138"	.38095	288	468	756
8	"8-out7139"	.28787	228	564	792
8	"8-out7140"	.35555	48	87	135
8	"8-out7141"	.66285	232	118	350
8	"8-out7142"	.61194	82	52	134
8	"8-out7143"	.36936	41	70	111
8	"8-out7144"	.24865	277	837	1114
8	"8-out7145"	.22166	88	309	397
8	"8-out7146"	.33885	389	759	1148
8	"8-out7147"	.23242	119	393	512
8	"8-out7148"	.20272	149	586	735
8	"8-out7149"	.18000	81	369	450
8	"8-out7150"	.23708	101	325	426
8	"8-out7151"	.61329	203	128	331
8	"8-out7152"	.36215	511	900	1411
8	"8-out7153"	.32142	99	209	308
8	"8-out7154"	.14498	39	230	269
8	"8-out7155"	.45466	356	427	783
8	"8-out7156"	.26145	234	661	895
8	"8-out7157"	.26700	263	722	985
8	"8-out7158"	.44159	155	196	351
8	"8-out7159"	.25884	117	335	452
8	"8-out7160"	.98876	176	2	178
8	"8-out7161"	.98578	208	3	211
8	"8-out7162"	.49521	259	264	523
8	"8-out7163"	.93655	310	21	331
8	"8-out7164"	.98943	281	3	284
8	"8-out7165"	.84520	1032	189	1221
8	"8-out7166"	.17241	70	336	406
8	"8-out7167"	.70616	298	124	422
8	"8-out7168"	.18863	146	628	774
8	"8-out7169"	.42832	251	335	586
8	"8-out7170"	.20000	52	208	260
8	"8-out7171"	.22813	60	203	263
8	"8-out7172"	.18257	132	591	723
8	"8-out7173"	.66772	422	210	632
8	"8-out7174"	.29870	184	432	616
8	"8-out7175"	.24485	107	330	437
8	"8-out7176"	.27155	252	676	928
8	"8-out7177"	.26829	55	150	205
8	"8-out7178"	.40883	74	107	181
8	"8-out7179"	.16525	78	394	472
8	"8-out7180"	.29898	148	347	495
8	"8-out7181"	.27222	49	131	180
8	"8-out7182"	.22627	31	106	137
8	"8-out7183"	.21637	74	268	342
8	"8-out7184"	.36299	155	272	427
8	"8-out7185"	.25373	51	150	201
8	"8-out7186"	.99239	522	4	526
8	"8-out7187"	.75925	205	65	270
8	"8-out7188"	.43258	154	202	356
8	"8-out7189"	.15010	71	402	473
8	"8-out7190"	.22038	80	283	363
8	"8-out7191"	.40721	158	230	388
8	"8-out7192"	.26315	40	112	152
8	"8-out7193"	.24644	52	159	211
8	"8-out7194"	.18958	142	607	749
8	"8-out7195"	.31977	173	368	541
8	"8-out7196"	.99065	106	1	107
8	"8-out7197"	.59854	82	55	137
8	"8-out7198"	.96728	207	7	214
8	"8-out7199"	.91543	433	40	473
8	"8-out7200"	.96491	220	8	228
8	"8-out7201"	.96929	221	7	228
8	"8-out7202"	.23916	160	509	669
8	"8-out7203"	.36842	70	120	190
8	"8-out7204"	.20104	193	767	960
8	"8-out7205"	.65181	234	125	359
8	"8-out7206"	.39145	330	513	843
8	"8-out7207"	.32571	328	679	1007
8	"8-out7208"	.65660	348	182	530
8	"8-out7209"	.34517	68	129	197
8	"8-out7210"	.65486	74	39	113
8	"8-out7211"	.99395	493	3	496
8	"8-out7212"	.22508	70	241	311
8	"8-out7213"	.99395	493	3	496
8	"8-out7214"	.99395	493	3	496
8	"8-out7215"	.19620	62	254	316
8	"8-out7216"	.99047	104	1	105
8	"8-out7217"	.93913	108	7	115
8	"8-out7218"	.42904	130	173	303
8	"8-out7219"	.29081	57	139	196
8	"8-out7220"	.17910	24	110	134
8	"8-out7221"	.20898	121	458	579
8	"8-out7222"	.29440	358	858	1216
8	"8-out7223"	.27852	83	215	298
8	"8-out7224"	.39465	502	770	1272
8	"8-out7225"	.41252	224	319	543
8	"8-out7226"	.97126	169	5	174
8	"8-out7227"	.71921	292	114	406
8	"8-out7228"	.17032	101	492	593
8	"8-out7229"	.20338	48	188	236
8	"8-out7230"	.21840	178	637	815
8	"8-out7231"	.98611	284	4	288
8	"8-out7232"	.30039	228	531	759
8	"8-out7233"	.34017	398	772	1170
8	"8-out7234"	.45907	129	152	281
8	"8-out7235"	.24248	226	706	932
8	"8-out7236"	.23056	86	287	373
8	"8-out7237"	.34259	37	71	108
8	"8-out7238"	.99395	493	3	496
8	"8-out7239"	.48036	159	172	331
8	"8-out7240"	.43755	480	617	1097
8	"8-out7241"	.92647	441	35	476
8	"8-out7242"	.20603	41	158	199
8	"8-out7243"	.13333	18	117	135
8	"8-out7244"	.27944	140	361	501
8	"8-out7245"	.38450	273	437	710
8	"8-out7246"	.99393	164	1	165
8	"8-out7247"	.98422	312	5	317
8	"8-out7248"	.26535	121	335	456
8	"8-out7249"	.62500	120	72	192
8	"8-out7250"	.59060	88	61	149
8	"8-out7251"	.98726	155	2	157
8	"8-out7252"	.99596	247	1	248
8	"8-out7253"	.96621	143	5	148
8	"8-out7254"	.99371	158	1	159
8	"8-out7255"	.34153	111	214	325
8	"8-out7256"	.47868	146	159	305
8	"8-out7257"	.37827	101	166	267
8	"8-out7258"	.15172	22	123	145
8	"8-out7259"	.34319	174	333	507
8	"8-out7260"	.61702	116	72	188
8	"8-out7261"	.24231	134	419	553
8	"8-out7262"	.28850	133	328	461
8	"8-out7263"	.27092	356	958	1314
8	"8-out7264"	.27234	128	342	470
8	"8-out7265"	.46110	492	575	1067
8	"8-out7266"	.35060	115	213	328
8	"8-out7267"	.60516	328	214	542
8	"8-out7268"	.99337	150	1	151
8	"8-out7269"	.37304	714	1200	1914
8	"8-out7270"	.16203	35	181	216
8	"8-out7271"	.83524	218	43	261
8	"8-out7272"	.61200	153	97	250
8	"8-out7273"	.21637	111	402	513
8	"8-out7274"	.57906	260	189	449
8	"8-out7275"	.32903	51	104	155
8	"8-out7276"	.30434	28	64	92
8	"8-out7277"	.88461	345	45	390
8	"8-out7278"	.78169	111	31	142
8	"8-out7279"	.23648	35	113	148
8	"8-out7280"	.39871	124	187	311
8	"8-out7281"	.30142	148	343	491
8	"8-out7282"	.14905	79	451	530
8	"8-out7283"	.53846	182	156	338
8	"8-out7284"	.15139	38	213	251
8	"8-out7285"	.66559	207	104	311
8	"8-out7286"	.30784	306	688	994
8	"8-out7287"	.13470	59	379	438
8	"8-out7288"	.88571	217	28	245
8	"8-out7289"	.57104	631	474	1105
8	"8-out7290"	.64935	100	54	154
8	"8-out7291"	.16666	26	130	156
8	"8-out7292"	.37189	479	809	1288
8	"8-out7293"	.23640	100	323	423
8	"8-out7294"	.30263	69	159	228
8	"8-out7295"	.22039	67	237	304
8	"8-out7296"	.36960	231	394	625
8	"8-out7297"	.46715	64	73	137
8	"8-out7298"	.14743	23	133	156
8	"8-out7299"	.34748	131	246	377
8	"8-out7300"	.20704	47	180	227
8	"8-out7301"	.75000	324	108	432
8	"8-out7302"	.53846	84	72	156
8	"8-out7303"	.30203	415	959	1374
8	"8-out7304"	.54067	319	271	590
8	"8-out7305"	.21941	113	402	515
8	"8-out7306"	.20554	89	344	433
8	"8-out7307"	.54384	583	489	1072
8	"8-out7308"	.70526	134	56	190
8	"8-out7309"	.27927	124	320	444
8	"8-out7310"	.32828	455	931	1386
8	"8-out7311"	.99624	265	1	266
8	"8-out7312"	.70250	281	119	400
8	"8-out7313"	.32344	229	479	708
8	"8-out7314"	.39759	231	350	581
8	"8-out7315"	.23541	117	380	497
8	"8-out7316"	.76623	59	18	77
8	"8-out7317"	.24651	53	162	215
8	"8-out7318"	.44615	29	36	65
8	"8-out7319"	.84615	561	102	663
8	"8-out7320"	.97515	157	4	161
8	"8-out7321"	.97590	243	6	249
8	"8-out7322"	.22402	166	575	741
8	"8-out7323"	.30129	163	378	541
8	"8-out7324"	.30949	251	560	811
8	"8-out7325"	.38878	631	992	1623
8	"8-out7326"	.15086	35	197	232
8	"8-out7327"	.12334	28	199	227
8	"8-out7328"	.09016	22	222	244
8	"8-out7329"	.37268	161	271	432
8	"8-out7330"	.61459	421	264	685
8	"8-out7331"	.39175	190	295	485
8	"8-out7332"	.48780	80	84	164
8	"8-out7333"	.21339	86	317	403
8	"8-out7334"	.20555	37	143	180
8	"8-out7335"	.37349	62	104	166
8	"8-out7336"	.76582	121	37	158
8	"8-out7337"	.98639	145	2	147
8	"8-out7338"	.36942	116	198	314
8	"8-out7339"	.21120	49	183	232
8	"8-out7340"	.20327	87	341	428
8	"8-out7341"	.65359	100	53	153
8	"8-out7342"	.32000	128	272	400
8	"8-out7343"	.38657	167	265	432
8	"8-out7344"	.34642	300	566	866
8	"8-out7345"	.34069	216	418	634
8	"8-out7346"	.32044	116	246	362
8	"8-out7347"	.19795	155	628	783
8	"8-out7348"	.30645	38	86	124
8	"8-out7349"	.03896	6	148	154
8	"8-out7350"	.24623	49	150	199
8	"8-out7351"	.20454	45	175	220
8	"8-out7352"	.36940	99	169	268
8	"8-out7353"	.32508	92	191	283
8	"8-out7354"	.52617	191	172	363
8	"8-out7355"	.34615	108	204	312
8	"8-out7356"	.33742	110	216	326
8	"8-out7357"	.26625	389	1072	1461
8	"8-out7358"	.53333	64	56	120
8	"8-out7359"	.05504	6	103	109
8	"8-out7360"	.61096	479	305	784
8	"8-out7361"	.13033	174	1161	1335
8	"8-out7362"	.44047	111	141	252
8	"8-out7363"	.52813	291	260	551
8	"8-out7364"	.99395	493	3	496
8	"8-out7365"	.30599	97	220	317
8	"8-out7366"	.99494	197	1	198
8	"8-out7367"	.39583	133	203	336
8	"8-out7368"	.99047	104	1	105
8	"8-out7369"	.31203	83	183	266
8	"8-out7370"	.20128	251	996	1247
8	"8-out7371"	.32148	199	420	619
8	"8-out7372"	.39897	156	235	391
8	"8-out7373"	.61111	66	42	108
8	"8-out7374"	.27941	95	245	340
8	"8-out7375"	.23750	171	549	720
8	"8-out7376"	.21739	25	90	115
8	"8-out7377"	.31515	52	113	165
8	"8-out7378"	.20560	132	510	642
8	"8-out7379"	.84175	383	72	455
8	"8-out7380"	.99245	526	4	530
8	"8-out7381"	.42883	235	313	548
8	"8-out7382"	.25925	63	180	243
8	"8-out7383"	.07567	14	171	185
8	"8-out7384"	.54062	173	147	320
8	"8-out7385"	.31034	162	360	522
8	"8-out7386"	.97435	456	12	468
8	"8-out7387"	.32149	163	344	507
8	"8-out7388"	.20527	210	813	1023
8	"8-out7389"	.10948	30	244	274
8	"8-out7390"	.74740	216	73	289
8	"8-out7391"	.43804	152	195	347
8	"8-out7392"	.23442	79	258	337
8	"8-out7393"	.30448	95	217	312
8	"8-out7394"	.46224	404	470	874
8	"8-out7395"	.24285	34	106	140
8	"8-out7396"	.98238	1227	22	1249
8	"8-out7397"	.98201	819	15	834
8	"8-out7398"	.98128	1206	23	1229
8	"8-out7399"	.60616	177	115	292
8	"8-out7400"	.27702	82	214	296
8	"8-out7401"	.25872	126	361	487
8	"8-out7402"	.23675	447	1441	1888
8	"8-out7403"	.82178	166	36	202
8	"8-out7404"	.28571	114	285	399
8	"8-out7405"	.21662	86	311	397
8	"8-out7406"	.19431	82	340	422
8	"8-out7407"	.40000	238	357	595
8	"8-out7408"	.23342	88	289	377
8	"8-out7409"	.22521	368	1266	1634
8	"8-out7410"	.38109	125	203	328
8	"8-out7411"	.98607	354	5	359
8	"8-out7412"	.37578	180	299	479
8	"8-out7413"	.39708	191	290	481
8	"8-out7414"	.22429	120	415	535
8	"8-out7415"	.18725	94	408	502
8	"8-out7416"	.36854	307	526	833
8	"8-out7417"	.43430	119	155	274
8	"8-out7418"	.93389	777	55	832
8	"8-out7419"	.21383	170	625	795
8	"8-out7420"	.23644	109	352	461
8	"8-out7421"	.34276	218	418	636
8	"8-out7422"	.15851	94	499	593
8	"8-out7423"	.48437	155	165	320
8	"8-out7424"	.33618	275	543	818
8	"8-out7425"	.86460	447	70	517
8	"8-out7426"	.28150	239	610	849
8	"8-out7427"	.52469	85	77	162
8	"8-out7428"	.93292	153	11	164
8	"8-out7429"	.92682	152	12	164
8	"8-out7430"	.92682	152	12	164
8	"8-out7431"	.92682	152	12	164
8	"8-out7432"	.59929	513	343	856
8	"8-out7433"	.43387	292	381	673
8	"8-out7434"	.32304	178	373	551
8	"8-out7435"	.11944	86	634	720
8	"8-out7436"	.20382	245	957	1202
8	"8-out7437"	.92810	284	22	306
8	"8-out7438"	.93589	73	5	78
8	"8-out7439"	.67469	56	27	83
8	"8-out7440"	.98901	90	1	91
8	"8-out7441"	.32323	32	67	99
8	"8-out7442"	.99152	117	1	118
8	"8-out7443"	.97894	93	2	95
8	"8-out7444"	.25373	17	50	67
8	"8-out7445"	.96296	130	5	135
8	"8-out7446"	.99418	171	1	172
8	"8-out7447"	.97368	148	4	152
8	"8-out7448"	.98039	100	2	102
8	"8-out7449"	.97849	91	2	93
8	"8-out7450"	.73967	645	227	872
8	"8-out7451"	.97058	66	2	68
8	"8-out7452"	.35892	374	668	1042
8	"8-out7453"	.29750	119	281	400
8	"8-out7454"	.27968	212	546	758
8	"8-out7455"	.23428	41	134	175
8	"8-out7456"	.41549	118	166	284
8	"8-out7457"	.38144	111	180	291
8	"8-out7458"	.31626	105	227	332
8	"8-out7459"	.96887	716	23	739
8	"8-out7460"	.37134	254	430	684
8	"8-out7461"	.33516	244	484	728
8	"8-out7462"	.86913	870	131	1001
8	"8-out7463"	.20073	163	649	812
8	"8-out7464"	.28459	255	641	896
8	"8-out7465"	.28101	188	481	669
8	"8-out7466"	.31317	202	443	645
8	"8-out7467"	.31098	167	370	537
8	"8-out7468"	.38078	428	696	1124
8	"8-out7469"	.21492	72	263	335
8	"8-out7470"	.22807	65	220	285
8	"8-out7471"	.37024	107	182	289
8	"8-out7472"	.27173	75	201	276
8	"8-out7473"	.17624	46	215	261
8	"8-out7474"	.38563	408	650	1058
8	"8-out7475"	.20732	317	1212	1529
8	"8-out7476"	.33360	412	823	1235
8	"8-out7477"	.86459	779	122	901
8	"8-out7478"	.94463	546	32	578
8	"8-out7479"	.25877	236	676	912
8	"8-out7480"	.11812	101	754	855
8	"8-out7481"	.50205	122	121	243
8	"8-out7482"	.19944	72	289	361
8	"8-out7483"	.27066	167	450	617
8	"8-out7484"	.23152	47	156	203
8	"8-out7485"	.36693	91	157	248
8	"8-out7486"	.22394	101	350	451
8	"8-out7487"	.43798	113	145	258
8	"8-out7488"	.22811	86	291	377
8	"8-out7489"	.99295	141	1	142
8	"8-out7490"	1.00000	2	0	2
8	"8-out7491"	.24767	133	404	537
8	"8-out7492"	.28571	128	320	448
8	"8-out7493"	.97211	488	14	502
8	"8-out7494"	.19607	30	123	153
8	"8-out7495"	.37790	130	214	344
8	"8-out7496"	.36708	58	100	158
8	"8-out7497"	.99453	182	1	183
8	"8-out7498"	.38578	76	121	197
8	"8-out7499"	.21850	85	304	389
8	"8-out7500"	.85135	63	11	74
8	"8-out7501"	.94496	910	53	963
8	"8-out7502"	.63783	236	134	370
8	"8-out7503"	.31578	120	260	380
8	"8-out7504"	.20350	186	728	914
8	"8-out7505"	.31145	816	1804	2620
8	"8-out7506"	.37239	340	573	913
8	"8-out7507"	.28131	265	677	942
8	"8-out7508"	.36732	299	515	814
8	"8-out7509"	.23512	245	797	1042
8	"8-out7510"	.25000	172	516	688
8	"8-out7511"	.29572	519	1236	1755
8	"8-out7512"	.24235	103	322	425
8	"8-out7513"	.34251	174	334	508
8	"8-out7514"	.31492	154	335	489
8	"8-out7515"	.84525	508	93	601
8	"8-out7516"	.24230	126	394	520
8	"8-out7517"	.62162	161	98	259
8	"8-out7518"	.24148	78	245	323
8	"8-out7519"	.18050	50	227	277
8	"8-out7520"	.95655	2444	111	2555
8	"8-out7521"	.13232	61	400	461
8	"8-out7522"	.22413	91	315	406
8	"8-out7523"	.44698	430	532	962
8	"8-out7524"	.13265	91	595	686
8	"8-out7525"	.24468	299	923	1222
8	"8-out7526"	.99519	207	1	208
8	"8-out7527"	.97345	440	12	452
8	"8-out7528"	.97749	304	7	311
8	"8-out7529"	.99172	599	5	604
8	"8-out7530"	.97142	136	4	140
8	"8-out7531"	.98907	181	2	183
8	"8-out7532"	.98924	92	1	93
8	"8-out7533"	.96732	148	5	153
8	"8-out7534"	.99386	162	1	163
8	"8-out7535"	.99551	222	1	223
8	"8-out7536"	.98701	228	3	231
8	"8-out7537"	.98734	78	1	79
8	"8-out7538"	.99728	368	1	369
8	"8-out7539"	.99280	138	1	139
8	"8-out7540"	.24132	306	962	1268
8	"8-out7541"	.20566	138	533	671
8	"8-out7542"	.18258	151	676	827
8	"8-out7543"	.55747	291	231	522
8	"8-out7544"	.99236	390	3	393
8	"8-out7545"	.99099	220	2	222
8	"8-out7546"	.36734	54	93	147
8	"8-out7547"	.70391	126	53	179
8	"8-out7548"	.78400	686	189	875
8	"8-out7549"	.29270	317	766	1083
8	"8-out7550"	.31376	155	339	494
8	"8-out7551"	.21769	123	442	565
8	"8-out7552"	.14876	90	515	605
8	"8-out7553"	.32026	433	919	1352
8	"8-out7554"	.68703	1102	502	1604
8	"8-out7555"	.22005	237	840	1077
8	"8-out7556"	.38015	387	631	1018
8	"8-out7557"	.32945	453	922	1375
8	"8-out7558"	.31884	330	705	1035
8	"8-out7559"	.21183	204	759	963
8	"8-out7560"	.20699	225	862	1087
8	"8-out7561"	.31407	337	736	1073
8	"8-out7562"	.19347	166	692	858
8	"8-out7563"	.20423	135	526	661
8	"8-out7564"	.73237	457	167	624
8	"8-out7565"	.19789	94	381	475
8	"8-out7566"	.10344	27	234	261
8	"8-out7567"	.36615	119	206	325
8	"8-out7568"	.99293	281	2	283
8	"8-out7569"	.30434	42	96	138
8	"8-out7570"	.54119	289	245	534
8	"8-out7571"	.69354	86	38	124
8	"8-out7572"	.34782	56	105	161
8	"8-out7573"	.16612	51	256	307
8	"8-out7574"	.28450	134	337	471
8	"8-out7575"	.29341	49	118	167
8	"8-out7576"	.34886	277	517	794
8	"8-out7577"	.42941	651	865	1516
8	"8-out7578"	.96604	313	11	324
8	"8-out7579"	.28146	161	411	572
8	"8-out7580"	.34673	69	130	199
8	"8-out7581"	.98947	94	1	95
8	"8-out7582"	.16000	16	84	100
8	"8-out7583"	.44680	63	78	141
8	"8-out7584"	.15601	83	449	532
8	"8-out7585"	.99090	218	2	220
8	"8-out7586"	.97101	67	2	69
8	"8-out7587"	.16634	85	426	511
8	"8-out7588"	.11219	23	182	205
8	"8-out7589"	.73144	207	76	283
8	"8-out7590"	.40474	1519	2234	3753
8	"8-out7591"	1.00000	156	0	156
8	"8-out7592"	.27228	168	449	617
8	"8-out7593"	.99610	256	1	257
8	"8-out7594"	.21064	95	356	451
8	"8-out7595"	.30000	66	154	220
8	"8-out7596"	.20588	84	324	408
8	"8-out7597"	.30246	98	226	324
8	"8-out7598"	.23557	49	159	208
8	"8-out7599"	.27678	62	162	224
8	"8-out7600"	.98432	314	5	319
8	"8-out7601"	.42182	143	196	339
8	"8-out7602"	.34259	111	213	324
8	"8-out7603"	.55757	92	73	165
8	"8-out7604"	.13942	29	179	208
8	"8-out7605"	.28735	125	310	435
8	"8-out7606"	.24216	85	266	351
8	"8-out7607"	.22707	52	177	229
8	"8-out7608"	.43410	56	73	129
8	"8-out7609"	.29579	197	469	666
8	"8-out7610"	.39105	201	313	514
8	"8-out7611"	.20588	28	108	136
8	"8-out7612"	.20427	86	335	421
8	"8-out7613"	.32716	53	109	162
8	"8-out7614"	.22807	130	440	570
8	"8-out7615"	.25833	62	178	240
8	"8-out7616"	.36216	201	354	555
8	"8-out7617"	.33103	48	97	145
8	"8-out7618"	.43750	126	162	288
8	"8-out7619"	.87192	177	26	203
8	"8-out7620"	.27851	105	272	377
8	"8-out7621"	.30654	103	233	336
8	"8-out7622"	.43589	68	88	156
8	"8-out7623"	.94736	234	13	247
8	"8-out7624"	.53591	97	84	181
8	"8-out7625"	.49777	447	451	898
8	"8-out7626"	.16833	151	746	897
8	"8-out7627"	.23032	79	264	343
8	"8-out7628"	.35438	101	184	285
8	"8-out7629"	.25590	65	189	254
8	"8-out7630"	.30072	83	193	276
8	"8-out7631"	.17824	195	899	1094
8	"8-out7632"	.30059	251	584	835
8	"8-out7633"	.22530	130	447	577
8	"8-out7634"	.29215	149	361	510
8	"8-out7635"	.38815	236	372	608
8	"8-out7636"	.33875	354	691	1045
8	"8-out7637"	.19680	197	804	1001
8	"8-out7638"	.25806	48	138	186
8	"8-out7639"	.71658	445	176	621
8	"8-out7640"	.46013	352	413	765
8	"8-out7641"	.98571	138	2	140
8	"8-out7642"	.29281	53	128	181
8	"8-out7643"	.26622	525	1447	1972
8	"8-out7644"	.99285	139	1	140
8	"8-out7645"	.34285	492	943	1435
8	"8-out7646"	.25223	113	335	448
8	"8-out7647"	.96743	505	17	522
8	"8-out7648"	.16986	195	953	1148
8	"8-out7649"	.99428	174	1	175
8	"8-out7650"	.68911	266	120	386
8	"8-out7651"	.31180	169	373	542
8	"8-out7652"	.98214	110	2	112
8	"8-out7653"	.99082	108	1	109
8	"8-out7654"	.99107	111	1	112
8	"8-out7655"	.99115	112	1	113
8	"8-out7656"	.99107	111	1	112
8	"8-out7657"	.98245	112	2	114
8	"8-out7658"	.99047	104	1	105
8	"8-out7659"	.98214	110	2	112
8	"8-out7660"	.96330	105	4	109
8	"8-out7661"	.98165	107	2	109
8	"8-out7662"	.99159	118	1	119
8	"8-out7663"	.96460	109	4	113
8	"8-out7664"	.97345	110	3	113
8	"8-out7665"	.99122	113	1	114
8	"8-out7666"	.96460	109	4	113
8	"8-out7667"	.99107	111	1	112
8	"8-out7668"	.98245	112	2	114
8	"8-out7669"	.97391	112	3	115
8	"8-out7670"	.99082	108	1	109
8	"8-out7671"	.99193	123	1	124
8	"8-out7672"	.98260	113	2	115
8	"8-out7673"	.93693	104	7	111
8	"8-out7674"	.99130	114	1	115
8	"8-out7675"	.98245	112	2	114
8	"8-out7676"	.99130	114	1	115
8	"8-out7677"	.99099	110	1	111
8	"8-out7678"	.98245	112	2	114
8	"8-out7679"	.97368	111	3	114
8	"8-out7680"	.99122	113	1	114
8	"8-out7681"	.99122	113	1	114
8	"8-out7682"	.99122	113	1	114
8	"8-out7683"	.51602	161	151	312
8	"8-out7684"	.42346	249	339	588
8	"8-out7685"	.29239	200	484	684
8	"8-out7686"	.68167	212	99	311
8	"8-out7687"	.96938	285	9	294
8	"8-out7688"	.84452	440	81	521
8	"8-out7689"	.50241	104	103	207
8	"8-out7690"	.13523	71	454	525
8	"8-out7691"	.53312	169	148	317
8	"8-out7692"	.22574	256	878	1134
8	"8-out7693"	.28767	126	312	438
8	"8-out7694"	.36470	62	108	170
8	"8-out7695"	.19614	61	250	311
8	"8-out7696"	.18666	98	427	525
8	"8-out7697"	.99493	393	2	395
8	"8-out7698"	.15758	81	433	514
8	"8-out7699"	.99719	356	1	357
8	"8-out7700"	.92015	461	40	501
8	"8-out7701"	.52589	132	119	251
8	"8-out7702"	.24166	203	637	840
8	"8-out7703"	1.00000	156	0	156
8	"8-out7704"	.40196	82	122	204
8	"8-out7705"	.34055	173	335	508
8	"8-out7706"	.69032	107	48	155
8	"8-out7707"	.84033	100	19	119
8	"8-out7708"	.94835	202	11	213
8	"8-out7709"	.47931	139	151	290
8	"8-out7710"	.42209	149	204	353
8	"8-out7711"	.99009	100	1	101
8	"8-out7712"	.31346	163	357	520
8	"8-out7713"	.56880	186	141	327
8	"8-out7714"	.31929	91	194	285
8	"8-out7715"	1.00000	156	0	156
8	"8-out7716"	1.00000	156	0	156
8	"8-out7717"	.52982	151	134	285
8	"8-out7718"	.26987	146	395	541
8	"8-out7719"	.48712	227	239	466
8	"8-out7720"	.35124	183	338	521
8	"8-out7721"	.87439	181	26	207
8	"8-out7722"	.37556	83	138	221
8	"8-out7723"	.30701	140	316	456
8	"8-out7724"	.20364	246	962	1208
8	"8-out7725"	.21083	214	801	1015
8	"8-out7726"	.31897	237	506	743
8	"8-out7727"	.16191	125	647	772
8	"8-out7728"	.72584	556	210	766
8	"8-out7729"	.29665	124	294	418
8	"8-out7730"	.20685	187	717	904
8	"8-out7731"	.21860	47	168	215
8	"8-out7732"	.99122	113	1	114
8	"8-out7733"	.22400	28	97	125
8	"8-out7734"	.21649	42	152	194
8	"8-out7735"	.90476	95	10	105
8	"8-out7736"	.37894	144	236	380
8	"8-out7737"	.44839	126	155	281
8	"8-out7738"	.29770	78	184	262
8	"8-out7739"	.33082	88	178	266
8	"8-out7740"	.73515	161	58	219
8	"8-out7741"	.31034	108	240	348
8	"8-out7742"	.27667	70	183	253
8	"8-out7743"	.40247	130	193	323
8	"8-out7744"	.97969	579	12	591
8	"8-out7745"	.98909	635	7	642
8	"8-out7746"	.25221	114	338	452
8	"8-out7747"	.32574	143	296	439
8	"8-out7748"	.38167	729	1181	1910
8	"8-out7749"	.23255	30	99	129
8	"8-out7750"	.19905	42	169	211
8	"8-out7751"	.18189	207	931	1138
8	"8-out7752"	.35457	217	395	612
8	"8-out7753"	.36000	378	672	1050
8	"8-out7754"	.23951	137	435	572
8	"8-out7755"	.99319	438	3	441
8	"8-out7756"	.25443	86	252	338
8	"8-out7757"	.48987	242	252	494
8	"8-out7758"	.41060	333	478	811
8	"8-out7759"	.49745	391	395	786
8	"8-out7760"	.43112	338	446	784
8	"8-out7761"	.17137	85	411	496
8	"8-out7762"	.31782	41	88	129
8	"8-out7763"	.86761	367	56	423
8	"8-out7764"	.34931	153	285	438
8	"8-out7765"	.45625	73	87	160
8	"8-out7766"	.29124	203	494	697
8	"8-out7767"	.20857	73	277	350
8	"8-out7768"	.14141	14	85	99
8	"8-out7769"	.44943	80	98	178
8	"8-out7770"	.37974	120	196	316
8	"8-out7771"	.20809	36	137	173
8	"8-out7772"	.18538	104	457	561
8	"8-out7773"	.38397	139	223	362
8	"8-out7774"	.99574	234	1	235
8	"8-out7775"	.35135	104	192	296
8	"8-out7776"	.67666	203	97	300
8	"8-out7777"	.96363	371	14	385
8	"8-out7778"	.18633	30	131	161
8	"8-out7779"	.21568	132	480	612
8	"8-out7780"	.28019	58	149	207
8	"8-out7781"	.24175	66	207	273
8	"8-out7782"	.31415	71	155	226
8	"8-out7783"	.23364	25	82	107
8	"8-out7784"	.23421	178	582	760
8	"8-out7785"	.27636	76	199	275
8	"8-out7786"	.27000	297	803	1100
8	"8-out7787"	.24886	165	498	663
8	"8-out7788"	.41353	55	78	133
8	"8-out7789"	.35458	228	415	643
8	"8-out7790"	.25813	127	365	492
8	"8-out7791"	.17316	40	191	231
8	"8-out7792"	.28761	65	161	226
8	"8-out7793"	.36909	86	147	233
8	"8-out7794"	.33739	83	163	246
8	"8-out7795"	.46540	74	85	159
8	"8-out7796"	.23606	72	233	305
8	"8-out7797"	.40714	57	83	140
8	"8-out7798"	.32232	205	431	636
8	"8-out7799"	.30447	102	233	335
8	"8-out7800"	.92413	134	11	145
8	"8-out7801"	.31090	476	1055	1531
8	"8-out7802"	.29098	142	346	488
8	"8-out7803"	.23669	298	961	1259
8	"8-out7804"	.91020	223	22	245
8	"8-out7805"	.15882	27	143	170
8	"8-out7806"	.41901	119	165	284
8	"8-out7807"	.21730	113	407	520
8	"8-out7808"	.29411	130	312	442
8	"8-out7809"	.98245	112	2	114
8	"8-out7810"	.96491	110	4	114
8	"8-out7811"	.98245	112	2	114
8	"8-out7812"	.99697	990	3	993
8	"8-out7813"	.24193	30	94	124
8	"8-out7814"	.21938	43	153	196
8	"8-out7815"	.38977	122	191	313
8	"8-out7816"	.99295	141	1	142
8	"8-out7817"	.41575	343	482	825
8	"8-out7818"	.21138	52	194	246
8	"8-out7819"	.57500	138	102	240
8	"8-out7820"	.33984	174	338	512
8	"8-out7821"	.74698	62	21	83
8	"8-out7822"	.29128	127	309	436
8	"8-out7823"	.94000	94	6	100
8	"8-out7824"	.26956	31	84	115
8	"8-out7825"	.19718	42	171	213
8	"8-out7826"	.11640	22	167	189
8	"8-out7827"	.22222	54	189	243
8	"8-out7828"	.21074	149	558	707
8	"8-out7829"	.98319	117	2	119
8	"8-out7830"	.53389	63	55	118
8	"8-out7831"	.39062	50	78	128
8	"8-out7832"	.21111	76	284	360
8	"8-out7833"	.88343	144	19	163
8	"8-out7834"	.36470	62	108	170
8	"8-out7835"	.49390	81	83	164
8	"8-out7836"	.25109	115	343	458
8	"8-out7837"	.15259	47	261	308
8	"8-out7838"	.98437	63	1	64
8	"8-out7839"	.34240	302	580	882
8	"8-out7840"	.22009	184	652	836
8	"8-out7841"	.30733	67	151	218
8	"8-out7842"	.42367	136	185	321
8	"8-out7843"	.96654	260	9	269
8	"8-out7844"	.29894	142	333	475
8	"8-out7845"	.26690	75	206	281
8	"8-out7846"	.25628	51	148	199
8	"8-out7847"	.15104	29	163	192
8	"8-out7848"	.31000	93	207	300
8	"8-out7849"	.37254	76	128	204
8	"8-out7850"	.26666	112	308	420
8	"8-out7851"	.18264	40	179	219
8	"8-out7852"	.21511	37	135	172
8	"8-out7853"	.14093	21	128	149
8	"8-out7854"	.15340	81	447	528
8	"8-out7855"	.29111	177	431	608
8	"8-out7856"	.54734	289	239	528
8	"8-out7857"	.80973	183	43	226
8	"8-out7858"	.59349	73	50	123
8	"8-out7859"	.30828	160	359	519
8	"8-out7860"	.98666	74	1	75
8	"8-out7861"	.98051	151	3	154
8	"8-out7862"	.77241	112	33	145
8	"8-out7863"	.19101	204	864	1068
8	"8-out7864"	.27822	69	179	248
8	"8-out7865"	.87707	264	37	301
8	"8-out7866"	.92241	107	9	116
8	"8-out7867"	.23195	45	149	194
8	"8-out7868"	.86398	667	105	772
8	"8-out7869"	.27906	60	155	215
8	"8-out7870"	.32727	252	518	770
8	"8-out7871"	.29924	79	185	264
8	"8-out7872"	.34597	73	138	211
8	"8-out7873"	.25000	54	162	216
8	"8-out7874"	.39459	73	112	185
8	"8-out7875"	.44247	50	63	113
8	"8-out7876"	.60137	175	116	291
8	"8-out7877"	.23267	47	155	202
8	"8-out7878"	.39704	349	530	879
8	"8-out7879"	.22580	91	312	403
8	"8-out7880"	.99543	218	1	219
8	"8-out7881"	.63924	202	114	316
8	"8-out7882"	.97122	135	4	139
8	"8-out7883"	.60986	136	87	223
8	"8-out7884"	.29032	63	154	217
8	"8-out7885"	.30275	33	76	109
8	"8-out7886"	.29369	163	392	555
8	"8-out7887"	.12765	30	205	235
8	"8-out7888"	.52229	82	75	157
8	"8-out7889"	.51103	301	288	589
8	"8-out7890"	.19746	156	634	790
8	"8-out7891"	.49504	100	102	202
8	"8-out7892"	.93809	197	13	210
8	"8-out7893"	.35448	162	295	457
8	"8-out7894"	.29098	71	173	244
8	"8-out7895"	.41324	131	186	317
8	"8-out7896"	.98936	279	3	282
8	"8-out7897"	.15846	29	154	183
8	"8-out7898"	.68214	191	89	280
8	"8-out7899"	.62470	263	158	421
8	"8-out7900"	.21022	37	139	176
8	"8-out7901"	.35740	99	178	277
8	"8-out7902"	.34883	90	168	258
8	"8-out7903"	.98194	272	5	277
8	"8-out7904"	.25641	60	174	234
8	"8-out7905"	.25859	474	1359	1833
8	"8-out7906"	.59751	144	97	241
8	"8-out7907"	.24637	85	260	345
8	"8-out7908"	.27252	124	331	455
8	"8-out7909"	.25379	117	344	461
8	"8-out7910"	.22352	57	198	255
8	"8-out7911"	.36930	154	263	417
8	"8-out7912"	.74324	55	19	74
8	"8-out7913"	.28802	89	220	309
8	"8-out7914"	.93905	339	22	361
8	"8-out7915"	.49142	401	415	816
8	"8-out7916"	.19196	43	181	224
8	"8-out7917"	.67664	113	54	167
8	"8-out7918"	.69655	202	88	290
8	"8-out7919"	.33103	48	97	145
8	"8-out7920"	.31019	733	1630	2363
8	"8-out7921"	.72983	181	67	248
8	"8-out7922"	.52039	370	341	711
8	"8-out7923"	.29451	220	527	747
8	"8-out7924"	.62162	161	98	259
8	"8-out7925"	1.00000	153	0	153
8	"8-out7926"	.33333	144	288	432
8	"8-out7927"	.20909	69	261	330
8	"8-out7928"	.55118	70	57	127
8	"8-out7929"	.97727	43	1	44
8	"8-out7930"	.90076	118	13	131
8	"8-out7931"	.23893	27	86	113
8	"8-out7932"	.40421	192	283	475
8	"8-out7933"	.57500	138	102	240
8	"8-out7934"	.33595	128	253	381
8	"8-out7935"	.45549	348	416	764
8	"8-out7936"	.33045	153	310	463
8	"8-out7937"	.23950	97	308	405
8	"8-out7938"	.55140	177	144	321
8	"8-out7939"	.27500	55	145	200
8	"8-out7940"	.96078	98	4	102
8	"8-out7941"	.21296	115	425	540
8	"8-out7942"	.45299	53	64	117
8	"8-out7943"	.96815	152	5	157
8	"8-out7944"	.51149	89	85	174
8	"8-out7945"	.68493	50	23	73
8	"8-out7946"	.25113	331	987	1318
8	"8-out7947"	.30070	341	793	1134
8	"8-out7948"	.18655	161	702	863
8	"8-out7949"	.30141	406	941	1347
8	"8-out7950"	.43566	342	443	785
8	"8-out7951"	.81954	654	144	798
8	"8-out7952"	.31702	311	670	981
8	"8-out7953"	.29478	311	744	1055
8	"8-out7954"	.89784	334	38	372
8	"8-out7955"	.31133	1104	2442	3546
8	"8-out7956"	.25000	331	993	1324
8	"8-out7957"	.37744	348	574	922
8	"8-out7958"	.98167	375	7	382
8	"8-out7959"	.30714	43	97	140
8	"8-out7960"	.07777	14	166	180
8	"8-out7961"	.99275	137	1	138
8	"8-out7962"	.66117	482	247	729
8	"8-out7963"	.37956	624	1020	1644
8	"8-out7964"	.28413	335	844	1179
8	"8-out7965"	.99024	203	2	205
8	"8-out7966"	.98245	112	2	114
8	"8-out7967"	.99074	107	1	108
8	"8-out7968"	.99056	105	1	106
8	"8-out7969"	.99107	111	1	112
8	"8-out7970"	.99107	111	1	112
8	"8-out7971"	.99137	115	1	116
8	"8-out7972"	.99107	111	1	112
8	"8-out7973"	.97272	107	3	110
8	"8-out7974"	.99082	108	1	109
8	"8-out7975"	.98484	130	2	132
8	"8-out7976"	.96460	109	4	113
8	"8-out7977"	.99115	112	1	113
8	"8-out7978"	.99130	114	1	115
8	"8-out7979"	.99107	111	1	112
8	"8-out7980"	.99107	111	1	112
8	"8-out7981"	.99130	114	1	115
8	"8-out7982"	.99107	111	1	112
8	"8-out7983"	.98230	111	2	113
8	"8-out7984"	.98165	107	2	109
8	"8-out7985"	.98260	113	2	115
8	"8-out7986"	.98260	113	2	115
8	"8-out7987"	.99130	114	1	115
8	"8-out7988"	.99130	114	1	115
8	"8-out7989"	.98260	113	2	115
8	"8-out7990"	.98245	112	2	114
8	"8-out7991"	.96396	107	4	111
8	"8-out7992"	.98245	112	2	114
8	"8-out7993"	.96491	110	4	114
8	"8-out7994"	.99122	113	1	114
8	"8-out7995"	.99122	113	1	114
8	"8-out7996"	.99439	710	4	714
8	"8-out7997"	.24620	162	496	658
8	"8-out7998"	.97727	43	1	44
8	"8-out7999"	.41712	151	211	362
8	"8-out8000"	.48409	274	292	566
8	"8-out16001"	.31213	108	238	346
8	"8-out16002"	.39453	101	155	256
8	"8-out16003"	.55840	349	276	625
8	"8-out16004"	.16101	57	297	354
8	"8-out16005"	.19180	117	493	610
8	"8-out16006"	.26771	102	279	381
8	"8-out16007"	.21751	77	277	354
8	"8-out16008"	.98795	82	1	83
8	"8-out16009"	.20281	72	283	355
8	"8-out16010"	.14067	46	281	327
8	"8-out16011"	.77739	227	65	292
8	"8-out16012"	.24456	135	417	552
8	"8-out16013"	.35675	330	595	925
8	"8-out16014"	.98892	625	7	632
8	"8-out16015"	.98892	625	7	632
8	"8-out16016"	.59854	82	55	137
8	"8-out16017"	.76200	349	109	458
8	"8-out16018"	.35514	152	276	428
8	"8-out16019"	.20033	121	483	604
8	"8-out16020"	.83908	365	70	435
8	"8-out16021"	.27045	119	321	440
8	"8-out16022"	.25102	245	731	976
8	"8-out16023"	.85812	375	62	437
8	"8-out16024"	.31358	180	394	574
8	"8-out16025"	.18421	77	341	418
8	"8-out16026"	.45272	158	191	349
8	"8-out16027"	.22350	97	337	434
8	"8-out16028"	.36363	136	238	374
8	"8-out16029"	.42982	196	260	456
8	"8-out16030"	.44608	211	262	473
8	"8-out16031"	.42253	120	164	284
8	"8-out16032"	.33275	193	387	580
8	"8-out16033"	.26548	240	664	904
8	"8-out16034"	.30769	84	189	273
8	"8-out16035"	.76245	199	62	261
8	"8-out16036"	.15315	85	470	555
8	"8-out16037"	.26565	246	680	926
8	"8-out16038"	.36607	82	142	224
8	"8-out16039"	.18997	197	840	1037
8	"8-out16040"	.18436	191	845	1036
8	"8-out16041"	.09905	21	191	212
8	"8-out16042"	.31798	449	963	1412
8	"8-out16043"	.55782	82	65	147
8	"8-out16044"	.26123	93	263	356
8	"8-out16045"	.23429	194	634	828
8	"8-out16046"	.16896	49	241	290
8	"8-out16047"	.98490	783	12	795
8	"8-out16048"	.45833	319	377	696
8	"8-out16049"	.48175	264	284	548
8	"8-out16050"	.99047	104	1	105
8	"8-out16051"	.23988	83	263	346
8	"8-out16052"	.38923	188	295	483
8	"8-out16053"	.18987	90	384	474
8	"8-out16054"	.25894	123	352	475
8	"8-out16055"	.43376	203	265	468
8	"8-out16056"	.63557	368	211	579
8	"8-out16057"	.31263	146	321	467
8	"8-out16058"	.21091	85	318	403
8	"8-out16059"	.21768	96	345	441
8	"8-out16060"	.33261	308	618	926
8	"8-out16061"	.32019	130	276	406
8	"8-out16062"	.63713	676	385	1061
8	"8-out16063"	.71631	303	120	423
8	"8-out16064"	.13163	57	376	433
8	"8-out16065"	.99790	476	1	477
8	"8-out16066"	.41770	302	421	723
8	"8-out16067"	.46855	149	169	318
8	"8-out16068"	.31838	71	152	223
8	"8-out16069"	.25000	46	138	184
8	"8-out16070"	.90515	773	81	854
8	"8-out16071"	.99549	221	1	222
8	"8-out16072"	.26386	157	438	595
8	"8-out16073"	.16045	56	293	349
8	"8-out16074"	.26444	151	420	571
8	"8-out16075"	.62956	362	213	575
8	"8-out16076"	.21276	60	222	282
8	"8-out16077"	.12318	136	968	1104
8	"8-out16078"	.42671	393	528	921
8	"8-out16079"	.16591	147	739	886
8	"8-out16080"	.57343	531	395	926
8	"8-out16081"	.98305	58	1	59
8	"8-out16082"	.98305	58	1	59
8	"8-out16083"	.96610	57	2	59
8	"8-out16084"	.41141	137	196	333
8	"8-out16085"	.21069	130	487	617
8	"8-out16086"	.65555	59	31	90
8	"8-out16087"	.38582	98	156	254
8	"8-out16088"	.16780	74	367	441
8	"8-out16089"	.48752	215	226	441
8	"8-out16090"	.21198	46	171	217
8	"8-out16091"	.48484	80	85	165
8	"8-out16092"	.38169	171	277	448
8	"8-out16093"	.19230	80	336	416
8	"8-out16094"	.47665	194	213	407
8	"8-out16095"	.21730	108	389	497
8	"8-out16096"	.35022	159	295	454
8	"8-out16097"	.22452	271	936	1207
8	"8-out16098"	.26490	191	530	721
8	"8-out16099"	.17571	68	319	387
8	"8-out16100"	.40512	237	348	585
8	"8-out16101"	.25040	155	464	619
8	"8-out16102"	.15094	56	315	371
8	"8-out16103"	.47122	131	147	278
8	"8-out16104"	.51187	194	185	379
8	"8-out16105"	.18616	113	494	607
8	"8-out16106"	.25996	137	390	527
8	"8-out16107"	.27453	179	473	652
8	"8-out16108"	.32919	106	216	322
8	"8-out16109"	.41156	121	173	294
8	"8-out16110"	.30743	459	1034	1493
8	"8-out16111"	.29545	117	279	396
8	"8-out16112"	.19648	257	1051	1308
8	"8-out16113"	.22897	49	165	214
8	"8-out16114"	.20279	116	456	572
8	"8-out16115"	.96916	220	7	227
8	"8-out16116"	.62691	531	316	847
8	"8-out16117"	.32957	234	476	710
8	"8-out16118"	.25066	94	281	375
8	"8-out16119"	.39464	339	520	859
8	"8-out16120"	.24910	139	419	558
8	"8-out16121"	.32606	299	618	917
8	"8-out16122"	.19069	41	174	215
8	"8-out16123"	.17703	185	860	1045
8	"8-out16124"	.20836	956	3632	4588
8	"8-out16125"	.19353	964	4017	4981
8	"8-out16126"	.33802	120	235	355
8	"8-out16127"	.22346	80	278	358
8	"8-out16128"	.27220	95	254	349
8	"8-out16129"	.30946	134	299	433
8	"8-out16130"	.32480	368	765	1133
8	"8-out16131"	.36842	259	444	703
8	"8-out16132"	.25422	301	883	1184
8	"8-out16133"	.15575	69	374	443
8	"8-out16134"	.31152	100	221	321
8	"8-out16135"	.35135	104	192	296
8	"8-out16136"	.36440	258	450	708
8	"8-out16137"	.99642	279	1	280
8	"8-out16138"	.15587	65	352	417
8	"8-out16139"	.30232	26	60	86
8	"8-out16140"	.78640	324	88	412
8	"8-out16141"	.26678	151	415	566
8	"8-out16142"	.24741	695	2114	2809
8	"8-out16143"	.25000	35	105	140
8	"8-out16144"	.27768	168	437	605
8	"8-out16145"	.24561	154	473	627
8	"8-out16146"	.36470	31	54	85
8	"8-out16147"	.69042	707	317	1024
8	"8-out16148"	.21875	28	100	128
8	"8-out16149"	.68939	91	41	132
8	"8-out16150"	.29545	39	93	132
8	"8-out16151"	.18079	32	145	177
8	"8-out16152"	.47777	86	94	180
8	"8-out16153"	.22004	90	319	409
8	"8-out16154"	.18181	58	261	319
8	"8-out16155"	.73876	263	93	356
8	"8-out16156"	.99399	331	2	333
8	"8-out16157"	.22551	99	340	439
8	"8-out16158"	.27747	154	401	555
8	"8-out16159"	.40054	147	220	367
8	"8-out16160"	.85488	271	46	317
8	"8-out16161"	.21493	95	347	442
8	"8-out16162"	.16053	48	251	299
8	"8-out16163"	.38742	339	536	875
8	"8-out16164"	.46181	127	148	275
8	"8-out16165"	.23824	147	470	617
8	"8-out16166"	.24250	89	278	367
8	"8-out16167"	.30628	117	265	382
8	"8-out16168"	.62184	148	90	238
8	"8-out16169"	.23724	93	299	392
8	"8-out16170"	.24557	236	725	961
8	"8-out16171"	.23358	153	502	655
8	"8-out16172"	.36363	32	56	88
8	"8-out16173"	.26457	59	164	223
8	"8-out16174"	.98611	284	4	288
8	"8-out16175"	.27788	147	382	529
8	"8-out16176"	.26285	276	774	1050
8	"8-out16177"	.75342	770	252	1022
8	"8-out16178"	.24450	89	275	364
8	"8-out16179"	.32993	162	329	491
8	"8-out16180"	.35714	100	180	280
8	"8-out16181"	.10096	21	187	208
8	"8-out16182"	.26309	211	591	802
8	"8-out16183"	.41095	90	129	219
8	"8-out16184"	.20095	42	167	209
8	"8-out16185"	.86431	3510	551	4061
8	"8-out16186"	.30979	136	303	439
8	"8-out16187"	.99295	141	1	142
8	"8-out16188"	.16911	46	226	272
8	"8-out16189"	.24615	96	294	390
8	"8-out16190"	.44571	78	97	175
8	"8-out16191"	.93670	74	5	79
8	"8-out16192"	.39060	291	454	745
8	"8-out16193"	.98901	180	2	182
8	"8-out16194"	.99275	137	1	138
8	"8-out16195"	.98484	130	2	132
8	"8-out16196"	.39459	73	112	185
8	"8-out16197"	.63902	131	74	205
8	"8-out16198"	.32734	164	337	501
8	"8-out16199"	.58227	46	33	79
8	"8-out16200"	.31020	76	169	245
8	"8-out16201"	.24336	165	513	678
8	"8-out16202"	.23703	160	515	675
8	"8-out16203"	.47058	32	36	68
8	"8-out16204"	.21473	102	373	475
8	"8-out16205"	.38392	43	69	112
8	"8-out16206"	.31739	219	471	690
8	"8-out16207"	.16566	110	554	664
8	"8-out16208"	.31891	826	1764	2590
8	"8-out16209"	.32537	259	537	796
8	"8-out16210"	.24390	120	372	492
8	"8-out16211"	.54138	399	338	737
8	"8-out16212"	.28981	222	544	766
8	"8-out16213"	.29942	259	606	865
8	"8-out16214"	.17817	160	738	898
8	"8-out16215"	.16454	142	721	863
8	"8-out16216"	.96644	288	10	298
8	"8-out16217"	.98113	156	3	159
8	"8-out16218"	.66776	203	101	304
8	"8-out16219"	.71551	83	33	116
8	"8-out16220"	.69109	132	59	191
8	"8-out16221"	.68674	285	130	415
8	"8-out16222"	.30806	126	283	409
8	"8-out16223"	.98989	98	1	99
8	"8-out16224"	.26439	271	754	1025
8	"8-out16225"	.16258	93	479	572
8	"8-out16226"	.17482	100	472	572
8	"8-out16227"	.14035	80	490	570
8	"8-out16228"	.64510	369	203	572
8	"8-out16229"	.21631	122	442	564
8	"8-out16230"	.93233	248	18	266
8	"8-out16231"	.94736	252	14	266
8	"8-out16232"	.95112	253	13	266
8	"8-out16233"	.45657	205	244	449
8	"8-out16234"	.28832	237	585	822
8	"8-out16235"	.32702	242	498	740
8	"8-out16236"	.35950	174	310	484
8	"8-out16237"	.13766	72	451	523
8	"8-out16238"	.29079	139	339	478
8	"8-out16239"	.28343	142	359	501
8	"8-out16240"	.30340	223	512	735
8	"8-out16241"	.28832	252	622	874
8	"8-out16242"	.46840	126	143	269
8	"8-out16243"	.29571	131	312	443
8	"8-out16244"	.19730	88	358	446
8	"8-out16245"	.14446	64	379	443
8	"8-out16246"	.19750	79	321	400
8	"8-out16247"	.62740	293	174	467
8	"8-out16248"	.76939	367	110	477
8	"8-out16249"	.35439	230	419	649
8	"8-out16250"	.84468	310	57	367
8	"8-out16251"	.12912	47	317	364
8	"8-out16252"	.40684	107	156	263
8	"8-out16253"	.65502	150	79	229
8	"8-out16254"	.09538	31	294	325
8	"8-out16255"	.41666	130	182	312
8	"8-out16256"	.90425	170	18	188
8	"8-out16257"	.02525	5	193	198
8	"8-out16258"	.99248	132	1	133
8	"8-out16259"	.97058	33	1	34
8	"8-out16260"	.33333	117	234	351
8	"8-out16261"	.52717	97	87	184
8	"8-out16262"	.54666	82	68	150
8	"8-out16263"	.03791	8	203	211
8	"8-out16264"	.32124	372	786	1158
8	"8-out16265"	.67613	119	57	176
8	"8-out16266"	.87301	55	8	63
8	"8-out16267"	.19066	94	399	493
8	"8-out16268"	.81884	226	50	276
8	"8-out16269"	.31219	128	282	410
8	"8-out16270"	.30966	990	2207	3197
8	"8-out16271"	.70895	95	39	134
8	"8-out16272"	.20744	117	447	564
8	"8-out16273"	.15265	118	655	773
8	"8-out16274"	.24696	61	186	247
8	"8-out16275"	.79721	401	102	503
8	"8-out16276"	.97368	74	2	76
8	"8-out16277"	.98130	210	4	214
8	"8-out16278"	.66829	137	68	205
8	"8-out16279"	.37023	204	347	551
8	"8-out16280"	.98368	1628	27	1655
8	"8-out16281"	.26415	98	273	371
8	"8-out16282"	.40531	122	179	301
8	"8-out16283"	.12211	37	266	303
8	"8-out16284"	.19043	207	880	1087
8	"8-out16285"	.38461	60	96	156
8	"8-out16286"	.99099	110	1	111
8	"8-out16287"	.28443	223	561	784
8	"8-out16288"	.31944	46	98	144
8	"8-out16289"	.22830	321	1085	1406
8	"8-out16290"	.12000	21	154	175
8	"8-out16291"	.28156	165	421	586
8	"8-out16292"	.99441	356	2	358
8	"8-out16293"	.98165	107	2	109
8	"8-out16294"	.29223	192	465	657
8	"8-out16295"	.25068	92	275	367
8	"8-out16296"	.42494	385	521	906
8	"8-out16297"	.23943	170	540	710
8	"8-out16298"	.39130	351	546	897
8	"8-out16299"	.29939	197	461	658
8	"8-out16300"	.27386	109	289	398
8	"8-out16301"	.26515	70	194	264
8	"8-out16302"	.23680	480	1547	2027
8	"8-out16303"	.98648	146	2	148
8	"8-out16304"	.20251	193	760	953
8	"8-out16305"	.22692	177	603	780
8	"8-out16306"	.30337	54	124	178
8	"8-out16307"	.23346	286	939	1225
8	"8-out16308"	.29210	496	1202	1698
8	"8-out16309"	.99563	228	1	229
8	"8-out16310"	.36000	153	272	425
8	"8-out16311"	.99313	434	3	437
8	"8-out16312"	.29836	256	602	858
8	"8-out16313"	.32283	41	86	127
8	"8-out16314"	.27607	45	118	163
8	"8-out16315"	.31993	183	389	572
8	"8-out16316"	.70709	688	285	973
8	"8-out16317"	.39797	197	298	495
8	"8-out16318"	.99315	580	4	584
8	"8-out16319"	.99240	523	4	527
8	"8-out16320"	.67418	269	130	399
8	"8-out16321"	.34177	135	260	395
8	"8-out16322"	.44075	93	118	211
8	"8-out16323"	.31914	30	64	94
8	"8-out16324"	.42319	135	184	319
8	"8-out16325"	.45786	288	341	629
8	"8-out16326"	.24050	19	60	79
8	"8-out16327"	.95342	348	17	365
8	"8-out16328"	.92408	353	29	382
8	"8-out16329"	.92226	261	22	283
8	"8-out16330"	.38596	44	70	114
8	"8-out16331"	.37500	48	80	128
8	"8-out16332"	.19003	61	260	321
8	"8-out16333"	.51264	223	212	435
8	"8-out16334"	.32038	165	350	515
8	"8-out16335"	.15625	55	297	352
8	"8-out16336"	.18686	37	161	198
8	"8-out16337"	.73134	98	36	134
8	"8-out16338"	.97368	222	6	228
8	"8-out16339"	.88846	462	58	520
8	"8-out16340"	.36315	414	726	1140
8	"8-out16341"	.43512	218	283	501
8	"8-out16342"	.40026	3030	4540	7570
8	"8-out16343"	.98811	499	6	505
8	"8-out16344"	.36245	278	489	767
8	"8-out16345"	.23841	175	559	734
8	"8-out16346"	.84360	534	99	633
8	"8-out16347"	.68525	344	158	502
8	"8-out16348"	.98245	56	1	57
8	"8-out16349"	.52572	991	894	1885
8	"8-out16350"	.20917	114	431	545
8	"8-out16351"	.22770	166	563	729
8	"8-out16352"	.09126	23	229	252
8	"8-out16353"	.24230	126	394	520
8	"8-out16354"	.56616	261	200	461
8	"8-out16355"	.28644	112	279	391
8	"8-out16356"	.27480	385	1016	1401
8	"8-out16357"	.21574	137	498	635
8	"8-out16358"	.35464	233	424	657
8	"8-out16359"	.36658	430	743	1173
8	"8-out16360"	.25086	145	433	578
8	"8-out16361"	.25751	240	692	932
8	"8-out16362"	.31720	354	762	1116
8	"8-out16363"	.36277	345	606	951
8	"8-out16364"	.25280	293	866	1159
8	"8-out16365"	.22000	44	156	200
8	"8-out16366"	.31041	149	331	480
8	"8-out16367"	.69957	326	140	466
8	"8-out16368"	.25255	420	1243	1663
8	"8-out16369"	.33018	70	142	212
8	"8-out16370"	.33242	244	490	734
8	"8-out16371"	.99280	138	1	139
8	"8-out16372"	.98039	150	3	153
8	"8-out16373"	.99295	141	1	142
8	"8-out16374"	.59756	49	33	82
8	"8-out16375"	.44578	629	782	1411
8	"8-out16376"	.53061	234	207	441
8	"8-out16377"	.19683	112	457	569
8	"8-out16378"	.31347	121	265	386
8	"8-out16379"	.99134	458	4	462
8	"8-out16380"	.47809	371	405	776
8	"8-out16381"	.27890	702	1815	2517
8	"8-out16382"	.27601	252	661	913
8	"8-out16383"	.27472	75	198	273
8	"8-out16384"	.22972	34	114	148
8	"8-out16385"	.56291	85	66	151
8	"8-out16386"	.98823	168	2	170
8	"8-out16387"	.47183	67	75	142
8	"8-out16388"	.86454	217	34	251
8	"8-out16389"	.99288	279	2	281
8	"8-out16390"	.44273	402	506	908
8	"8-out16391"	.99090	327	3	330
8	"8-out16392"	.16551	120	605	725
8	"8-out16393"	.37288	176	296	472
8	"8-out16394"	.98734	78	1	79
8	"8-out16395"	.98734	156	2	158
8	"8-out16396"	.98734	156	2	158
8	"8-out16397"	.97916	141	3	144
8	"8-out16398"	.31979	63	134	197
8	"8-out16399"	.54013	323	275	598
8	"8-out16400"	.99453	182	1	183
8	"8-out16401"	.59302	51	35	86
8	"8-out16402"	.99403	500	3	503
8	"8-out16403"	.98863	87	1	88
8	"8-out16404"	.32780	178	365	543
8	"8-out16405"	.21681	49	177	226
8	"8-out16406"	.24024	80	253	333
8	"8-out16407"	.26691	71	195	266
8	"8-out16408"	.28205	77	196	273
8	"8-out16409"	.26536	95	263	358
8	"8-out16410"	.27586	72	189	261
8	"8-out16411"	.70967	198	81	279
8	"8-out16412"	.18503	47	207	254
8	"8-out16413"	.25806	96	276	372
8	"8-out16414"	.25099	63	188	251
8	"8-out16415"	.29720	85	201	286
8	"8-out16416"	.17112	32	155	187
8	"8-out16417"	.30492	254	579	833
8	"8-out16418"	.22656	145	495	640
8	"8-out16419"	.60446	677	443	1120
8	"8-out16420"	.56357	164	127	291
8	"8-out16421"	.35820	72	129	201
8	"8-out16422"	.87572	303	43	346
8	"8-out16423"	.16816	56	277	333
8	"8-out16424"	.46764	159	181	340
8	"8-out16425"	.20428	248	966	1214
8	"8-out16426"	.96223	1223	48	1271
8	"8-out16427"	.35555	112	203	315
8	"8-out16428"	.21917	64	228	292
8	"8-out16429"	.25000	65	195	260
8	"8-out16430"	.34426	84	160	244
8	"8-out16431"	.32203	285	600	885
8	"8-out16432"	.54930	752	617	1369
8	"8-out16433"	.67114	100	49	149
8	"8-out16434"	.52000	195	180	375
8	"8-out16435"	.18421	49	217	266
8	"8-out16436"	.21459	147	538	685
8	"8-out16437"	.22648	65	222	287
8	"8-out16438"	.08571	15	160	175
8	"8-out16439"	.37282	365	614	979
8	"8-out16440"	.56181	459	358	817
8	"8-out16441"	.37706	319	527	846
8	"8-out16442"	.26159	502	1417	1919
8	"8-out16443"	.44947	258	316	574
8	"8-out16444"	.15943	680	3585	4265
8	"8-out16445"	.39405	106	163	269
8	"8-out16446"	.18479	141	622	763
8	"8-out16447"	.30044	1294	3013	4307
8	"8-out16448"	.25287	1142	3374	4516
8	"8-out16449"	.93582	175	12	187
8	"8-out16450"	.39847	1778	2684	4462
8	"8-out16451"	.10544	62	526	588
8	"8-out16452"	.23300	216	711	927
8	"8-out16453"	.25586	120	349	469
8	"8-out16454"	.13529	46	294	340
8	"8-out16455"	.19080	166	704	870
8	"8-out16456"	.18235	62	278	340
8	"8-out16457"	.16455	143	726	869
8	"8-out16458"	.20370	110	430	540
8	"8-out16459"	.16640	104	521	625
8	"8-out16460"	.27522	120	316	436
8	"8-out16461"	.22727	115	391	506
8	"8-out16462"	.17521	468	2203	2671
8	"8-out16463"	.42523	182	246	428
8	"8-out16464"	.25342	111	327	438
8	"8-out16465"	.30684	139	314	453
8	"8-out16466"	.50930	219	211	430
8	"8-out16467"	.98913	364	4	368
8	"8-out16468"	.23725	214	688	902
8	"8-out16469"	.32745	297	610	907
8	"8-out16470"	.22938	153	514	667
8	"8-out16471"	.37011	379	645	1024
8	"8-out16472"	.39204	207	321	528
8	"8-out16473"	.26937	490	1329	1819
8	"8-out16474"	.44272	344	433	777
8	"8-out16475"	.32584	58	120	178
8	"8-out16476"	.93725	956	64	1020
8	"8-out16477"	.37965	153	250	403
8	"8-out16478"	.26376	182	508	690
8	"8-out16479"	.32923	241	491	732
8	"8-out16480"	.22455	139	480	619
8	"8-out16481"	.55591	343	274	617
8	"8-out16482"	.99185	487	4	491
8	"8-out16483"	.25314	141	416	557
8	"8-out16484"	.37974	60	98	158
8	"8-out16485"	.46250	74	86	160
8	"8-out16486"	.54183	136	115	251
8	"8-out16487"	.39207	89	138	227
8	"8-out16488"	.25420	121	355	476
8	"8-out16489"	.99350	612	4	616
8	"8-out16490"	.10232	22	193	215
8	"8-out16491"	.50000	110	110	220
8	"8-out16492"	.24929	88	265	353
8	"8-out16493"	.34595	137	259	396
8	"8-out16494"	.31719	131	282	413
8	"8-out16495"	.15895	79	418	497
8	"8-out16496"	.63574	281	161	442
8	"8-out16497"	.54655	452	375	827
8	"8-out16498"	.95815	664	29	693
8	"8-out16499"	.31552	124	269	393
8	"8-out16500"	.45581	98	117	215
8	"8-out16501"	.33649	142	280	422
8	"8-out16502"	.16853	30	148	178
8	"8-out16503"	.98076	102	2	104
8	"8-out16504"	.99462	185	1	186
8	"8-out16505"	.97297	216	6	222
8	"8-out16506"	.97820	718	16	734
8	"8-out16507"	.26199	142	400	542
8	"8-out16508"	.24783	200	607	807
8	"8-out16509"	.28195	225	573	798
8	"8-out16510"	.21755	114	410	524
8	"8-out16511"	.28358	76	192	268
8	"8-out16512"	.98750	395	5	400
8	"8-out16513"	.30434	63	144	207
8	"8-out16514"	.29428	103	247	350
8	"8-out16515"	.25917	240	686	926
8	"8-out16516"	.13777	62	388	450
8	"8-out16517"	.52144	231	212	443
8	"8-out16518"	.95901	351	15	366
8	"8-out16519"	.24464	80	247	327
8	"8-out16520"	.21818	60	215	275
8	"8-out16521"	.25000	66	198	264
8	"8-out16522"	.95145	196	10	206
8	"8-out16523"	.25618	870	2526	3396
8	"8-out16524"	.74093	143	50	193
8	"8-out16525"	.20103	39	155	194
8	"8-out16526"	.26136	161	455	616
8	"8-out16527"	.30612	45	102	147
8	"8-out16528"	.63522	101	58	159
8	"8-out16529"	.46405	71	82	153
8	"8-out16530"	.98969	192	2	194
8	"8-out16531"	.97354	184	5	189
8	"8-out16532"	.99470	188	1	189
8	"8-out16533"	.99470	188	1	189
8	"8-out16534"	.99470	188	1	189
8	"8-out16535"	.99470	188	1	189
8	"8-out16536"	.99470	188	1	189
8	"8-out16537"	.99470	188	1	189
8	"8-out16538"	.98125	157	3	160
8	"8-out16539"	.35557	325	589	914
8	"8-out16540"	.30467	202	461	663
8	"8-out16541"	.44566	324	403	727
8	"8-out16542"	.78426	349	96	445
8	"8-out16543"	.90469	674	71	745
8	"8-out16544"	.99367	157	1	158
8	"8-out16545"	.97425	757	20	777
8	"8-out16546"	.75621	152	49	201
8	"8-out16547"	.16071	72	376	448
8	"8-out16548"	.33537	219	434	653
8	"8-out16549"	.19395	122	507	629
8	"8-out16550"	.25040	155	464	619
8	"8-out16551"	.22388	60	208	268
8	"8-out16552"	.99152	468	4	472
8	"8-out16553"	.30451	243	555	798
8	"8-out16554"	.65804	229	119	348
8	"8-out16555"	.33592	173	342	515
8	"8-out16556"	.15909	154	814	968
8	"8-out16557"	.23887	102	325	427
8	"8-out16558"	.45679	37	44	81
8	"8-out16559"	.99285	139	1	140
8	"8-out16560"	.89189	66	8	74
8	"8-out16561"	.26470	117	325	442
8	"8-out16562"	.99393	164	1	165
8	"8-out16563"	.99006	299	3	302
8	"8-out16564"	.47474	1720	1903	3623
8	"8-out16565"	.99134	458	4	462
8	"8-out16566"	.30662	88	199	287
8	"8-out16567"	.99352	460	3	463
8	"8-out16568"	.30469	227	518	745
8	"8-out16569"	.32960	59	120	179
8	"8-out16570"	.27517	235	619	854
8	"8-out16571"	.46111	166	194	360
8	"8-out16572"	.45114	628	764	1392
8	"8-out16573"	.21397	49	180	229
8	"8-out16574"	.56666	85	65	150
8	"8-out16575"	.24137	210	660	870
8	"8-out16576"	.57291	55	41	96
8	"8-out16577"	.39961	205	308	513
8	"8-out16578"	.97272	214	6	220
8	"8-out16579"	.97916	188	4	192
8	"8-out16580"	.28026	213	547	760
8	"8-out16581"	.47449	307	340	647
8	"8-out16582"	.27568	110	289	399
8	"8-out16583"	.35263	67	123	190
8	"8-out16584"	.21904	23	82	105
8	"8-out16585"	.24791	119	361	480
8	"8-out16586"	.35012	139	258	397
8	"8-out16587"	.87352	297	43	340
8	"8-out16588"	.85517	124	21	145
8	"8-out16589"	.42718	132	177	309
8	"8-out16590"	.33134	167	337	504
8	"8-out16591"	.96691	263	9	272
8	"8-out16592"	.89370	227	27	254
8	"8-out16593"	.90588	231	24	255
8	"8-out16594"	.16875	121	596	717
8	"8-out16595"	.17966	76	347	423
8	"8-out16596"	.98994	394	4	398
8	"8-out16597"	.25986	112	319	431
8	"8-out16598"	.18907	45	193	238
8	"8-out16599"	.40540	90	132	222
8	"8-out16600"	.25590	65	189	254
8	"8-out16601"	.12863	31	210	241
8	"8-out16602"	.14336	80	478	558
8	"8-out16603"	.25648	89	258	347
8	"8-out16604"	.33421	126	251	377
8	"8-out16605"	.23232	46	152	198
8	"8-out16606"	.26015	173	492	665
8	"8-out16607"	.25068	92	275	367
8	"8-out16608"	.98395	368	6	374
8	"8-out16609"	.31850	136	291	427
8	"8-out16610"	.58400	73	52	125
8	"8-out16611"	.33136	224	452	676
8	"8-out16612"	.21176	950	3536	4486
8	"8-out16613"	.38565	258	411	669
8	"8-out16614"	.36921	319	545	864
8	"8-out16615"	.37834	269	442	711
8	"8-out16616"	.19402	39	162	201
8	"8-out16617"	.31506	161	350	511
8	"8-out16618"	.08727	48	502	550
8	"8-out16619"	.99196	247	2	249
8	"8-out16620"	.30942	151	337	488
8	"8-out16621"	.18604	72	315	387
8	"8-out16622"	.19001	198	844	1042
8	"8-out16623"	.41161	163	233	396
8	"8-out16624"	.13821	51	318	369
8	"8-out16625"	.31564	119	258	377
8	"8-out16626"	.19488	61	252	313
8	"8-out16627"	.32288	103	216	319
8	"8-out16628"	.27525	188	495	683
8	"8-out16629"	.41150	93	133	226
8	"8-out16630"	.27662	200	523	723
8	"8-out16631"	.27920	490	1265	1755
8	"8-out16632"	.33769	129	253	382
8	"8-out16633"	.27893	294	760	1054
8	"8-out16634"	.24197	113	354	467
8	"8-out16635"	.28867	306	754	1060
8	"8-out16636"	.29036	205	501	706
8	"8-out16637"	.26169	207	584	791
8	"8-out16638"	.24869	238	719	957
8	"8-out16639"	.96141	598	24	622
8	"8-out16640"	.32567	241	499	740
8	"8-out16641"	.21647	134	485	619
8	"8-out16642"	.25454	56	164	220
8	"8-out16643"	.20539	99	383	482
8	"8-out16644"	.25882	88	252	340
8	"8-out16645"	.64406	190	105	295
8	"8-out16646"	.54377	118	99	217
8	"8-out16647"	.37616	161	267	428
8	"8-out16648"	.27777	110	286	396
8	"8-out16649"	.72058	147	57	204
8	"8-out16650"	.11418	33	256	289
8	"8-out16651"	.27304	77	205	282
8	"8-out16652"	.91975	298	26	324
8	"8-out16653"	.38575	130	207	337
8	"8-out16654"	.24137	84	264	348
8	"8-out16655"	.72392	236	90	326
8	"8-out16656"	.12931	30	202	232
8	"8-out16657"	.39013	87	136	223
8	"8-out16658"	.61674	383	238	621
8	"8-out16659"	.22614	109	373	482
8	"8-out16660"	.14705	60	348	408
8	"8-out16661"	.86567	290	45	335
8	"8-out16662"	.36223	188	331	519
8	"8-out16663"	.95785	250	11	261
8	"8-out16664"	.70149	188	80	268
8	"8-out16665"	.85409	240	41	281
8	"8-out16666"	.92173	212	18	230
8	"8-out16667"	.17571	55	258	313
8	"8-out16668"	.19135	93	393	486
8	"8-out16669"	.18045	48	218	266
8	"8-out16670"	.59885	209	140	349
8	"8-out16671"	.25352	90	265	355
8	"8-out16672"	.17630	61	285	346
8	"8-out16673"	.16806	60	297	357
8	"8-out16674"	.99611	513	2	515
8	"8-out16675"	.22382	62	215	277
8	"8-out16676"	.23509	71	231	302
8	"8-out16677"	.27471	528	1394	1922
8	"8-out16678"	.27581	187	491	678
8	"8-out16679"	.23199	277	917	1194
8	"8-out16680"	.25418	91	267	358
8	"8-out16681"	.23214	52	172	224
8	"8-out16682"	.07843	20	235	255
8	"8-out16683"	.43485	257	334	591
8	"8-out16684"	.80169	566	140	706
8	"8-out16685"	.31535	76	165	241
8	"8-out16686"	.21621	104	377	481
8	"8-out16687"	.70634	178	74	252
8	"8-out16688"	.96470	164	6	170
8	"8-out16689"	.98984	195	2	197
8	"8-out16690"	.23463	168	548	716
8	"8-out16691"	.85373	572	98	670
8	"8-out16692"	.97058	33	1	34
8	"8-out16693"	.99699	664	2	666
8	"8-out16694"	.46549	317	364	681
8	"8-out16695"	.34090	300	580	880
8	"8-out16696"	.35878	249	445	694
8	"8-out16697"	.24495	170	524	694
8	"8-out16698"	.97386	559	15	574
8	"8-out16699"	.16986	752	3675	4427
8	"8-out16700"	.24521	1101	3389	4490
8	"8-out16701"	.22471	20	69	89
8	"8-out16702"	.86725	98	15	113
8	"8-out16703"	.30328	249	572	821
8	"8-out16704"	.54639	53	44	97
8	"8-out16705"	.34259	222	426	648
8	"8-out16706"	.17798	76	351	427
8	"8-out16707"	.50554	319	312	631
8	"8-out16708"	.16095	47	245	292
8	"8-out16709"	.48800	183	192	375
8	"8-out16710"	.23963	688	2183	2871
8	"8-out16711"	.99090	218	2	220
8	"8-out16712"	.20986	166	625	791
8	"8-out16713"	.18000	54	246	300
8	"8-out16714"	.49259	133	137	270
8	"8-out16715"	.90647	252	26	278
8	"8-out16716"	.28066	389	997	1386
8	"8-out16717"	.19191	38	160	198
8	"8-out16718"	.17186	270	1301	1571
8	"8-out16719"	.23325	101	332	433
8	"8-out16720"	.24343	371	1153	1524
8	"8-out16721"	.25760	144	415	559
8	"8-out16722"	.31252	701	1542	2243
8	"8-out16723"	.21932	84	299	383
8	"8-out16724"	.09266	24	235	259
8	"8-out16725"	.33536	110	218	328
8	"8-out16726"	.31128	80	177	257
8	"8-out16727"	.27882	104	269	373
8	"8-out16728"	.89215	91	11	102
8	"8-out16729"	.23754	62	199	261
8	"8-out16730"	.31291	950	2086	3036
8	"8-out16731"	.22266	334	1166	1500
8	"8-out16732"	.16367	82	419	501
8	"8-out16733"	.15101	156	877	1033
8	"8-out16734"	.27507	181	477	658
8	"8-out16735"	.93848	534	35	569
8	"8-out16736"	.40108	221	330	551
8	"8-out16737"	.99082	108	1	109
8	"8-out16738"	.28728	495	1228	1723
8	"8-out16739"	.73804	2192	778	2970
8	"8-out16740"	.54822	108	89	197
8	"8-out16741"	.36379	406	710	1116
8	"8-out16742"	.27141	225	604	829
8	"8-out16743"	.50505	50	49	99
8	"8-out16744"	.44482	129	161	290
8	"8-out16745"	.37142	156	264	420
8	"8-out16746"	.33111	149	301	450
8	"8-out16747"	.33100	142	287	429
8	"8-out16748"	.28012	179	460	639
8	"8-out16749"	.23114	95	316	411
8	"8-out16750"	.43352	150	196	346
8	"8-out16751"	.87188	245	36	281
8	"8-out16752"	.32183	56	118	174
8	"8-out16753"	.14906	48	274	322
8	"8-out16754"	.22104	229	807	1036
8	"8-out16755"	.27983	68	175	243
8	"8-out16756"	.99191	368	3	371
8	"8-out16757"	.20094	255	1014	1269
8	"8-out16758"	.17934	158	723	881
8	"8-out16759"	.31542	317	688	1005
8	"8-out16760"	.29058	213	520	733
8	"8-out16761"	.39222	353	547	900
8	"8-out16762"	.99775	445	1	446
8	"8-out16763"	.28571	64	160	224
8	"8-out16764"	.40856	525	760	1285
8	"8-out16765"	.53333	64	56	120
8	"8-out16766"	.20967	169	637	806
8	"8-out16767"	.98717	77	1	78
8	"8-out16768"	.99212	126	1	127
8	"8-out16769"	.19512	112	462	574
8	"8-out16770"	.92810	142	11	153
8	"8-out16771"	.14821	83	477	560
8	"8-out16772"	.21632	771	2793	3564
8	"8-out16773"	.18210	635	2852	3487
8	"8-out16774"	.24008	890	2817	3707
8	"8-out16775"	.27777	85	221	306
8	"8-out16776"	.89473	187	22	209
8	"8-out16777"	.43859	25	32	57
8	"8-out16778"	.20129	155	615	770
8	"8-out16779"	.29223	237	574	811
8	"8-out16780"	.33121	416	840	1256
8	"8-out16781"	.78899	602	161	763
8	"8-out16782"	.65400	310	164	474
8	"8-out16783"	.28424	83	209	292
8	"8-out16784"	.46864	142	161	303
8	"8-out16785"	.33885	184	359	543
8	"8-out16786"	.16062	31	162	193
8	"8-out16787"	.16291	94	483	577
8	"8-out16788"	.60000	87	58	145
8	"8-out16789"	.30027	109	254	363
8	"8-out16790"	.17887	171	785	956
8	"8-out16791"	.33587	88	174	262
8	"8-out16792"	.25454	42	123	165
8	"8-out16793"	.49664	74	75	149
8	"8-out16794"	.97058	99	3	102
8	"8-out16795"	.25403	299	878	1177
8	"8-out16796"	.33057	40	81	121
8	"8-out16797"	.99444	179	1	180
8	"8-out16798"	.97297	72	2	74
8	"8-out16799"	.98198	763	14	777
8	"8-out16800"	.98198	763	14	777
8	"8-out16801"	.98664	517	7	524
8	"8-out16802"	.35893	229	409	638
8	"8-out16803"	.12096	45	327	372
8	"8-out16804"	.25517	37	108	145
8	"8-out16805"	.42519	54	73	127
8	"8-out16806"	.24864	230	695	925
8	"8-out16807"	.42198	403	552	955
8	"8-out16808"	.53174	67	59	126
8	"8-out16809"	.23210	321	1062	1383
8	"8-out16810"	.29347	54	130	184
8	"8-out16811"	.34944	94	175	269
8	"8-out16812"	.97058	264	8	272
8	"8-out16813"	.97560	280	7	287
8	"8-out16814"	.47857	67	73	140
8	"8-out16815"	.29729	143	338	481
8	"8-out16816"	.22222	40	140	180
8	"8-out16817"	.17854	243	1118	1361
8	"8-out16818"	.40590	1264	1850	3114
8	"8-out16819"	.62348	154	93	247
8	"8-out16820"	.62000	310	190	500
8	"8-out16821"	.54741	583	482	1065
8	"8-out16822"	.19186	33	139	172
8	"8-out16823"	.39872	187	282	469
8	"8-out16824"	.26701	51	140	191
8	"8-out16825"	.34920	110	205	315
8	"8-out16826"	.30955	204	455	659
8	"8-out16827"	.30478	210	479	689
8	"8-out16828"	.99218	127	1	128
8	"8-out16829"	.40085	281	420	701
8	"8-out16830"	.36633	37	64	101
8	"8-out16831"	.44647	171	212	383
8	"8-out16832"	.37586	109	181	290
8	"8-out16833"	.42468	234	317	551
8	"8-out16834"	.36328	93	163	256
8	"8-out16835"	.29587	258	614	872
8	"8-out16836"	.97777	88	2	90
8	"8-out16837"	.96932	158	5	163
8	"8-out16838"	.45514	137	164	301
8	"8-out16839"	.29527	437	1043	1480
8	"8-out16840"	.99019	101	1	102
8	"8-out16841"	.29383	124	298	422
8	"8-out16842"	.30192	157	363	520
8	"8-out16843"	.35526	27	49	76
8	"8-out16844"	.29811	79	186	265
8	"8-out16845"	.99310	144	1	145
8	"8-out16846"	.25867	82	235	317
8	"8-out16847"	.30845	124	278	402
8	"8-out16848"	.24242	32	100	132
8	"8-out16849"	.27986	171	440	611
8	"8-out16850"	.97755	479	11	490
8	"8-out16851"	.98163	481	9	490
8	"8-out16852"	.98412	496	8	504
8	"8-out16853"	.87786	460	64	524
8	"8-out16854"	.87819	447	62	509
8	"8-out16855"	.27766	138	359	497
8	"8-out16856"	.48044	86	93	179
8	"8-out16857"	.42028	58	80	138
8	"8-out16858"	.19205	29	122	151
8	"8-out16859"	.23357	32	105	137
8	"8-out16860"	.56462	83	64	147
8	"8-out16861"	.50000	25	25	50
8	"8-out16862"	.22535	144	495	639
8	"8-out16863"	.99470	188	1	189
8	"8-out16864"	.99470	188	1	189
8	"8-out16865"	.99470	188	1	189
8	"8-out16866"	.43382	59	77	136
8	"8-out16867"	.99024	203	2	205
8	"8-out16868"	.56612	244	187	431
8	"8-out16869"	.26659	241	663	904
8	"8-out16870"	.29318	129	311	440
8	"8-out16871"	.32472	88	183	271
8	"8-out16872"	.32410	316	659	975
8	"8-out16873"	.98198	763	14	777
8	"8-out16874"	.38108	133	216	349
8	"8-out16875"	.24651	53	162	215
8	"8-out16876"	.14447	102	604	706
8	"8-out16877"	.36213	88	155	243
8	"8-out16878"	.24080	144	454	598
8	"8-out16879"	.22809	164	555	719
8	"8-out16880"	.29330	149	359	508
8	"8-out16881"	.98136	158	3	161
8	"8-out16882"	.81368	214	49	263
8	"8-out16883"	.87072	229	34	263
8	"8-out16884"	.99245	526	4	530
8	"8-out16885"	.21564	193	702	895
8	"8-out16886"	.24583	192	589	781
8	"8-out16887"	.40336	96	142	238
8	"8-out16888"	.07407	6	75	81
8	"8-out16889"	.98765	80	1	81
8	"8-out16890"	.33333	36	72	108
8	"8-out16891"	.41614	134	188	322
8	"8-out16892"	.13698	30	189	219
8	"8-out16893"	.55882	114	90	204
8	"8-out16894"	.94230	49	3	52
8	"8-out16895"	.98412	124	2	126
8	"8-out16896"	.98437	63	1	64
8	"8-out16897"	.98701	76	1	77
8	"8-out16898"	.98305	58	1	59
8	"8-out16899"	.96363	53	2	55
8	"8-out16900"	.31421	389	849	1238
8	"8-out16901"	.35286	271	497	768
8	"8-out16902"	.31410	245	535	780
8	"8-out16903"	.98222	221	4	225
8	"8-out16904"	.54337	238	200	438
8	"8-out16905"	.98387	61	1	62
8	"8-out16906"	.24850	373	1128	1501
8	"8-out16907"	.99200	124	1	125
8	"8-out16908"	.99221	510	4	514
8	"8-out16909"	.91743	100	9	109
8	"8-out16910"	.90990	202	20	222
8	"8-out16911"	.52577	51	46	97
8	"8-out16912"	.66867	222	110	332
8	"8-out16913"	.99074	107	1	108
8	"8-out16914"	.99074	107	1	108
8	"8-out16915"	.99425	173	1	174
8	"8-out16916"	.21744	192	691	883
8	"8-out16917"	.34072	123	238	361
8	"8-out16918"	.34366	122	233	355
8	"8-out16919"	.69879	58	25	83
8	"8-out16920"	.97530	79	2	81
8	"8-out16921"	.57017	65	49	114
8	"8-out16922"	.29824	102	240	342
8	"8-out16923"	.52571	184	166	350
8	"8-out16924"	.36771	82	141	223
8	"8-out16925"	.93457	100	7	107
8	"8-out16926"	.54867	62	51	113
8	"8-out16927"	.27789	264	686	950
8	"8-out16928"	.27607	180	472	652
8	"8-out16929"	.39240	186	288	474
8	"8-out16930"	.44954	147	180	327
8	"8-out16931"	.33818	93	182	275
8	"8-out16932"	.28037	120	308	428
8	"8-out16933"	.20270	90	354	444
8	"8-out16934"	.23655	22	71	93
8	"8-out16935"	.34166	41	79	120
8	"8-out16936"	.22006	68	241	309
8	"8-out16937"	.38888	105	165	270
8	"8-out16938"	.97965	337	7	344
8	"8-out16939"	.27565	94	247	341
8	"8-out16940"	.19362	164	683	847
8	"8-out16941"	.17600	66	309	375
8	"8-out16942"	.91250	73	7	80
8	"8-out16943"	.21666	65	235	300
8	"8-out16944"	.45876	178	210	388
8	"8-out16945"	.27142	152	408	560
8	"8-out16946"	.83415	337	67	404
8	"8-out16947"	.98571	207	3	210
8	"8-out16948"	.72095	602	233	835
8	"8-out16949"	.32663	65	134	199
8	"8-out16950"	.29378	156	375	531
8	"8-out16951"	.31184	179	395	574
8	"8-out16952"	.27699	59	154	213
8	"8-out16953"	.29629	88	209	297
8	"8-out16954"	.98936	186	2	188
8	"8-out16955"	.82945	214	44	258
8	"8-out16956"	.19257	109	457	566
8	"8-out16957"	.19251	36	151	187
8	"8-out16958"	.23517	119	387	506
8	"8-out16959"	.35135	208	384	592
8	"8-out16960"	.41228	705	1005	1710
8	"8-out16961"	.19194	286	1204	1490
8	"8-out16962"	.32075	51	108	159
8	"8-out16963"	.25591	119	346	465
8	"8-out16964"	.19162	87	367	454
8	"8-out16965"	.62825	169	100	269
8	"8-out16966"	.18750	15	65	80
8	"8-out16967"	.52234	187	171	358
8	"8-out16968"	.36434	94	164	258
8	"8-out16969"	.36627	126	218	344
8	"8-out16970"	.99496	593	3	596
8	"8-out16971"	.95904	281	12	293
8	"8-out16972"	.31818	959	2055	3014
8	"8-out16973"	.41592	141	198	339
8	"8-out16974"	.33000	99	201	300
8	"8-out16975"	.44502	1202	1499	2701
8	"8-out16976"	.18181	16	72	88
8	"8-out16977"	.18750	72	312	384
8	"8-out16978"	.32258	20	42	62
8	"8-out16979"	.94076	270	17	287
8	"8-out16980"	.48653	578	610	1188
8	"8-out16981"	.36065	88	156	244
8	"8-out16982"	.29568	89	212	301
8	"8-out16983"	.39817	131	198	329
8	"8-out16984"	.21932	252	897	1149
8	"8-out16985"	.17812	57	263	320
8	"8-out16986"	.25765	101	291	392
8	"8-out16987"	.36655	228	394	622
8	"8-out16988"	.32523	883	1832	2715
8	"8-out16989"	.43796	233	299	532
8	"8-out16990"	.99644	3085	11	3096
8	"8-out16991"	.52173	60	55	115
8	"8-out16992"	.29081	326	795	1121
8	"8-out16993"	.39285	121	187	308
8	"8-out16994"	.98039	100	2	102
8	"8-out16995"	.57011	309	233	542
8	"8-out16996"	.83000	83	17	100
8	"8-out16997"	.37288	220	370	590
8	"8-out16998"	.14689	26	151	177
8	"8-out16999"	.97540	238	6	244
8	"8-out17000"	.97530	79	2	81
8	"8-out17001"	.30691	213	481	694
8	"8-out17002"	.24347	140	435	575
8	"8-out17003"	.21237	127	471	598
8	"8-out17004"	.55826	618	489	1107
8	"8-out17005"	.99360	466	3	469
8	"8-out17006"	.34120	159	307	466
8	"8-out17007"	.13084	14	93	107
8	"8-out17008"	.16841	385	1901	2286
8	"8-out17009"	.36242	191	336	527
8	"8-out17010"	.38775	57	90	147
8	"8-out17011"	.29914	35	82	117
8	"8-out17012"	.23890	296	943	1239
8	"8-out17013"	.20618	100	385	485
8	"8-out17014"	.23666	346	1116	1462
8	"8-out17015"	.35522	119	216	335
8	"8-out17016"	.22956	132	443	575
8	"8-out17017"	.47570	235	259	494
8	"8-out17018"	.34444	310	590	900
8	"8-out17019"	.32527	175	363	538
8	"8-out17020"	.75757	1200	384	1584
8	"8-out17021"	.98734	78	1	79
8	"8-out17022"	.89492	494	58	552
8	"8-out17023"	.83076	270	55	325
8	"8-out17024"	.44785	292	360	652
8	"8-out17025"	.45000	162	198	360
8	"8-out17026"	.50561	90	88	178
8	"8-out17027"	.38858	286	450	736
8	"8-out17028"	.35416	323	589	912
8	"8-out17029"	.17584	150	703	853
8	"8-out17030"	.29533	114	272	386
8	"8-out17031"	.24540	387	1190	1577
8	"8-out17032"	.19121	309	1307	1616
8	"8-out17033"	.20842	99	376	475
8	"8-out17034"	.50000	87	87	174
8	"8-out17035"	.12222	44	316	360
8	"8-out17036"	.22437	81	280	361
8	"8-out17037"	.63576	192	110	302
8	"8-out17038"	.38461	115	184	299
8	"8-out17039"	.27540	84	221	305
8	"8-out17040"	.33600	84	166	250
8	"8-out17041"	.38461	105	168	273
8	"8-out17042"	.31107	680	1506	2186
8	"8-out17043"	.70139	1454	619	2073
8	"8-out17044"	.16500	66	334	400
8	"8-out17045"	.82766	341	71	412
8	"8-out17046"	.22198	414	1451	1865
8	"8-out17047"	.18360	336	1494	1830
8	"8-out17048"	.15714	319	1711	2030
8	"8-out17049"	.29704	584	1382	1966
8	"8-out17050"	.22032	412	1458	1870
8	"8-out17051"	.21690	444	1603	2047
8	"8-out17052"	.26308	563	1577	2140
8	"8-out17053"	.25154	528	1571	2099
8	"8-out17054"	.24117	499	1570	2069
8	"8-out17055"	.42715	129	173	302
8	"8-out17056"	.64656	311	170	481
8	"8-out17057"	.20631	85	327	412
8	"8-out17058"	.37701	187	309	496
8	"8-out17059"	.22699	74	252	326
8	"8-out17060"	.18954	58	248	306
8	"8-out17061"	.16616	55	276	331
8	"8-out17062"	.42658	215	289	504
8	"8-out17063"	.21747	117	421	538
8	"8-out17064"	.51413	291	275	566
8	"8-out17065"	.26774	660	1805	2465
8	"8-out17066"	.22497	517	1781	2298
8	"8-out17067"	.99152	117	1	118
8	"8-out17068"	.14910	92	525	617
8	"8-out17069"	.02521	6	232	238
8	"8-out17070"	.25048	385	1152	1537
8	"8-out17071"	.21282	73	270	343
8	"8-out17072"	.19687	63	257	320
8	"8-out17073"	.35825	254	455	709
8	"8-out17074"	.26807	178	486	664
8	"8-out17075"	.99186	122	1	123
8	"8-out17076"	.40384	105	155	260
8	"8-out17077"	.53488	138	120	258
8	"8-out17078"	.89534	154	18	172
8	"8-out17079"	.12807	26	177	203
8	"8-out17080"	.98053	403	8	411
8	"8-out17081"	.30041	146	340	486
8	"8-out17082"	.28278	138	350	488
8	"8-out17083"	.37368	142	238	380
8	"8-out17084"	.38095	144	234	378
8	"8-out17085"	.22347	99	344	443
8	"8-out17086"	.64417	315	174	489
8	"8-out17087"	.93589	73	5	78
8	"8-out17088"	.67073	55	27	82
8	"8-out17089"	.43157	123	162	285
8	"8-out17090"	.26217	70	197	267
8	"8-out17091"	.44469	201	251	452
8	"8-out17092"	.40769	106	154	260
8	"8-out17093"	.48809	41	43	84
8	"8-out17094"	.54347	50	42	92
8	"8-out17095"	.13963	31	191	222
8	"8-out17096"	.23928	67	213	280
8	"8-out17097"	.48314	43	46	89
8	"8-out17098"	.48214	54	58	112
8	"8-out17099"	.06763	14	193	207
8	"8-out17100"	.65853	81	42	123
8	"8-out17101"	.45258	210	254	464
8	"8-out17102"	.25113	111	331	442
8	"8-out17103"	.38775	57	90	147
8	"8-out17104"	.99074	214	2	216
8	"8-out17105"	.98091	257	5	262
8	"8-out17106"	.54918	134	110	244
8	"8-out17107"	.73504	516	186	702
8	"8-out17108"	.41720	194	271	465
8	"8-out17109"	.26273	98	275	373
8	"8-out17110"	.26442	110	306	416
8	"8-out17111"	.50909	140	135	275
8	"8-out17112"	.63888	483	273	756
8	"8-out17113"	.30864	25	56	81
8	"8-out17114"	.19298	11	46	57
8	"8-out17115"	.28129	182	465	647
8	"8-out17116"	.36538	190	330	520
8	"8-out17117"	.32456	111	231	342
8	"8-out17118"	.30446	232	530	762
8	"8-out17119"	.29695	117	277	394
8	"8-out17120"	.26727	205	562	767
8	"8-out17121"	.45318	121	146	267
8	"8-out17122"	.49455	227	232	459
8	"8-out17123"	.34824	179	335	514
8	"8-out17124"	.17670	135	629	764
8	"8-out17125"	.16580	32	161	193
8	"8-out17126"	.99242	131	1	132
8	"8-out17127"	.99563	228	1	229
8	"8-out17128"	.33187	76	153	229
8	"8-out17129"	.98260	226	4	230
8	"8-out17130"	.84657	309	56	365
8	"8-out17131"	.96791	181	6	187
8	"8-out17132"	.96969	160	5	165
8	"8-out17133"	.13173	22	145	167
8	"8-out17134"	.99145	116	1	117
8	"8-out17135"	.23277	98	323	421
8	"8-out17136"	.43814	85	109	194
8	"8-out17137"	.92067	325	28	353
8	"8-out17138"	.23337	172	565	737
8	"8-out17139"	.23101	1098	3655	4753
8	"8-out17140"	.33165	66	133	199
8	"8-out17141"	.13756	26	163	189
8	"8-out17142"	.76322	303	94	397
8	"8-out17143"	.17475	72	340	412
8	"8-out17144"	.45959	91	107	198
8	"8-out17145"	.59109	292	202	494
8	"8-out17146"	.97628	247	6	253
8	"8-out17147"	.88076	229	31	260
8	"8-out17148"	.21109	194	725	919
8	"8-out17149"	.15361	155	854	1009
8	"8-out17150"	.38748	353	558	911
8	"8-out17151"	.13017	22	147	169
8	"8-out17152"	.43406	79	103	182
8	"8-out17153"	.28961	53	130	183
8	"8-out17154"	.18027	223	1014	1237
8	"8-out17155"	.48520	82	87	169
8	"8-out17156"	.28541	137	343	480
8	"8-out17157"	.34299	71	136	207
8	"8-out17158"	.98630	144	2	146
8	"8-out17159"	.31578	120	260	380
8	"8-out17160"	.31481	68	148	216
8	"8-out17161"	.22271	100	349	449
8	"8-out17162"	.31034	180	400	580
8	"8-out17163"	.98850	86	1	87
8	"8-out17164"	.32438	290	604	894
8	"8-out17165"	.35072	316	585	901
8	"8-out17166"	.37834	339	557	896
8	"8-out17167"	.18339	369	1643	2012
8	"8-out17168"	.18119	372	1681	2053
8	"8-out17169"	.37373	111	186	297
8	"8-out17170"	.70338	83	35	118
8	"8-out17171"	.34736	66	124	190
8	"8-out17172"	.65979	64	33	97
8	"8-out17173"	.99328	148	1	149
8	"8-out17174"	.26732	324	888	1212
8	"8-out17175"	.73173	701	257	958
8	"8-out17176"	.20781	218	831	1049
8	"8-out17177"	.32737	366	752	1118
8	"8-out17178"	.25925	259	740	999
8	"8-out17179"	.22307	232	808	1040
8	"8-out17180"	.25000	89	267	356
8	"8-out17181"	.48808	635	666	1301
8	"8-out17182"	.26101	320	906	1226
8	"8-out17183"	.06698	14	195	209
8	"8-out17184"	.50000	84	84	168
8	"8-out17185"	.37387	292	489	781
8	"8-out17186"	.26712	195	535	730
8	"8-out17187"	.19784	147	596	743
8	"8-out17188"	.13397	84	543	627
8	"8-out17189"	.88815	270	34	304
8	"8-out17190"	.74161	221	77	298
8	"8-out17191"	.43709	271	349	620
8	"8-out17192"	.98349	417	7	424
8	"8-out17193"	.98349	417	7	424
8	"8-out17194"	.98341	415	7	422
8	"8-out17195"	.98349	417	7	424
8	"8-out17196"	.98349	417	7	424
8	"8-out17197"	.98349	417	7	424
8	"8-out17198"	.46679	724	827	1551
8	"8-out17199"	.57751	894	654	1548
8	"8-out17200"	.16842	32	158	190
8	"8-out17201"	.98113	104	2	106
8	"8-out17202"	.54853	243	200	443
8	"8-out17203"	.23692	154	496	650
8	"8-out17204"	.23243	43	142	185
8	"8-out17205"	.41955	133	184	317
8	"8-out17206"	.29695	117	277	394
8	"8-out17207"	.16272	62	319	381
8	"8-out17208"	.86718	333	51	384
8	"8-out17209"	.59636	164	111	275
8	"8-out17210"	.44383	241	302	543
8	"8-out17211"	.36821	190	326	516
8	"8-out17212"	.40149	485	723	1208
8	"8-out17213"	.45847	138	163	301
8	"8-out17214"	.26629	143	394	537
8	"8-out17215"	.51697	746	697	1443
8	"8-out17216"	.22800	127	430	557
8	"8-out17217"	.24206	183	573	756
8	"8-out17218"	.44067	52	66	118
8	"8-out17219"	.55000	121	99	220
8	"8-out17220"	.75247	304	100	404
8	"8-out17221"	.19387	38	158	196
8	"8-out17222"	.19364	128	533	661
8	"8-out17223"	.27140	206	553	759
8	"8-out17224"	.26710	402	1103	1505
8	"8-out17225"	.37752	561	925	1486
8	"8-out17226"	.21911	133	474	607
8	"8-out17227"	.35000	56	104	160
8	"8-out17228"	.24827	72	218	290
8	"8-out17229"	.31275	76	167	243
8	"8-out17230"	.98496	131	2	133
8	"8-out17231"	.63063	70	41	111
8	"8-out17232"	.26910	81	220	301
8	"8-out17233"	.37591	565	938	1503
8	"8-out17234"	.47200	59	66	125
8	"8-out17235"	.60884	179	115	294
8	"8-out17236"	.42972	159	211	370
8	"8-out17237"	.99512	204	1	205
8	"8-out17238"	.54734	237	196	433
8	"8-out17239"	.83177	89	18	107
8	"8-out17240"	.34239	126	242	368
8	"8-out17241"	.42857	42	56	98
8	"8-out17242"	.59908	263	176	439
8	"8-out17243"	.43617	41	53	94
8	"8-out17244"	.34862	38	71	109
8	"8-out17245"	.36036	40	71	111
8	"8-out17246"	.52941	63	56	119
8	"8-out17247"	.14786	97	559	656
8	"8-out17248"	.17719	101	469	570
8	"8-out17249"	.82105	156	34	190
8	"8-out17250"	.22250	89	311	400
8	"8-out17251"	.24861	90	272	362
8	"8-out17252"	.35836	105	188	293
8	"8-out17253"	.45859	72	85	157
8	"8-out17254"	.25477	80	234	314
8	"8-out17255"	.16605	91	457	548
8	"8-out17256"	.99621	263	1	264
8	"8-out17257"	.82474	80	17	97
8	"8-out17258"	.45338	107	129	236
8	"8-out17259"	.15284	118	654	772
8	"8-out17260"	.98666	666	9	675
8	"8-out17261"	.26696	118	324	442
8	"8-out17262"	.27594	109	286	395
8	"8-out17263"	.26666	32	88	120
8	"8-out17264"	.66825	421	209	630
8	"8-out17265"	.41528	125	176	301
8	"8-out17266"	.51026	174	167	341
8	"8-out17267"	.51970	857	792	1649
8	"8-out17268"	.30724	106	239	345
8	"8-out17269"	.16535	84	424	508
8	"8-out17270"	.23198	103	341	444
8	"8-out17271"	.56571	99	76	175
8	"8-out17272"	.49425	86	88	174
8	"8-out17273"	.33369	304	607	911
8	"8-out17274"	.28373	246	621	867
8	"8-out17275"	.98701	76	1	77
8	"8-out17276"	.97596	203	5	208
8	"8-out17277"	.34562	75	142	217
8	"8-out17278"	.38554	96	153	249
8	"8-out17279"	.28163	69	176	245
8	"8-out17280"	.30424	258	590	848
8	"8-out17281"	.51577	327	307	634
8	"8-out17282"	.25363	157	462	619
8	"8-out17283"	.26755	80	219	299
8	"8-out17284"	.43939	58	74	132
8	"8-out17285"	.92541	608	49	657
8	"8-out17286"	.33383	223	445	668
8	"8-out17287"	.25078	80	239	319
8	"8-out17288"	.30573	96	218	314
8	"8-out17289"	.25126	149	444	593
8	"8-out17290"	.23559	229	743	972
8	"8-out17291"	.26538	69	191	260
8	"8-out17292"	.99539	216	1	217
8	"8-out17293"	.29425	246	590	836
8	"8-out17294"	.62303	119	72	191
8	"8-out17295"	.95045	211	11	222
8	"8-out17296"	.19583	47	193	240
8	"8-out17297"	.20930	45	170	215
8	"8-out17298"	.45454	60	72	132
8	"8-out17299"	.29044	79	193	272
8	"8-out17300"	.24137	98	308	406
8	"8-out17301"	.74547	1731	591	2322
8	"8-out17302"	.31272	177	389	566
8	"8-out17303"	.37111	239	405	644
8	"8-out17304"	.22129	185	651	836
8	"8-out17305"	.34538	277	525	802
8	"8-out17306"	.98104	207	4	211
8	"8-out17307"	.18307	106	473	579
8	"8-out17308"	.43835	64	82	146
8	"8-out17309"	.24166	87	273	360
8	"8-out17310"	.97739	735	17	752
8	"8-out17311"	.93063	322	24	346
8	"8-out17312"	.41379	204	289	493
8	"8-out17313"	.27739	405	1055	1460
8	"8-out17314"	.26369	260	726	986
8	"8-out17315"	.79360	273	71	344
8	"8-out17316"	.30731	441	994	1435
8	"8-out17317"	.68115	235	110	345
8	"8-out17318"	.67286	181	88	269
8	"8-out17319"	.98785	244	3	247
8	"8-out17320"	.59760	747	503	1250
8	"8-out17321"	.50383	263	259	522
8	"8-out17322"	.27255	145	387	532
8	"8-out17323"	.30407	97	222	319
8	"8-out17324"	.99378	160	1	161
8	"8-out17325"	.26388	57	159	216
8	"8-out17326"	.79520	497	128	625
8	"8-out17327"	.25511	237	692	929
8	"8-out17328"	.98581	139	2	141
8	"8-out17329"	.31578	42	91	133
8	"8-out17330"	.25446	57	167	224
8	"8-out17331"	.28406	148	373	521
8	"8-out17332"	.29224	147	356	503
8	"8-out17333"	.32509	329	683	1012
8	"8-out17334"	.27922	129	333	462
8	"8-out17335"	.38042	412	671	1083
8	"8-out17336"	.96963	479	15	494
8	"8-out17337"	.75000	393	131	524
8	"8-out17338"	.20288	422	1658	2080
8	"8-out17339"	.99029	510	5	515
8	"8-out17340"	.29411	170	408	578
8	"8-out17341"	.28989	218	534	752
8	"8-out17342"	.21868	103	368	471
8	"8-out17343"	.44876	254	312	566
8	"8-out17344"	.30528	127	289	416
8	"8-out17345"	.88269	459	61	520
8	"8-out17346"	.46638	111	127	238
8	"8-out17347"	.52837	270	241	511
8	"8-out17348"	.38775	133	210	343
8	"8-out17349"	.38202	204	330	534
8	"8-out17350"	.53937	226	193	419
8	"8-out17351"	.25000	30	90	120
8	"8-out17352"	.41404	171	242	413
8	"8-out17353"	.45783	152	180	332
8	"8-out17354"	.73333	264	96	360
8	"8-out17355"	.33445	99	197	296
8	"8-out17356"	.27837	130	337	467
8	"8-out17357"	.98593	771	11	782
8	"8-out17358"	.76442	159	49	208
8	"8-out17359"	.99377	479	3	482
8	"8-out17360"	.22532	404	1389	1793
8	"8-out17361"	.98936	93	1	94
8	"8-out17362"	.26011	135	384	519
8	"8-out17363"	.34408	64	122	186
8	"8-out17364"	.92035	104	9	113
8	"8-out17365"	.24935	96	289	385
8	"8-out17366"	.26041	75	213	288
8	"8-out17367"	.18149	51	230	281
8	"8-out17368"	.98507	198	3	201
8	"8-out17369"	.26917	172	467	639
8	"8-out17370"	.52397	153	139	292
8	"8-out17371"	.32450	49	102	151
8	"8-out17372"	.76898	243	73	316
8	"8-out17373"	.89743	140	16	156
8	"8-out17374"	.84472	136	25	161
8	"8-out17375"	.30981	786	1751	2537
8	"8-out17376"	.55652	64	51	115
8	"8-out17377"	.76587	193	59	252
8	"8-out17378"	.30255	331	763	1094
8	"8-out17379"	.31440	980	2137	3117
8	"8-out17380"	.59622	158	107	265
8	"8-out17381"	.88695	408	52	460
8	"8-out17382"	.84814	229	41	270
8	"8-out17383"	.39160	504	783	1287
8	"8-out17384"	.27572	134	352	486
8	"8-out17385"	.87919	131	18	149
8	"8-out17386"	.97058	264	8	272
8	"8-out17387"	.28834	955	2357	3312
8	"8-out17388"	.63875	267	151	418
8	"8-out17389"	.31282	122	268	390
8	"8-out17390"	.48360	59	63	122
8	"8-out17391"	.31632	93	201	294
8	"8-out17392"	.43072	143	189	332
8	"8-out17393"	.60937	234	150	384
8	"8-out17394"	.41288	173	246	419
8	"8-out17395"	.99152	117	1	118
8	"8-out17396"	.31898	126	269	395
8	"8-out17397"	.47802	87	95	182
8	"8-out17398"	.32427	370	771	1141
8	"8-out17399"	.99206	125	1	126
8	"8-out17400"	.22509	113	389	502
8	"8-out17401"	.38521	198	316	514
8	"8-out17402"	.26741	142	389	531
8	"8-out17403"	.24897	122	368	490
8	"8-out17404"	.31047	163	362	525
8	"8-out17405"	.96917	503	16	519
8	"8-out17406"	.96023	483	20	503
8	"8-out17407"	.31329	245	537	782
8	"8-out17408"	.78358	105	29	134
8	"8-out17409"	.55747	97	77	174
8	"8-out17410"	.83710	185	36	221
8	"8-out17411"	.99290	140	1	141
8	"8-out17412"	.29477	79	189	268
8	"8-out17413"	.57613	140	103	243
8	"8-out17414"	.18831	29	125	154
8	"8-out17415"	.98947	94	1	95
8	"8-out17416"	.99107	111	1	112
8	"8-out17417"	.27137	73	196	269
8	"8-out17418"	.14691	31	180	211
8	"8-out17419"	.63176	175	102	277
8	"8-out17420"	.25382	315	926	1241
8	"8-out17421"	.25000	60	180	240
8	"8-out17422"	.58418	229	163	392
8	"8-out17423"	.24888	56	169	225
8	"8-out17424"	.42727	47	63	110
8	"8-out17425"	.22943	212	712	924
8	"8-out17426"	.16741	75	373	448
8	"8-out17427"	.19832	95	384	479
8	"8-out17428"	.26315	105	294	399
8	"8-out17429"	.26203	185	521	706
8	"8-out17430"	.36526	61	106	167
8	"8-out17431"	.38372	33	53	86
8	"8-out17432"	.39097	416	648	1064
8	"8-out17433"	.23404	22	72	94
8	"8-out17434"	.33048	425	861	1286
8	"8-out17435"	.36708	29	50	79
8	"8-out17436"	.45238	38	46	84
8	"8-out17437"	.23706	110	354	464
8	"8-out17438"	.98961	381	4	385
8	"8-out17439"	.98863	87	1	88
8	"8-out17440"	.28571	272	680	952
8	"8-out17441"	.28571	238	595	833
8	"8-out17442"	.32280	92	193	285
8	"8-out17443"	.20808	278	1058	1336
8	"8-out17444"	.16934	211	1035	1246
8	"8-out17445"	.16377	66	337	403
8	"8-out17446"	.29305	97	234	331
8	"8-out17447"	.99367	314	2	316
8	"8-out17448"	.25072	87	260	347
8	"8-out17449"	.98989	98	1	99
8	"8-out17450"	.30134	515	1194	1709
8	"8-out17451"	.32971	334	679	1013
8	"8-out17452"	.29538	205	489	694
8	"8-out17453"	.21446	347	1271	1618
8	"8-out17454"	.20389	377	1472	1849
8	"8-out17455"	.33199	580	1167	1747
8	"8-out17456"	.38319	456	734	1190
8	"8-out17457"	.34931	204	380	584
8	"8-out17458"	.33704	242	476	718
8	"8-out17459"	.24089	119	375	494
8	"8-out17460"	.22257	1114	3891	5005
8	"8-out17461"	.64750	259	141	400
8	"8-out17462"	.76744	363	110	473
8	"8-out17463"	.27358	116	308	424
8	"8-out17464"	.78240	338	94	432
8	"8-out17465"	.34000	153	297	450
8	"8-out17466"	.95581	411	19	430
8	"8-out17467"	.72517	409	155	564
8	"8-out17468"	.74113	418	146	564
8	"8-out17469"	.63474	749	431	1180
8	"8-out17470"	.40704	208	303	511
8	"8-out17471"	.33802	216	423	639
8	"8-out17472"	.45179	239	290	529
8	"8-out17473"	.40372	260	384	644
8	"8-out17474"	.90269	436	47	483
8	"8-out17475"	.25262	265	784	1049
8	"8-out17476"	.51474	384	362	746
8	"8-out17477"	.26533	186	515	701
8	"8-out17478"	.42690	146	196	342
8	"8-out17479"	.40170	94	140	234
8	"8-out17480"	.31989	119	253	372
8	"8-out17481"	.19059	77	327	404
8	"8-out17482"	.23684	45	145	190
8	"8-out17483"	.36338	133	233	366
8	"8-out17484"	.32504	196	407	603
8	"8-out17485"	.39591	97	148	245
8	"8-out17486"	.99206	375	3	378
8	"8-out17487"	.99206	375	3	378
8	"8-out17488"	.41803	102	142	244
8	"8-out17489"	.22950	56	188	244
8	"8-out17490"	.22784	90	305	395
8	"8-out17491"	.52658	208	187	395
8	"8-out17492"	.27131	35	94	129
8	"8-out17493"	.25575	100	291	391
8	"8-out17494"	.99107	1554	14	1568
8	"8-out17495"	.87349	145	21	166
8	"8-out17496"	.31132	33	73	106
8	"8-out17497"	.33412	141	281	422
8	"8-out17498"	.53996	358	305	663
8	"8-out17499"	.31557	77	167	244
8	"8-out17500"	.35885	150	268	418
8	"8-out17501"	.17548	63	296	359
8	"8-out17502"	.98039	50	1	51
8	"8-out17503"	.27272	111	296	407
8	"8-out17504"	.13636	48	304	352
8	"8-out17505"	.28136	74	189	263
8	"8-out17506"	.22857	80	270	350
8	"8-out17507"	.98913	637	7	644
8	"8-out17508"	.58627	299	211	510
8	"8-out17509"	.19913	92	370	462
8	"8-out17510"	.20038	209	834	1043
8	"8-out17511"	.28571	148	370	518
8	"8-out17512"	.33264	320	642	962
8	"8-out17513"	.42241	49	67	116
8	"8-out17514"	.23234	204	674	878
8	"8-out17515"	.33333	91	182	273
8	"8-out17516"	.27083	91	245	336
8	"8-out17517"	.67130	241	118	359
8	"8-out17518"	.21800	46	165	211
8	"8-out17519"	.26806	256	699	955
8	"8-out17520"	.34038	322	624	946
8	"8-out17521"	.26354	180	503	683
8	"8-out17522"	.24131	125	393	518
8	"8-out17523"	.25821	110	316	426
8	"8-out17524"	.17383	93	442	535
8	"8-out17525"	.39743	31	47	78
8	"8-out17526"	.75000	57	19	76
8	"8-out17527"	.90625	377	39	416
8	"8-out17528"	.35589	347	628	975
8	"8-out17529"	.36656	353	610	963
8	"8-out17530"	.23496	254	827	1081
8	"8-out17531"	.82273	854	184	1038
8	"8-out17532"	.34619	359	678	1037
8	"8-out17533"	.96097	197	8	205
8	"8-out17534"	.89268	183	22	205
8	"8-out17535"	.40122	197	294	491
8	"8-out17536"	.22669	124	423	547
8	"8-out17537"	.23399	95	311	406
8	"8-out17538"	.37425	125	209	334
8	"8-out17539"	.80968	234	55	289
8	"8-out17540"	.97799	800	18	818
8	"8-out17541"	.24172	168	527	695
8	"8-out17542"	.33658	69	136	205
8	"8-out17543"	.58536	96	68	164
8	"8-out17544"	.33116	51	103	154
8	"8-out17545"	.57432	85	63	148
8	"8-out17546"	.25608	263	764	1027
8	"8-out17547"	.99401	498	3	501
8	"8-out17548"	.25000	295	885	1180
8	"8-out17549"	.49492	585	597	1182
8	"8-out17550"	.21243	352	1305	1657
8	"8-out17551"	.24218	395	1236	1631
8	"8-out17552"	.31971	180	383	563
8	"8-out17553"	.30847	244	547	791
8	"8-out17554"	.25671	153	443	596
8	"8-out17555"	.14461	47	278	325
8	"8-out17556"	.33956	327	636	963
8	"8-out17557"	.16522	115	581	696
8	"8-out17558"	.18804	129	557	686
8	"8-out17559"	.30917	384	858	1242
8	"8-out17560"	.43049	576	762	1338
8	"8-out17561"	.84732	333	60	393
8	"8-out17562"	.29795	146	344	490
8	"8-out17563"	.29411	25	60	85
8	"8-out17564"	.25773	25	72	97
8	"8-out17565"	.48837	42	44	86
8	"8-out17566"	.30362	109	250	359
8	"8-out17567"	.21879	163	582	745
8	"8-out17568"	.21495	92	336	428
8	"8-out17569"	.49912	285	286	571
8	"8-out17570"	.34563	103	195	298
8	"8-out17571"	.25765	143	412	555
8	"8-out17572"	.41379	120	170	290
8	"8-out17573"	.99145	116	1	117
8	"8-out17574"	.74347	171	59	230
8	"8-out17575"	.16817	93	460	553
8	"8-out17576"	.34693	119	224	343
8	"8-out17577"	.38905	263	413	676
8	"8-out17578"	.98290	115	2	117
8	"8-out17579"	.98347	119	2	121
8	"8-out17580"	.99166	119	1	120
8	"8-out17581"	.21590	57	207	264
8	"8-out17582"	.30238	127	293	420
8	"8-out17583"	.30913	132	295	427
8	"8-out17584"	.95726	112	5	117
8	"8-out17585"	.14384	83	494	577
8	"8-out17586"	.84140	504	95	599
8	"8-out17587"	.54702	285	236	521
8	"8-out17588"	.27255	142	379	521
8	"8-out17589"	.76070	391	123	514
8	"8-out17590"	.28582	357	892	1249
8	"8-out17591"	.28016	137	352	489
8	"8-out17592"	.23738	80	257	337
8	"8-out17593"	.20562	95	367	462
8	"8-out17594"	.97166	583	17	600
8	"8-out17595"	.50098	254	253	507
8	"8-out17596"	.25365	156	459	615
8	"8-out17597"	.25273	208	615	823
8	"8-out17598"	.23088	154	513	667
8	"8-out17599"	.46308	207	240	447
8	"8-out17600"	.23279	115	379	494
8	"8-out17601"	.33548	104	206	310
8	"8-out17602"	.18110	209	945	1154
8	"8-out17603"	.24111	95	299	394
8	"8-out17604"	.62931	438	258	696
8	"8-out17605"	.32486	243	505	748
8	"8-out17606"	.26547	313	866	1179
8	"8-out17607"	.29230	342	828	1170
8	"8-out17608"	.50720	176	171	347
8	"8-out17609"	.28187	630	1605	2235
8	"8-out17610"	.47368	378	420	798
8	"8-out17611"	.24392	261	809	1070
8	"8-out17612"	.35762	368	661	1029
8	"8-out17613"	.23076	120	400	520
8	"8-out17614"	.27583	331	869	1200
8	"8-out17615"	.97727	258	6	264
8	"8-out17616"	.43859	200	256	456
8	"8-out17617"	.74468	420	144	564
8	"8-out17618"	.51625	270	253	523
8	"8-out17619"	.74759	311	105	416
8	"8-out17620"	.33380	702	1401	2103
8	"8-out17621"	.47592	257	283	540
8	"8-out17622"	.44982	260	318	578
8	"8-out17623"	.86567	406	63	469
8	"8-out17624"	.15748	40	214	254
8	"8-out17625"	.39739	122	185	307
8	"8-out17626"	.35745	163	293	456
8	"8-out17627"	.20279	174	684	858
8	"8-out17628"	.27485	141	372	513
8	"8-out17629"	.32000	160	340	500
8	"8-out17630"	.24844	440	1331	1771
8	"8-out17631"	.64031	324	182	506
8	"8-out17632"	.23609	399	1291	1690
8	"8-out17633"	.22596	94	322	416
8	"8-out17634"	.45550	215	257	472
8	"8-out17635"	.98564	206	3	209
8	"8-out17636"	.33647	107	211	318
8	"8-out17637"	.32543	357	740	1097
8	"8-out17638"	.22382	233	808	1041
8	"8-out17639"	.95609	196	9	205
8	"8-out17640"	.99009	200	2	202
8	"8-out17641"	.34417	201	383	584
8	"8-out17642"	.38913	179	281	460
8	"8-out17643"	.27507	96	253	349
8	"8-out17644"	.22838	103	348	451
8	"8-out17645"	.25301	126	372	498
8	"8-out17646"	.50931	246	237	483
8	"8-out17647"	.99224	128	1	129
8	"8-out17648"	.22222	26	91	117
8	"8-out17649"	.26448	575	1599	2174
8	"8-out17650"	.16037	34	178	212
8	"8-out17651"	.54861	79	65	144
8	"8-out17652"	.26500	53	147	200
8	"8-out17653"	.24561	336	1032	1368
8	"8-out17654"	.33955	91	177	268
8	"8-out17655"	.45890	67	79	146
8	"8-out17656"	.23899	114	363	477
8	"8-out17657"	.99326	295	2	297
8	"8-out17658"	.74063	257	90	347
8	"8-out17659"	.98201	546	10	556
8	"8-out17660"	.35658	322	581	903
8	"8-out17661"	.68127	575	269	844
8	"8-out17662"	.24080	72	227	299
8	"8-out17663"	.25503	76	222	298
8	"8-out17664"	.31619	246	532	778
8	"8-out17665"	.35421	164	299	463
8	"8-out17666"	.32978	62	126	188
8	"8-out17667"	.31067	32	71	103
8	"8-out17668"	.26943	156	423	579
8	"8-out17669"	.25860	263	754	1017
8	"8-out17670"	.19838	196	792	988
8	"8-out17671"	.33400	332	662	994
8	"8-out17672"	.23924	189	601	790
8	"8-out17673"	.26419	214	596	810
8	"8-out17674"	.74151	918	320	1238
8	"8-out17675"	.32515	53	110	163
8	"8-out17676"	.30212	342	790	1132
8	"8-out17677"	.54247	447	377	824
8	"8-out17678"	.37500	99	165	264
8	"8-out17679"	.51592	324	304	628
8	"8-out17680"	.21578	41	149	190
8	"8-out17681"	.30179	421	974	1395
8	"8-out17682"	.24813	266	806	1072
8	"8-out17683"	.44714	258	319	577
8	"8-out17684"	.22307	435	1515	1950
8	"8-out17685"	.44539	575	716	1291
8	"8-out17686"	.98602	776	11	787
8	"8-out17687"	.86766	1567	239	1806
8	"8-out17688"	.32447	415	864	1279
8	"8-out17689"	.60335	432	284	716
8	"8-out17690"	.40170	188	280	468
8	"8-out17691"	.32327	150	314	464
8	"8-out17692"	.28074	121	310	431
8	"8-out17693"	.33868	211	412	623
8	"8-out17694"	.97476	618	16	634
8	"8-out17695"	.43080	193	255	448
8	"8-out17696"	.57053	364	274	638
8	"8-out17697"	.43012	237	314	551
8	"8-out17698"	.37115	193	327	520
8	"8-out17699"	.34766	186	349	535
8	"8-out17700"	.31671	108	233	341
8	"8-out17701"	.47452	298	330	628
8	"8-out17702"	.38764	207	327	534
8	"8-out17703"	.28947	88	216	304
8	"8-out17704"	.20040	100	399	499
8	"8-out17705"	.22683	71	242	313
8	"8-out17706"	.23161	63	209	272
8	"8-out17707"	.30434	161	368	529
8	"8-out17708"	.53696	138	119	257
8	"8-out17709"	.21559	94	342	436
8	"8-out17710"	.98961	286	3	289
8	"8-out17711"	.24426	213	659	872
8	"8-out17712"	.14321	57	341	398
8	"8-out17713"	.14558	61	358	419
8	"8-out17714"	.37089	316	536	852
8	"8-out17715"	.24431	258	798	1056
8	"8-out17716"	.28742	384	952	1336
8	"8-out17717"	.21373	330	1214	1544
8	"8-out17718"	.67115	1047	513	1560
8	"8-out17719"	.32136	528	1115	1643
8	"8-out17720"	.56357	164	127	291
8	"8-out17721"	.93856	275	18	293
8	"8-out17722"	.19352	269	1121	1390
8	"8-out17723"	.17223	98	471	569
8	"8-out17724"	.69565	352	154	506
8	"8-out17725"	.34624	152	287	439
8	"8-out17726"	.72739	539	202	741
8	"8-out17727"	.23630	69	223	292
8	"8-out17728"	.31043	113	251	364
8	"8-out17729"	.33727	257	505	762
8	"8-out17730"	.98319	117	2	119
8	"8-out17731"	.39446	228	350	578
8	"8-out17732"	.25425	254	745	999
8	"8-out17733"	.97457	115	3	118
8	"8-out17734"	.98319	117	2	119
8	"8-out17735"	.13183	41	270	311
8	"8-out17736"	.30376	113	259	372
8	"8-out17737"	.15027	55	311	366
8	"8-out17738"	.29896	58	136	194
8	"8-out17739"	.17662	68	317	385
8	"8-out17740"	.64734	268	146	414
8	"8-out17741"	.68944	111	50	161
8	"8-out17742"	.43049	96	127	223
8	"8-out17743"	.99818	549	1	550
8	"8-out17744"	.37825	247	406	653
8	"8-out17745"	.50641	79	77	156
8	"8-out17746"	.36825	457	784	1241
8	"8-out17747"	.98268	227	4	231
8	"8-out17748"	.16800	21	104	125
8	"8-out17749"	.59349	146	100	246
8	"8-out17750"	.53248	418	367	785
8	"8-out17751"	.35135	52	96	148
8	"8-out17752"	.98198	327	6	333
8	"8-out17753"	.32063	101	214	315
8	"8-out17754"	.98692	151	2	153
8	"8-out17755"	.49192	274	283	557
8	"8-out17756"	.16145	31	161	192
8	"8-out17757"	.24642	69	211	280
8	"8-out17758"	.63380	90	52	142
8	"8-out17759"	.21686	54	195	249
8	"8-out17760"	.17037	23	112	135
8	"8-out17761"	.53688	131	113	244
8	"8-out17762"	.35643	108	195	303
8	"8-out17763"	.30352	319	732	1051
8	"8-out17764"	.20791	247	941	1188
8	"8-out17765"	.29695	234	554	788
8	"8-out17766"	.30707	347	783	1130
8	"8-out17767"	.26526	139	385	524
8	"8-out17768"	.35117	164	303	467
8	"8-out17769"	.34194	172	331	503
8	"8-out17770"	.26525	113	313	426
8	"8-out17771"	.32708	157	323	480
8	"8-out17772"	.21205	102	379	481
8	"8-out17773"	.33701	61	120	181
8	"8-out17774"	.23756	148	475	623
8	"8-out17775"	.23991	107	339	446
8	"8-out17776"	.81818	126	28	154
8	"8-out17777"	.34826	171	320	491
8	"8-out17778"	.25964	1453	4143	5596
8	"8-out17779"	.31250	25	55	80
8	"8-out17780"	.99393	164	1	165
8	"8-out17781"	.19337	35	146	181
8	"8-out17782"	.15472	54	295	349
8	"8-out17783"	.34140	437	843	1280
8	"8-out17784"	.75257	73	24	97
8	"8-out17785"	.56428	79	61	140
8	"8-out17786"	.99512	204	1	205
8	"8-out17787"	.42572	192	259	451
8	"8-out17788"	.99572	233	1	234
8	"8-out17789"	.73357	201	73	274
8	"8-out17790"	.81005	290	68	358
8	"8-out17791"	.22702	42	143	185
8	"8-out17792"	.23056	86	287	373
8	"8-out17793"	.92099	2005	172	2177
8	"8-out17794"	.99731	372	1	373
8	"8-out17795"	.57692	255	187	442
8	"8-out17796"	.75466	283	92	375
8	"8-out17797"	.16129	105	546	651
8	"8-out17798"	.36500	219	381	600
8	"8-out17799"	.18408	155	687	842
8	"8-out17800"	.22660	276	942	1218
8	"8-out17801"	.35118	892	1648	2540
8	"8-out17802"	.23961	248	787	1035
8	"8-out17803"	.65719	763	398	1161
8	"8-out17804"	.51948	80	74	154
8	"8-out17805"	.24392	281	871	1152
8	"8-out17806"	.26812	281	767	1048
8	"8-out17807"	.43478	60	78	138
8	"8-out17808"	.99600	249	1	250
8	"8-out17809"	.39397	379	583	962
8	"8-out17810"	.36674	150	259	409
8	"8-out17811"	.47680	185	203	388
8	"8-out17812"	.99145	116	1	117
8	"8-out17813"	.99152	117	1	118
8	"8-out17814"	.43814	85	109	194
8	"8-out17815"	.99333	149	1	150
8	"8-out17816"	.50909	56	54	110
8	"8-out17817"	.99145	116	1	117
8	"8-out17818"	.99285	139	1	140
8	"8-out17819"	.17575	29	136	165
8	"8-out17820"	.28354	262	662	924
8	"8-out17821"	.72151	171	66	237
8	"8-out17822"	.28549	187	468	655
8	"8-out17823"	.37643	853	1413	2266
8	"8-out17824"	.79735	783	199	982
8	"8-out17825"	.32524	67	139	206
8	"8-out17826"	.31894	325	694	1019
8	"8-out17827"	.15966	19	100	119
8	"8-out17828"	.64655	75	41	116
8	"8-out17829"	.71806	163	64	227
8	"8-out17830"	.33920	77	150	227
8	"8-out17831"	.59422	432	295	727
8	"8-out17832"	.76165	441	138	579
8	"8-out17833"	.21195	39	145	184
8	"8-out17834"	.26796	138	377	515
8	"8-out17835"	.21593	336	1220	1556
8	"8-out17836"	.32508	184	382	566
8	"8-out17837"	.49618	65	66	131
8	"8-out17838"	.37410	52	87	139
8	"8-out17839"	.79375	127	33	160
8	"8-out17840"	.21276	140	518	658
8	"8-out17841"	.74974	722	241	963
8	"8-out17842"	.25907	264	755	1019
8	"8-out17843"	.30891	291	651	942
8	"8-out17844"	.18497	197	868	1065
8	"8-out17845"	.28018	601	1544	2145
8	"8-out17846"	.35376	254	464	718
8	"8-out17847"	.93170	191	14	205
8	"8-out17848"	.70401	421	177	598
8	"8-out17849"	.24892	116	350	466
8	"8-out17850"	.12149	13	94	107
8	"8-out17851"	.43396	69	90	159
8	"8-out17852"	.28571	82	205	287
8	"8-out17853"	.20456	197	766	963
8	"8-out17854"	.50940	758	730	1488
8	"8-out17855"	.26857	423	1152	1575
8	"8-out17856"	.48780	40	42	82
8	"8-out17857"	.97752	696	16	712
8	"8-out17858"	.27520	172	453	625
8	"8-out17859"	.26770	155	424	579
8	"8-out17860"	.16576	215	1082	1297
8	"8-out17861"	.18162	251	1131	1382
8	"8-out17862"	.28148	38	97	135
8	"8-out17863"	.37089	79	134	213
8	"8-out17864"	.27408	330	874	1204
8	"8-out17865"	.22420	491	1699	2190
8	"8-out17866"	.69401	406	179	585
8	"8-out17867"	.36636	366	633	999
8	"8-out17868"	.76243	138	43	181
8	"8-out17869"	.21285	53	196	249
8	"8-out17870"	.15131	46	258	304
8	"8-out17871"	.34188	120	231	351
8	"8-out17872"	.26515	586	1624	2210
8	"8-out17873"	.99297	424	3	427
8	"8-out17874"	.42038	198	273	471
8	"8-out17875"	.35481	446	811	1257
8	"8-out17876"	.57285	287	214	501
8	"8-out17877"	.78612	408	111	519
8	"8-out17878"	.33753	241	473	714
8	"8-out17879"	.25934	319	911	1230
8	"8-out17880"	.33539	163	323	486
8	"8-out17881"	.18433	120	531	651
8	"8-out17882"	.13942	29	179	208
8	"8-out17883"	.17710	280	1301	1581
8	"8-out17884"	.28717	112	278	390
8	"8-out17885"	.25588	87	253	340
8	"8-out17886"	.24623	278	851	1129
8	"8-out17887"	.43225	335	440	775
8	"8-out17888"	.94337	683	41	724
8	"8-out17889"	.64118	411	230	641
8	"8-out17890"	.65789	275	143	418
8	"8-out17891"	.25902	122	349	471
8	"8-out17892"	.98319	117	2	119
8	"8-out17893"	.99145	116	1	117
8	"8-out17894"	.99145	116	1	117
8	"8-out17895"	.26578	80	221	301
8	"8-out17896"	.99145	116	1	117
8	"8-out17897"	.38787	128	202	330
8	"8-out17898"	.30795	178	400	578
8	"8-out17899"	.25161	39	116	155
8	"8-out17900"	.35483	88	160	248
8	"8-out17901"	.54957	194	159	353
8	"8-out17902"	.77600	97	28	125
8	"8-out17903"	.84210	112	21	133
8	"8-out17904"	.56899	334	253	587
8	"8-out17905"	.65975	318	164	482
8	"8-out17906"	.46691	127	145	272
8	"8-out17907"	.29442	507	1215	1722
8	"8-out17908"	.35169	249	459	708
8	"8-out17909"	.27000	108	292	400
8	"8-out17910"	.56187	168	131	299
8	"8-out17911"	.30642	186	421	607
8	"8-out17912"	.46349	146	169	315
8	"8-out17913"	.21052	48	180	228
8	"8-out17914"	.93650	177	12	189
8	"8-out17915"	.89947	170	19	189
8	"8-out17916"	.95238	180	9	189
8	"8-out17917"	.27807	52	135	187
8	"8-out17918"	.44781	266	328	594
8	"8-out17919"	.93000	186	14	200
8	"8-out17920"	.98469	193	3	196
8	"8-out17921"	.99441	178	1	179
8	"8-out17922"	.51265	243	231	474
8	"8-out17923"	.12500	18	126	144
8	"8-out17924"	.29852	243	571	814
8	"8-out17925"	.12143	166	1201	1367
8	"8-out17926"	.98387	122	2	124
8	"8-out17927"	.21742	272	979	1251
8	"8-out17928"	.99479	382	2	384
8	"8-out17929"	.29559	47	112	159
8	"8-out17930"	.97169	103	3	106
8	"8-out17931"	.83098	177	36	213
8	"8-out17932"	.84450	315	58	373
8	"8-out17933"	.24141	218	685	903
8	"8-out17934"	.25000	48	144	192
8	"8-out17935"	.22155	296	1040	1336
8	"8-out17936"	.72529	866	328	1194
8	"8-out17937"	.36117	147	260	407
8	"8-out17938"	.93920	448	29	477
8	"8-out17939"	.32363	267	558	825
8	"8-out17940"	.35947	55	98	153
8	"8-out17941"	.30000	54	126	180
8	"8-out17942"	.26296	142	398	540
8	"8-out17943"	.16784	71	352	423
8	"8-out17944"	.20033	119	475	594
8	"8-out17945"	.62760	241	143	384
8	"8-out17946"	.38056	94	153	247
8	"8-out17947"	.41265	163	232	395
8	"8-out17948"	.99305	143	1	144
8	"8-out17949"	.35178	197	363	560
8	"8-out17950"	.21500	43	157	200
8	"8-out17951"	.35426	237	432	669
8	"8-out17952"	.42105	128	176	304
8	"8-out17953"	.97222	105	3	108
8	"8-out17954"	.20483	144	559	703
8	"8-out17955"	.22680	44	150	194
8	"8-out17956"	.21266	47	174	221
8	"8-out17957"	.14159	32	194	226
8	"8-out17958"	.99145	116	1	117
8	"8-out17959"	.99145	116	1	117
8	"8-out17960"	.34935	109	203	312
8	"8-out17961"	.99309	719	5	724
8	"8-out17962"	.40751	141	205	346
8	"8-out17963"	.63265	155	90	245
8	"8-out17964"	.53594	82	71	153
8	"8-out17965"	.27238	432	1154	1586
8	"8-out17966"	.16917	45	221	266
8	"8-out17967"	.24032	149	471	620
8	"8-out17968"	.34400	43	82	125
8	"8-out17969"	.99386	324	2	326
8	"8-out17970"	.81791	274	61	335
8	"8-out17971"	.24050	38	120	158
8	"8-out17972"	.98780	162	2	164
8	"8-out17973"	.91509	97	9	106
8	"8-out17974"	.98941	374	4	378
8	"8-out17975"	.12645	76	525	601
8	"8-out17976"	.24047	101	319	420
8	"8-out17977"	.66230	608	310	918
8	"8-out17978"	.26129	133	376	509
8	"8-out17979"	.23529	108	351	459
8	"8-out17980"	.35353	35	64	99
8	"8-out17981"	.22916	33	111	144
8	"8-out17982"	.28021	153	393	546
8	"8-out17983"	.33489	214	425	639
8	"8-out17984"	.25765	101	291	392
8	"8-out17985"	.56772	197	150	347
8	"8-out17986"	.32421	237	494	731
8	"8-out17987"	.42166	253	347	600
8	"8-out17988"	.27011	235	635	870
8	"8-out17989"	.98805	331	4	335
8	"8-out17990"	.21315	81	299	380
8	"8-out17991"	.30534	371	844	1215
8	"8-out17992"	.56072	277	217	494
8	"8-out17993"	.27762	98	255	353
8	"8-out17994"	.55621	188	150	338
8	"8-out17995"	.57673	233	171	404
8	"8-out17996"	.29729	99	234	333
8	"8-out17997"	.57102	406	305	711
8	"8-out17998"	.32568	142	294	436
8	"8-out17999"	.44705	228	282	510
8	"8-out18000"	.15254	144	800	944
8	"8-out18001"	.41533	363	511	874
8	"8-out18002"	.22683	71	242	313
8	"8-out18003"	.62469	258	155	413
8	"8-out18004"	.64673	238	130	368
8	"8-out18005"	.08571	6	64	70
8	"8-out18006"	.85135	504	88	592
8	"8-out18007"	.63750	408	232	640
8	"8-out18008"	.17880	81	372	453
8	"8-out18009"	.26865	18	49	67
8	"8-out18010"	.10307	47	409	456
8	"8-out18011"	.15234	78	434	512
8	"8-out18012"	.64251	1082	602	1684
8	"8-out18013"	.36227	121	213	334
8	"8-out18014"	.39698	79	120	199
8	"8-out18015"	.22282	41	143	184
8	"8-out18016"	.22346	40	139	179
8	"8-out18017"	.32524	67	139	206
8	"8-out18018"	.19209	34	143	177
8	"8-out18019"	.57205	131	98	229
8	"8-out18020"	.22538	103	354	457
8	"8-out18021"	.71005	120	49	169
8	"8-out18022"	.77511	162	47	209
8	"8-out18023"	.27991	131	337	468
8	"8-out18024"	.98464	513	8	521
8	"8-out18025"	.31134	118	261	379
8	"8-out18026"	.09513	43	409	452
8	"8-out18027"	.98920	550	6	556
8	"8-out18028"	.15826	91	484	575
8	"8-out18029"	.61981	269	165	434
8	"8-out18030"	.16574	90	453	543
8	"8-out18031"	.22985	77	258	335
8	"8-out18032"	.84463	1109	204	1313
8	"8-out18033"	.31843	114	244	358
8	"8-out18034"	.20760	142	542	684
8	"8-out18035"	.34375	55	105	160
8	"8-out18036"	.19834	48	194	242
8	"8-out18037"	.30645	76	172	248
8	"8-out18038"	.41368	774	1097	1871
8	"8-out18039"	.98230	333	6	339
8	"8-out18040"	.22168	137	481	618
8	"8-out18041"	.51909	299	277	576
8	"8-out18042"	.45709	554	658	1212
8	"8-out18043"	.31558	166	360	526
8	"8-out18044"	.43515	302	392	694
8	"8-out18045"	.99699	664	2	666
8	"8-out18046"	.16791	45	223	268
8	"8-out18047"	.25053	117	350	467
8	"8-out18048"	.36494	127	221	348
8	"8-out18049"	.12000	9	66	75
8	"8-out18050"	.21859	87	311	398
8	"8-out18051"	.17575	58	272	330
8	"8-out18052"	.34299	355	680	1035
8	"8-out18053"	.24458	79	244	323
8	"8-out18054"	.27547	146	384	530
8	"8-out18055"	.29949	118	276	394
8	"8-out18056"	.16666	14	70	84
8	"8-out18057"	.34718	117	220	337
8	"8-out18058"	.98165	107	2	109
8	"8-out18059"	.99251	663	5	668
8	"8-out18060"	.23806	359	1149	1508
8	"8-out18061"	.35498	153	278	431
8	"8-out18062"	.24675	76	232	308
8	"8-out18063"	.91875	147	13	160
8	"8-out18064"	.31386	129	282	411
8	"8-out18065"	.36531	217	377	594
8	"8-out18066"	.20086	93	370	463
8	"8-out18067"	.20504	65	252	317
8	"8-out18068"	.21807	111	398	509
8	"8-out18069"	.96482	192	7	199
8	"8-out18070"	.30593	67	152	219
8	"8-out18071"	.30182	99	229	328
8	"8-out18072"	.46296	75	87	162
8	"8-out18073"	.03870	6	149	155
8	"8-out18074"	.30569	59	134	193
8	"8-out18075"	.18644	33	144	177
8	"8-out18076"	.40000	228	342	570
8	"8-out18077"	.29151	79	192	271
8	"8-out18078"	.45027	249	304	553
8	"8-out18079"	.36483	193	336	529
8	"8-out18080"	.25278	68	201	269
8	"8-out18081"	.29605	45	107	152
8	"8-out18082"	.36028	205	364	569
8	"8-out18083"	.24293	43	134	177
8	"8-out18084"	.17613	31	145	176
8	"8-out18085"	.21933	118	420	538
8	"8-out18086"	.39766	68	103	171
8	"8-out18087"	.34558	94	178	272
8	"8-out18088"	.76744	429	130	559
8	"8-out18089"	.99728	368	1	369
8	"8-out18090"	.14864	44	252	296
8	"8-out18091"	.72920	447	166	613
8	"8-out18092"	.27272	174	464	638
8	"8-out18093"	.19230	75	315	390
8	"8-out18094"	.52845	260	232	492
8	"8-out18095"	.99122	226	2	228
8	"8-out18096"	.99242	131	1	132
8	"8-out18097"	.89417	169	20	189
8	"8-out18098"	.97354	184	5	189
8	"8-out18099"	.98941	187	2	189
8	"8-out18100"	.26108	106	300	406
8	"8-out18101"	.40963	68	98	166
8	"8-out18102"	.99500	199	1	200
8	"8-out18103"	.25942	117	334	451
8	"8-out18104"	.32236	98	206	304
8	"8-out18105"	.43195	292	384	676
8	"8-out18106"	.33846	66	129	195
8	"8-out18107"	.72777	131	49	180
8	"8-out18108"	.32394	115	240	355
8	"8-out18109"	.88690	298	38	336
8	"8-out18110"	.33031	73	148	221
8	"8-out18111"	.32413	94	196	290
8	"8-out18112"	.53252	131	115	246
8	"8-out18113"	.16949	100	490	590
8	"8-out18114"	.26688	245	673	918
8	"8-out18115"	.82758	168	35	203
8	"8-out18116"	.24794	151	458	609
8	"8-out18117"	.80000	180	45	225
8	"8-out18118"	.28735	300	744	1044
8	"8-out18119"	.29924	515	1206	1721
8	"8-out18120"	.33183	148	298	446
8	"8-out18121"	.37939	324	530	854
8	"8-out18122"	.35582	58	105	163
8	"8-out18123"	.97222	140	4	144
8	"8-out18124"	.09562	35	331	366
8	"8-out18125"	.24797	92	279	371
8	"8-out18126"	.32567	170	352	522
8	"8-out18127"	.24441	186	575	761
8	"8-out18128"	.44594	132	164	296
8	"8-out18129"	.50847	90	87	177
8	"8-out18130"	.65128	254	136	390
8	"8-out18131"	.14093	126	768	894
8	"8-out18132"	.55833	67	53	120
8	"8-out18133"	.67469	1512	729	2241
8	"8-out18134"	.36231	50	88	138
8	"8-out18135"	.18138	76	343	419
8	"8-out18136"	.36170	170	300	470
8	"8-out18137"	.98622	501	7	508
8	"8-out18138"	.51395	313	296	609
8	"8-out18139"	.29606	241	573	814
8	"8-out18140"	.44444	36	45	81
8	"8-out18141"	.17049	52	253	305
8	"8-out18142"	.34199	158	304	462
8	"8-out18143"	.15689	83	446	529
8	"8-out18144"	.22278	131	457	588
8	"8-out18145"	.16904	154	757	911
8	"8-out18146"	.72093	682	264	946
8	"8-out18147"	.21573	192	698	890
8	"8-out18148"	.22473	209	721	930
8	"8-out18149"	.23627	99	320	419
8	"8-out18150"	.27348	99	263	362
8	"8-out18151"	.17419	108	512	620
8	"8-out18152"	.39285	132	204	336
8	"8-out18153"	.50159	157	156	313
8	"8-out18154"	.93220	110	8	118
8	"8-out18155"	.20593	111	428	539
8	"8-out18156"	.27536	95	250	345
8	"8-out18157"	.98769	562	7	569
8	"8-out18158"	.68928	193	87	280
8	"8-out18159"	.27518	183	482	665
8	"8-out18160"	.99539	216	1	217
8	"8-out18161"	.26946	45	122	167
8	"8-out18162"	.78925	191	51	242
8	"8-out18163"	.35398	160	292	452
8	"8-out18164"	.41316	226	321	547
8	"8-out18165"	.26415	14	39	53
8	"8-out18166"	.97169	103	3	106
8	"8-out18167"	.32125	328	693	1021
8	"8-out18168"	.31535	76	165	241
8	"8-out18169"	.18362	83	369	452
8	"8-out18170"	.22560	37	127	164
8	"8-out18171"	.25419	106	311	417
8	"8-out18172"	.32644	79	163	242
8	"8-out18173"	.28998	194	475	669
8	"8-out18174"	.51546	150	141	291
8	"8-out18175"	.25000	139	417	556
8	"8-out18176"	.24675	152	464	616
8	"8-out18177"	.28079	155	397	552
8	"8-out18178"	.21590	114	414	528
8	"8-out18179"	.24056	51	161	212
8	"8-out18180"	.33333	121	242	363
8	"8-out18181"	.79757	461	117	578
8	"8-out18182"	.25481	172	503	675
8	"8-out18183"	.24242	80	250	330
8	"8-out18184"	.21755	57	205	262
8	"8-out18185"	.16541	88	444	532
8	"8-out18186"	.14966	135	767	902
8	"8-out18187"	.21323	87	321	408
8	"8-out18188"	.11122	112	895	1007
8	"8-out18189"	.15244	134	745	879
8	"8-out18190"	.18444	147	650	797
8	"8-out18191"	.21600	135	490	625
8	"8-out18192"	.28962	254	623	877
8	"8-out18193"	.94293	347	21	368
8	"8-out18194"	.13601	125	794	919
8	"8-out18195"	.29955	272	636	908
8	"8-out18196"	.31276	299	657	956
8	"8-out18197"	.38248	83	134	217
8	"8-out18198"	.25306	248	732	980
8	"8-out18199"	.77614	527	152	679
8	"8-out18200"	.25064	677	2024	2701
8	"8-out18201"	.63662	219	125	344
8	"8-out18202"	.37500	180	300	480
8	"8-out18203"	.27678	93	243	336
8	"8-out18204"	.29404	499	1198	1697
8	"8-out18205"	.34021	511	991	1502
8	"8-out18206"	.10984	29	235	264
8	"8-out18207"	.20756	181	691	872
8	"8-out18208"	.22843	143	483	626
8	"8-out18209"	.16556	150	756	906
8	"8-out18210"	.41666	420	588	1008
8	"8-out18211"	.32432	48	100	148
8	"8-out18212"	.97952	287	6	293
8	"8-out18213"	.16197	69	357	426
8	"8-out18214"	.76097	156	49	205
8	"8-out18215"	.42801	110	147	257
8	"8-out18216"	.27217	135	361	496
8	"8-out18217"	.32086	163	345	508
8	"8-out18218"	.67561	327	157	484
8	"8-out18219"	.99581	238	1	239
8	"8-out18220"	.25000	58	174	232
8	"8-out18221"	.25214	88	261	349
8	"8-out18222"	.49635	136	138	274
8	"8-out18223"	.26530	169	468	637
8	"8-out18224"	.89189	198	24	222
8	"8-out18225"	.29545	78	186	264
8	"8-out18226"	.90825	198	20	218
8	"8-out18227"	.98314	933	16	949
8	"8-out18228"	.26245	158	444	602
8	"8-out18229"	.29322	212	511	723
8	"8-out18230"	.15032	23	130	153
8	"8-out18231"	.26233	101	284	385
8	"8-out18232"	.32454	160	333	493
8	"8-out18233"	.99082	324	3	327
8	"8-out18234"	.32666	98	202	300
8	"8-out18235"	.22916	99	333	432
8	"8-out18236"	.44019	92	117	209
8	"8-out18237"	.59090	195	135	330
8	"8-out18238"	.20775	150	572	722
8	"8-out18239"	.50609	83	81	164
8	"8-out18240"	.15732	73	391	464
8	"8-out18241"	.24212	146	457	603
8	"8-out18242"	.23089	139	463	602
8	"8-out18243"	.27022	157	424	581
8	"8-out18244"	.29577	189	450	639
8	"8-out18245"	.31828	141	302	443
8	"8-out18246"	.36622	219	379	598
8	"8-out18247"	.34328	46	88	134
8	"8-out18248"	.74006	242	85	327
8	"8-out18249"	.40268	60	89	149
8	"8-out18250"	.24736	47	143	190
8	"8-out18251"	.08021	15	172	187
8	"8-out18252"	.20454	81	315	396
8	"8-out18253"	.27751	58	151	209
8	"8-out18254"	.99167	834	7	841
8	"8-out18255"	.44170	197	249	446
8	"8-out18256"	.84210	240	45	285
8	"8-out18257"	.38563	467	744	1211
8	"8-out18258"	.20357	182	712	894
8	"8-out18259"	.36158	128	226	354
8	"8-out18260"	.93458	943	66	1009
8	"8-out18261"	.26297	152	426	578
8	"8-out18262"	.24773	137	416	553
8	"8-out18263"	.39634	130	198	328
8	"8-out18264"	.90654	97	10	107
8	"8-out18265"	.29706	374	885	1259
8	"8-out18266"	.43236	179	235	414
8	"8-out18267"	.17984	496	2262	2758
8	"8-out18268"	.16061	429	2242	2671
8	"8-out18269"	.08333	32	352	384
8	"8-out18270"	.24444	33	102	135
8	"8-out18271"	.70573	578	241	819
8	"8-out18272"	.34306	141	270	411
8	"8-out18273"	.58921	142	99	241
8	"8-out18274"	.28059	133	341	474
8	"8-out18275"	.21399	52	191	243
8	"8-out18276"	.30215	42	97	139
8	"8-out18277"	.91282	911	87	998
8	"8-out18278"	.28378	21	53	74
8	"8-out18279"	.99506	806	4	810
8	"8-out18280"	.36518	214	372	586
8	"8-out18281"	.95495	106	5	111
8	"8-out18282"	.37333	112	188	300
8	"8-out18283"	.39215	60	93	153
8	"8-out18284"	.98895	179	2	181
8	"8-out18285"	.86486	352	55	407
8	"8-out18286"	.26016	416	1183	1599
8	"8-out18287"	.32365	513	1072	1585
8	"8-out18288"	.33640	73	144	217
8	"8-out18289"	.18061	164	744	908
8	"8-out18290"	.20158	178	705	883
8	"8-out18291"	.29679	176	417	593
8	"8-out18292"	.21189	253	941	1194
8	"8-out18293"	.99590	243	1	244
8	"8-out18294"	.42073	207	285	492
8	"8-out18295"	.25000	71	213	284
8	"8-out18296"	.42857	48	64	112
8	"8-out18297"	.22885	46	155	201
8	"8-out18298"	.45833	110	130	240
8	"8-out18299"	.42324	284	387	671
8	"8-out18300"	.22567	589	2021	2610
8	"8-out18301"	.14072	226	1380	1606
8	"8-out18302"	.17239	271	1301	1572
8	"8-out18303"	.98983	1169	12	1181
8	"8-out18304"	.31426	434	947	1381
8	"8-out18305"	.29713	249	589	838
8	"8-out18306"	.41951	86	119	205
8	"8-out18307"	.29642	174	413	587
8	"8-out18308"	.41105	171	245	416
8	"8-out18309"	.31830	346	741	1087
8	"8-out18310"	.31226	168	370	538
8	"8-out18311"	.43092	131	173	304
8	"8-out18312"	.66587	279	140	419
8	"8-out18313"	.29307	182	439	621
8	"8-out18314"	.15183	29	162	191
8	"8-out18315"	.87833	592	82	674
8	"8-out18316"	.62426	427	257	684
8	"8-out18317"	.38781	140	221	361
8	"8-out18318"	.59347	200	137	337
8	"8-out18319"	.63501	214	123	337
8	"8-out18320"	.18554	77	338	415
8	"8-out18321"	.18990	79	337	416
8	"8-out18322"	.20379	86	336	422
8	"8-out18323"	.49879	207	208	415
8	"8-out18324"	.15212	68	379	447
8	"8-out18325"	.19765	101	410	511
8	"8-out18326"	.26491	111	308	419
8	"8-out18327"	.25135	93	277	370
8	"8-out18328"	.21558	83	302	385
8	"8-out18329"	.28781	137	339	476
8	"8-out18330"	.27924	74	191	265
8	"8-out18331"	.20258	47	185	232
8	"8-out18332"	.18691	80	348	428
8	"8-out18333"	.20525	86	333	419
8	"8-out18334"	.21145	48	179	227
8	"8-out18335"	.27777	75	195	270
8	"8-out18336"	.24538	93	286	379
8	"8-out18337"	.21282	83	307	390
8	"8-out18338"	.38297	90	145	235
8	"8-out18339"	.69892	195	84	279
8	"8-out18340"	.32624	138	285	423
8	"8-out18341"	.48120	64	69	133
8	"8-out18342"	.23076	78	260	338
8	"8-out18343"	.12554	58	404	462
8	"8-out18344"	.47619	40	44	84
8	"8-out18345"	.47384	154	171	325
8	"8-out18346"	.31939	84	179	263
8	"8-out18347"	.42857	114	152	266
8	"8-out18348"	.32209	86	181	267
8	"8-out18349"	.14880	25	143	168
8	"8-out18350"	.26708	129	354	483
8	"8-out18351"	.13153	88	581	669
8	"8-out18352"	.99324	147	1	148
8	"8-out18353"	.86088	427	69	496
8	"8-out18354"	.32661	162	334	496
8	"8-out18355"	.93832	213	14	227
8	"8-out18356"	.99551	222	1	223
8	"8-out18357"	.51659	358	335	693
8	"8-out18358"	.47311	44	49	93
8	"8-out18359"	.51882	317	294	611
8	"8-out18360"	.41847	77	107	184
8	"8-out18361"	.21621	56	203	259
8	"8-out18362"	.16733	42	209	251
8	"8-out18363"	.23786	289	926	1215
8	"8-out18364"	.24054	229	723	952
8	"8-out18365"	.31475	271	590	861
8	"8-out18366"	.19683	199	812	1011
8	"8-out18367"	.99473	567	3	570
8	"8-out18368"	.06878	13	176	189
8	"8-out18369"	.22727	55	187	242
8	"8-out18370"	.23906	153	487	640
8	"8-out18371"	.34285	168	322	490
8	"8-out18372"	.26426	176	490	666
8	"8-out18373"	.17835	89	410	499
8	"8-out18374"	.17025	95	463	558
8	"8-out18375"	.42679	137	184	321
8	"8-out18376"	.26995	115	311	426
8	"8-out18377"	.18585	92	403	495
8	"8-out18378"	.26260	151	424	575
8	"8-out18379"	.14629	73	426	499
8	"8-out18380"	.26409	89	248	337
8	"8-out18381"	.28813	153	378	531
8	"8-out18382"	.99517	619	3	622
8	"8-out18383"	.28329	368	931	1299
8	"8-out18384"	.51364	320	303	623
8	"8-out18385"	.15200	38	212	250
8	"8-out18386"	.24620	81	248	329
8	"8-out18387"	.17863	189	869	1058
8	"8-out18388"	.96589	878	31	909
8	"8-out18389"	.97735	561	13	574
8	"8-out18390"	.40490	264	388	652
8	"8-out18391"	.36854	307	526	833
8	"8-out18392"	.21103	88	329	417
8	"8-out18393"	.95454	105	5	110
8	"8-out18394"	.98319	117	2	119
8	"8-out18395"	.98300	347	6	353
8	"8-out18396"	.97941	333	7	340
8	"8-out18397"	.99204	374	3	377
8	"8-out18398"	.99558	451	2	453
8	"8-out18399"	.96226	102	4	106
8	"8-out18400"	.25053	117	350	467
8	"8-out18401"	.32907	103	210	313
8	"8-out18402"	.26997	125	338	463
8	"8-out18403"	.27305	151	402	553
8	"8-out18404"	.15438	44	241	285
8	"8-out18405"	.78000	117	33	150
8	"8-out18406"	.98901	90	1	91
8	"8-out18407"	.28370	101	255	356
8	"8-out18408"	.35143	110	203	313
8	"8-out18409"	.08863	46	473	519
8	"8-out18410"	.19391	102	424	526
8	"8-out18411"	.27343	35	93	128
8	"8-out18412"	.12478	73	512	585
8	"8-out18413"	.26014	109	310	419
8	"8-out18414"	.34831	62	116	178
8	"8-out18415"	.98717	77	1	78
8	"8-out18416"	.27397	40	106	146
8	"8-out18417"	.23048	307	1025	1332
8	"8-out18418"	.46111	83	97	180
8	"8-out18419"	.28934	57	140	197
8	"8-out18420"	.63366	128	74	202
8	"8-out18421"	.15337	25	138	163
8	"8-out18422"	.37523	203	338	541
8	"8-out18423"	.77034	426	127	553
8	"8-out18424"	.35929	143	255	398
8	"8-out18425"	.27096	42	113	155
8	"8-out18426"	.24867	47	142	189
8	"8-out18427"	.28457	179	450	629
8	"8-out18428"	.88065	214	29	243
8	"8-out18429"	.32849	181	370	551
8	"8-out18430"	.21568	33	120	153
8	"8-out18431"	.78980	124	33	157
8	"8-out18432"	.22814	167	565	732
8	"8-out18433"	.86752	203	31	234
8	"8-out18434"	.35925	97	173	270
8	"8-out18435"	.25150	125	372	497
8	"8-out18436"	.99082	216	2	218
8	"8-out18437"	.31884	286	611	897
8	"8-out18438"	.26315	40	112	152
8	"8-out18439"	.35849	95	170	265
8	"8-out18440"	.28782	175	433	608
8	"8-out18441"	.20967	117	441	558
8	"8-out18442"	.26523	161	446	607
8	"8-out18443"	.20643	109	419	528
8	"8-out18444"	.18666	98	427	525
8	"8-out18445"	.41111	222	318	540
8	"8-out18446"	.19396	373	1550	1923
8	"8-out18447"	.16129	35	182	217
8	"8-out18448"	.27835	54	140	194
8	"8-out18449"	.25910	505	1444	1949
8	"8-out18450"	.88398	922	121	1043
8	"8-out18451"	.32175	139	293	432
8	"8-out18452"	.24456	45	139	184
8	"8-out18453"	.93243	207	15	222
8	"8-out18454"	.95045	211	11	222
8	"8-out18455"	.99590	243	1	244
8	"8-out18456"	.45714	96	114	210
8	"8-out18457"	.32485	383	796	1179
8	"8-out18458"	.52033	499	460	959
8	"8-out18459"	.99583	239	1	240
8	"8-out18460"	.98103	931	18	949
8	"8-out18461"	.26366	164	458	622
8	"8-out18462"	.21250	153	567	720
8	"8-out18463"	.98643	509	7	516
8	"8-out18464"	.38042	727	1184	1911
8	"8-out18465"	.25550	116	338	454
8	"8-out18466"	.97152	580	17	597
8	"8-out18467"	.80048	329	82	411
8	"8-out18468"	.48425	123	131	254
8	"8-out18469"	.40920	169	244	413
8	"8-out18470"	.26131	127	359	486
8	"8-out18471"	.27641	573	1500	2073
8	"8-out18472"	.24514	164	505	669
8	"8-out18473"	.30939	168	375	543
8	"8-out18474"	.30942	151	337	488
8	"8-out18475"	.25994	98	279	377
8	"8-out18476"	.33634	261	515	776
8	"8-out18477"	.29866	580	1362	1942
8	"8-out18478"	.34786	383	718	1101
8	"8-out18479"	.24458	113	349	462
8	"8-out18480"	.30303	40	92	132
8	"8-out18481"	.17322	66	315	381
8	"8-out18482"	.92967	661	50	711
8	"8-out18483"	.55952	47	37	84
8	"8-out18484"	.46222	104	121	225
8	"8-out18485"	.91284	199	19	218
8	"8-out18486"	.30081	148	344	492
8	"8-out18487"	.26933	289	784	1073
8	"8-out18488"	.35885	75	134	209
8	"8-out18489"	.42153	137	188	325
8	"8-out18490"	.24705	63	192	255
8	"8-out18491"	.18637	93	406	499
8	"8-out18492"	.19230	140	588	728
8	"8-out18493"	.17272	209	1001	1210
8	"8-out18494"	.31440	155	338	493
8	"8-out18495"	.20353	207	810	1017
8	"8-out18496"	.19469	44	182	226
8	"8-out18497"	.35143	220	406	626
8	"8-out18498"	.29579	176	419	595
8	"8-out18499"	.21134	41	153	194
8	"8-out18500"	.87692	456	64	520
8	"8-out18501"	.18777	86	372	458
8	"8-out18502"	.23091	121	403	524
8	"8-out18503"	.20958	35	132	167
8	"8-out18504"	.30683	166	375	541
8	"8-out18505"	.19629	106	434	540
8	"8-out18506"	.26512	149	413	562
8	"8-out18507"	.19624	94	385	479
8	"8-out18508"	.89807	326	37	363
8	"8-out18509"	.21455	56	205	261
8	"8-out18510"	.26966	240	650	890
8	"8-out18511"	.21800	92	330	422
8	"8-out18512"	.26896	539	1465	2004
8	"8-out18513"	.38546	175	279	454
8	"8-out18514"	.22832	108	365	473
8	"8-out18515"	.22039	67	237	304
8	"8-out18516"	.49658	364	369	733
8	"8-out18517"	.97938	95	2	97
8	"8-out18518"	.99056	105	1	106
8	"8-out18519"	.28657	190	473	663
8	"8-out18520"	.17316	40	191	231
8	"8-out18521"	.17191	60	289	349
8	"8-out18522"	.23314	249	819	1068
8	"8-out18523"	.26400	66	184	250
8	"8-out18524"	.63510	275	158	433
8	"8-out18525"	.21111	76	284	360
8	"8-out18526"	.18807	82	354	436
8	"8-out18527"	.21333	80	295	375
8	"8-out18528"	.20813	87	331	418
8	"8-out18529"	.67436	292	141	433
8	"8-out18530"	.28074	347	889	1236
8	"8-out18531"	.20942	40	151	191
8	"8-out18532"	.16666	35	175	210
8	"8-out18533"	.33842	133	260	393
8	"8-out18534"	.24791	89	270	359
8	"8-out18535"	.69298	79	35	114
8	"8-out18536"	.39639	308	469	777
8	"8-out18537"	.29206	151	366	517
8	"8-out18538"	.83248	164	33	197
8	"8-out18539"	.32515	53	110	163
8	"8-out18540"	.21428	72	264	336
8	"8-out18541"	.10606	14	118	132
8	"8-out18542"	.17571	123	577	700
8	"8-out18543"	.19967	123	493	616
8	"8-out18544"	.97794	133	3	136
8	"8-out18545"	.99154	352	3	355
8	"8-out18546"	.24418	42	130	172
8	"8-out18547"	.20793	110	419	529
8	"8-out18548"	.81132	86	20	106
8	"8-out18549"	.86507	109	17	126
8	"8-out18550"	.68435	245	113	358
8	"8-out18551"	.96531	334	12	346
8	"8-out18552"	.97041	328	10	338
8	"8-out18553"	.95027	344	18	362
8	"8-out18554"	.27848	132	342	474
8	"8-out18555"	.97560	40	1	41
8	"8-out18556"	.87500	21	3	24
8	"8-out18557"	.92592	25	2	27
8	"8-out18558"	.19175	121	510	631
8	"8-out18559"	.45340	326	393	719
8	"8-out18560"	.17302	68	325	393
8	"8-out18561"	.95689	333	15	348
8	"8-out18562"	.16961	48	235	283
8	"8-out18563"	.23866	221	705	926
8	"8-out18564"	.25384	66	194	260
8	"8-out18565"	.25675	76	220	296
8	"8-out18566"	.41463	136	192	328
8	"8-out18567"	.25899	144	412	556
8	"8-out18568"	.33816	140	274	414
8	"8-out18569"	.21212	21	78	99
8	"8-out18570"	.40305	264	391	655
8	"8-out18571"	.11435	137	1061	1198
8	"8-out18572"	.99157	353	3	356
8	"8-out18573"	.64912	37	20	57
8	"8-out18574"	.25824	47	135	182
8	"8-out18575"	.56862	29	22	51
8	"8-out18576"	.98063	1114	22	1136
8	"8-out18577"	.36996	101	172	273
8	"8-out18578"	.33647	107	211	318
8	"8-out18579"	.53317	225	197	422
8	"8-out18580"	.34666	104	196	300
8	"8-out18581"	.99145	116	1	117
8	"8-out18582"	.99145	116	1	117
8	"8-out18583"	.99145	116	1	117
8	"8-out18584"	.28694	200	497	697
8	"8-out18585"	.42896	157	209	366
8	"8-out18586"	.38679	246	390	636
8	"8-out18587"	.90147	366	40	406
8	"8-out18588"	.22458	95	328	423
8	"8-out18589"	.99555	224	1	225
8	"8-out18590"	.99541	217	1	218
8	"8-out18591"	.21346	149	549	698
8	"8-out18592"	.99090	327	3	330
8	"8-out18593"	.99082	324	3	327
8	"8-out18594"	.97169	103	3	106
8	"8-out18595"	.33439	315	627	942
8	"8-out18596"	.78988	203	54	257
8	"8-out18597"	.22432	83	287	370
8	"8-out18598"	.23981	53	168	221
8	"8-out18599"	.99170	239	2	241
8	"8-out18600"	.92792	206	16	222
8	"8-out18601"	.97674	168	4	172
8	"8-out18602"	.36343	161	282	443
8	"8-out18603"	.27645	243	636	879
8	"8-out18604"	.20352	150	587	737
8	"8-out18605"	.22307	29	101	130
8	"8-out18606"	.16923	22	108	130
8	"8-out18607"	.15625	20	108	128
8	"8-out18608"	.15503	20	109	129
8	"8-out18609"	.20000	26	104	130
8	"8-out18610"	.97391	112	3	115
8	"8-out18611"	.19086	71	301	372
8	"8-out18612"	.83593	107	21	128
8	"8-out18613"	.46031	58	68	126
8	"8-out18614"	.46825	59	67	126
8	"8-out18615"	.52380	66	60	126
8	"8-out18616"	.48412	61	65	126
8	"8-out18617"	.47619	60	66	126
8	"8-out18618"	.49206	62	64	126
8	"8-out18619"	.53968	68	58	126
8	"8-out18620"	.11029	15	121	136
8	"8-out18621"	.28676	39	97	136
8	"8-out18622"	.16176	22	114	136
8	"8-out18623"	.67931	197	93	290
8	"8-out18624"	.30025	357	832	1189
8	"8-out18625"	.23243	86	284	370
8	"8-out18626"	.61002	219	140	359
8	"8-out18627"	.25271	93	275	368
8	"8-out18628"	.29512	121	289	410
8	"8-out18629"	.98591	140	2	142
8	"8-out18630"	.98591	140	2	142
8	"8-out18631"	.94930	206	11	217
8	"8-out18632"	.29438	131	314	445
8	"8-out18633"	.34602	100	189	289
8	"8-out18634"	.25061	305	912	1217
8	"8-out18635"	.13428	47	303	350
8	"8-out18636"	.28506	63	158	221
8	"8-out18637"	.70063	330	141	471
8	"8-out18638"	.22857	96	324	420
8	"8-out18639"	.19431	123	510	633
8	"8-out18640"	.97706	213	5	218
8	"8-out18641"	.99264	135	1	136
8	"8-out18642"	.34625	134	253	387
8	"8-out18643"	.29540	148	353	501
8	"8-out18644"	.22852	141	476	617
8	"8-out18645"	.31446	150	327	477
8	"8-out18646"	.23390	258	845	1103
8	"8-out18647"	.32500	78	162	240
8	"8-out18648"	.99606	253	1	254
8	"8-out18649"	.72272	318	122	440
8	"8-out18650"	.29817	212	499	711
8	"8-out18651"	.14883	32	183	215
8	"8-out18652"	.18779	40	173	213
8	"8-out18653"	.14155	31	188	219
8	"8-out18654"	.19607	50	205	255
8	"8-out18655"	.97938	95	2	97
8	"8-out18656"	.22704	89	303	392
8	"8-out18657"	.18320	24	107	131
8	"8-out18658"	.20000	26	104	130
8	"8-out18659"	.14615	19	111	130
8	"8-out18660"	.15625	20	108	128
8	"8-out18661"	.07692	10	120	130
8	"8-out18662"	.18181	26	117	143
8	"8-out18663"	.37795	48	79	127
8	"8-out18664"	.87046	168	25	193
8	"8-out18665"	.84756	139	25	164
8	"8-out18666"	.50000	63	63	126
8	"8-out18667"	.48412	61	65	126
8	"8-out18668"	.48412	61	65	126
8	"8-out18669"	.50000	63	63	126
8	"8-out18670"	.51104	370	354	724
8	"8-out18671"	.81403	2320	530	2850
8	"8-out18672"	.96428	27	1	28
8	"8-out18673"	.98345	416	7	423
8	"8-out18674"	.98198	327	6	333
8	"8-out18675"	.98753	396	5	401
8	"8-out18676"	.19602	69	283	352
8	"8-out18677"	.98305	116	2	118
8	"8-out18678"	.41214	129	184	313
8	"8-out18679"	.99145	116	1	117
8	"8-out18680"	.28009	121	311	432
8	"8-out18681"	.48351	132	141	273
8	"8-out18682"	.99130	114	1	115
8	"8-out18683"	.25146	43	128	171
8	"8-out18684"	.99156	235	2	237
8	"8-out18685"	.38818	92	145	237
8	"8-out18686"	.04918	6	116	122
8	"8-out18687"	.92584	437	35	472
8	"8-out18688"	.26439	101	281	382
8	"8-out18689"	.37420	177	296	473
8	"8-out18690"	.24576	29	89	118
8	"8-out18691"	.31157	105	232	337
8	"8-out18692"	.45074	151	184	335
8	"8-out18693"	.25961	135	385	520
8	"8-out18694"	.73493	244	88	332
8	"8-out18695"	.66044	177	91	268
8	"8-out18696"	.09480	31	296	327
8	"8-out18697"	.55516	156	125	281
8	"8-out18698"	.45292	789	953	1742
8	"8-out18699"	.30103	87	202	289
8	"8-out18700"	.44715	110	136	246
8	"8-out18701"	.08695	22	231	253
8	"8-out18702"	.27073	111	299	410
8	"8-out18703"	.35251	98	180	278
8	"8-out18704"	.23186	211	699	910
8	"8-out18705"	.25000	176	528	704
8	"8-out18706"	.35395	103	188	291
8	"8-out18707"	.38439	133	213	346
8	"8-out18708"	.28589	231	577	808
8	"8-out18709"	.49004	197	205	402
8	"8-out18710"	.14213	113	682	795
8	"8-out18711"	.39847	314	474	788
8	"8-out18712"	.15405	116	637	753
8	"8-out18713"	.28723	216	536	752
8	"8-out18714"	.31481	119	259	378
8	"8-out18715"	.50929	356	343	699
8	"8-out18716"	.27113	186	500	686
8	"8-out18717"	.33757	530	1040	1570
8	"8-out18718"	.34927	628	1170	1798
8	"8-out18719"	.21237	278	1031	1309
8	"8-out18720"	.21197	556	2067	2623
8	"8-out18721"	.28433	118	297	415
8	"8-out18722"	.33333	78	156	234
8	"8-out18723"	.20000	65	260	325
8	"8-out18724"	.34627	107	202	309
8	"8-out18725"	.13772	46	288	334
8	"8-out18726"	.39447	200	307	507
8	"8-out18727"	.10584	38	321	359
8	"8-out18728"	.08635	31	328	359
8	"8-out18729"	.97457	115	3	118
8	"8-out18730"	.99186	122	1	123
8	"8-out18731"	.99200	124	1	125
8	"8-out18732"	.35740	99	178	277
8	"8-out18733"	.26522	135	374	509
8	"8-out18734"	.35117	105	194	299
8	"8-out18735"	.24813	100	303	403
8	"8-out18736"	.27272	66	176	242
8	"8-out18737"	.17718	73	339	412
8	"8-out18738"	.98290	115	2	117
8	"8-out18739"	.22558	67	230	297
8	"8-out18740"	.43271	209	274	483
8	"8-out18741"	.96946	127	4	131
8	"8-out18742"	.32000	160	340	500
8	"8-out18743"	.27710	230	600	830
8	"8-out18744"	.97222	35	1	36
8	"8-out18745"	.14758	58	335	393
8	"8-out18746"	.93913	216	14	230
8	"8-out18747"	.24113	34	107	141
8	"8-out18748"	.99305	143	1	144
8	"8-out18749"	.17630	61	285	346
8	"8-out18750"	.35059	88	163	251
8	"8-out18751"	.21340	312	1150	1462
8	"8-out18752"	.76136	67	21	88
8	"8-out18753"	.34361	234	447	681
8	"8-out18754"	.31214	167	368	535
8	"8-out18755"	.25912	71	203	274
8	"8-out18756"	.47774	998	1091	2089
8	"8-out18757"	.99470	188	1	189
8	"8-out18758"	.34146	84	162	246
8	"8-out18759"	.37804	93	153	246
8	"8-out18760"	.39913	184	277	461
8	"8-out18761"	.26778	256	700	956
8	"8-out18762"	.14739	65	376	441
8	"8-out18763"	.15365	63	347	410
8	"8-out18764"	.20180	112	443	555
8	"8-out18765"	.36842	28	48	76
8	"8-out18766"	.91666	22	2	24
8	"8-out18767"	.95833	23	1	24
8	"8-out18768"	.56761	298	227	525
8	"8-out18769"	.13095	22	146	168
8	"8-out18770"	.14983	46	261	307
8	"8-out18771"	.62216	522	317	839
8	"8-out18772"	.23780	39	125	164
8	"8-out18773"	.99410	337	2	339
8	"8-out18774"	.29493	64	153	217
8	"8-out18775"	.75925	205	65	270
8	"8-out18776"	.49431	174	178	352
8	"8-out18777"	.17910	60	275	335
8	"8-out18778"	.50159	157	156	313
8	"8-out18779"	.20930	99	374	473
8	"8-out18780"	.98290	115	2	117
8	"8-out18781"	.39130	261	406	667
8	"8-out18782"	.99130	114	1	115
8	"8-out18783"	.44106	116	147	263
8	"8-out18784"	.29812	1304	3070	4374
8	"8-out18785"	.19520	114	470	584
8	"8-out18786"	.98290	115	2	117
8	"8-out18787"	.18809	139	600	739
8	"8-out18788"	.58368	279	199	478
8	"8-out18789"	.34230	89	171	260
8	"8-out18790"	.26388	304	848	1152
8	"8-out18791"	.42066	342	471	813
8	"8-out18792"	.36582	274	475	749
8	"8-out18793"	.59659	386	261	647
8	"8-out18794"	.37500	150	250	400
8	"8-out18795"	.99152	117	1	118
8	"8-out18796"	.19540	85	350	435
8	"8-out18797"	.99152	117	1	118
8	"8-out18798"	.93419	4784	337	5121
8	"8-out18799"	.99145	116	1	117
8	"8-out18800"	.99137	115	1	116
8	"8-out18801"	.20879	95	360	455
8	"8-out18802"	.98319	117	2	119
8	"8-out18803"	.23893	189	602	791
8	"8-out18804"	.99145	116	1	117
8	"8-out18805"	.30468	39	89	128
8	"8-out18806"	.42086	117	161	278
8	"8-out18807"	.36875	59	101	160
8	"8-out18808"	.25945	247	705	952
8	"8-out18809"	.24713	108	329	437
8	"8-out18810"	.45806	71	84	155
8	"8-out18811"	.31054	159	353	512
8	"8-out18812"	.30935	129	288	417
8	"8-out18813"	.66360	217	110	327
8	"8-out18814"	.99519	207	1	208
8	"8-out18815"	.99519	207	1	208
8	"8-out18816"	.99519	207	1	208
8	"8-out18817"	.88657	469	60	529
8	"8-out18818"	.22304	120	418	538
8	"8-out18819"	.22574	121	415	536
8	"8-out18820"	.35428	62	113	175
8	"8-out18821"	.53370	190	166	356
8	"8-out18822"	.17525	51	240	291
8	"8-out18823"	.32747	261	536	797
8	"8-out18824"	.30392	279	639	918
8	"8-out18825"	.29602	82	195	277
8	"8-out18826"	.43500	87	113	200
8	"8-out18827"	.16494	16	81	97
8	"8-out18828"	.22816	162	548	710
8	"8-out18829"	.19795	58	235	293
8	"8-out18830"	.30284	298	686	984
8	"8-out18831"	.31823	274	587	861
8	"8-out18832"	.74633	662	225	887
8	"8-out18833"	.28140	280	715	995
8	"8-out18834"	.77560	318	92	410
8	"8-out18835"	.32303	115	241	356
8	"8-out18836"	.26595	100	276	376
8	"8-out18837"	.85271	110	19	129
8	"8-out18838"	.29213	26	63	89
8	"8-out18839"	.47422	138	153	291
8	"8-out18840"	.52158	145	133	278
8	"8-out18841"	.24125	138	434	572
8	"8-out18842"	.50000	250	250	500
8	"8-out18843"	.37007	141	240	381
8	"8-out18844"	.28551	205	513	718
8	"8-out18845"	.86857	304	46	350
8	"8-out18846"	.31677	236	509	745
8	"8-out18847"	.16666	126	630	756
8	"8-out18848"	.30726	220	496	716
8	"8-out18849"	.24367	154	478	632
8	"8-out18850"	.47169	225	252	477
8	"8-out18851"	.23076	63	210	273
8	"8-out18852"	.32915	105	214	319
8	"8-out18853"	.16022	58	304	362
8	"8-out18854"	.99519	207	1	208
8	"8-out18855"	.18213	53	238	291
8	"8-out18856"	.38953	134	210	344
8	"8-out18857"	.25287	110	325	435
8	"8-out18858"	.33675	164	323	487
8	"8-out18859"	.62923	297	175	472
8	"8-out18860"	.18361	65	289	354
8	"8-out18861"	.26644	81	223	304
8	"8-out18862"	.45806	284	336	620
8	"8-out18863"	.19488	160	661	821
8	"8-out18864"	.15159	109	610	719
8	"8-out18865"	.38333	322	518	840
8	"8-out18866"	.26509	303	840	1143
8	"8-out18867"	.20335	109	427	536
8	"8-out18868"	.54263	280	236	516
8	"8-out18869"	.98113	52	1	53
8	"8-out18870"	.33812	47	92	139
8	"8-out18871"	.96428	27	1	28
8	"8-out18872"	.50564	179	175	354
8	"8-out18873"	.30000	165	385	550
8	"8-out18874"	.30222	217	501	718
8	"8-out18875"	.19626	168	688	856
8	"8-out18876"	.93464	286	20	306
8	"8-out18877"	.23502	51	166	217
8	"8-out18878"	.43030	355	470	825
8	"8-out18879"	.50684	37	36	73
8	"8-out18880"	.94524	328	19	347
8	"8-out18881"	.89408	363	43	406
8	"8-out18882"	.99145	116	1	117
8	"8-out18883"	.99145	116	1	117
8	"8-out18884"	.14411	49	291	340
8	"8-out18885"	.99145	116	1	117
8	"8-out18886"	.40637	102	149	251
8	"8-out18887"	.82720	225	47	272
8	"8-out18888"	.99115	112	1	113
8	"8-out18889"	.11111	13	104	117
8	"8-out18890"	.26033	63	179	242
8	"8-out18891"	.31642	262	566	828
8	"8-out18892"	.49034	127	132	259
8	"8-out18893"	.97435	114	3	117
8	"8-out18894"	.43606	532	688	1220
8	"8-out18895"	.71232	416	168	584
8	"8-out18896"	.30794	186	418	604
8	"8-out18897"	.36241	162	285	447
8	"8-out18898"	.28865	56	138	194
8	"8-out18899"	.99509	203	1	204
8	"8-out18900"	.24774	329	999	1328
8	"8-out18901"	.49576	117	119	236
8	"8-out18902"	.21599	389	1412	1801
8	"8-out18903"	.18055	52	236	288
8	"8-out18904"	.30516	130	296	426
8	"8-out18905"	.28846	150	370	520
8	"8-out18906"	.24210	69	216	285
8	"8-out18907"	.24915	74	223	297
8	"8-out18908"	.99641	556	2	558
8	"8-out18909"	.18628	182	795	977
8	"8-out18910"	.24923	81	244	325
8	"8-out18911"	.37590	156	259	415
8	"8-out18912"	.91666	22	2	24
8	"8-out18913"	.27788	279	725	1004
8	"8-out18914"	.19047	136	578	714
8	"8-out18915"	.23300	24	79	103
8	"8-out18916"	.32000	40	85	125
8	"8-out18917"	.99159	118	1	119
8	"8-out18918"	.98319	117	2	119
8	"8-out18919"	.99137	115	1	116
8	"8-out18920"	.99145	116	1	117
8	"8-out18921"	.23980	100	317	417
8	"8-out18922"	.13157	45	297	342
8	"8-out18923"	.42889	190	253	443
8	"8-out18924"	.24013	207	655	862
8	"8-out18925"	.28486	143	359	502
8	"8-out18926"	.99145	116	1	117
8	"8-out18927"	.99145	116	1	117
8	"8-out18928"	.36934	294	502	796
8	"8-out18929"	.35658	92	166	258
8	"8-out18930"	.18545	51	224	275
8	"8-out18931"	.26568	72	199	271
8	"8-out18932"	.31250	75	165	240
8	"8-out18933"	.42867	580	773	1353
8	"8-out18934"	.99468	187	1	188
8	"8-out18935"	.26315	140	392	532
8	"8-out18936"	.17549	53	249	302
8	"8-out18937"	.76119	102	32	134
8	"8-out18938"	.17924	38	174	212
8	"8-out18939"	.58928	165	115	280
8	"8-out18940"	.99145	116	1	117
8	"8-out18941"	.23698	255	821	1076
8	"8-out18942"	.99145	116	1	117
8	"8-out18943"	.20074	54	215	269
8	"8-out18944"	.98290	115	2	117
8	"8-out18945"	.33395	179	357	536
8	"8-out18946"	.61875	198	122	320
8	"8-out18947"	.11914	28	207	235
8	"8-out18948"	.56153	73	57	130
8	"8-out18949"	.20241	201	792	993
8	"8-out18950"	.56812	492	374	866
8	"8-out18951"	.71646	657	260	917
8	"8-out18952"	.22310	141	491	632
8	"8-out18953"	.41975	68	94	162
8	"8-out18954"	.48226	136	146	282
8	"8-out18955"	.31338	89	195	284
8	"8-out18956"	.26065	159	451	610
8	"8-out18957"	.17587	35	164	199
8	"8-out18958"	.23818	131	419	550
8	"8-out18959"	.43799	166	213	379
8	"8-out18960"	.25000	113	339	452
8	"8-out18961"	.70049	283	121	404
8	"8-out18962"	.33333	86	172	258
8	"8-out18963"	.99305	143	1	144
8	"8-out18964"	.36426	212	370	582
8	"8-out18965"	.25385	444	1305	1749
8	"8-out18966"	.79120	72	19	91
8	"8-out18967"	.53846	56	48	104
8	"8-out18968"	.46153	36	42	78
8	"8-out18969"	.95127	449	23	472
8	"8-out18970"	.28000	21	54	75
8	"8-out18971"	.28012	179	460	639
8	"8-out18972"	.91291	304	29	333
8	"8-out18973"	.91604	491	45	536
8	"8-out18974"	.24380	118	366	484
8	"8-out18975"	.31521	87	189	276
8	"8-out18976"	.95620	393	18	411
8	"8-out18977"	.86290	214	34	248
8	"8-out18978"	.79220	122	32	154
8	"8-out18979"	.36734	180	310	490
8	"8-out18980"	.28423	137	345	482
8	"8-out18981"	.21634	45	163	208
8	"8-out18982"	.42028	87	120	207
8	"8-out18983"	.81025	158	37	195
8	"8-out18984"	.38461	80	128	208
8	"8-out18985"	.40000	240	360	600
8	"8-out18986"	.64880	109	59	168
8	"8-out18987"	.99115	112	1	113
8	"8-out18988"	.92920	315	24	339
8	"8-out18989"	.33200	415	835	1250
8	"8-out18990"	.99065	106	1	107
8	"8-out18991"	.79439	170	44	214
8	"8-out18992"	.29965	786	1837	2623
8	"8-out18993"	.31847	100	214	314
8	"8-out18994"	.33647	107	211	318
8	"8-out18995"	.97972	145	3	148
8	"8-out18996"	.31699	207	446	653
8	"8-out18997"	.62595	82	49	131
8	"8-out18998"	.42468	234	317	551
8	"8-out18999"	.99555	224	1	225
8	"8-out19000"	.26768	140	383	523
8	"8-out19001"	.45982	103	121	224
8	"8-out19002"	.17025	269	1311	1580
8	"8-out19003"	.55452	239	192	431
8	"8-out19004"	.38640	216	343	559
8	"8-out19005"	.38684	200	317	517
8	"8-out19006"	.99236	130	1	131
8	"8-out19007"	.35245	43	79	122
8	"8-out19008"	.14615	19	111	130
8	"8-out19009"	.40292	413	612	1025
8	"8-out19010"	.28389	134	338	472
8	"8-out19011"	.99200	124	1	125
8	"8-out19012"	.98484	130	2	132
8	"8-out19013"	.99248	132	1	133
8	"8-out19014"	.94708	179	10	189
8	"8-out19015"	.95767	181	8	189
8	"8-out19016"	.97354	184	5	189
8	"8-out19017"	.97340	183	5	188
8	"8-out19018"	.95767	181	8	189
8	"8-out19019"	.30237	153	353	506
8	"8-out19020"	.78787	104	28	132
8	"8-out19021"	.36216	67	118	185
8	"8-out19022"	.32795	61	125	186
8	"8-out19023"	.26544	116	321	437
8	"8-out19024"	.24548	136	418	554
8	"8-out19025"	.31002	133	296	429
8	"8-out19026"	.60360	469	308	777
8	"8-out19027"	.20952	66	249	315
8	"8-out19028"	.97192	450	13	463
8	"8-out19029"	.24657	72	220	292
8	"8-out19030"	.16864	128	631	759
8	"8-out19031"	.98000	98	2	100
8	"8-out19032"	.36466	225	392	617
8	"8-out19033"	.98363	601	10	611
8	"8-out19034"	.27350	192	510	702
8	"8-out19035"	.92165	200	17	217
8	"8-out19036"	.13793	16	100	116
8	"8-out19037"	.26908	141	383	524
8	"8-out19038"	.99065	424	4	428
8	"8-out19039"	.97169	103	3	106
8	"8-out19040"	.25285	155	458	613
8	"8-out19041"	.97872	92	2	94
8	"8-out19042"	.76454	276	85	361
8	"8-out19043"	.95833	391	17	408
8	"8-out19044"	.18761	100	433	533
8	"8-out19045"	.99145	116	1	117
8	"8-out19046"	.27804	176	457	633
8	"8-out19047"	.79024	162	43	205
8	"8-out19048"	.24175	44	138	182
8	"8-out19049"	.20666	31	119	150
8	"8-out19050"	.45882	78	92	170
8	"8-out19051"	.17374	323	1536	1859
8	"8-out19052"	.94117	64	4	68
8	"8-out19053"	.13742	65	408	473
8	"8-out19054"	.85294	58	10	68
8	"8-out19055"	.19690	89	363	452
8	"8-out19056"	.22365	104	361	465
8	"8-out19057"	.97687	169	4	173
8	"8-out19058"	.18884	132	567	699
8	"8-out19059"	.28132	220	562	782
8	"8-out19060"	.23789	172	551	723
8	"8-out19061"	.23800	119	381	500
8	"8-out19062"	.16560	26	131	157
8	"8-out19063"	.25266	166	491	657
8	"8-out19064"	.53813	127	109	236
8	"8-out19065"	.49253	297	306	603
8	"8-out19066"	.26522	196	543	739
8	"8-out19067"	.61863	863	532	1395
8	"8-out19068"	.23125	111	369	480
8	"8-out19069"	.83522	441	87	528
8	"8-out19070"	.84741	311	56	367
8	"8-out19071"	.22318	129	449	578
8	"8-out19072"	.59558	81	55	136
8	"8-out19073"	.21985	93	330	423
8	"8-out19074"	.14411	49	291	340
8	"8-out19075"	.44927	31	38	69
8	"8-out19076"	.56164	41	32	73
8	"8-out19077"	.25055	113	338	451
8	"8-out19078"	1.00000	17	0	17
8	"8-out19079"	.55764	208	165	373
8	"8-out19080"	.29144	218	530	748
8	"8-out19081"	.19714	166	676	842
8	"8-out19082"	.50258	292	289	581
8	"8-out19083"	.35376	277	506	783
8	"8-out19084"	.35656	527	951	1478
8	"8-out19085"	.99137	115	1	116
8	"8-out19086"	.99145	116	1	117
8	"8-out19087"	.27525	545	1435	1980
8	"8-out19088"	.71889	156	61	217
8	"8-out19089"	.26121	99	280	379
8	"8-out19090"	.32493	129	268	397
8	"8-out19091"	.31924	204	435	639
8	"8-out19092"	.47394	282	313	595
8	"8-out19093"	.27350	32	85	117
8	"8-out19094"	.94786	600	33	633
8	"8-out19095"	.40800	102	148	250
8	"8-out19096"	.18493	81	357	438
8	"8-out19097"	.26940	177	480	657
8	"8-out19098"	.28265	132	335	467
8	"8-out19099"	.11436	78	604	682
8	"8-out19100"	.98769	562	7	569
8	"8-out19101"	.31948	123	262	385
8	"8-out19102"	.62765	118	70	188
8	"8-out19103"	.99137	115	1	116
8	"8-out19104"	.22809	151	511	662
8	"8-out19105"	.77461	354	103	457
8	"8-out19106"	.84012	268	51	319
8	"8-out19107"	.57142	200	150	350
8	"8-out19108"	.23776	170	545	715
8	"8-out19109"	.27727	183	477	660
8	"8-out19110"	.33762	105	206	311
8	"8-out19111"	.98449	254	4	258
8	"8-out19112"	.78232	363	101	464
8	"8-out19113"	.19283	581	2432	3013
8	"8-out19114"	.23291	242	797	1039
8	"8-out19115"	.22393	479	1660	2139
8	"8-out19116"	.52941	693	616	1309
8	"8-out19117"	.98287	1779	31	1810
8	"8-out19118"	.79310	391	102	493
8	"8-out19119"	.19614	122	500	622
8	"8-out19120"	.27088	107	288	395
8	"8-out19121"	.98648	73	1	74
8	"8-out19122"	.99300	426	3	429
8	"8-out19123"	.99699	664	2	666
8	"8-out19124"	.31612	147	318	465
8	"8-out19125"	.30580	237	538	775
8	"8-out19126"	.46862	366	415	781
8	"8-out19127"	.32548	152	315	467
8	"8-out19128"	.28125	126	322	448
8	"8-out19129"	.99063	952	9	961
8	"8-out19130"	.14171	71	430	501
8	"8-out19131"	.99699	664	2	666
8	"8-out19132"	.18656	50	218	268
8	"8-out19133"	.20767	92	351	443
8	"8-out19134"	.48416	214	228	442
8	"8-out19135"	.29880	251	589	840
8	"8-out19136"	.60835	393	253	646
8	"8-out19137"	.34774	177	332	509
8	"8-out19138"	.24787	233	707	940
8	"8-out19139"	.08823	6	62	68
8	"8-out19140"	.73504	86	31	117
8	"8-out19141"	.12093	67	487	554
8	"8-out19142"	.80672	480	115	595
8	"8-out19143"	.17954	79	361	440
8	"8-out19144"	.20886	132	500	632
8	"8-out19145"	.13502	64	410	474
8	"8-out19146"	.21126	15	56	71
8	"8-out19147"	.98379	425	7	432
8	"8-out19148"	.97892	511	11	522
8	"8-out19149"	.97818	538	12	550
8	"8-out19150"	.24836	76	230	306
8	"8-out19151"	.41810	194	270	464
8	"8-out19152"	.46942	284	321	605
8	"8-out19153"	.99806	517	1	518
8	"8-out19154"	.99145	116	1	117
8	"8-out19155"	.37339	174	292	466
8	"8-out19156"	.62866	193	114	307
8	"8-out19157"	.34957	122	227	349
8	"8-out19158"	.39143	256	398	654
8	"8-out19159"	.25641	30	87	117
8	"8-out19160"	.95744	45	2	47
8	"8-out19161"	.99448	902	5	907
8	"8-out19162"	.83766	129	25	154
8	"8-out19163"	.23508	260	846	1106
8	"8-out19164"	.46010	173	203	376
8	"8-out19165"	.21677	168	607	775
8	"8-out19166"	.17959	44	201	245
8	"8-out19167"	.22377	32	111	143
8	"8-out19168"	.27027	120	324	444
8	"8-out19169"	.64016	306	172	478
8	"8-out19170"	.90476	171	18	189
8	"8-out19171"	.43148	148	195	343
8	"8-out19172"	.25267	118	349	467
8	"8-out19173"	.63157	156	91	247
8	"8-out19174"	.28947	121	297	418
8	"8-out19175"	.17489	85	401	486
8	"8-out19176"	.25512	137	400	537
8	"8-out19177"	.98750	79	1	80
8	"8-out19178"	.99280	138	1	139
8	"8-out19179"	.31122	122	270	392
8	"8-out19180"	.23144	106	352	458
8	"8-out19181"	.26666	20	55	75
8	"8-out19182"	.93062	550	41	591
8	"8-out19183"	.32567	156	323	479
8	"8-out19184"	.94357	602	36	638
8	"8-out19185"	.88034	103	14	117
8	"8-out19186"	.46005	167	196	363
8	"8-out19187"	.16666	82	410	492
8	"8-out19188"	.39723	201	305	506
8	"8-out19189"	.27202	247	661	908
8	"8-out19190"	.39116	124	193	317
8	"8-out19191"	.99157	353	3	356
8	"8-out19192"	.24226	94	294	388
8	"8-out19193"	.49083	509	528	1037
8	"8-out19194"	.97588	4937	122	5059
8	"8-out19195"	.19031	169	719	888
8	"8-out19196"	.60476	254	166	420
8	"8-out19197"	.39863	291	439	730
8	"8-out19198"	.34622	188	355	543
8	"8-out19199"	.13013	19	127	146
8	"8-out19200"	.25990	223	635	858
8	"8-out19201"	.19073	70	297	367
8	"8-out19202"	.93852	687	45	732
8	"8-out19203"	.29393	97	233	330
8	"8-out19204"	.45267	220	266	486
8	"8-out19205"	.30112	134	311	445
8	"8-out19206"	.25365	156	459	615
8	"8-out19207"	.99295	141	1	142
8	"8-out19208"	.99230	387	3	390
8	"8-out19209"	.37070	248	421	669
8	"8-out19210"	.76943	297	89	386
8	"8-out19211"	.17283	210	1005	1215
8	"8-out19212"	.06811	22	301	323
8	"8-out19213"	.15915	60	317	377
8	"8-out19214"	.09523	6	57	63
8	"8-out19215"	.21325	74	273	347
8	"8-out19216"	.20035	1129	4506	5635
8	"8-out19217"	.42115	219	301	520
8	"8-out19218"	.53826	211	181	392
8	"8-out19219"	.93548	87	6	93
8	"8-out19220"	.28321	81	205	286
8	"8-out19221"	.21573	170	618	788
8	"8-out19222"	.41304	95	135	230
8	"8-out19223"	.92199	721	61	782
8	"8-out19224"	.62845	455	269	724
8	"8-out19225"	.33600	84	166	250
8	"8-out19226"	.37050	206	350	556
8	"8-out19227"	.42715	431	578	1009
8	"8-out19228"	.18095	76	344	420
8	"8-out19229"	.29096	103	251	354
8	"8-out19230"	.74712	260	88	348
8	"8-out19231"	.31372	128	280	408
8	"8-out19232"	.24946	116	349	465
8	"8-out19233"	.95833	23	1	24
8	"8-out19234"	.75555	68	22	90
8	"8-out19235"	.33104	241	487	728
8	"8-out19236"	.27454	165	436	601
8	"8-out19237"	.20608	122	470	592
8	"8-out19238"	.18348	60	267	327
8	"8-out19239"	.25732	79	228	307
8	"8-out19240"	.96760	448	15	463
8	"8-out19241"	.67730	191	91	282
8	"8-out19242"	.47216	212	237	449
8	"8-out19243"	.43119	94	124	218
8	"8-out19244"	.30256	118	272	390
8	"8-out19245"	.82098	133	29	162
8	"8-out19246"	.23170	38	126	164
8	"8-out19247"	.77027	57	17	74
8	"8-out19248"	.36595	86	149	235
8	"8-out19249"	.17415	62	294	356
8	"8-out19250"	.32590	117	242	359
8	"8-out19251"	.33483	149	296	445
8	"8-out19252"	.76492	410	126	536
8	"8-out19253"	.33536	165	327	492
8	"8-out19254"	.11764	6	45	51
8	"8-out19255"	.40769	106	154	260
8	"8-out19256"	.28000	70	180	250
8	"8-out19257"	.99145	116	1	117
8	"8-out19258"	.19746	109	443	552
8	"8-out19259"	.98319	117	2	119
8	"8-out19260"	.30370	82	188	270
8	"8-out19261"	.50609	166	162	328
8	"8-out19262"	.98290	115	2	117
8	"8-out19263"	.39007	110	172	282
8	"8-out19264"	.98260	113	2	115
8	"8-out19265"	.24540	147	452	599
8	"8-out19266"	.38625	163	259	422
8	"8-out19267"	.41509	264	372	636
8	"8-out19268"	.41230	134	191	325
8	"8-out19269"	.15539	85	462	547
8	"8-out19270"	.99275	137	1	138
8	"8-out19271"	.31861	101	216	317
8	"8-out19272"	.19685	100	408	508
8	"8-out19273"	.43843	146	187	333
8	"8-out19274"	.72957	259	96	355
8	"8-out19275"	.21960	112	398	510
8	"8-out19276"	.10416	30	258	288
8	"8-out19277"	.55425	189	152	341
8	"8-out19278"	.33948	184	358	542
8	"8-out19279"	.27777	100	260	360
8	"8-out19280"	.85714	78	13	91
8	"8-out19281"	.22518	152	523	675
8	"8-out19282"	.32069	220	466	686
8	"8-out19283"	.95043	326	17	343
8	"8-out19284"	.31359	143	313	456
8	"8-out19285"	.40740	55	80	135
8	"8-out19286"	.36065	176	312	488
8	"8-out19287"	.35574	127	230	357
8	"8-out19288"	.95833	23	1	24
8	"8-out19289"	.79166	19	5	24
8	"8-out19290"	.95833	23	1	24
8	"8-out19291"	.78787	78	21	99
8	"8-out19292"	.89473	527	62	589
8	"8-out19293"	.79133	493	130	623
8	"8-out19294"	.36956	51	87	138
8	"8-out19295"	.75536	176	57	233
8	"8-out19296"	.59171	200	138	338
8	"8-out19297"	.98290	115	2	117
8	"8-out19298"	.99152	117	1	118
8	"8-out19299"	.25892	58	166	224
8	"8-out19300"	.19337	111	463	574
8	"8-out19301"	.14414	32	190	222
8	"8-out19302"	.33996	188	365	553
8	"8-out19303"	.69940	235	101	336
8	"8-out19304"	.98290	115	2	117
8	"8-out19305"	.38505	134	214	348
8	"8-out19306"	.42160	605	830	1435
8	"8-out19307"	.82938	175	36	211
8	"8-out19308"	.17794	71	328	399
8	"8-out19309"	.29055	240	586	826
8	"8-out19310"	.97887	139	3	142
8	"8-out19311"	.18181	60	270	330
8	"8-out19312"	.99404	501	3	504
8	"8-out19313"	.18518	25	110	135
8	"8-out19314"	.41481	112	158	270
8	"8-out19315"	.47959	47	51	98
8	"8-out19316"	.30847	91	204	295
8	"8-out19317"	.32972	122	248	370
8	"8-out19318"	.35028	124	230	354
8	"8-out19319"	.29353	118	284	402
8	"8-out19320"	.95833	23	1	24
8	"8-out19321"	.75000	18	6	24
8	"8-out19322"	.25342	74	218	292
8	"8-out19323"	.96928	284	9	293
8	"8-out19324"	.96928	284	9	293
8	"8-out19325"	.22784	72	244	316
8	"8-out19326"	.40637	625	913	1538
8	"8-out19327"	.20621	239	920	1159
8	"8-out19328"	.29294	162	391	553
8	"8-out19329"	.16101	57	297	354
8	"8-out19330"	.41142	288	412	700
8	"8-out19331"	.99309	1150	8	1158
8	"8-out19332"	.54782	63	52	115
8	"8-out19333"	.43576	329	426	755
8	"8-out19334"	.22916	22	74	96
8	"8-out19335"	.12977	17	114	131
8	"8-out19336"	.31924	136	290	426
8	"8-out19337"	.21478	61	223	284
8	"8-out19338"	.98319	117	2	119
8	"8-out19339"	.98319	117	2	119
8	"8-out19340"	.37861	131	215	346
8	"8-out19341"	.96551	56	2	58
8	"8-out19342"	.99145	116	1	117
8	"8-out19343"	.99152	117	1	118
8	"8-out19344"	.20911	78	295	373
8	"8-out19345"	.21052	64	240	304
8	"8-out19346"	.82000	82	18	100
8	"8-out19347"	.26592	96	265	361
8	"8-out19348"	.57777	52	38	90
8	"8-out19349"	.20287	113	444	557
8	"8-out19350"	.30254	226	521	747
8	"8-out19351"	.20215	75	296	371
8	"8-out19352"	.78426	309	85	394
8	"8-out19353"	.89017	308	38	346
8	"8-out19354"	.39896	77	116	193
8	"8-out19355"	.27638	55	144	199
8	"8-out19356"	.99551	222	1	223
8	"8-out19357"	.39068	109	170	279
8	"8-out19358"	.99401	332	2	334
8	"8-out19359"	.27720	135	352	487
8	"8-out19360"	.65897	257	133	390
8	"8-out19361"	.64118	411	230	641
8	"8-out19362"	.42121	270	371	641
8	"8-out19363"	.80263	61	15	76
8	"8-out19364"	.35349	187	342	529
8	"8-out19365"	.17664	59	275	334
8	"8-out19366"	.98198	327	6	333
8	"8-out19367"	.96245	282	11	293
8	"8-out19368"	.97269	285	8	293
8	"8-out19369"	.51224	230	219	449
8	"8-out19370"	.30635	106	240	346
8	"8-out19371"	.34475	161	306	467
8	"8-out19372"	.64139	406	227	633
8	"8-out19373"	.98328	353	6	359
8	"8-out19374"	.11518	22	169	191
8	"8-out19375"	.31606	61	132	193
8	"8-out19376"	.31779	225	483	708
8	"8-out19377"	.97368	407	11	418
8	"8-out19378"	.24855	86	260	346
8	"8-out19379"	.82748	283	59	342
8	"8-out19380"	.81527	331	75	406
8	"8-out19381"	.30033	179	417	596
8	"8-out19382"	.95833	23	1	24
8	"8-out19383"	.66250	53	27	80
8	"8-out19384"	.21582	60	218	278
8	"8-out19385"	.25714	72	208	280
8	"8-out19386"	.98305	116	2	118
8	"8-out19387"	.99145	116	1	117
8	"8-out19388"	.21568	55	200	255
8	"8-out19389"	.35892	187	334	521
8	"8-out19390"	.19284	178	745	923
8	"8-out19391"	.20000	49	196	245
8	"8-out19392"	.27325	282	750	1032
8	"8-out19393"	.26564	484	1338	1822
8	"8-out19394"	.19194	224	943	1167
8	"8-out19395"	.25031	200	599	799
8	"8-out19396"	.20551	164	634	798
8	"8-out19397"	.29643	308	731	1039
8	"8-out19398"	.29144	385	936	1321
8	"8-out19399"	.25136	46	137	183
8	"8-out19400"	.29352	290	698	988
8	"8-out19401"	.22532	210	722	932
8	"8-out19402"	.23791	128	410	538
8	"8-out19403"	.33031	73	148	221
8	"8-out19404"	.37939	162	265	427
8	"8-out19405"	.44783	176	217	393
8	"8-out19406"	.25321	138	407	545
8	"8-out19407"	.20718	98	375	473
8	"8-out19408"	.25893	703	2012	2715
8	"8-out19409"	.39319	1931	2980	4911
8	"8-out19410"	.25645	1420	4117	5537
8	"8-out19411"	.83187	381	77	458
8	"8-out19412"	.27125	335	900	1235
8	"8-out19413"	.19345	130	542	672
8	"8-out19414"	.18317	135	602	737
8	"8-out19415"	.18701	72	313	385
8	"8-out19416"	.78154	415	116	531
8	"8-out19417"	.98125	157	3	160
8	"8-out19418"	.29197	40	97	137
8	"8-out19419"	.61728	50	31	81
8	"8-out19420"	.65476	55	29	84
8	"8-out19421"	.77777	49	14	63
8	"8-out19422"	.83687	236	46	282
8	"8-out19423"	.78039	199	56	255
8	"8-out19424"	.79638	176	45	221
8	"8-out19425"	.92307	180	15	195
8	"8-out19426"	.80597	162	39	201
8	"8-out19427"	.92574	187	15	202
8	"8-out19428"	.93589	146	10	156
8	"8-out19429"	.84705	216	39	255
8	"8-out19430"	.84745	150	27	177
8	"8-out19431"	.66666	64	32	96
8	"8-out19432"	.75000	84	28	112
8	"8-out19433"	.91860	158	14	172
8	"8-out19434"	.89795	88	10	98
8	"8-out19435"	.90816	89	9	98
8	"8-out19436"	.79411	108	28	136
8	"8-out19437"	.71794	140	55	195
8	"8-out19438"	.75301	125	41	166
8	"8-out19439"	.85082	154	27	181
8	"8-out19440"	.83414	171	34	205
8	"8-out19441"	.89523	188	22	210
8	"8-out19442"	.89729	166	19	185
8	"8-out19443"	.85714	180	30	210
8	"8-out19444"	.83812	233	45	278
8	"8-out19445"	.92405	219	18	237
8	"8-out19446"	.86046	111	18	129
8	"8-out19447"	.92121	152	13	165
8	"8-out19448"	.92513	173	14	187
8	"8-out19449"	.98224	166	3	169
8	"8-out19450"	.74647	53	18	71
8	"8-out19451"	.67741	42	20	62
8	"8-out19452"	.77669	80	23	103
8	"8-out19453"	.68400	171	79	250
8	"8-out19454"	.91954	160	14	174
8	"8-out19455"	.87421	139	20	159
8	"8-out19456"	.92207	142	12	154
8	"8-out19457"	.86875	139	21	160
8	"8-out19458"	.83431	141	28	169
8	"8-out19459"	.94968	151	8	159
8	"8-out19460"	.22198	105	368	473
8	"8-out19461"	.37572	387	643	1030
8	"8-out19462"	.30468	39	89	128
8	"8-out19463"	.85964	147	24	171
8	"8-out19464"	.55384	252	203	455
8	"8-out19465"	.87750	394	55	449
8	"8-out19466"	.82675	377	79	456
8	"8-out19467"	.73630	363	130	493
8	"8-out19468"	.17462	128	605	733
8	"8-out19469"	.95341	880	43	923
8	"8-out19470"	.28315	269	681	950
8	"8-out19471"	.17634	85	397	482
8	"8-out19472"	.21200	226	840	1066
8	"8-out19473"	.49024	201	209	410
8	"8-out19474"	.83168	336	68	404
8	"8-out19475"	.42647	58	78	136
8	"8-out19476"	.98113	52	1	53
8	"8-out19477"	.99236	130	1	131
8	"8-out19478"	.98420	997	16	1013
8	"8-out19479"	.80769	63	15	78
8	"8-out19480"	.88546	201	26	227
8	"8-out19481"	.19306	217	907	1124
8	"8-out19482"	.97127	372	11	383
8	"8-out19483"	.23319	111	365	476
8	"8-out19484"	.50566	268	262	530
8	"8-out19485"	.59829	280	188	468
8	"8-out19486"	.99044	829	8	837
8	"8-out19487"	.41751	205	286	491
8	"8-out19488"	.23119	372	1237	1609
8	"8-out19489"	.31516	555	1206	1761
8	"8-out19490"	.19195	229	964	1193
8	"8-out19491"	.30666	483	1092	1575
8	"8-out19492"	.55238	232	188	420
8	"8-out19493"	.72870	231	86	317
8	"8-out19494"	.86920	638	96	734
8	"8-out19495"	.22566	255	875	1130
8	"8-out19496"	.45038	118	144	262
8	"8-out19497"	.95833	391	17	408
8	"8-out19498"	.37876	264	433	697
8	"8-out19499"	.26243	269	756	1025
8	"8-out19500"	.37461	490	818	1308
8	"8-out19501"	.19334	93	388	481
8	"8-out19502"	.82203	97	21	118
8	"8-out19503"	.78813	93	25	118
8	"8-out19504"	.38410	58	93	151
8	"8-out19505"	.21627	186	674	860
8	"8-out19506"	.43321	120	157	277
8	"8-out19507"	.18103	42	190	232
8	"8-out19508"	.42231	193	264	457
8	"8-out19509"	.23932	185	588	773
8	"8-out19510"	.17514	31	146	177
8	"8-out19511"	.23481	174	567	741
8	"8-out19512"	.21059	620	2324	2944
8	"8-out19513"	.24555	207	636	843
8	"8-out19514"	.19489	145	599	744
8	"8-out19515"	.28767	168	416	584
8	"8-out19516"	.21287	43	159	202
8	"8-out19517"	.21606	199	722	921
8	"8-out19518"	.32220	222	467	689
8	"8-out19519"	.24657	36	110	146
8	"8-out19520"	.26436	23	64	87
8	"8-out19521"	.50304	165	163	328
8	"8-out19522"	.26643	77	212	289
8	"8-out19523"	.96808	91	3	94
8	"8-out19524"	.54493	946	790	1736
8	"8-out19525"	.34136	411	793	1204
8	"8-out19526"	.59624	127	86	213
8	"8-out19527"	.26875	437	1189	1626
8	"8-out19528"	.07368	14	176	190
8	"8-out19529"	.28643	57	142	199
8	"8-out19530"	.26153	51	144	195
8	"8-out19531"	.67336	134	65	199
8	"8-out19532"	.72767	163	61	224
8	"8-out19533"	.15025	29	164	193
8	"8-out19534"	.24242	48	150	198
8	"8-out19535"	.30721	149	336	485
8	"8-out19536"	.18960	62	265	327
8	"8-out19537"	.31901	52	111	163
8	"8-out19538"	.49714	87	88	175
8	"8-out19539"	.20168	24	95	119
8	"8-out19540"	.33888	183	357	540
8	"8-out19541"	.30746	527	1187	1714
8	"8-out19542"	.32052	292	619	911
8	"8-out19543"	.69357	507	224	731
8	"8-out19544"	.61027	202	129	331
8	"8-out19545"	.38600	193	307	500
8	"8-out19546"	.36746	183	315	498
8	"8-out19547"	.21693	82	296	378
8	"8-out19548"	.24407	103	319	422
8	"8-out19549"	.23809	90	288	378
8	"8-out19550"	.18064	56	254	310
8	"8-out19551"	.97568	321	8	329
8	"8-out19552"	.16885	90	443	533
8	"8-out19553"	.33038	187	379	566
8	"8-out19554"	.29659	296	702	998
8	"8-out19555"	.82001	852	187	1039
8	"8-out19556"	.37437	149	249	398
8	"8-out19557"	.22077	68	240	308
8	"8-out19558"	.41666	75	105	180
8	"8-out19559"	.99047	104	1	105
8	"8-out19560"	.98776	323	4	327
8	"8-out19561"	.20979	30	113	143
8	"8-out19562"	.23359	121	397	518
8	"8-out19563"	.24012	79	250	329
8	"8-out19564"	.96428	243	9	252
8	"8-out19565"	.20569	65	251	316
8	"8-out19566"	.13772	69	432	501
8	"8-out19567"	.24905	66	199	265
8	"8-out19568"	.17217	99	476	575
8	"8-out19569"	.24094	133	419	552
8	"8-out19570"	.24786	116	352	468
8	"8-out19571"	.22119	48	169	217
8	"8-out19572"	.36627	63	109	172
8	"8-out19573"	.38726	304	481	785
8	"8-out19574"	.56846	137	104	241
8	"8-out19575"	.30817	98	220	318
8	"8-out19576"	.23514	91	296	387
8	"8-out19577"	.21146	59	220	279
8	"8-out19578"	.18813	92	397	489
8	"8-out19579"	.16000	84	441	525
8	"8-out19580"	.24784	461	1399	1860
8	"8-out19581"	.63876	145	82	227
8	"8-out19582"	.37403	582	974	1556
8	"8-out19583"	.16088	116	605	721
8	"8-out19584"	.89914	419	47	466
8	"8-out19585"	.90510	372	39	411
8	"8-out19586"	.17780	125	578	703
8	"8-out19587"	.45756	124	147	271
8	"8-out19588"	.22099	40	141	181
8	"8-out19589"	.21470	111	406	517
8	"8-out19590"	.37667	730	1208	1938
8	"8-out19591"	.45477	181	217	398
8	"8-out19592"	.21834	100	358	458
8	"8-out19593"	.98347	119	2	121
8	"8-out19594"	.96153	125	5	130
8	"8-out19595"	.20712	93	356	449
8	"8-out19596"	.48881	153	160	313
8	"8-out19597"	.80090	177	44	221
8	"8-out19598"	.42131	83	114	197
8	"8-out19599"	.53367	103	90	193
8	"8-out19600"	.39795	39	59	98
8	"8-out19601"	.99080	431	4	435
8	"8-out19602"	.17552	294	1381	1675
8	"8-out19603"	.13353	219	1421	1640
8	"8-out19604"	.39590	232	354	586
8	"8-out19605"	.83805	207	40	247
8	"8-out19606"	.71541	181	72	253
8	"8-out19607"	.31571	454	984	1438
8	"8-out19608"	.23217	127	420	547
8	"8-out19609"	.66942	81	40	121
8	"8-out19610"	.44878	92	113	205
8	"8-out19611"	.61607	138	86	224
8	"8-out19612"	.22377	64	222	286
8	"8-out19613"	.31914	270	576	846
8	"8-out19614"	.24709	362	1103	1465
8	"8-out19615"	.24235	103	322	425
8	"8-out19616"	.16949	60	294	354
8	"8-out19617"	.23241	76	251	327
8	"8-out19618"	.24117	82	258	340
8	"8-out19619"	.98780	162	2	164
8	"8-out19620"	.99076	322	3	325
8	"8-out19621"	.99528	211	1	212
8	"8-out19622"	.41776	221	308	529
8	"8-out19623"	.33436	108	215	323
8	"8-out19624"	.45657	205	244	449
8	"8-out19625"	.38549	101	161	262
8	"8-out19626"	.23712	198	637	835
8	"8-out19627"	.36347	1479	2590	4069
8	"8-out19628"	.40000	56	84	140
8	"8-out19629"	.97590	81	2	83
8	"8-out19630"	.94444	51	3	54
8	"8-out19631"	.99324	147	1	148
8	"8-out19632"	.41250	66	94	160
8	"8-out19633"	.26585	239	660	899
8	"8-out19634"	.30538	102	232	334
8	"8-out19635"	.86407	267	42	309
8	"8-out19636"	.21942	192	683	875
8	"8-out19637"	.49929	353	354	707
8	"8-out19638"	.32392	241	503	744
8	"8-out19639"	.33921	173	337	510
8	"8-out19640"	.48913	45	47	92
8	"8-out19641"	.13135	62	410	472
8	"8-out19642"	.33611	121	239	360
8	"8-out19643"	.16895	172	846	1018
8	"8-out19644"	.32181	354	746	1100
8	"8-out19645"	.20510	273	1058	1331
8	"8-out19646"	.98936	93	1	94
8	"8-out19647"	.39325	70	108	178
8	"8-out19648"	.38108	399	648	1047
8	"8-out19649"	.65359	100	53	153
8	"8-out19650"	.27046	76	205	281
8	"8-out19651"	.41899	75	104	179
8	"8-out19652"	.20218	37	146	183
8	"8-out19653"	.43478	70	91	161
8	"8-out19654"	.24571	43	132	175
8	"8-out19655"	.99173	120	1	121
8	"8-out19656"	.21106	309	1155	1464
8	"8-out19657"	.21923	326	1161	1487
8	"8-out19658"	.73481	1222	441	1663
8	"8-out19659"	.23906	399	1270	1669
8	"8-out19660"	.21378	366	1346	1712
8	"8-out19661"	.21186	357	1328	1685
8	"8-out19662"	.99311	1732	12	1744
8	"8-out19663"	.99254	1731	13	1744
8	"8-out19664"	.20880	313	1186	1499
8	"8-out19665"	.15175	156	872	1028
8	"8-out19666"	.15112	154	865	1019
8	"8-out19667"	.20415	462	1801	2263
8	"8-out19668"	.31477	294	640	934
8	"8-out19669"	.34423	242	461	703
8	"8-out19670"	.26395	156	435	591
8	"8-out19671"	.26169	179	505	684
8	"8-out19672"	.39177	219	340	559
8	"8-out19673"	.18867	20	86	106
8	"8-out19674"	.67567	50	24	74
8	"8-out19675"	.63200	79	46	125
8	"8-out19676"	.26839	62	169	231
8	"8-out19677"	.22352	152	528	680
8	"8-out19678"	.25526	461	1345	1806
8	"8-out19679"	.40999	517	744	1261
8	"8-out19680"	.29514	407	972	1379
8	"8-out19681"	.27359	229	608	837
8	"8-out19682"	.22997	445	1490	1935
8	"8-out19683"	.28819	762	1882	2644
8	"8-out19684"	.19764	218	885	1103
8	"8-out19685"	.22842	217	733	950
8	"8-out19686"	.28127	308	787	1095
8	"8-out19687"	.30985	374	833	1207
8	"8-out19688"	.21263	101	374	475
8	"8-out19689"	.98418	1058	17	1075
8	"8-out19690"	.27027	40	108	148
8	"8-out19691"	.35103	119	220	339
8	"8-out19692"	.43417	155	202	357
8	"8-out19693"	.80148	323	80	403
8	"8-out19694"	.80232	276	68	344
8	"8-out19695"	.24779	759	2304	3063
8	"8-out19696"	.30363	167	383	550
8	"8-out19697"	.23152	166	551	717
8	"8-out19698"	.22672	207	706	913
8	"8-out19699"	.16210	83	429	512
8	"8-out19700"	.14720	87	504	591
8	"8-out19701"	.18260	105	470	575
8	"8-out19702"	.73493	122	44	166
8	"8-out19703"	.40414	78	115	193
8	"8-out19704"	.38554	64	102	166
8	"8-out19705"	.25864	359	1029	1388
8	"8-out19706"	.21945	185	658	843
8	"8-out19707"	.19866	89	359	448
8	"8-out19708"	.99565	458	2	460
8	"8-out19709"	.20000	157	628	785
8	"8-out19710"	.16690	118	589	707
8	"8-out19711"	.15097	101	568	669
8	"8-out19712"	.55855	124	98	222
8	"8-out19713"	.57425	58	43	101
8	"8-out19714"	.20935	94	355	449
8	"8-out19715"	.35217	461	848	1309
8	"8-out19716"	.41935	117	162	279
8	"8-out19717"	.19550	235	967	1202
8	"8-out19718"	.31558	243	527	770
8	"8-out19719"	.21375	115	423	538
8	"8-out19720"	.99145	116	1	117
8	"8-out19721"	.33600	42	83	125
8	"8-out19722"	.78688	96	26	122
8	"8-out19723"	.44444	144	180	324
8	"8-out19724"	.12114	51	370	421
8	"8-out19725"	.37844	165	271	436
8	"8-out19726"	.16493	95	481	576
8	"8-out19727"	.58522	594	421	1015
8	"8-out19728"	.21695	325	1173	1498
8	"8-out19729"	.23668	120	387	507
8	"8-out19730"	.32374	405	846	1251
8	"8-out19731"	.33992	275	534	809
8	"8-out19732"	.40972	59	85	144
8	"8-out19733"	.18750	30	130	160
8	"8-out19734"	.64748	90	49	139
8	"8-out19735"	.36474	120	209	329
8	"8-out19736"	.35962	342	609	951
8	"8-out19737"	.31096	241	534	775
8	"8-out19738"	.16296	88	452	540
8	"8-out19739"	.34130	257	496	753
8	"8-out19740"	.33928	57	111	168
8	"8-out19741"	.35714	65	117	182
8	"8-out19742"	.34172	95	183	278
8	"8-out19743"	.37793	274	451	725
8	"8-out19744"	.91304	1176	112	1288
8	"8-out19745"	.22373	230	798	1028
8	"8-out19746"	.91071	1173	115	1288
8	"8-out19747"	.33409	437	871	1308
8	"8-out19748"	.22741	297	1009	1306
8	"8-out19749"	.35010	814	1511	2325
8	"8-out19750"	.44585	70	87	157
8	"8-out19751"	.19985	273	1093	1366
8	"8-out19752"	.19849	291	1175	1466
8	"8-out19753"	.77516	231	67	298
8	"8-out19754"	.98214	55	1	56
8	"8-out19755"	.43627	89	115	204
8	"8-out19756"	.20390	115	449	564
8	"8-out19757"	.53459	85	74	159
8	"8-out19758"	.32616	258	533	791
8	"8-out19759"	.34293	655	1255	1910
8	"8-out19760"	.28158	341	870	1211
8	"8-out19761"	.50160	1250	1242	2492
8	"8-out19762"	.20537	191	739	930
8	"8-out19763"	.26976	430	1164	1594
8	"8-out19764"	.98898	449	5	454
8	"8-out19765"	.26492	324	899	1223
8	"8-out19766"	.21650	265	959	1224
8	"8-out19767"	.24405	236	731	967
8	"8-out19768"	.27866	192	497	689
8	"8-out19769"	.27975	228	587	815
8	"8-out19770"	.98750	79	1	80
8	"8-out19771"	.46197	164	191	355
8	"8-out19772"	.80609	291	70	361
8	"8-out19773"	.25566	79	230	309
8	"8-out19774"	.32962	415	844	1259
8	"8-out19775"	.21733	178	641	819
8	"8-out19776"	.27397	180	477	657
8	"8-out19777"	.23989	178	564	742
8	"8-out19778"	.14285	22	132	154
8	"8-out19779"	.59504	72	49	121
8	"8-out19780"	.26593	121	334	455
8	"8-out19781"	.42857	48	64	112
8	"8-out19782"	.16738	39	194	233
8	"8-out19783"	.58823	50	35	85
8	"8-out19784"	.38000	76	124	200
8	"8-out19785"	.53551	98	85	183
8	"8-out19786"	.26767	53	145	198
8	"8-out19787"	.36633	74	128	202
8	"8-out19788"	.38659	75	119	194
8	"8-out19789"	.96107	321	13	334
8	"8-out19790"	.18758	142	615	757
8	"8-out19791"	.20664	56	215	271
8	"8-out19792"	.25785	320	921	1241
8	"8-out19793"	.29301	361	871	1232
8	"8-out19794"	.25940	255	728	983
8	"8-out19795"	.56551	82	63	145
8	"8-out19796"	.26347	88	246	334
8	"8-out19797"	.36222	117	206	323
8	"8-out19798"	.13455	88	566	654
8	"8-out19799"	.92537	310	25	335
8	"8-out19800"	.22957	281	943	1224
8	"8-out19801"	.42065	167	230	397
8	"8-out19802"	.40720	147	214	361
8	"8-out19803"	.16402	62	316	378
8	"8-out19804"	.19018	62	264	326
8	"8-out19805"	.16935	63	309	372
8	"8-out19806"	.36571	64	111	175
8	"8-out19807"	.18575	73	320	393
8	"8-out19808"	.26162	90	254	344
8	"8-out19809"	.16492	63	319	382
8	"8-out19810"	.49473	188	192	380
8	"8-out19811"	.32614	121	250	371
8	"8-out19812"	.75054	343	114	457
8	"8-out19813"	.37777	34	56	90
8	"8-out19814"	.20581	92	355	447
8	"8-out19815"	.63188	218	127	345
8	"8-out19816"	.31007	351	781	1132
8	"8-out19817"	.22914	272	915	1187
8	"8-out19818"	.53656	1416	1223	2639
8	"8-out19819"	.99358	775	5	780
8	"8-out19820"	.34349	169	323	492
8	"8-out19821"	.29520	191	456	647
8	"8-out19822"	.73983	182	64	246
8	"8-out19823"	.37795	96	158	254
8	"8-out19824"	.23417	111	363	474
8	"8-out19825"	.24155	93	292	385
8	"8-out19826"	.30141	447	1036	1483
8	"8-out19827"	.45669	58	69	127
8	"8-out19828"	.40267	873	1295	2168
8	"8-out19829"	.18400	23	102	125
8	"8-out19830"	.27464	195	515	710
8	"8-out19831"	.27966	132	340	472
8	"8-out19832"	.34252	298	572	870
8	"8-out19833"	.21575	126	458	584
8	"8-out19834"	.36170	170	300	470
8	"8-out19835"	.36563	200	347	547
8	"8-out19836"	.37619	354	587	941
8	"8-out19837"	.68091	1195	560	1755
8	"8-out19838"	.41409	188	266	454
8	"8-out19839"	.19263	136	570	706
8	"8-out19840"	.93000	93	7	100
8	"8-out19841"	.33422	501	998	1499
8	"8-out19842"	.19845	283	1143	1426
8	"8-out19843"	.32361	111	232	343
8	"8-out19844"	.56059	1471	1153	2624
8	"8-out19845"	.30185	179	414	593
8	"8-out19846"	.51479	87	82	169
8	"8-out19847"	.41935	117	162	279
8	"8-out19848"	.37572	195	324	519
8	"8-out19849"	.24102	141	444	585
8	"8-out19850"	.16916	113	555	668
8	"8-out19851"	.78000	117	33	150
8	"8-out19852"	.72000	54	21	75
8	"8-out19853"	.81250	65	15	80
8	"8-out19854"	.91509	97	9	106
8	"8-out19855"	.53623	37	32	69
8	"8-out19856"	.88000	110	15	125
8	"8-out19857"	.62162	69	42	111
8	"8-out19858"	.62500	75	45	120
8	"8-out19859"	.97297	108	3	111
8	"8-out19860"	.24444	110	340	450
8	"8-out19861"	.29323	195	470	665
8	"8-out19862"	.52048	216	199	415
8	"8-out19863"	.24815	168	509	677
8	"8-out19864"	.98587	349	5	354
8	"8-out19865"	.97236	387	11	398
8	"8-out19866"	.52212	118	108	226
8	"8-out19867"	.26200	60	169	229
8	"8-out19868"	.21067	75	281	356
8	"8-out19869"	.32439	121	252	373
8	"8-out19870"	.91428	288	27	315
8	"8-out19871"	.61250	98	62	160
8	"8-out19872"	.25153	41	122	163
8	"8-out19873"	.67278	220	107	327
8	"8-out19874"	.09625	18	169	187
8	"8-out19875"	.99086	217	2	219
8	"8-out19876"	.63025	150	88	238
8	"8-out19877"	.24738	142	432	574
8	"8-out19878"	.23057	273	911	1184
8	"8-out19879"	.32547	69	143	212
8	"8-out19880"	.38345	153	246	399
8	"8-out19881"	.16347	111	568	679
8	"8-out19882"	.13207	14	92	106
8	"8-out19883"	.27762	201	523	724
8	"8-out19884"	.14227	105	633	738
8	"8-out19885"	.31090	134	297	431
8	"8-out19886"	.98958	95	1	96
8	"8-out19887"	.22404	300	1039	1339
8	"8-out19888"	.26550	381	1054	1435
8	"8-out19889"	.14373	163	971	1134
8	"8-out19890"	.28887	340	837	1177
8	"8-out19891"	.40421	192	283	475
8	"8-out19892"	.13205	159	1045	1204
8	"8-out19893"	.30254	357	823	1180
8	"8-out19894"	.37928	465	761	1226
8	"8-out19895"	.24665	295	901	1196
8	"8-out19896"	.17860	222	1021	1243
8	"8-out19897"	.80645	225	54	279
8	"8-out19898"	.49295	70	72	142
8	"8-out19899"	.29152	251	610	861
8	"8-out19900"	.23157	22	73	95
8	"8-out19901"	.26444	119	331	450
8	"8-out19902"	.28178	328	836	1164
8	"8-out19903"	.44680	126	156	282
8	"8-out19904"	.15363	57	314	371
8	"8-out19905"	.26417	177	493	670
8	"8-out19906"	.23478	243	792	1035
8	"8-out19907"	.13402	39	252	291
8	"8-out19908"	.30567	70	159	229
8	"8-out19909"	.81333	183	42	225
8	"8-out19910"	.37044	366	622	988
8	"8-out19911"	.85436	88	15	103
8	"8-out19912"	.33815	257	503	760
8	"8-out19913"	.19751	159	646	805
8	"8-out19914"	.30962	74	165	239
8	"8-out19915"	.21929	50	178	228
8	"8-out19916"	.21397	49	180	229
8	"8-out19917"	.98598	211	3	214
8	"8-out19918"	.20553	52	201	253
8	"8-out19919"	.99557	225	1	226
8	"8-out19920"	.23140	112	372	484
8	"8-out19921"	.15176	73	408	481
8	"8-out19922"	.38965	113	177	290
8	"8-out19923"	.39800	80	121	201
8	"8-out19924"	.39106	140	218	358
8	"8-out19925"	.29205	125	303	428
8	"8-out19926"	.27881	150	388	538
8	"8-out19927"	.18624	195	852	1047
8	"8-out19928"	.98529	67	1	68
8	"8-out19929"	.31034	72	160	232
8	"8-out19930"	.36818	493	846	1339
8	"8-out19931"	.32080	111	235	346
8	"8-out19932"	.31476	130	283	413
8	"8-out19933"	.30686	143	323	466
8	"8-out19934"	.99319	146	1	147
8	"8-out19935"	.27935	69	178	247
8	"8-out19936"	.93297	348	25	373
8	"8-out19937"	.22414	375	1298	1673
8	"8-out19938"	.35329	59	108	167
8	"8-out19939"	.27419	85	225	310
8	"8-out19940"	.99047	104	1	105
8	"8-out19941"	.06172	5	76	81
8	"8-out19942"	.07228	6	77	83
8	"8-out19943"	.43611	611	790	1401
8	"8-out19944"	.34208	391	752	1143
8	"8-out19945"	.27438	166	439	605
8	"8-out19946"	.26111	188	532	720
8	"8-out19947"	.36943	382	652	1034
8	"8-out19948"	.24684	137	418	555
8	"8-out19949"	.12794	38	259	297
8	"8-out19950"	.76036	422	133	555
8	"8-out19951"	.21548	512	1864	2376
8	"8-out19952"	.29565	170	405	575
8	"8-out19953"	.26929	150	407	557
8	"8-out19954"	.82105	234	51	285
8	"8-out19955"	.36301	106	186	292
8	"8-out19956"	.24749	74	225	299
8	"8-out19957"	.39024	160	250	410
8	"8-out19958"	.54435	135	113	248
8	"8-out19959"	.40229	35	52	87
8	"8-out19960"	.35365	58	106	164
8	"8-out19961"	.21212	70	260	330
8	"8-out19962"	.36156	111	196	307
8	"8-out19963"	.33870	126	246	372
8	"8-out19964"	.24500	49	151	200
8	"8-out19965"	.41209	579	826	1405
8	"8-out19966"	.25673	267	773	1040
8	"8-out19967"	.18908	194	832	1026
8	"8-out19968"	.27042	278	750	1028
8	"8-out19969"	.11054	153	1231	1384
8	"8-out19970"	.23477	212	691	903
8	"8-out19971"	.19813	149	603	752
8	"8-out19972"	.30778	514	1156	1670
8	"8-out19973"	.26094	441	1249	1690
8	"8-out19974"	.25724	435	1256	1691
8	"8-out19975"	.18824	346	1492	1838
8	"8-out19976"	.32664	570	1175	1745
8	"8-out19977"	.26193	439	1237	1676
8	"8-out19978"	.16556	526	2651	3177
8	"8-out19979"	.26156	684	1931	2615
8	"8-out19980"	.98809	249	3	252
8	"8-out19981"	.12200	51	367	418
8	"8-out19982"	.37335	199	334	533
8	"8-out19983"	.38106	165	268	433
8	"8-out19984"	.71818	158	62	220
8	"8-out19985"	.99393	164	1	165
8	"8-out19986"	.24829	146	442	588
8	"8-out19987"	.36271	107	188	295
8	"8-out19988"	.39378	76	117	193
8	"8-out19989"	.22972	119	399	518
8	"8-out19990"	.13522	43	275	318
8	"8-out19991"	.70748	208	86	294
8	"8-out19992"	.64248	124	69	193
8	"8-out19993"	.42765	133	178	311
8	"8-out19994"	.30392	62	142	204
8	"8-out19995"	.23267	47	155	202
8	"8-out19996"	.25431	59	173	232
8	"8-out19997"	.26465	167	464	631
8	"8-out19998"	.20439	93	362	455
8	"8-out19999"	.39367	137	211	348
8	"8-out20000"	.33900	299	583	882
8	"8-out20001"	.24611	95	291	386
8	"8-out20002"	.11556	49	375	424
8	"8-out20003"	.25959	115	328	443
8	"8-out20004"	.30113	106	246	352
8	"8-out20005"	.31884	132	282	414
8	"8-out20006"	.37793	209	344	553
8	"8-out20007"	.42857	33	44	77
8	"8-out20008"	.39361	148	228	376
8	"8-out20009"	.63768	44	25	69
8	"8-out20010"	.28174	304	775	1079
8	"8-out20011"	.98421	187	3	190
8	"8-out20012"	.30962	74	165	239
8	"8-out20013"	.46534	47	54	101
8	"8-out20014"	.36945	75	128	203
8	"8-out20015"	.74074	80	28	108
8	"8-out20016"	.29921	38	89	127
8	"8-out20017"	.43167	796	1048	1844
8	"8-out20018"	.54755	190	157	347
8	"8-out20019"	.94307	1226	74	1300
8	"8-out20020"	.28942	345	847	1192
8	"8-out20021"	.37194	517	873	1390
8	"8-out20022"	.88734	575	73	648
8	"8-out20023"	.29150	151	367	518
8	"8-out20024"	.25910	128	366	494
8	"8-out20025"	.81428	114	26	140
8	"8-out20026"	.21243	41	152	193
8	"8-out20027"	.25842	537	1541	2078
8	"8-out20028"	.35502	60	109	169
8	"8-out20029"	.99206	125	1	126
8	"8-out20030"	.95901	117	5	122
8	"8-out20031"	.20262	170	669	839
8	"8-out20032"	.49675	459	465	924
8	"8-out20033"	.20754	22	84	106
8	"8-out20034"	.38205	230	372	602
8	"8-out20035"	.16855	297	1465	1762
8	"8-out20036"	.68559	652	299	951
8	"8-out20037"	.41787	173	241	414
8	"8-out20038"	.99212	126	1	127
8	"8-out20039"	.59003	367	255	622
8	"8-out20040"	.45306	111	134	245
8	"8-out20041"	.49618	65	66	131
8	"8-out20042"	.19879	33	133	166
8	"8-out20043"	.25842	115	330	445
8	"8-out20044"	.99397	165	1	166
8	"8-out20045"	.99628	268	1	269
8	"8-out20046"	.77464	55	16	71
8	"8-out20047"	.97476	309	8	317
8	"8-out20048"	.20689	30	115	145
8	"8-out20049"	.18817	105	453	558
8	"8-out20050"	.25557	149	434	583
8	"8-out20051"	.30868	167	374	541
8	"8-out20052"	.95698	89	4	93
8	"8-out20053"	.55462	660	530	1190
8	"8-out20054"	.30225	107	247	354
8	"8-out20055"	.29798	281	662	943
8	"8-out20056"	.96506	663	24	687
8	"8-out20057"	.31662	259	559	818
8	"8-out20058"	.17560	131	615	746
8	"8-out20059"	.18296	159	710	869
8	"8-out20060"	.23245	53	175	228
8	"8-out20061"	.27868	68	176	244
8	"8-out20062"	.11494	30	231	261
8	"8-out20063"	.28909	61	150	211
8	"8-out20064"	.28260	65	165	230
8	"8-out20065"	.30909	68	152	220
8	"8-out20066"	.76818	169	51	220
8	"8-out20067"	.16000	36	189	225
8	"8-out20068"	.13173	22	145	167
8	"8-out20069"	.68464	165	76	241
8	"8-out20070"	.37288	88	148	236
8	"8-out20071"	.55823	393	311	704
8	"8-out20072"	.41536	265	373	638
8	"8-out20073"	.52061	101	93	194
8	"8-out20074"	.27409	91	241	332
8	"8-out20075"	.39142	146	227	373
8	"8-out20076"	.21733	326	1174	1500
8	"8-out20077"	.83182	460	93	553
8	"8-out20078"	.34755	220	413	633
8	"8-out20079"	.24778	56	170	226
8	"8-out20080"	.99109	334	3	337
8	"8-out20081"	.35537	43	78	121
8	"8-out20082"	.19874	284	1145	1429
8	"8-out20083"	.13609	164	1041	1205
8	"8-out20084"	.20322	227	890	1117
8	"8-out20085"	.86061	1451	235	1686
8	"8-out20086"	.34758	309	580	889
8	"8-out20087"	.29712	424	1003	1427
8	"8-out20088"	.19246	235	986	1221
8	"8-out20089"	.39680	521	792	1313
8	"8-out20090"	.30156	269	623	892
8	"8-out20091"	.21219	87	323	410
8	"8-out20092"	.46408	168	194	362
8	"8-out20093"	.20987	136	512	648
8	"8-out20094"	.21088	31	116	147
8	"8-out20095"	.28265	145	368	513
8	"8-out20096"	.21644	129	467	596
8	"8-out20097"	.42857	258	344	602
8	"8-out20098"	.24109	433	1363	1796
8	"8-out20099"	.95731	314	14	328
8	"8-out20100"	.21321	71	262	333
8	"8-out20101"	.95280	323	16	339
8	"8-out20102"	.96636	316	11	327
8	"8-out20103"	.33300	337	675	1012
8	"8-out20104"	.27494	237	625	862
8	"8-out20105"	.47193	185	207	392
8	"8-out20106"	.19795	194	786	980
8	"8-out20107"	.20731	153	585	738
8	"8-out20108"	.30917	256	572	828
8	"8-out20109"	.31108	261	578	839
8	"8-out20110"	.37142	286	484	770
8	"8-out20111"	.34640	212	400	612
8	"8-out20112"	.24625	395	1209	1604
8	"8-out20113"	.23847	357	1140	1497
8	"8-out20114"	.26111	458	1296	1754
8	"8-out20115"	.87152	502	74	576
8	"8-out20116"	.23204	265	877	1142
8	"8-out20117"	.34190	439	845	1284
8	"8-out20118"	.16245	45	232	277
8	"8-out20119"	.21033	57	214	271
8	"8-out20120"	.26123	250	707	957
8	"8-out20121"	.97580	121	3	124
8	"8-out20122"	.29213	78	189	267
8	"8-out20123"	.36000	36	64	100
8	"8-out20124"	.61194	246	156	402
8	"8-out20125"	.20698	77	295	372
8	"8-out20126"	.34375	132	252	384
8	"8-out20127"	.34164	137	264	401
8	"8-out20128"	.31738	126	271	397
8	"8-out20129"	.23620	214	692	906
8	"8-out20130"	.25813	246	707	953
8	"8-out20131"	.16867	70	345	415
8	"8-out20132"	.31115	159	352	511
8	"8-out20133"	.21078	43	161	204
8	"8-out20134"	.20137	176	698	874
8	"8-out20135"	.80711	703	168	871
8	"8-out20136"	.27990	117	301	418
8	"8-out20137"	.18041	70	318	388
8	"8-out20138"	.31610	104	225	329
8	"8-out20139"	.98913	182	2	184
8	"8-out20140"	.74210	141	49	190
8	"8-out20141"	.34725	133	250	383
8	"8-out20142"	.28248	50	127	177
8	"8-out20143"	.41904	88	122	210
8	"8-out20144"	.22282	164	572	736
8	"8-out20145"	.23543	198	643	841
8	"8-out20146"	.19808	62	251	313
8	"8-out20147"	.36043	133	236	369
8	"8-out20148"	.47023	79	89	168
8	"8-out20149"	.93258	83	6	89
8	"8-out20150"	.31753	67	144	211
8	"8-out20151"	.16207	53	274	327
8	"8-out20152"	.95348	41	2	43
8	"8-out20153"	.98165	107	2	109
8	"8-out20154"	.98165	107	2	109
8	"8-out20155"	.92307	36	3	39
8	"8-out20156"	.95348	41	2	43
8	"8-out20157"	.90521	191	20	211
8	"8-out20158"	.21538	56	204	260
8	"8-out20159"	.80732	419	100	519
8	"8-out20160"	.23593	172	557	729
8	"8-out20161"	.33639	183	361	544
8	"8-out20162"	.29051	95	232	327
8	"8-out20163"	.19047	84	357	441
8	"8-out20164"	.85249	393	68	461
8	"8-out20165"	.40411	314	463	777
8	"8-out20166"	.19375	93	387	480
8	"8-out20167"	.44525	122	152	274
8	"8-out20168"	.70881	185	76	261
8	"8-out20169"	.83419	161	32	193
8	"8-out20170"	.24681	155	473	628
8	"8-out20171"	.50476	53	52	105
8	"8-out20172"	.23393	193	632	825
8	"8-out20173"	.44585	140	174	314
8	"8-out20174"	.40284	85	126	211
8	"8-out20175"	.30488	343	782	1125
8	"8-out20176"	.46572	197	226	423
8	"8-out20177"	.37198	154	260	414
8	"8-out20178"	.41935	143	198	341
8	"8-out20179"	.21359	88	324	412
8	"8-out20180"	.30901	72	161	233
8	"8-out20181"	.33891	81	158	239
8	"8-out20182"	.36184	1104	1947	3051
8	"8-out20183"	.90204	221	24	245
8	"8-out20184"	.29729	77	182	259
8	"8-out20185"	.24222	109	341	450
8	"8-out20186"	.96287	415	16	431
8	"8-out20187"	.40169	190	283	473
8	"8-out20188"	.72972	81	30	111
8	"8-out20189"	.88888	56	7	63
8	"8-out20190"	.73611	53	19	72
8	"8-out20191"	.80188	85	21	106
8	"8-out20192"	.50632	40	39	79
8	"8-out20193"	.75781	97	31	128
8	"8-out20194"	.67191	256	125	381
8	"8-out20195"	.26475	157	436	593
8	"8-out20196"	.15686	280	1505	1785
8	"8-out20197"	.20266	167	657	824
8	"8-out20198"	.98785	488	6	494
8	"8-out20199"	.95138	137	7	144
8	"8-out20200"	.32057	134	284	418
8	"8-out20201"	.37820	871	1432	2303
8	"8-out20202"	.14141	14	85	99
8	"8-out20203"	.36293	188	330	518
8	"8-out20204"	.30000	33	77	110
8	"8-out20205"	.25136	46	137	183
8	"8-out20206"	.25000	25	75	100
8	"8-out20207"	.27145	136	365	501
8	"8-out20208"	.98005	344	7	351
8	"8-out20209"	.07035	14	185	199
8	"8-out20210"	.23316	180	592	772
8	"8-out20211"	.35606	141	255	396
8	"8-out20212"	.58015	76	55	131
8	"8-out20213"	.98493	327	5	332
8	"8-out20214"	.30050	180	419	599
8	"8-out20215"	.25845	107	307	414
8	"8-out20216"	.32296	135	283	418
8	"8-out20217"	.33127	375	757	1132
8	"8-out20218"	.15588	159	861	1020
8	"8-out20219"	.21865	225	804	1029
8	"8-out20220"	.31198	380	838	1218
8	"8-out20221"	.59075	179	124	303
8	"8-out20222"	.28571	102	255	357
8	"8-out20223"	.21147	258	962	1220
8	"8-out20224"	.18620	54	236	290
8	"8-out20225"	.19500	242	999	1241
8	"8-out20226"	.22306	205	714	919
8	"8-out20227"	.62000	62	38	100
8	"8-out20228"	.27131	70	188	258
8	"8-out20229"	.33922	403	785	1188
8	"8-out20230"	.76674	927	282	1209
8	"8-out20231"	.98500	197	3	200
8	"8-out20232"	.30289	272	626	898
8	"8-out20233"	.58064	54	39	93
8	"8-out20234"	.14569	22	129	151
8	"8-out20235"	.34529	77	146	223
8	"8-out20236"	.47435	111	123	234
8	"8-out20237"	.38281	49	79	128
8	"8-out20238"	.98148	106	2	108
8	"8-out20239"	.32666	49	101	150
8	"8-out20240"	.26552	124	343	467
8	"8-out20241"	.37878	50	82	132
8	"8-out20242"	.98639	145	2	147
8	"8-out20243"	.99539	216	1	217
8	"8-out20244"	.30930	103	230	333
8	"8-out20245"	.39344	48	74	122
8	"8-out20246"	.37241	54	91	145
8	"8-out20247"	.33454	92	183	275
8	"8-out20248"	.20325	25	98	123
8	"8-out20249"	.11864	28	208	236
8	"8-out20250"	.41587	131	184	315
8	"8-out20251"	.37328	109	183	292
8	"8-out20252"	.48695	56	59	115
8	"8-out20253"	.41025	32	46	78
8	"8-out20254"	.27839	527	1366	1893
8	"8-out20255"	.83794	424	82	506
8	"8-out20256"	.99414	679	4	683
8	"8-out20257"	.24852	505	1527	2032
8	"8-out20258"	.19633	332	1359	1691
8	"8-out20259"	.24121	254	799	1053
8	"8-out20260"	.32402	348	726	1074
8	"8-out20261"	.98878	441	5	446
8	"8-out20262"	.98878	441	5	446
8	"8-out20263"	.98529	134	2	136
8	"8-out20264"	.98750	395	5	400
8	"8-out20265"	.26120	338	956	1294
8	"8-out20266"	.34031	1040	2016	3056
8	"8-out20267"	.18153	59	266	325
8	"8-out20268"	.33908	59	115	174
8	"8-out20269"	.29319	56	135	191
8	"8-out20270"	.28787	19	47	66
8	"8-out20271"	.45394	69	83	152
8	"8-out20272"	.49844	160	161	321
8	"8-out20273"	.31239	184	405	589
8	"8-out20274"	.54545	114	95	209
8	"8-out20275"	.31578	78	169	247
8	"8-out20276"	.24179	221	693	914
8	"8-out20277"	.26829	66	180	246
8	"8-out20278"	.96183	252	10	262
8	"8-out20279"	.61693	153	95	248
8	"8-out20280"	.88235	45	6	51
8	"8-out20281"	.99378	160	1	161
8	"8-out20282"	.28856	159	392	551
8	"8-out20283"	.95652	66	3	69
8	"8-out20284"	.92430	635	52	687
8	"8-out20285"	.87037	94	14	108
8	"8-out20286"	.27544	46	121	167
8	"8-out20287"	.16481	148	750	898
8	"8-out20288"	.40000	86	129	215
8	"8-out20289"	.28985	60	147	207
8	"8-out20290"	.21639	66	239	305
8	"8-out20291"	.19642	44	180	224
8	"8-out20292"	.26339	59	165	224
8	"8-out20293"	.29223	64	155	219
8	"8-out20294"	.82727	182	38	220
8	"8-out20295"	.18835	55	237	292
8	"8-out20296"	.85909	189	31	220
8	"8-out20297"	.31578	66	143	209
8	"8-out20298"	.20642	45	173	218
8	"8-out20299"	.53080	112	99	211
8	"8-out20300"	.45622	99	118	217
8	"8-out20301"	.40655	248	362	610
8	"8-out20302"	.19268	79	331	410
8	"8-out20303"	.27342	286	760	1046
8	"8-out20304"	.27517	194	511	705
8	"8-out20305"	.67334	336	163	499
8	"8-out20306"	.62876	188	111	299
8	"8-out20307"	.27445	275	727	1002
8	"8-out20308"	.69634	305	133	438
8	"8-out20309"	.44694	139	172	311
8	"8-out20310"	.22319	256	891	1147
8	"8-out20311"	.24242	64	200	264
8	"8-out20312"	.18846	49	211	260
8	"8-out20313"	.22352	38	132	170
8	"8-out20314"	.76142	150	47	197
8	"8-out20315"	.99071	427	4	431
8	"8-out20316"	.39459	73	112	185
8	"8-out20317"	.25797	97	279	376
8	"8-out20318"	.24242	96	300	396
8	"8-out20319"	.98490	261	4	265
8	"8-out20320"	.99371	158	1	159
8	"8-out20321"	.98522	200	3	203
8	"8-out20322"	.71168	274	111	385
8	"8-out20323"	.21393	43	158	201
8	"8-out20324"	.20863	87	330	417
8	"8-out20325"	.20412	89	347	436
8	"8-out20326"	.17647	75	350	425
8	"8-out20327"	.52941	441	392	833
8	"8-out20328"	.62629	181	108	289
8	"8-out20329"	.41675	398	557	955
8	"8-out20330"	.97902	140	3	143
8	"8-out20331"	.37837	112	184	296
8	"8-out20332"	.99240	392	3	395
8	"8-out20333"	.97312	688	19	707
8	"8-out20334"	.99240	392	3	395
8	"8-out20335"	.28880	80	197	277
8	"8-out20336"	.34347	395	755	1150
8	"8-out20337"	.29591	29	69	98
8	"8-out20338"	.22318	206	717	923
8	"8-out20339"	.48484	304	323	627
8	"8-out20340"	.66812	457	227	684
8	"8-out20341"	.23801	134	429	563
8	"8-out20342"	.31045	95	211	306
8	"8-out20343"	.30303	30	69	99
8	"8-out20344"	.31097	204	452	656
8	"8-out20345"	.32323	32	67	99
8	"8-out20346"	.56164	164	128	292
8	"8-out20347"	.23902	98	312	410
8	"8-out20348"	.29467	155	371	526
8	"8-out20349"	.21408	76	279	355
8	"8-out20350"	.59610	214	145	359
8	"8-out20351"	.41340	296	420	716
8	"8-out20352"	.94736	72	4	76
8	"8-out20353"	.81881	1175	260	1435
8	"8-out20354"	.59144	401	277	678
8	"8-out20355"	.55050	218	178	396
8	"8-out20356"	.52380	66	60	126
8	"8-out20357"	.98400	123	2	125
8	"8-out20358"	.35030	695	1289	1984
8	"8-out20359"	.40206	234	348	582
8	"8-out20360"	.22773	179	607	786
8	"8-out20361"	.98564	206	3	209
8	"8-out20362"	.20529	31	120	151
8	"8-out20363"	.37585	165	274	439
8	"8-out20364"	.53271	114	100	214
8	"8-out20365"	.29230	209	506	715
8	"8-out20366"	.98290	230	4	234
8	"8-out20367"	.99502	200	1	201
8	"8-out20368"	.81726	407	91	498
8	"8-out20369"	.99493	393	2	395
8	"8-out20370"	.92170	412	35	447
8	"8-out20371"	.96762	269	9	278
8	"8-out20372"	.62992	160	94	254
8	"8-out20373"	.96739	89	3	92
8	"8-out20374"	.99435	1057	6	1063
8	"8-out20375"	.38429	93	149	242
8	"8-out20376"	.57021	134	101	235
8	"8-out20377"	.99735	377	1	378
8	"8-out20378"	.44937	253	310	563
8	"8-out20379"	.99009	100	1	101
8	"8-out20380"	.60070	170	113	283
8	"8-out20381"	.28371	324	818	1142
8	"8-out20382"	.38805	130	205	335
8	"8-out20383"	.58510	55	39	94
8	"8-out20384"	.92391	85	7	92
8	"8-out20385"	.40583	153	224	377
8	"8-out20386"	.42805	357	477	834
8	"8-out20387"	.40988	141	203	344
8	"8-out20388"	.34540	124	235	359
8	"8-out20389"	.31560	89	193	282
8	"8-out20390"	.43771	130	167	297
8	"8-out20391"	.30396	138	316	454
8	"8-out20392"	.36195	274	483	757
8	"8-out20393"	.38837	127	200	327
8	"8-out20394"	.32344	109	228	337
8	"8-out20395"	.32238	108	227	335
8	"8-out20396"	.84769	423	76	499
8	"8-out20397"	.34365	111	212	323
8	"8-out20398"	.98823	84	1	85
8	"8-out20399"	.65120	323	173	496
8	"8-out20400"	.96672	523	18	541
8	"8-out20401"	.25242	260	770	1030
8	"8-out20402"	.36781	32	55	87
8	"8-out20403"	.26923	35	95	130
8	"8-out20404"	.45551	128	153	281
8	"8-out20405"	.26597	129	356	485
8	"8-out20406"	.94273	889	54	943
8	"8-out20407"	.39829	327	494	821
8	"8-out20408"	.43402	125	163	288
8	"8-out20409"	.47457	84	93	177
8	"8-out20410"	.27906	48	124	172
8	"8-out20411"	.88640	476	61	537
8	"8-out20412"	.31643	156	337	493
9	"9-out1"	.96470	410	15	425
9	"9-out2"	.99383	645	4	649
9	"9-out3"	.30057	104	242	346
9	"9-out4"	.36158	128	226	354
9	"9-out5"	.35555	96	174	270
9	"9-out6"	.31360	106	232	338
9	"9-out7"	.75454	581	189	770
9	"9-out8"	.30000	189	441	630
9	"9-out9"	.34224	128	246	374
9	"9-out10"	.31457	615	1340	1955
9	"9-out11"	.97003	777	24	801
9	"9-out12"	.26046	859	2439	3298
9	"9-out13"	.22346	259	900	1159
9	"9-out14"	.26255	298	837	1135
9	"9-out15"	.86782	801	122	923
9	"9-out16"	.86759	806	123	929
9	"9-out17"	.24528	247	760	1007
9	"9-out18"	.20444	193	751	944
9	"9-out19"	.82921	772	159	931
9	"9-out20"	.86587	807	125	932
9	"9-out21"	.28102	437	1118	1555
9	"9-out22"	.34883	120	224	344
9	"9-out23"	.16400	41	209	250
9	"9-out24"	.37298	185	311	496
9	"9-out25"	.50445	396	389	785
9	"9-out26"	.72307	188	72	260
9	"9-out27"	.79867	603	152	755
9	"9-out28"	.29205	283	686	969
9	"9-out29"	.30081	111	258	369
9	"9-out30"	.20747	422	1612	2034
9	"9-out31"	.33703	395	777	1172
9	"9-out32"	.28491	102	256	358
9	"9-out33"	.99652	287	1	288
9	"9-out34"	.99709	343	1	344
9	"9-out35"	.65570	299	157	456
9	"9-out36"	.62302	552	334	886
9	"9-out37"	.67915	580	274	854
9	"9-out38"	.34848	299	559	858
9	"9-out39"	.22287	76	265	341
9	"9-out40"	.39220	171	265	436
9	"9-out41"	.13736	50	314	364
9	"9-out42"	.32019	130	276	406
9	"9-out43"	.70143	390	166	556
9	"9-out44"	.33916	155	302	457
9	"9-out45"	.72644	239	90	329
9	"9-out46"	.89192	784	95	879
9	"9-out47"	.15828	85	452	537
9	"9-out48"	.63959	504	284	788
9	"9-out49"	.24060	64	202	266
9	"9-out50"	.65068	285	153	438
9	"9-out51"	.69459	257	113	370
9	"9-out52"	.99682	314	1	315
9	"9-out53"	.30243	186	429	615
9	"9-out54"	.21341	140	516	656
9	"9-out55"	.31443	233	508	741
9	"9-out56"	.52515	334	302	636
9	"9-out57"	.31604	262	567	829
9	"9-out58"	.49377	238	244	482
9	"9-out59"	.39653	320	487	807
9	"9-out60"	.30923	231	516	747
9	"9-out61"	.40068	117	175	292
9	"9-out62"	.31875	153	327	480
9	"9-out63"	.27282	242	645	887
9	"9-out64"	.29416	731	1754	2485
9	"9-out65"	.24178	287	900	1187
9	"9-out66"	.17814	150	692	842
9	"9-out67"	.33745	300	589	889
9	"9-out68"	.24827	108	327	435
9	"9-out69"	.42503	343	464	807
9	"9-out70"	.25000	409	1227	1636
9	"9-out71"	.80722	335	80	415
9	"9-out72"	.20043	183	730	913
9	"9-out73"	.53235	181	159	340
9	"9-out74"	.50781	65	63	128
9	"9-out75"	.26386	157	438	595
9	"9-out76"	.87002	656	98	754
9	"9-out77"	.47783	485	530	1015
9	"9-out78"	.24189	194	608	802
9	"9-out79"	.24787	495	1502	1997
9	"9-out80"	.38591	504	802	1306
9	"9-out81"	.22233	424	1483	1907
9	"9-out82"	.52735	588	527	1115
9	"9-out83"	.15289	222	1230	1452
9	"9-out84"	.99346	608	4	612
9	"9-out85"	.28089	25	64	89
9	"9-out86"	.30290	438	1008	1446
9	"9-out87"	.38228	354	572	926
9	"9-out88"	.30147	41	95	136
9	"9-out89"	.17625	49	229	278
9	"9-out90"	.22045	125	442	567
9	"9-out91"	.99054	419	4	423
9	"9-out92"	.99777	895	2	897
9	"9-out93"	.47247	206	230	436
9	"9-out94"	.57777	104	76	180
9	"9-out95"	.99705	338	1	339
9	"9-out96"	.44812	203	250	453
9	"9-out97"	.31360	106	232	338
9	"9-out98"	.49406	833	853	1686
9	"9-out99"	.87213	266	39	305
9	"9-out100"	.34082	182	352	534
9	"9-out101"	.35294	192	352	544
9	"9-out102"	.27735	109	284	393
9	"9-out103"	.34168	191	368	559
9	"9-out104"	.95821	344	15	359
9	"9-out105"	.29100	55	134	189
9	"9-out106"	.21753	258	928	1186
9	"9-out107"	.46081	147	172	319
9	"9-out108"	.72489	166	63	229
9	"9-out109"	.99134	229	2	231
9	"9-out110"	.27770	208	541	749
9	"9-out111"	.34935	189	352	541
9	"9-out112"	.41549	59	83	142
9	"9-out113"	.26785	45	123	168
9	"9-out114"	.92121	152	13	165
9	"9-out115"	.92972	344	26	370
9	"9-out116"	.17532	314	1477	1791
9	"9-out117"	.26384	162	452	614
9	"9-out118"	.99897	975	1	976
9	"9-out119"	.37078	198	336	534
9	"9-out120"	.22689	54	184	238
9	"9-out121"	.99707	1022	3	1025
9	"9-out122"	.19904	83	334	417
9	"9-out123"	.36764	75	129	204
9	"9-out124"	.51688	199	186	385
9	"9-out125"	.26589	92	254	346
9	"9-out126"	.32464	137	285	422
9	"9-out127"	.24193	75	235	310
9	"9-out128"	.30745	396	892	1288
9	"9-out129"	.83476	778	154	932
9	"9-out130"	.20964	113	426	539
9	"9-out131"	.13597	127	807	934
9	"9-out132"	.86075	816	132	948
9	"9-out133"	.48411	518	552	1070
9	"9-out134"	.86358	804	127	931
9	"9-out135"	.35076	161	298	459
9	"9-out136"	.86266	804	128	932
9	"9-out137"	.85052	808	142	950
9	"9-out138"	.86526	822	128	950
9	"9-out139"	.30888	80	179	259
9	"9-out140"	.93142	326	24	350
9	"9-out141"	.69444	300	132	432
9	"9-out142"	.27440	1411	3731	5142
9	"9-out143"	.68199	178	83	261
9	"9-out144"	.48387	30	32	62
9	"9-out145"	.14476	65	384	449
9	"9-out146"	.99065	106	1	107
9	"9-out147"	.23387	435	1425	1860
9	"9-out148"	.48773	179	188	367
9	"9-out149"	.22340	523	1818	2341
9	"9-out150"	.30591	119	270	389
9	"9-out151"	.45754	97	115	212
9	"9-out152"	.25673	200	579	779
9	"9-out153"	.60412	293	192	485
9	"9-out154"	.29196	207	502	709
9	"9-out155"	.31243	294	647	941
9	"9-out156"	.30499	348	793	1141
9	"9-out157"	.37966	183	299	482
9	"9-out158"	.13555	61	389	450
9	"9-out159"	.27485	741	1955	2696
9	"9-out160"	.29799	104	245	349
9	"9-out161"	.46285	162	188	350
9	"9-out162"	.98373	242	4	246
9	"9-out163"	.35937	115	205	320
9	"9-out164"	.98684	75	1	76
9	"9-out165"	.28301	255	646	901
9	"9-out166"	.20224	90	355	445
9	"9-out167"	.38869	220	346	566
9	"9-out168"	.32083	214	453	667
9	"9-out169"	.67527	497	239	736
9	"9-out170"	.84313	86	16	102
9	"9-out171"	.64893	183	99	282
9	"9-out172"	.35894	341	609	950
9	"9-out173"	.30357	170	390	560
9	"9-out174"	.24356	123	382	505
9	"9-out175"	.40217	185	275	460
9	"9-out176"	.31971	313	666	979
9	"9-out177"	.28620	336	838	1174
9	"9-out178"	.15413	41	225	266
9	"9-out179"	.13782	43	269	312
9	"9-out180"	.97297	36	1	37
9	"9-out181"	.44924	416	510	926
9	"9-out182"	.30796	174	391	565
9	"9-out183"	.24166	87	273	360
9	"9-out184"	.38954	231	362	593
9	"9-out185"	.21000	21	79	100
9	"9-out186"	.97986	146	3	149
9	"9-out187"	.66822	143	71	214
9	"9-out188"	.31736	106	228	334
9	"9-out189"	.26751	84	230	314
9	"9-out190"	.25698	92	266	358
9	"9-out191"	.24152	349	1096	1445
9	"9-out192"	.25355	339	998	1337
9	"9-out193"	.76965	1537	460	1997
9	"9-out194"	.31202	205	452	657
9	"9-out195"	.27258	531	1417	1948
9	"9-out196"	.37500	48	80	128
9	"9-out197"	.48000	156	169	325
9	"9-out198"	.22222	64	224	288
9	"9-out199"	.30885	715	1600	2315
9	"9-out200"	.28668	84	209	293
9	"9-out201"	.55172	80	65	145
9	"9-out202"	.25092	68	203	271
9	"9-out203"	.20000	85	340	425
9	"9-out204"	.40703	162	236	398
9	"9-out205"	.94524	1053	61	1114
9	"9-out206"	.98598	211	3	214
9	"9-out207"	.33426	119	237	356
9	"9-out208"	.42045	148	204	352
9	"9-out209"	.20056	71	283	354
9	"9-out210"	.52185	203	186	389
9	"9-out211"	.99766	427	1	428
9	"9-out212"	.99710	1032	3	1035
9	"9-out213"	.29083	146	356	502
9	"9-out214"	.27695	131	342	473
9	"9-out215"	.35889	365	652	1017
9	"9-out216"	.99641	278	1	279
9	"9-out217"	.99641	278	1	279
9	"9-out218"	.94059	190	12	202
9	"9-out219"	.99285	139	1	140
9	"9-out220"	.97785	265	6	271
9	"9-out221"	.16242	102	526	628
9	"9-out222"	.37878	175	287	462
9	"9-out223"	.92121	456	39	495
9	"9-out224"	.37815	90	148	238
9	"9-out225"	.42692	260	349	609
9	"9-out226"	.70133	263	112	375
9	"9-out227"	.90871	219	22	241
9	"9-out228"	.25709	154	445	599
9	"9-out229"	.16361	134	685	819
9	"9-out230"	.30159	548	1269	1817
9	"9-out231"	.94704	304	17	321
9	"9-out232"	.49206	155	160	315
9	"9-out233"	.90268	269	29	298
9	"9-out234"	.84276	268	50	318
9	"9-out235"	.93333	294	21	315
9	"9-out236"	.92012	288	25	313
9	"9-out237"	.96485	302	11	313
9	"9-out238"	.26234	85	239	324
9	"9-out239"	.89751	289	33	322
9	"9-out240"	.50783	162	157	319
9	"9-out241"	.89902	276	31	307
9	"9-out242"	.55987	173	136	309
9	"9-out243"	.82200	254	55	309
9	"9-out244"	.91946	274	24	298
9	"9-out245"	.94817	311	17	328
9	"9-out246"	.33118	103	208	311
9	"9-out247"	.42405	134	182	316
9	"9-out248"	.36774	114	196	310
9	"9-out249"	.35185	114	210	324
9	"9-out250"	.39502	143	219	362
9	"9-out251"	.92903	288	22	310
9	"9-out252"	.94568	296	17	313
9	"9-out253"	.93589	292	20	312
9	"9-out254"	.96153	300	12	312
9	"9-out255"	.96474	301	11	312
9	"9-out256"	.91666	286	26	312
9	"9-out257"	.94871	296	16	312
9	"9-out258"	.95833	299	13	312
9	"9-out259"	.91150	309	30	339
9	"9-out260"	.92434	281	23	304
9	"9-out261"	.36274	222	390	612
9	"9-out262"	.37549	95	158	253
9	"9-out263"	.28400	71	179	250
9	"9-out264"	.99175	361	3	364
9	"9-out265"	.99175	361	3	364
9	"9-out266"	.24925	84	253	337
9	"9-out267"	.24571	172	528	700
9	"9-out268"	.71729	510	201	711
9	"9-out269"	.55297	381	308	689
9	"9-out270"	.46975	132	149	281
9	"9-out271"	.32936	83	169	252
9	"9-out272"	.97766	394	9	403
9	"9-out273"	.28653	100	249	349
9	"9-out274"	.59756	196	132	328
9	"9-out275"	.82442	108	23	131
9	"9-out276"	.93299	557	40	597
9	"9-out277"	.64391	566	313	879
9	"9-out278"	.33942	223	434	657
9	"9-out279"	.45536	352	421	773
9	"9-out280"	.41176	154	220	374
9	"9-out281"	.96585	1301	46	1347
9	"9-out282"	.98955	1326	14	1340
9	"9-out283"	.29807	310	730	1040
9	"9-out284"	.23395	277	907	1184
9	"9-out285"	.42183	170	233	403
9	"9-out286"	.20930	90	340	430
9	"9-out287"	.36126	263	465	728
9	"9-out288"	.31097	357	791	1148
9	"9-out289"	.87082	809	120	929
9	"9-out290"	.86782	801	122	923
9	"9-out291"	.86881	808	122	930
9	"9-out292"	.17964	173	790	963
9	"9-out293"	.61004	571	365	936
9	"9-out294"	.25222	312	925	1237
9	"9-out295"	.84311	790	147	937
9	"9-out296"	.80842	768	182	950
9	"9-out297"	.25619	62	180	242
9	"9-out298"	.26688	166	456	622
9	"9-out299"	.54016	195	166	361
9	"9-out300"	.98314	175	3	178
9	"9-out301"	.20588	28	108	136
9	"9-out302"	.22469	111	383	494
9	"9-out303"	.30036	82	191	273
9	"9-out304"	.44556	176	219	395
9	"9-out305"	.21535	101	368	469
9	"9-out306"	.27545	257	676	933
9	"9-out307"	.91200	114	11	125
9	"9-out308"	.99476	190	1	191
9	"9-out309"	.22947	123	413	536
9	"9-out310"	.68049	164	77	241
9	"9-out311"	.42977	306	406	712
9	"9-out312"	.33745	273	536	809
9	"9-out313"	.36690	408	704	1112
9	"9-out314"	.33172	275	554	829
9	"9-out315"	.30847	273	612	885
9	"9-out316"	.19459	72	298	370
9	"9-out317"	.16666	25	125	150
9	"9-out318"	.32701	69	142	211
9	"9-out319"	.34916	147	274	421
9	"9-out320"	.95247	481	24	505
9	"9-out321"	.32365	78	163	241
9	"9-out322"	.16953	69	338	407
9	"9-out323"	.28181	93	237	330
9	"9-out324"	.44127	263	333	596
9	"9-out325"	.96969	384	12	396
9	"9-out326"	.20370	33	129	162
9	"9-out327"	.19871	62	250	312
9	"9-out328"	.33464	85	169	254
9	"9-out329"	.96391	374	14	388
9	"9-out330"	.28450	202	508	710
9	"9-out331"	.25773	100	288	388
9	"9-out332"	.35362	302	552	854
9	"9-out333"	.71111	96	39	135
9	"9-out334"	.47606	348	383	731
9	"9-out335"	.28472	82	206	288
9	"9-out336"	.17520	65	306	371
9	"9-out337"	.97232	773	22	795
9	"9-out338"	.95717	760	34	794
9	"9-out339"	.96603	768	27	795
9	"9-out340"	.86951	813	122	935
9	"9-out341"	.97476	927	24	951
9	"9-out342"	.98092	720	14	734
9	"9-out343"	.26817	782	2134	2916
9	"9-out344"	.84160	797	150	947
9	"9-out345"	.84631	804	146	950
9	"9-out346"	.87017	811	121	932
9	"9-out347"	.86858	813	123	936
9	"9-out348"	.36385	151	264	415
9	"9-out349"	.32658	226	466	692
9	"9-out350"	.24473	523	1614	2137
9	"9-out351"	.25148	127	378	505
9	"9-out352"	.20689	60	230	290
9	"9-out353"	.32033	115	244	359
9	"9-out354"	.55990	486	382	868
9	"9-out355"	.12807	78	531	609
9	"9-out356"	.30654	164	371	535
9	"9-out357"	.31509	144	313	457
9	"9-out358"	.99581	238	1	239
9	"9-out359"	.28260	208	528	736
9	"9-out360"	.33828	296	579	875
9	"9-out361"	.33255	286	574	860
9	"9-out362"	.20034	117	467	584
9	"9-out363"	.20078	102	406	508
9	"9-out364"	.34943	123	229	352
9	"9-out365"	.20000	88	352	440
9	"9-out366"	.36904	31	53	84
9	"9-out367"	.26275	139	390	529
9	"9-out368"	.19548	26	107	133
9	"9-out369"	.62190	176	107	283
9	"9-out370"	.99573	467	2	469
9	"9-out371"	.83571	117	23	140
9	"9-out372"	.26946	765	2074	2839
9	"9-out373"	.99769	864	2	866
9	"9-out374"	.48295	694	743	1437
9	"9-out375"	.55102	351	286	637
9	"9-out376"	.27423	580	1535	2115
9	"9-out377"	.81623	191	43	234
9	"9-out378"	.62745	160	95	255
9	"9-out379"	.50191	131	130	261
9	"9-out380"	.72085	235	91	326
9	"9-out381"	.37423	122	204	326
9	"9-out382"	.49473	188	192	380
9	"9-out383"	.40077	103	154	257
9	"9-out384"	.27806	109	283	392
9	"9-out385"	.19397	58	241	299
9	"9-out386"	.26523	74	205	279
9	"9-out387"	.30314	77	177	254
9	"9-out388"	.19230	25	105	130
9	"9-out389"	.41091	143	205	348
9	"9-out390"	.37388	126	211	337
9	"9-out391"	.93150	68	5	73
9	"9-out392"	.37037	30	51	81
9	"9-out393"	.26900	92	250	342
9	"9-out394"	.46517	187	215	402
9	"9-out395"	.99175	361	3	364
9	"9-out396"	.45951	244	287	531
9	"9-out397"	.30131	160	371	531
9	"9-out398"	.28260	156	396	552
9	"9-out399"	.25086	363	1084	1447
9	"9-out400"	.98863	87	1	88
9	"9-out401"	.35860	123	220	343
9	"9-out402"	.25700	110	318	428
9	"9-out403"	.41904	132	183	315
9	"9-out404"	.28767	231	572	803
9	"9-out405"	.24153	264	829	1093
9	"9-out406"	.25452	183	536	719
9	"9-out407"	.26493	102	283	385
9	"9-out408"	.61052	58	37	95
9	"9-out409"	.33539	217	430	647
9	"9-out410"	.40804	659	956	1615
9	"9-out411"	.56043	51	40	91
9	"9-out412"	.47422	46	51	97
9	"9-out413"	.29870	69	162	231
9	"9-out414"	.99107	111	1	112
9	"9-out415"	.98290	115	2	117
9	"9-out416"	.35090	639	1182	1821
9	"9-out417"	.50671	302	294	596
9	"9-out418"	.25776	83	239	322
9	"9-out419"	.77702	115	33	148
9	"9-out420"	.30718	372	839	1211
9	"9-out421"	.40102	156	233	389
9	"9-out422"	.99280	138	1	139
9	"9-out423"	.19767	34	138	172
9	"9-out424"	.48545	317	336	653
9	"9-out425"	.54153	176	149	325
9	"9-out426"	.57640	215	158	373
9	"9-out427"	.64576	206	113	319
9	"9-out428"	.81303	287	66	353
9	"9-out429"	.23137	59	196	255
9	"9-out430"	.29660	1047	2483	3530
9	"9-out431"	.54357	1054	885	1939
9	"9-out432"	.66064	1281	658	1939
9	"9-out433"	.37252	602	1014	1616
9	"9-out434"	.25503	342	999	1341
9	"9-out435"	.27668	705	1843	2548
9	"9-out436"	.27922	43	111	154
9	"9-out437"	.99871	1560	2	1562
9	"9-out438"	.22482	163	562	725
9	"9-out439"	.52662	89	80	169
9	"9-out440"	.37412	107	179	286
9	"9-out441"	.25530	337	983	1320
9	"9-out442"	.80549	791	191	982
9	"9-out443"	.19546	138	568	706
9	"9-out444"	.99529	635	3	638
9	"9-out445"	.99762	420	1	421
9	"9-out446"	.99537	861	4	865
9	"9-out447"	.99402	666	4	670
9	"9-out448"	.30608	161	365	526
9	"9-out449"	.19478	142	587	729
9	"9-out450"	.12850	87	590	677
9	"9-out451"	.36332	2423	4246	6669
9	"9-out452"	.36111	39	69	108
9	"9-out453"	.26932	216	586	802
9	"9-out454"	.99922	1287	1	1288
9	"9-out455"	.34825	140	262	402
9	"9-out456"	.42162	156	214	370
9	"9-out457"	.09770	34	314	348
9	"9-out458"	.20481	68	264	332
9	"9-out459"	.69551	217	95	312
9	"9-out460"	.96474	301	11	312
9	"9-out461"	.87898	276	38	314
9	"9-out462"	.91331	295	28	323
9	"9-out463"	.96793	332	11	343
9	"9-out464"	.60576	189	123	312
9	"9-out465"	.86858	271	41	312
9	"9-out466"	.31944	115	245	360
9	"9-out467"	.75241	234	77	311
9	"9-out468"	.72910	253	94	347
9	"9-out469"	.35691	111	200	311
9	"9-out470"	.44545	147	183	330
9	"9-out471"	.83962	267	51	318
9	"9-out472"	.64630	201	110	311
9	"9-out473"	.45938	164	193	357
9	"9-out474"	.87500	273	39	312
9	"9-out475"	.38801	123	194	317
9	"9-out476"	.90705	283	29	312
9	"9-out477"	.33750	108	212	320
9	"9-out478"	.91233	281	27	308
9	"9-out479"	.34848	115	215	330
9	"9-out480"	.94637	300	17	317
9	"9-out481"	.33009	102	207	309
9	"9-out482"	.69620	220	96	316
9	"9-out483"	.92721	293	23	316
9	"9-out484"	.77243	241	71	312
9	"9-out485"	.44347	153	192	345
9	"9-out486"	.83012	259	53	312
9	"9-out487"	.83012	259	53	312
9	"9-out488"	.90705	283	29	312
9	"9-out489"	.85302	296	51	347
9	"9-out490"	.31832	99	212	311
9	"9-out491"	.84935	265	47	312
9	"9-out492"	.53605	171	148	319
9	"9-out493"	.36314	134	235	369
9	"9-out494"	.85057	296	52	348
9	"9-out495"	.38961	120	188	308
9	"9-out496"	.86038	265	43	308
9	"9-out497"	.98437	315	5	320
9	"9-out498"	.88993	283	35	318
9	"9-out499"	.94252	328	20	348
9	"9-out500"	.92976	278	21	299
9	"9-out501"	.59271	179	123	302
9	"9-out502"	.91411	298	28	326
9	"9-out503"	.49677	154	156	310
9	"9-out504"	.89320	276	33	309
9	"9-out505"	.52903	164	146	310
9	"9-out506"	.83439	262	52	314
9	"9-out507"	.55732	175	139	314
9	"9-out508"	.50320	157	155	312
9	"9-out509"	.93949	295	19	314
9	"9-out510"	.84482	294	54	348
9	"9-out511"	.83012	259	53	312
9	"9-out512"	.96485	302	11	313
9	"9-out513"	.90506	286	30	316
9	"9-out514"	.68181	210	98	308
9	"9-out515"	.89067	277	34	311
9	"9-out516"	.31428	99	216	315
9	"9-out517"	.93630	294	20	314
9	"9-out518"	.45541	143	171	314
9	"9-out519"	.44585	140	174	314
9	"9-out520"	.69329	217	96	313
9	"9-out521"	.91082	286	28	314
9	"9-out522"	.67834	213	101	314
9	"9-out523"	.43949	138	176	314
9	"9-out524"	.65420	210	111	321
9	"9-out525"	.62305	200	121	321
9	"9-out526"	.75570	232	75	307
9	"9-out527"	.72347	225	86	311
9	"9-out528"	.47213	144	161	305
9	"9-out529"	.49196	153	158	311
9	"9-out530"	.34259	111	213	324
9	"9-out531"	.81595	266	60	326
9	"9-out532"	.92941	316	24	340
9	"9-out533"	.27974	87	224	311
9	"9-out534"	.83333	260	52	312
9	"9-out535"	.94230	294	18	312
9	"9-out536"	.93527	289	20	309
9	"9-out537"	.95389	331	16	347
9	"9-out538"	.48338	160	171	331
9	"9-out539"	.35897	112	200	312
9	"9-out540"	.32807	104	213	317
9	"9-out541"	.29166	91	221	312
9	"9-out542"	.68025	217	102	319
9	"9-out543"	.78640	243	66	309
9	"9-out544"	.84615	264	48	312
9	"9-out545"	.94533	294	17	311
9	"9-out546"	.90064	281	31	312
9	"9-out547"	.88709	275	35	310
9	"9-out548"	.91318	284	27	311
9	"9-out549"	.72784	230	86	316
9	"9-out550"	.40597	136	199	335
9	"9-out551"	.42258	131	179	310
9	"9-out552"	.68471	215	99	314
9	"9-out553"	.41694	123	172	295
9	"9-out554"	.71081	263	107	370
9	"9-out555"	.15006	116	657	773
9	"9-out556"	.27876	126	326	452
9	"9-out557"	.20153	79	313	392
9	"9-out558"	.31446	200	436	636
9	"9-out559"	.27617	240	629	869
9	"9-out560"	.28219	252	641	893
9	"9-out561"	.36853	171	293	464
9	"9-out562"	.99074	107	1	108
9	"9-out563"	.37890	704	1154	1858
9	"9-out564"	.21907	85	303	388
9	"9-out565"	.27557	396	1041	1437
9	"9-out566"	.97314	2283	63	2346
9	"9-out567"	.33152	61	123	184
9	"9-out568"	.17787	127	587	714
9	"9-out569"	.28249	313	795	1108
9	"9-out570"	.37391	691	1157	1848
9	"9-out571"	.60153	1250	828	2078
9	"9-out572"	.38683	94	149	243
9	"9-out573"	.36930	219	374	593
9	"9-out574"	.14778	30	173	203
9	"9-out575"	.35230	229	421	650
9	"9-out576"	.63116	243	142	385
9	"9-out577"	.44715	165	204	369
9	"9-out578"	.20876	81	307	388
9	"9-out579"	.90495	219	23	242
9	"9-out580"	.99175	361	3	364
9	"9-out581"	.48526	280	297	577
9	"9-out582"	.57281	177	132	309
9	"9-out583"	.67637	209	100	309
9	"9-out584"	.94212	293	18	311
9	"9-out585"	.92284	311	26	337
9	"9-out586"	.47603	149	164	313
9	"9-out587"	.40563	144	211	355
9	"9-out588"	.54968	177	145	322
9	"9-out589"	.38658	121	192	313
9	"9-out590"	.40822	129	187	316
9	"9-out591"	.41100	127	182	309
9	"9-out592"	.92580	287	23	310
9	"9-out593"	.92258	286	24	310
9	"9-out594"	.36538	114	198	312
9	"9-out595"	.85576	267	45	312
9	"9-out596"	.29687	95	225	320
9	"9-out597"	.33121	104	210	314
9	"9-out598"	.32802	103	211	314
9	"9-out599"	.58412	184	131	315
9	"9-out600"	.76635	246	75	321
9	"9-out601"	.70739	220	91	311
9	"9-out602"	.88524	270	35	305
9	"9-out603"	.86513	263	41	304
9	"9-out604"	.93610	293	20	313
9	"9-out605"	.86858	271	41	312
9	"9-out606"	.44918	137	168	305
9	"9-out607"	.44884	136	167	303
9	"9-out608"	.36419	118	206	324
9	"9-out609"	.94822	293	16	309
9	"9-out610"	.91401	287	27	314
9	"9-out611"	.38187	118	191	309
9	"9-out612"	.25937	83	237	320
9	"9-out613"	.37261	117	197	314
9	"9-out614"	.88414	290	38	328
9	"9-out615"	.90822	287	29	316
9	"9-out616"	.35514	114	207	321
9	"9-out617"	.38387	119	191	310
9	"9-out618"	.37920	124	203	327
9	"9-out619"	.84592	280	51	331
9	"9-out620"	.92604	288	23	311
9	"9-out621"	.37662	116	192	308
9	"9-out622"	.49271	169	174	343
9	"9-out623"	.46645	146	167	313
9	"9-out624"	.34138	113	218	331
9	"9-out625"	.42492	133	180	313
9	"9-out626"	.64890	207	112	319
9	"9-out627"	.86538	270	42	312
9	"9-out628"	.85942	269	44	313
9	"9-out629"	.36893	114	195	309
9	"9-out630"	.54340	169	142	311
9	"9-out631"	.42857	132	176	308
9	"9-out632"	.46302	144	167	311
9	"9-out633"	.86349	272	43	315
9	"9-out634"	.40064	125	187	312
9	"9-out635"	.28412	102	257	359
9	"9-out636"	.59870	185	124	309
9	"9-out637"	.74433	230	79	309
9	"9-out638"	.58598	184	130	314
9	"9-out639"	.42201	138	189	327
9	"9-out640"	.66557	203	102	305
9	"9-out641"	.44267	139	175	314
9	"9-out642"	.35039	89	165	254
9	"9-out643"	.27293	235	626	861
9	"9-out644"	.54485	164	137	301
9	"9-out645"	.99019	101	1	102
9	"9-out646"	.18131	99	447	546
9	"9-out647"	.33566	240	475	715
9	"9-out648"	.36706	243	419	662
9	"9-out649"	.39193	136	211	347
9	"9-out650"	.27212	326	872	1198
9	"9-out651"	.25000	176	528	704
9	"9-out652"	.40072	220	329	549
9	"9-out653"	.38867	302	475	777
9	"9-out654"	.28208	200	509	709
9	"9-out655"	.23398	84	275	359
9	"9-out656"	.24151	121	380	501
9	"9-out657"	.99567	230	1	231
9	"9-out658"	.87252	883	129	1012
9	"9-out659"	.28299	253	641	894
9	"9-out660"	.30571	107	243	350
9	"9-out661"	.33685	351	691	1042
9	"9-out662"	.34002	254	493	747
9	"9-out663"	.30472	387	883	1270
9	"9-out664"	.56653	149	114	263
9	"9-out665"	.26831	271	739	1010
9	"9-out666"	.64944	352	190	542
9	"9-out667"	.44608	302	375	677
9	"9-out668"	.88554	4851	627	5478
9	"9-out669"	.34570	177	335	512
9	"9-out670"	.45232	204	247	451
9	"9-out671"	.97863	14197	310	14507
9	"9-out672"	.82372	3701	792	4493
9	"9-out673"	.26934	174	472	646
9	"9-out674"	.99904	8376	8	8384
9	"9-out675"	.79442	997	258	1255
9	"9-out676"	.76501	433	133	566
9	"9-out677"	.99943	1772	1	1773
9	"9-out678"	.70689	3661	1518	5179
9	"9-out679"	.98709	2141	28	2169
9	"9-out680"	.98425	5565	89	5654
9	"9-out681"	.67374	254	123	377
9	"9-out682"	.60919	159	102	261
9	"9-out683"	.35555	32	58	90
9	"9-out684"	.44100	228	289	517
9	"9-out685"	.15779	86	459	545
9	"9-out686"	.21428	54	198	252
9	"9-out687"	.47222	238	266	504
9	"9-out688"	.77935	385	109	494
9	"9-out689"	.29746	47	111	158
9	"9-out690"	.73184	131	48	179
9	"9-out691"	.33333	47	94	141
9	"9-out692"	.36811	127	218	345
9	"9-out693"	.98969	96	1	97
9	"9-out694"	.24031	248	784	1032
9	"9-out695"	.28195	236	601	837
9	"9-out696"	.95772	521	23	544
9	"9-out697"	.25722	89	257	346
9	"9-out698"	.76603	442	135	577
9	"9-out699"	.76815	550	166	716
9	"9-out700"	.62126	187	114	301
9	"9-out701"	.61383	213	134	347
9	"9-out702"	.84276	268	50	318
9	"9-out703"	.78481	248	68	316
9	"9-out704"	.59270	195	134	329
9	"9-out705"	.94212	293	18	311
9	"9-out706"	.39158	121	188	309
9	"9-out707"	.21052	32	120	152
9	"9-out708"	.26498	221	613	834
9	"9-out709"	.99053	314	3	317
9	"9-out710"	.28963	95	233	328
9	"9-out711"	.48005	337	365	702
9	"9-out712"	.35937	69	123	192
9	"9-out713"	.93442	57	4	61
9	"9-out714"	.49541	108	110	218
9	"9-out715"	.40000	98	147	245
9	"9-out716"	.34090	90	174	264
9	"9-out717"	.32457	593	1234	1827
9	"9-out718"	.34955	316	588	904
9	"9-out719"	.51651	172	161	333
9	"9-out720"	.43134	333	439	772
9	"9-out721"	.35704	266	479	745
9	"9-out722"	.24778	28	85	113
9	"9-out723"	.46808	110	125	235
9	"9-out724"	.46336	898	1040	1938
9	"9-out725"	.35765	696	1250	1946
9	"9-out726"	.23809	490	1568	2058
9	"9-out727"	.25473	525	1536	2061
9	"9-out728"	.32374	304	635	939
9	"9-out729"	.18263	61	273	334
9	"9-out730"	.99401	166	1	167
9	"9-out731"	.22562	81	278	359
9	"9-out732"	.93750	15	1	16
9	"9-out733"	.24657	36	110	146
9	"9-out734"	.51901	805	746	1551
9	"9-out735"	.98961	286	3	289
9	"9-out736"	.23430	362	1183	1545
9	"9-out737"	.96894	312	10	322
9	"9-out738"	.96273	310	12	322
9	"9-out739"	.18000	72	328	400
9	"9-out740"	.38050	121	197	318
9	"9-out741"	.40764	128	186	314
9	"9-out742"	.52715	165	148	313
9	"9-out743"	.28703	93	231	324
9	"9-out744"	.89137	279	34	313
9	"9-out745"	.95454	315	15	330
9	"9-out746"	.47770	150	164	314
9	"9-out747"	.83384	271	54	325
9	"9-out748"	.96307	313	12	325
9	"9-out749"	.90967	282	28	310
9	"9-out750"	.34185	107	206	313
9	"9-out751"	.42811	134	179	313
9	"9-out752"	.94637	300	17	317
9	"9-out753"	.32492	103	214	317
9	"9-out754"	.83860	265	51	316
9	"9-out755"	.80769	252	60	312
9	"9-out756"	.86217	269	43	312
9	"9-out757"	.83601	260	51	311
9	"9-out758"	.90705	283	29	312
9	"9-out759"	.83653	261	51	312
9	"9-out760"	.93827	304	20	324
9	"9-out761"	.94339	300	18	318
9	"9-out762"	.88888	280	35	315
9	"9-out763"	.90064	281	31	312
9	"9-out764"	.78095	246	69	315
9	"9-out765"	.70793	223	92	315
9	"9-out766"	.33762	105	206	311
9	"9-out767"	.92523	297	24	321
9	"9-out768"	.94285	297	18	315
9	"9-out769"	.95238	300	15	315
9	"9-out770"	.65048	201	108	309
9	"9-out771"	.83171	257	52	309
9	"9-out772"	.93203	288	21	309
9	"9-out773"	.45886	145	171	316
9	"9-out774"	.56451	175	135	310
9	"9-out775"	.60586	186	121	307
9	"9-out776"	.28616	91	227	318
9	"9-out777"	.81350	253	58	311
9	"9-out778"	.91746	289	26	315
9	"9-out779"	.29073	91	222	313
9	"9-out780"	.92307	288	24	312
9	"9-out781"	.88524	270	35	305
9	"9-out782"	.36977	115	196	311
9	"9-out783"	.88571	279	36	315
9	"9-out784"	.37770	122	201	323
9	"9-out785"	.31935	99	211	310
9	"9-out786"	.37777	119	196	315
9	"9-out787"	.87296	268	39	307
9	"9-out788"	.88599	272	35	307
9	"9-out789"	.92971	291	22	313
9	"9-out790"	.56634	175	134	309
9	"9-out791"	.77070	242	72	314
9	"9-out792"	.92971	291	22	313
9	"9-out793"	.94769	308	17	325
9	"9-out794"	.89285	275	33	308
9	"9-out795"	.43910	137	175	312
9	"9-out796"	.86038	265	43	308
9	"9-out797"	.80064	249	62	311
9	"9-out798"	.85852	267	44	311
9	"9-out799"	.83174	262	53	315
9	"9-out800"	.45161	140	170	310
9	"9-out801"	.86984	274	41	315
9	"9-out802"	.46894	151	171	322
9	"9-out803"	.59888	215	144	359
9	"9-out804"	.95192	297	15	312
9	"9-out805"	.94585	297	17	314
9	"9-out806"	.19753	64	260	324
9	"9-out807"	.42271	134	183	317
9	"9-out808"	.40694	129	188	317
9	"9-out809"	.23839	77	246	323
9	"9-out810"	.32615	106	219	325
9	"9-out811"	.88387	274	36	310
9	"9-out812"	.80582	249	60	309
9	"9-out813"	.67812	217	103	320
9	"9-out814"	.91666	297	27	324
9	"9-out815"	.52453	171	155	326
9	"9-out816"	.84345	264	49	313
9	"9-out817"	.59032	183	127	310
9	"9-out818"	.46178	145	169	314
9	"9-out819"	.92774	321	25	346
9	"9-out820"	.77170	240	71	311
9	"9-out821"	.90705	283	29	312
9	"9-out822"	.91346	285	27	312
9	"9-out823"	.89032	276	34	310
9	"9-out824"	.74603	235	80	315
9	"9-out825"	.31347	100	219	319
9	"9-out826"	.32247	99	208	307
9	"9-out827"	.59874	191	128	319
9	"9-out828"	.98098	258	5	263
9	"9-out829"	.63870	198	112	310
9	"9-out830"	.67540	206	99	305
9	"9-out831"	.11764	18	135	153
9	"9-out832"	.27450	42	111	153
9	"9-out833"	.37209	112	189	301
9	"9-out834"	.34599	82	155	237
9	"9-out835"	.99534	214	1	215
9	"9-out836"	.26525	113	313	426
9	"9-out837"	.32867	188	384	572
9	"9-out838"	.31034	171	380	551
9	"9-out839"	.21357	129	475	604
9	"9-out840"	.62046	188	115	303
9	"9-out841"	.23841	144	460	604
9	"9-out842"	.84000	294	56	350
9	"9-out843"	.33858	172	336	508
9	"9-out844"	.28934	535	1314	1849
9	"9-out845"	.25104	300	895	1195
9	"9-out846"	.27411	179	474	653
9	"9-out847"	.29629	184	437	621
9	"9-out848"	.29242	193	467	660
9	"9-out849"	.47356	215	239	454
9	"9-out850"	.24212	169	529	698
9	"9-out851"	.36342	153	268	421
9	"9-out852"	.15206	59	329	388
9	"9-out853"	.36669	502	867	1369
9	"9-out854"	.14219	61	368	429
9	"9-out855"	.86909	405	61	466
9	"9-out856"	.41157	377	539	916
9	"9-out857"	.98871	701	8	709
9	"9-out858"	.31472	62	135	197
9	"9-out859"	.99879	3319	4	3323
9	"9-out860"	.99838	1235	2	1237
9	"9-out861"	.72301	4166	1596	5762
9	"9-out862"	.46863	1143	1296	2439
9	"9-out863"	.17329	61	291	352
9	"9-out864"	.31617	86	186	272
9	"9-out865"	.36809	240	412	652
9	"9-out866"	.30402	83	190	273
9	"9-out867"	.40648	213	311	524
9	"9-out868"	.32187	309	651	960
9	"9-out869"	.30125	144	334	478
9	"9-out870"	.36082	210	372	582
9	"9-out871"	.78461	255	70	325
9	"9-out872"	.14285	31	186	217
9	"9-out873"	.34090	105	203	308
9	"9-out874"	.98989	98	1	99
9	"9-out875"	.44827	377	464	841
9	"9-out876"	.42903	263	350	613
9	"9-out877"	.22935	25	84	109
9	"9-out878"	.25387	131	385	516
9	"9-out879"	.79500	318	82	400
9	"9-out880"	.37025	117	199	316
9	"9-out881"	.94966	283	15	298
9	"9-out882"	.85396	269	46	315
9	"9-out883"	.96739	267	9	276
9	"9-out884"	.61341	192	121	313
9	"9-out885"	.29074	157	383	540
9	"9-out886"	.43450	136	177	313
9	"9-out887"	.95092	310	16	326
9	"9-out888"	.42772	506	677	1183
9	"9-out889"	.48039	98	106	204
9	"9-out890"	.62142	261	159	420
9	"9-out891"	.39370	150	231	381
9	"9-out892"	.29353	118	284	402
9	"9-out893"	.20689	84	322	406
9	"9-out894"	.23137	118	392	510
9	"9-out895"	.74538	202	69	271
9	"9-out896"	.56346	182	141	323
9	"9-out897"	.28666	215	535	750
9	"9-out898"	.39904	168	253	421
9	"9-out899"	.28181	124	316	440
9	"9-out900"	.26993	44	119	163
9	"9-out901"	.99082	108	1	109
9	"9-out902"	.51006	76	73	149
9	"9-out903"	.99186	122	1	123
9	"9-out904"	.99481	192	1	193
9	"9-out905"	.18926	67	287	354
9	"9-out906"	.28494	106	266	372
9	"9-out907"	.17105	65	315	380
9	"9-out908"	.35057	122	226	348
9	"9-out909"	.69151	269	120	389
9	"9-out910"	.49081	935	970	1905
9	"9-out911"	.20623	86	331	417
9	"9-out912"	.27511	178	469	647
9	"9-out913"	.24836	38	115	153
9	"9-out914"	.34385	196	374	570
9	"9-out915"	.26292	178	499	677
9	"9-out916"	.38487	224	358	582
9	"9-out917"	.30116	490	1137	1627
9	"9-out918"	.31594	418	905	1323
9	"9-out919"	.35714	45	81	126
9	"9-out920"	.36734	36	62	98
9	"9-out921"	.27192	62	166	228
9	"9-out922"	.97765	350	8	358
9	"9-out923"	.37162	110	186	296
9	"9-out924"	.38590	761	1211	1972
9	"9-out925"	.98723	1083	14	1097
9	"9-out926"	.57864	1122	817	1939
9	"9-out927"	.35906	214	382	596
9	"9-out928"	.27268	577	1539	2116
9	"9-out929"	.24569	414	1271	1685
9	"9-out930"	.36580	199	345	544
9	"9-out931"	.35901	219	391	610
9	"9-out932"	.29380	545	1310	1855
9	"9-out933"	.27759	83	216	299
9	"9-out934"	.34848	92	172	264
9	"9-out935"	.21626	109	395	504
9	"9-out936"	.89365	521	62	583
9	"9-out937"	.52130	208	191	399
9	"9-out938"	.99530	212	1	213
9	"9-out939"	.32258	130	273	403
9	"9-out940"	.99663	296	1	297
9	"9-out941"	.17592	38	178	216
9	"9-out942"	.78409	69	19	88
9	"9-out943"	.23584	50	162	212
9	"9-out944"	.13425	29	187	216
9	"9-out945"	.18081	49	222	271
9	"9-out946"	.28033	134	344	478
9	"9-out947"	.83206	327	66	393
9	"9-out948"	.16149	26	135	161
9	"9-out949"	.83168	252	51	303
9	"9-out950"	.94551	295	17	312
9	"9-out951"	.93890	292	19	311
9	"9-out952"	.42812	137	183	320
9	"9-out953"	.66987	209	103	312
9	"9-out954"	.43769	137	176	313
9	"9-out955"	.95092	310	16	326
9	"9-out956"	.63953	550	310	860
9	"9-out957"	.24821	104	315	419
9	"9-out958"	.66763	231	115	346
9	"9-out959"	.79200	99	26	125
9	"9-out960"	.32851	91	186	277
9	"9-out961"	.34090	60	116	176
9	"9-out962"	.19574	46	189	235
9	"9-out963"	.13372	23	149	172
9	"9-out964"	.28000	112	288	400
9	"9-out965"	.23664	350	1129	1479
9	"9-out966"	.26822	92	251	343
9	"9-out967"	.85714	276	46	322
9	"9-out968"	.88787	293	37	330
9	"9-out969"	.97948	191	4	195
9	"9-out970"	.22661	63	215	278
9	"9-out971"	.37286	349	587	936
9	"9-out972"	.31617	430	930	1360
9	"9-out973"	.98214	55	1	56
9	"9-out974"	.57843	118	86	204
9	"9-out975"	.31657	233	503	736
9	"9-out976"	.29733	223	527	750
9	"9-out977"	.18750	75	325	400
9	"9-out978"	.29990	616	1438	2054
9	"9-out979"	.31221	69	152	221
9	"9-out980"	.20750	304	1161	1465
9	"9-out981"	.77570	166	48	214
9	"9-out982"	.98780	81	1	82
9	"9-out983"	.35319	83	152	235
9	"9-out984"	.39375	126	194	320
9	"9-out985"	.30165	73	169	242
9	"9-out986"	.30083	108	251	359
9	"9-out987"	.39223	404	626	1030
9	"9-out988"	.20735	62	237	299
9	"9-out989"	.32213	211	444	655
9	"9-out990"	.98167	482	9	491
9	"9-out991"	.18279	34	152	186
9	"9-out992"	.24329	136	423	559
9	"9-out993"	.27272	93	248	341
9	"9-out994"	.57341	289	215	504
9	"9-out995"	.23492	148	482	630
9	"9-out996"	.58794	361	253	614
9	"9-out997"	.42105	48	66	114
9	"9-out998"	.41221	54	77	131
9	"9-out999"	.98041	701	14	715
9	"9-out1000"	.64794	173	94	267
9	"9-out1001"	.97959	48	1	49
9	"9-out1002"	.99630	270	1	271
9	"9-out1003"	.93442	57	4	61
9	"9-out1004"	.54022	282	240	522
9	"9-out1005"	.99082	108	1	109
9	"9-out1006"	.22429	24	83	107
9	"9-out1007"	.19743	77	313	390
9	"9-out1008"	.46368	83	96	179
9	"9-out1009"	.23012	165	552	717
9	"9-out1010"	.46610	55	63	118
9	"9-out1011"	.30386	110	252	362
9	"9-out1012"	.27066	167	450	617
9	"9-out1013"	.29801	225	530	755
9	"9-out1014"	.17557	23	108	131
9	"9-out1015"	.24358	76	236	312
9	"9-out1016"	.39714	139	211	350
9	"9-out1017"	.47335	151	168	319
9	"9-out1018"	.33333	115	230	345
9	"9-out1019"	.24109	88	277	365
9	"9-out1020"	.34431	115	219	334
9	"9-out1021"	.23518	246	800	1046
9	"9-out1022"	.98737	391	5	396
9	"9-out1023"	.93571	786	54	840
9	"9-out1024"	.27753	63	164	227
9	"9-out1025"	.19206	121	509	630
9	"9-out1026"	.29213	78	189	267
9	"9-out1027"	.34868	53	99	152
9	"9-out1028"	.30873	410	918	1328
9	"9-out1029"	.21565	248	902	1150
9	"9-out1030"	.27042	96	259	355
9	"9-out1031"	.35738	104	187	291
9	"9-out1032"	.80571	141	34	175
9	"9-out1033"	.58536	96	68	164
9	"9-out1034"	.98648	73	1	74
9	"9-out1035"	.41747	344	480	824
9	"9-out1036"	.20985	98	369	467
9	"9-out1037"	.27536	304	800	1104
9	"9-out1038"	.81176	69	16	85
9	"9-out1039"	.30429	751	1717	2468
9	"9-out1040"	.25836	247	709	956
9	"9-out1041"	.94186	81	5	86
9	"9-out1042"	.25858	128	367	495
9	"9-out1043"	.30236	384	886	1270
9	"9-out1044"	.32673	99	204	303
9	"9-out1045"	.24470	127	392	519
9	"9-out1046"	.27812	220	571	791
9	"9-out1047"	.31460	140	305	445
9	"9-out1048"	.16877	80	394	474
9	"9-out1049"	.19318	34	142	176
9	"9-out1050"	.68918	102	46	148
9	"9-out1051"	.54726	110	91	201
9	"9-out1052"	.43373	108	141	249
9	"9-out1053"	.99782	459	1	460
9	"9-out1054"	.27245	185	494	679
9	"9-out1055"	.32152	118	249	367
9	"9-out1056"	.99711	346	1	347
9	"9-out1057"	.28960	170	417	587
9	"9-out1058"	.37009	302	514	816
9	"9-out1059"	.37316	203	341	544
9	"9-out1060"	.25087	143	427	570
9	"9-out1061"	.27210	200	535	735
9	"9-out1062"	.20754	88	336	424
9	"9-out1063"	.26442	110	306	416
9	"9-out1064"	.35305	179	328	507
9	"9-out1065"	.96969	32	1	33
9	"9-out1066"	.99551	222	1	223
9	"9-out1067"	.38592	384	611	995
9	"9-out1068"	.27556	97	255	352
9	"9-out1069"	.48251	69	74	143
9	"9-out1070"	.99130	114	1	115
9	"9-out1071"	.33962	126	245	371
9	"9-out1072"	.29818	164	386	550
9	"9-out1073"	.43497	97	126	223
9	"9-out1074"	.44715	770	952	1722
9	"9-out1075"	.40756	97	141	238
9	"9-out1076"	.30979	193	430	623
9	"9-out1077"	.55000	275	225	500
9	"9-out1078"	.35564	85	154	239
9	"9-out1079"	.30123	463	1074	1537
9	"9-out1080"	.55116	474	386	860
9	"9-out1081"	.27131	140	376	516
9	"9-out1082"	.42857	57	76	133
9	"9-out1083"	.35889	117	209	326
9	"9-out1084"	.56334	209	162	371
9	"9-out1085"	.99186	122	1	123
9	"9-out1086"	.99145	116	1	117
9	"9-out1087"	.99145	116	1	117
9	"9-out1088"	.18544	130	571	701
9	"9-out1089"	.35207	238	438	676
9	"9-out1090"	.70714	297	123	420
9	"9-out1091"	.85810	127	21	148
9	"9-out1092"	.33479	383	761	1144
9	"9-out1093"	.72789	107	40	147
9	"9-out1094"	.45366	470	566	1036
9	"9-out1095"	.22455	139	480	619
9	"9-out1096"	.74938	305	102	407
9	"9-out1097"	.97770	307	7	314
9	"9-out1098"	.70344	102	43	145
9	"9-out1099"	.38661	283	449	732
9	"9-out1100"	.87500	154	22	176
9	"9-out1101"	.71384	459	184	643
9	"9-out1102"	.33790	320	627	947
9	"9-out1103"	.27333	82	218	300
9	"9-out1104"	.56587	743	570	1313
9	"9-out1105"	.20833	45	171	216
9	"9-out1106"	.54858	525	432	957
9	"9-out1107"	.30029	206	480	686
9	"9-out1108"	.40180	311	463	774
9	"9-out1109"	.23790	118	378	496
9	"9-out1110"	.22777	123	417	540
9	"9-out1111"	.25000	62	186	248
9	"9-out1112"	.99624	265	1	266
9	"9-out1113"	.31541	88	191	279
9	"9-out1114"	.94186	81	5	86
9	"9-out1115"	.23746	270	867	1137
9	"9-out1116"	.45576	237	283	520
9	"9-out1117"	.46458	223	257	480
9	"9-out1118"	.25140	134	399	533
9	"9-out1119"	.31470	107	233	340
9	"9-out1120"	.48543	50	53	103
9	"9-out1121"	.39832	286	432	718
9	"9-out1122"	.31465	146	318	464
9	"9-out1123"	.31388	113	247	360
9	"9-out1124"	.25479	93	272	365
9	"9-out1125"	.31111	112	248	360
9	"9-out1126"	.55353	274	221	495
9	"9-out1127"	.95303	345	17	362
9	"9-out1128"	.34893	395	737	1132
9	"9-out1129"	.29789	255	601	856
9	"9-out1130"	.76534	1197	367	1564
9	"9-out1131"	.27037	471	1271	1742
9	"9-out1132"	.70138	202	86	288
9	"9-out1133"	.18739	116	503	619
9	"9-out1134"	.86614	110	17	127
9	"9-out1135"	.97603	611	15	626
9	"9-out1136"	.94962	377	20	397
9	"9-out1137"	.18143	43	194	237
9	"9-out1138"	.61538	344	215	559
9	"9-out1139"	.35600	178	322	500
9	"9-out1140"	.20520	134	519	653
9	"9-out1141"	.33768	699	1371	2070
9	"9-out1142"	.37213	195	329	524
9	"9-out1143"	.93230	303	22	325
9	"9-out1144"	.30283	96	221	317
9	"9-out1145"	.27758	161	419	580
9	"9-out1146"	.85806	266	44	310
9	"9-out1147"	.37462	124	207	331
9	"9-out1148"	.57668	188	138	326
9	"9-out1149"	.65909	261	135	396
9	"9-out1150"	.57681	199	146	345
9	"9-out1151"	.95092	310	16	326
9	"9-out1152"	.47530	154	170	324
9	"9-out1153"	.58306	179	128	307
9	"9-out1154"	.58441	315	224	539
9	"9-out1155"	.27504	140	369	509
9	"9-out1156"	.58213	202	145	347
9	"9-out1157"	.84591	269	49	318
9	"9-out1158"	.33012	103	209	312
9	"9-out1159"	.49838	154	155	309
9	"9-out1160"	.81548	358	81	439
9	"9-out1161"	.32794	568	1164	1732
9	"9-out1162"	.30508	522	1189	1711
9	"9-out1163"	.38317	82	132	214
9	"9-out1164"	.96813	881	29	910
9	"9-out1165"	.81901	1344	297	1641
9	"9-out1166"	.35773	474	851	1325
9	"9-out1167"	.31420	427	932	1359
9	"9-out1168"	.29694	68	161	229
9	"9-out1169"	.33644	72	142	214
9	"9-out1170"	.70886	112	46	158
9	"9-out1171"	.38671	99	157	256
9	"9-out1172"	.64579	361	198	559
9	"9-out1173"	.74909	206	69	275
9	"9-out1174"	.31606	61	132	193
9	"9-out1175"	.38260	132	213	345
9	"9-out1176"	.31574	359	778	1137
9	"9-out1177"	.31485	142	309	451
9	"9-out1178"	.34959	43	80	123
9	"9-out1179"	.69540	5541	2427	7968
9	"9-out1180"	.37658	714	1182	1896
9	"9-out1181"	.33752	161	316	477
9	"9-out1182"	.43902	36	46	82
9	"9-out1183"	.99649	568	2	570
9	"9-out1184"	.93548	58	4	62
9	"9-out1185"	.67685	155	74	229
9	"9-out1186"	.36507	23	40	63
9	"9-out1187"	.25378	67	197	264
9	"9-out1188"	.57352	39	29	68
9	"9-out1189"	.86313	391	62	453
9	"9-out1190"	.23645	96	310	406
9	"9-out1191"	.98089	308	6	314
9	"9-out1192"	.80582	249	60	309
9	"9-out1193"	.38755	81	128	209
9	"9-out1194"	.81436	930	212	1142
9	"9-out1195"	.23369	43	141	184
9	"9-out1196"	.35722	314	565	879
9	"9-out1197"	.37349	124	208	332
9	"9-out1198"	.66422	453	229	682
9	"9-out1199"	.24800	217	658	875
9	"9-out1200"	.13650	43	272	315
9	"9-out1201"	.99552	445	2	447
9	"9-out1202"	.36673	172	297	469
9	"9-out1203"	.98909	272	3	275
9	"9-out1204"	.98728	233	3	236
9	"9-out1205"	.98425	125	2	127
9	"9-out1206"	.24902	64	193	257
9	"9-out1207"	.65714	138	72	210
9	"9-out1208"	.46153	144	168	312
9	"9-out1209"	.16143	36	187	223
9	"9-out1210"	.23674	67	216	283
9	"9-out1211"	.98747	867	11	878
9	"9-out1212"	.98633	866	12	878
9	"9-out1213"	.98635	795	11	806
9	"9-out1214"	.98633	866	12	878
9	"9-out1215"	.98412	744	12	756
9	"9-out1216"	.97975	726	15	741
9	"9-out1217"	.24860	134	405	539
9	"9-out1218"	.31886	169	361	530
9	"9-out1219"	.54210	103	87	190
9	"9-out1220"	.30861	129	289	418
9	"9-out1221"	.38292	157	253	410
9	"9-out1222"	.40697	140	204	344
9	"9-out1223"	.31281	249	547	796
9	"9-out1224"	.23357	192	630	822
9	"9-out1225"	.24553	206	633	839
9	"9-out1226"	.29945	277	648	925
9	"9-out1227"	.32179	372	784	1156
9	"9-out1228"	.36949	545	930	1475
9	"9-out1229"	.37670	524	867	1391
9	"9-out1230"	.23955	344	1092	1436
9	"9-out1231"	.25900	453	1296	1749
9	"9-out1232"	.99685	317	1	318
9	"9-out1233"	.21769	438	1574	2012
9	"9-out1234"	.23157	484	1606	2090
9	"9-out1235"	.98571	69	1	70
9	"9-out1236"	.44012	272	346	618
9	"9-out1237"	.28964	179	439	618
9	"9-out1238"	.99543	218	1	219
9	"9-out1239"	.59065	215	149	364
9	"9-out1240"	.22950	98	329	427
9	"9-out1241"	.60860	283	182	465
9	"9-out1242"	.31364	223	488	711
9	"9-out1243"	.99704	337	1	338
9	"9-out1244"	.12643	33	228	261
9	"9-out1245"	.65504	526	277	803
9	"9-out1246"	.32195	66	139	205
9	"9-out1247"	.28239	85	216	301
9	"9-out1248"	.50265	569	563	1132
9	"9-out1249"	.26086	78	221	299
9	"9-out1250"	.99413	339	2	341
9	"9-out1251"	.32467	275	572	847
9	"9-out1252"	.99759	1246	3	1249
9	"9-out1253"	.98515	730	11	741
9	"9-out1254"	.31771	278	597	875
9	"9-out1255"	.23090	130	433	563
9	"9-out1256"	.42780	80	107	187
9	"9-out1257"	.40216	372	553	925
9	"9-out1258"	.25882	88	252	340
9	"9-out1259"	.41230	1173	1672	2845
9	"9-out1260"	.35849	247	442	689
9	"9-out1261"	.46386	276	319	595
9	"9-out1262"	.24901	315	950	1265
9	"9-out1263"	.18290	92	411	503
9	"9-out1264"	.53214	298	262	560
9	"9-out1265"	.16920	89	437	526
9	"9-out1266"	.21463	44	161	205
9	"9-out1267"	.65517	152	80	232
9	"9-out1268"	.88571	217	28	245
9	"9-out1269"	.18469	70	309	379
9	"9-out1270"	.90291	651	70	721
9	"9-out1271"	.94197	276	17	293
9	"9-out1272"	.91908	443	39	482
9	"9-out1273"	.95876	465	20	485
9	"9-out1274"	.20572	115	444	559
9	"9-out1275"	.72514	124	47	171
9	"9-out1276"	.74418	128	44	172
9	"9-out1277"	.48936	207	216	423
9	"9-out1278"	.31931	281	599	880
9	"9-out1279"	.28985	160	392	552
9	"9-out1280"	.62179	388	236	624
9	"9-out1281"	.85097	394	69	463
9	"9-out1282"	.39215	120	186	306
9	"9-out1283"	.41747	86	120	206
9	"9-out1284"	.98360	60	1	61
9	"9-out1285"	.90540	134	14	148
9	"9-out1286"	.30416	73	167	240
9	"9-out1287"	.18552	41	180	221
9	"9-out1288"	.37313	125	210	335
9	"9-out1289"	.24213	300	939	1239
9	"9-out1290"	.65829	131	68	199
9	"9-out1291"	.57908	216	157	373
9	"9-out1292"	.38550	133	212	345
9	"9-out1293"	.76712	168	51	219
9	"9-out1294"	.35324	136	249	385
9	"9-out1295"	.26548	240	664	904
9	"9-out1296"	.38000	133	217	350
9	"9-out1297"	.51497	172	162	334
9	"9-out1298"	.29222	154	373	527
9	"9-out1299"	.23535	241	783	1024
9	"9-out1300"	.29327	432	1041	1473
9	"9-out1301"	.27799	288	748	1036
9	"9-out1302"	.32906	180	367	547
9	"9-out1303"	.24102	94	296	390
9	"9-out1304"	.43801	53	68	121
9	"9-out1305"	.25829	288	827	1115
9	"9-out1306"	.62320	650	393	1043
9	"9-out1307"	.75546	380	123	503
9	"9-out1308"	.19808	290	1174	1464
9	"9-out1309"	.19474	289	1195	1484
9	"9-out1310"	.42660	526	707	1233
9	"9-out1311"	.55314	739	597	1336
9	"9-out1312"	.43176	405	533	938
9	"9-out1313"	.63855	53	30	83
9	"9-out1314"	.35179	108	199	307
9	"9-out1315"	.73835	206	73	279
9	"9-out1316"	.29315	90	217	307
9	"9-out1317"	.34126	86	166	252
9	"9-out1318"	.29096	87	212	299
9	"9-out1319"	.17647	27	126	153
9	"9-out1320"	.37037	30	51	81
9	"9-out1321"	.38328	133	214	347
9	"9-out1322"	.45917	343	404	747
9	"9-out1323"	.85069	245	43	288
9	"9-out1324"	.99500	199	1	200
9	"9-out1325"	.31508	541	1176	1717
9	"9-out1326"	.18055	39	177	216
9	"9-out1327"	.66304	305	155	460
9	"9-out1328"	.22239	145	507	652
9	"9-out1329"	.23030	231	772	1003
9	"9-out1330"	.29452	559	1339	1898
9	"9-out1331"	.52745	269	241	510
9	"9-out1332"	.58598	184	130	314
9	"9-out1333"	.95176	296	15	311
9	"9-out1334"	.30866	146	327	473
9	"9-out1335"	.83544	264	52	316
9	"9-out1336"	.54972	199	163	362
9	"9-out1337"	.63322	202	117	319
9	"9-out1338"	.43042	133	176	309
9	"9-out1339"	.30491	93	212	305
9	"9-out1340"	.90000	297	33	330
9	"9-out1341"	.92356	290	24	314
9	"9-out1342"	.85436	264	45	309
9	"9-out1343"	.92975	953	72	1025
9	"9-out1344"	.45937	147	173	320
9	"9-out1345"	.99363	468	3	471
9	"9-out1346"	.35121	72	133	205
9	"9-out1347"	.93851	290	19	309
9	"9-out1348"	.88924	281	35	316
9	"9-out1349"	.88888	280	35	315
9	"9-out1350"	.71220	245	99	344
9	"9-out1351"	.38141	119	193	312
9	"9-out1352"	.29807	93	219	312
9	"9-out1353"	.37345	121	203	324
9	"9-out1354"	.31250	100	220	320
9	"9-out1355"	.32087	103	218	321
9	"9-out1356"	.21523	65	237	302
9	"9-out1357"	.41772	132	184	316
9	"9-out1358"	.14920	47	268	315
9	"9-out1359"	.37223	118	199	317
9	"9-out1360"	.42367	136	185	321
9	"9-out1361"	.36858	115	197	312
9	"9-out1362"	.37770	122	201	323
9	"9-out1363"	.29299	92	222	314
9	"9-out1364"	.31940	107	228	335
9	"9-out1365"	.63722	202	115	317
9	"9-out1366"	.95987	311	13	324
9	"9-out1367"	.96285	337	13	350
9	"9-out1368"	.64951	202	109	311
9	"9-out1369"	.93630	294	20	314
9	"9-out1370"	.93630	294	20	314
9	"9-out1371"	.97264	320	9	329
9	"9-out1372"	.96551	308	11	319
9	"9-out1373"	.96214	305	12	317
9	"9-out1374"	.30312	97	223	320
9	"9-out1375"	.47352	152	169	321
9	"9-out1376"	.66358	215	109	324
9	"9-out1377"	.15264	49	272	321
9	"9-out1378"	.99792	482	1	483
9	"9-out1379"	.58289	334	239	573
9	"9-out1380"	.41998	643	888	1531
9	"9-out1381"	.37900	130	213	343
9	"9-out1382"	.43859	100	128	228
9	"9-out1383"	.98941	187	2	189
9	"9-out1384"	.75141	532	176	708
9	"9-out1385"	.31330	73	160	233
9	"9-out1386"	.36672	399	689	1088
9	"9-out1387"	.80998	422	99	521
9	"9-out1388"	.21955	128	455	583
9	"9-out1389"	.69300	307	136	443
9	"9-out1390"	.28571	52	130	182
9	"9-out1391"	.98823	168	2	170
9	"9-out1392"	.99411	169	1	170
9	"9-out1393"	.39516	98	150	248
9	"9-out1394"	.10434	48	412	460
9	"9-out1395"	.47194	143	160	303
9	"9-out1396"	.72131	44	17	61
9	"9-out1397"	.91803	56	5	61
9	"9-out1398"	.91803	56	5	61
9	"9-out1399"	.93442	57	4	61
9	"9-out1400"	.91803	56	5	61
9	"9-out1401"	.85245	52	9	61
9	"9-out1402"	.90163	55	6	61
9	"9-out1403"	.52597	81	73	154
9	"9-out1404"	.32536	245	508	753
9	"9-out1405"	.65371	185	98	283
9	"9-out1406"	.43080	165	218	383
9	"9-out1407"	.34059	219	424	643
9	"9-out1408"	.32835	198	405	603
9	"9-out1409"	.42176	186	255	441
9	"9-out1410"	.72817	292	109	401
9	"9-out1411"	.63468	172	99	271
9	"9-out1412"	.21296	46	170	216
9	"9-out1413"	.37470	157	262	419
9	"9-out1414"	.23076	57	190	247
9	"9-out1415"	.20000	48	192	240
9	"9-out1416"	.99264	135	1	136
9	"9-out1417"	.28737	148	367	515
9	"9-out1418"	.47452	149	165	314
9	"9-out1419"	.77192	308	91	399
9	"9-out1420"	.26373	168	469	637
9	"9-out1421"	.58125	93	67	160
9	"9-out1422"	.26477	112	311	423
9	"9-out1423"	.41455	131	185	316
9	"9-out1424"	.78616	250	68	318
9	"9-out1425"	.31152	100	221	321
9	"9-out1426"	.99270	136	1	137
9	"9-out1427"	.43558	142	184	326
9	"9-out1428"	.11904	35	259	294
9	"9-out1429"	.25758	280	807	1087
9	"9-out1430"	.45614	182	217	399
9	"9-out1431"	.31688	122	263	385
9	"9-out1432"	.34887	232	433	665
9	"9-out1433"	.26067	171	485	656
9	"9-out1434"	.39759	297	450	747
9	"9-out1435"	.36650	151	261	412
9	"9-out1436"	.24096	40	126	166
9	"9-out1437"	.61241	1144	724	1868
9	"9-out1438"	.80838	270	64	334
9	"9-out1439"	.28834	735	1814	2549
9	"9-out1440"	.97257	532	15	547
9	"9-out1441"	.32812	189	387	576
9	"9-out1442"	.29149	72	175	247
9	"9-out1443"	.26070	134	380	514
9	"9-out1444"	.24099	368	1159	1527
9	"9-out1445"	.28798	381	942	1323
9	"9-out1446"	.45531	107	128	235
9	"9-out1447"	.28016	418	1074	1492
9	"9-out1448"	.99159	118	1	119
9	"9-out1449"	.17916	43	197	240
9	"9-out1450"	.35117	328	606	934
9	"9-out1451"	.30939	112	250	362
9	"9-out1452"	.20103	116	461	577
9	"9-out1453"	.54266	159	134	293
9	"9-out1454"	.36690	51	88	139
9	"9-out1455"	.42723	91	122	213
9	"9-out1456"	.31081	161	357	518
9	"9-out1457"	.25957	61	174	235
9	"9-out1458"	.24255	57	178	235
9	"9-out1459"	.59482	69	47	116
9	"9-out1460"	.36111	78	138	216
9	"9-out1461"	.75247	76	25	101
9	"9-out1462"	.32487	64	133	197
9	"9-out1463"	.34186	294	566	860
9	"9-out1464"	.24658	235	718	953
9	"9-out1465"	.42231	106	145	251
9	"9-out1466"	.74822	422	142	564
9	"9-out1467"	.26143	200	565	765
9	"9-out1468"	.41945	138	191	329
9	"9-out1469"	.38053	43	70	113
9	"9-out1470"	.42213	309	423	732
9	"9-out1471"	.48195	641	689	1330
9	"9-out1472"	.33959	217	422	639
9	"9-out1473"	.53589	321	278	599
9	"9-out1474"	.59109	146	101	247
9	"9-out1475"	.59514	147	100	247
9	"9-out1476"	.41531	179	252	431
9	"9-out1477"	.25912	71	203	274
9	"9-out1478"	.34022	214	415	629
9	"9-out1479"	.31111	196	434	630
9	"9-out1480"	.29829	105	247	352
9	"9-out1481"	.28125	45	115	160
9	"9-out1482"	.17589	108	506	614
9	"9-out1483"	.28345	161	407	568
9	"9-out1484"	.66904	281	139	420
9	"9-out1485"	.23943	221	702	923
9	"9-out1486"	.41891	279	387	666
9	"9-out1487"	.29959	74	173	247
9	"9-out1488"	.82352	168	36	204
9	"9-out1489"	.28618	87	217	304
9	"9-out1490"	.73790	549	195	744
9	"9-out1491"	.47881	486	529	1015
9	"9-out1492"	.54761	230	190	420
9	"9-out1493"	.99918	1221	1	1222
9	"9-out1494"	.44250	354	446	800
9	"9-out1495"	.40697	210	306	516
9	"9-out1496"	.53132	229	202	431
9	"9-out1497"	.43856	232	297	529
9	"9-out1498"	.39085	188	293	481
9	"9-out1499"	.22606	85	291	376
9	"9-out1500"	.24723	67	204	271
9	"9-out1501"	.35197	705	1298	2003
9	"9-out1502"	.98209	384	7	391
9	"9-out1503"	.70945	210	86	296
9	"9-out1504"	.31048	154	342	496
9	"9-out1505"	.78400	294	81	375
9	"9-out1506"	.48829	563	590	1153
9	"9-out1507"	.99384	1131	7	1138
9	"9-out1508"	.50331	76	75	151
9	"9-out1509"	.23552	301	977	1278
9	"9-out1510"	.27626	142	372	514
9	"9-out1511"	.99056	105	1	106
9	"9-out1512"	.73400	218	79	297
9	"9-out1513"	.97278	286	8	294
9	"9-out1514"	.99333	1043	7	1050
9	"9-out1515"	.99384	1131	7	1138
9	"9-out1516"	.99382	1126	7	1133
9	"9-out1517"	.98352	418	7	425
9	"9-out1518"	.99758	413	1	414
9	"9-out1519"	.98379	425	7	432
9	"9-out1520"	.99766	428	1	429
9	"9-out1521"	.24197	113	354	467
9	"9-out1522"	.24253	138	431	569
9	"9-out1523"	.26904	113	307	420
9	"9-out1524"	.62921	56	33	89
9	"9-out1525"	.99655	289	1	290
9	"9-out1526"	.35833	172	308	480
9	"9-out1527"	.48638	125	132	257
9	"9-out1528"	.31956	147	313	460
9	"9-out1529"	.28855	174	429	603
9	"9-out1530"	.20805	93	354	447
9	"9-out1531"	.45609	187	223	410
9	"9-out1532"	.69059	279	125	404
9	"9-out1533"	.98257	282	5	287
9	"9-out1534"	.34279	447	857	1304
9	"9-out1535"	.41281	116	165	281
9	"9-out1536"	.60406	119	78	197
9	"9-out1537"	.36298	102	179	281
9	"9-out1538"	.44411	151	189	340
9	"9-out1539"	.99425	173	1	174
9	"9-out1540"	.27080	179	482	661
9	"9-out1541"	.87845	159	22	181
9	"9-out1542"	.90243	148	16	164
9	"9-out1543"	.99342	151	1	152
9	"9-out1544"	.67003	199	98	297
9	"9-out1545"	.29268	96	232	328
9	"9-out1546"	.37500	174	290	464
9	"9-out1547"	.99494	197	1	198
9	"9-out1548"	.39849	530	800	1330
9	"9-out1549"	.39916	762	1147	1909
9	"9-out1550"	.23198	103	341	444
9	"9-out1551"	.29493	128	306	434
9	"9-out1552"	.27056	125	337	462
9	"9-out1553"	.53539	1520	1319	2839
9	"9-out1554"	.29966	181	423	604
9	"9-out1555"	.62333	561	339	900
9	"9-out1556"	.86956	180	27	207
9	"9-out1557"	.27981	122	314	436
9	"9-out1558"	.39756	163	247	410
9	"9-out1559"	.11971	17	125	142
9	"9-out1560"	.96536	223	8	231
9	"9-out1561"	.42713	170	228	398
9	"9-out1562"	.36701	178	307	485
9	"9-out1563"	.68736	310	141	451
9	"9-out1564"	.97096	301	9	310
9	"9-out1565"	.66307	246	125	371
9	"9-out1566"	.27472	75	198	273
9	"9-out1567"	.51219	210	200	410
9	"9-out1568"	.57877	349	254	603
9	"9-out1569"	.36728	119	205	324
9	"9-out1570"	.75122	613	203	816
9	"9-out1571"	.40712	263	383	646
9	"9-out1572"	.18927	120	514	634
9	"9-out1573"	.35177	89	164	253
9	"9-out1574"	.48591	138	146	284
9	"9-out1575"	.42687	216	290	506
9	"9-out1576"	.38135	225	365	590
9	"9-out1577"	.49450	90	92	182
9	"9-out1578"	.53342	383	335	718
9	"9-out1579"	.38414	126	202	328
9	"9-out1580"	.33333	107	214	321
9	"9-out1581"	.80800	101	24	125
9	"9-out1582"	.83693	426	83	509
9	"9-out1583"	.28583	331	827	1158
9	"9-out1584"	.44615	87	108	195
9	"9-out1585"	.40503	177	260	437
9	"9-out1586"	.28269	147	373	520
9	"9-out1587"	.35280	151	277	428
9	"9-out1588"	.71612	222	88	310
9	"9-out1589"	.29756	61	144	205
9	"9-out1590"	.91238	302	29	331
9	"9-out1591"	.28662	45	112	157
9	"9-out1592"	.76954	187	56	243
9	"9-out1593"	.93680	593	40	633
9	"9-out1594"	.99529	635	3	638
9	"9-out1595"	.99889	901	1	902
9	"9-out1596"	.38596	44	70	114
9	"9-out1597"	.60483	75	49	124
9	"9-out1598"	.72839	59	22	81
9	"9-out1599"	.44866	118	145	263
9	"9-out1600"	.99590	243	1	244
9	"9-out1601"	.99761	418	1	419
9	"9-out1602"	.23667	151	487	638
9	"9-out1603"	.23487	229	746	975
9	"9-out1604"	.38139	246	399	645
9	"9-out1605"	.40245	394	585	979
9	"9-out1606"	.30182	297	687	984
9	"9-out1607"	.29767	320	755	1075
9	"9-out1608"	.99173	480	4	484
9	"9-out1609"	.33041	151	306	457
9	"9-out1610"	.43636	912	1178	2090
9	"9-out1611"	.55797	154	122	276
9	"9-out1612"	.32367	67	140	207
9	"9-out1613"	.98958	95	1	96
9	"9-out1614"	.59276	131	90	221
9	"9-out1615"	.22090	112	395	507
9	"9-out1616"	.18061	82	372	454
9	"9-out1617"	.30688	263	594	857
9	"9-out1618"	.82845	396	82	478
9	"9-out1619"	.31818	84	180	264
9	"9-out1620"	.98666	74	1	75
9	"9-out1621"	.24064	193	609	802
9	"9-out1622"	.46442	235	271	506
9	"9-out1623"	.99774	442	1	443
9	"9-out1624"	.20314	155	608	763
9	"9-out1625"	.39293	534	825	1359
9	"9-out1626"	.16549	94	474	568
9	"9-out1627"	.28372	122	308	430
9	"9-out1628"	.30258	82	189	271
9	"9-out1629"	.18585	113	495	608
9	"9-out1630"	.28962	740	1815	2555
9	"9-out1631"	.99714	349	1	350
9	"9-out1632"	.98102	362	7	369
9	"9-out1633"	.99714	349	1	350
9	"9-out1634"	.99728	368	1	369
9	"9-out1635"	.99728	368	1	369
9	"9-out1636"	.56542	121	93	214
9	"9-out1637"	.98600	493	7	500
9	"9-out1638"	.36734	72	124	196
9	"9-out1639"	.99393	164	1	165
9	"9-out1640"	.15604	93	503	596
9	"9-out1641"	.33950	165	321	486
9	"9-out1642"	.14976	65	369	434
9	"9-out1643"	.42290	192	262	454
9	"9-out1644"	.66244	157	80	237
9	"9-out1645"	.15492	22	120	142
9	"9-out1646"	.35233	68	125	193
9	"9-out1647"	.99891	920	1	921
9	"9-out1648"	.31870	385	823	1208
9	"9-out1649"	.34748	131	246	377
9	"9-out1650"	.23497	344	1120	1464
9	"9-out1651"	.33419	129	257	386
9	"9-out1652"	.34844	876	1638	2514
9	"9-out1653"	.27748	53	138	191
9	"9-out1654"	.94148	177	11	188
9	"9-out1655"	.57701	251	184	435
9	"9-out1656"	.97560	240	6	246
9	"9-out1657"	.86741	386	59	445
9	"9-out1658"	.55722	185	147	332
9	"9-out1659"	.34214	207	398	605
9	"9-out1660"	.31175	130	287	417
9	"9-out1661"	.24242	128	400	528
9	"9-out1662"	.29881	453	1063	1516
9	"9-out1663"	.29473	112	268	380
9	"9-out1664"	.34523	116	220	336
9	"9-out1665"	.20336	157	615	772
9	"9-out1666"	.28125	198	506	704
9	"9-out1667"	.31567	149	323	472
9	"9-out1668"	.97741	779	18	797
9	"9-out1669"	.31770	122	262	384
9	"9-out1670"	.76525	163	50	213
9	"9-out1671"	.18283	228	1019	1247
9	"9-out1672"	.99346	152	1	153
9	"9-out1673"	.29373	136	327	463
9	"9-out1674"	.60545	422	275	697
9	"9-out1675"	.28985	60	147	207
9	"9-out1676"	.25688	112	324	436
9	"9-out1677"	.99918	1221	1	1222
9	"9-out1678"	.99714	349	1	350
9	"9-out1679"	.42134	75	103	178
9	"9-out1680"	.23157	88	292	380
9	"9-out1681"	.22613	90	308	398
9	"9-out1682"	.21522	82	299	381
9	"9-out1683"	.34027	147	285	432
9	"9-out1684"	.32614	121	250	371
9	"9-out1685"	.38281	147	237	384
9	"9-out1686"	.30735	71	160	231
9	"9-out1687"	.98529	67	1	68
9	"9-out1688"	.99082	108	1	109
9	"9-out1689"	.30957	834	1860	2694
9	"9-out1690"	.44041	170	216	386
9	"9-out1691"	.31851	258	552	810
9	"9-out1692"	.99598	248	1	249
9	"9-out1693"	.24285	51	159	210
9	"9-out1694"	.19743	77	313	390
9	"9-out1695"	.25867	179	513	692
9	"9-out1696"	.50218	460	456	916
9	"9-out1697"	.75984	193	61	254
9	"9-out1698"	.35033	316	586	902
9	"9-out1699"	.20134	150	595	745
9	"9-out1700"	.87701	435	61	496
9	"9-out1701"	.26256	94	264	358
9	"9-out1702"	.32525	537	1114	1651
9	"9-out1703"	.30913	1448	3236	4684
9	"9-out1704"	.71142	249	101	350
9	"9-out1705"	.57261	138	103	241
9	"9-out1706"	.37500	87	145	232
9	"9-out1707"	.25563	136	396	532
9	"9-out1708"	.98666	74	1	75
9	"9-out1709"	.22873	328	1106	1434
9	"9-out1710"	.99347	457	3	460
9	"9-out1711"	.99692	324	1	325
9	"9-out1712"	.21960	112	398	510
9	"9-out1713"	.99065	106	1	107
9	"9-out1714"	.44897	66	81	147
9	"9-out1715"	.79930	462	116	578
9	"9-out1716"	.78301	249	69	318
9	"9-out1717"	.24904	130	392	522
9	"9-out1718"	.28330	404	1022	1426
9	"9-out1719"	.99646	563	2	565
9	"9-out1720"	.45937	147	173	320
9	"9-out1721"	.27536	190	500	690
9	"9-out1722"	.30068	132	307	439
9	"9-out1723"	.52533	197	178	375
9	"9-out1724"	.22247	99	346	445
9	"9-out1725"	.26804	26	71	97
9	"9-out1726"	.29186	183	444	627
9	"9-out1727"	.46170	217	253	470
9	"9-out1728"	.21072	114	427	541
9	"9-out1729"	.27806	161	418	579
9	"9-out1730"	.17985	25	114	139
9	"9-out1731"	.99643	838	3	841
9	"9-out1732"	.39614	267	407	674
9	"9-out1733"	.27860	56	145	201
9	"9-out1734"	.25241	628	1860	2488
9	"9-out1735"	.29727	709	1676	2385
9	"9-out1736"	.37318	103	173	276
9	"9-out1737"	.19607	80	328	408
9	"9-out1738"	.12403	32	226	258
9	"9-out1739"	.90879	558	56	614
9	"9-out1740"	.52997	1114	988	2102
9	"9-out1741"	.15563	127	689	816
9	"9-out1742"	.37433	70	117	187
9	"9-out1743"	.27095	181	487	668
9	"9-out1744"	.32007	322	684	1006
9	"9-out1745"	.75182	103	34	137
9	"9-out1746"	.12771	53	362	415
9	"9-out1747"	.95433	209	10	219
9	"9-out1748"	.28000	105	270	375
9	"9-out1749"	.33522	118	234	352
9	"9-out1750"	.18750	24	104	128
9	"9-out1751"	.29629	104	247	351
9	"9-out1752"	.97177	792	23	815
9	"9-out1753"	.39952	336	505	841
9	"9-out1754"	.24074	65	205	270
9	"9-out1755"	.57933	157	114	271
9	"9-out1756"	.92923	801	61	862
9	"9-out1757"	.13551	58	370	428
9	"9-out1758"	.19322	137	572	709
9	"9-out1759"	.36201	122	215	337
9	"9-out1760"	.67777	122	58	180
9	"9-out1761"	.98958	95	1	96
9	"9-out1762"	.71912	361	141	502
9	"9-out1763"	.30119	453	1051	1504
9	"9-out1764"	.15238	128	712	840
9	"9-out1765"	.59198	502	346	848
9	"9-out1766"	.25547	175	510	685
9	"9-out1767"	.92656	694	55	749
9	"9-out1768"	.41690	291	407	698
9	"9-out1769"	.23427	149	487	636
9	"9-out1770"	.34325	173	331	504
9	"9-out1771"	.98666	74	1	75
9	"9-out1772"	.48815	1133	1188	2321
9	"9-out1773"	.68634	186	85	271
9	"9-out1774"	.27116	253	680	933
9	"9-out1775"	.26461	86	239	325
9	"9-out1776"	.56268	193	150	343
9	"9-out1777"	.99397	1154	7	1161
9	"9-out1778"	.31910	157	335	492
9	"9-out1779"	.21262	64	237	301
9	"9-out1780"	.28767	357	884	1241
9	"9-out1781"	.99748	396	1	397
9	"9-out1782"	.43657	148	191	339
9	"9-out1783"	.99637	275	1	276
9	"9-out1784"	.37610	1108	1838	2946
9	"9-out1785"	.45257	167	202	369
9	"9-out1786"	.31770	210	451	661
9	"9-out1787"	.28729	156	387	543
9	"9-out1788"	.25252	50	148	198
9	"9-out1789"	.79891	147	37	184
9	"9-out1790"	.16190	68	352	420
9	"9-out1791"	.46835	111	126	237
9	"9-out1792"	.50000	136	136	272
9	"9-out1793"	.28607	113	282	395
9	"9-out1794"	.13207	28	184	212
9	"9-out1795"	.99333	149	1	150
9	"9-out1796"	.25917	113	323	436
9	"9-out1797"	.34838	162	303	465
9	"9-out1798"	.24038	50	158	208
9	"9-out1799"	.29107	62	151	213
9	"9-out1800"	.42681	312	419	731
9	"9-out1801"	.72407	845	322	1167
9	"9-out1802"	.44276	263	331	594
9	"9-out1803"	.21454	118	432	550
9	"9-out1804"	.23116	89	296	385
9	"9-out1805"	.23757	411	1319	1730
9	"9-out1806"	.26315	30	84	114
9	"9-out1807"	.15217	91	507	598
9	"9-out1808"	.46485	291	335	626
9	"9-out1809"	.30234	348	803	1151
9	"9-out1810"	.26890	313	851	1164
9	"9-out1811"	.27656	177	463	640
9	"9-out1812"	.35176	299	551	850
9	"9-out1813"	.37404	98	164	262
9	"9-out1814"	.23478	54	176	230
9	"9-out1815"	.28686	107	266	373
9	"9-out1816"	.30969	131	292	423
9	"9-out1817"	.43091	708	935	1643
9	"9-out1818"	.29385	67	161	228
9	"9-out1819"	.31347	200	438	638
9	"9-out1820"	.99921	1266	1	1267
9	"9-out1821"	.57976	149	108	257
9	"9-out1822"	.43895	302	386	688
9	"9-out1823"	.65808	460	239	699
9	"9-out1824"	.15561	54	293	347
9	"9-out1825"	.32167	138	291	429
9	"9-out1826"	.23821	192	614	806
9	"9-out1827"	.81250	52	12	64
9	"9-out1828"	.17684	55	256	311
9	"9-out1829"	.39532	457	699	1156
9	"9-out1830"	.25728	212	612	824
9	"9-out1831"	.33110	198	400	598
9	"9-out1832"	.27145	136	365	501
9	"9-out1833"	.22616	121	414	535
9	"9-out1834"	.05847	10	161	171
9	"9-out1835"	.20305	133	522	655
9	"9-out1836"	.51688	199	186	385
9	"9-out1837"	.30407	97	222	319
9	"9-out1838"	.99408	168	1	169
9	"9-out1839"	.33104	193	390	583
9	"9-out1840"	.87777	158	22	180
9	"9-out1841"	.77439	127	37	164
9	"9-out1842"	.97435	190	5	195
9	"9-out1843"	.62737	165	98	263
9	"9-out1844"	.30875	201	450	651
9	"9-out1845"	.34365	111	212	323
9	"9-out1846"	.19758	49	199	248
9	"9-out1847"	.16611	50	251	301
9	"9-out1848"	.99450	1449	8	1457
9	"9-out1849"	.97979	97	2	99
9	"9-out1850"	.28723	108	268	376
9	"9-out1851"	.17204	112	539	651
9	"9-out1852"	.35294	180	330	510
9	"9-out1853"	.34411	947	1805	2752
9	"9-out1854"	.29753	169	399	568
9	"9-out1855"	.15714	11	59	70
9	"9-out1856"	.25131	191	569	760
9	"9-out1857"	.98765	80	1	81
9	"9-out1858"	.99137	115	1	116
9	"9-out1859"	.98979	97	1	98
9	"9-out1860"	.29365	148	356	504
9	"9-out1861"	.38524	423	675	1098
9	"9-out1862"	.24293	86	268	354
9	"9-out1863"	.68587	369	169	538
9	"9-out1864"	.25835	348	999	1347
9	"9-out1865"	.31900	193	412	605
9	"9-out1866"	.93659	650	44	694
9	"9-out1867"	.28611	101	252	353
9	"9-out1868"	.54273	127	107	234
9	"9-out1869"	.44414	163	204	367
9	"9-out1870"	.70188	186	79	265
9	"9-out1871"	.32727	54	111	165
9	"9-out1872"	.25245	154	456	610
9	"9-out1873"	.35362	244	446	690
9	"9-out1874"	.47222	187	209	396
9	"9-out1875"	.41641	137	192	329
9	"9-out1876"	.55277	199	161	360
9	"9-out1877"	.58474	207	147	354
9	"9-out1878"	.30876	155	347	502
9	"9-out1879"	.73529	600	216	816
9	"9-out1880"	.49790	119	120	239
9	"9-out1881"	.34859	99	185	284
9	"9-out1882"	.30419	87	199	286
9	"9-out1883"	.40000	388	582	970
9	"9-out1884"	.99702	335	1	336
9	"9-out1885"	.74725	136	46	182
9	"9-out1886"	.17763	27	125	152
9	"9-out1887"	.94902	391	21	412
9	"9-out1888"	.81780	588	131	719
9	"9-out1889"	.32850	227	464	691
9	"9-out1890"	.35754	251	451	702
9	"9-out1891"	.72581	998	377	1375
9	"9-out1892"	.55656	733	584	1317
9	"9-out1893"	.51406	402	380	782
9	"9-out1894"	.95588	455	21	476
9	"9-out1895"	.98263	283	5	288
9	"9-out1896"	.98666	74	1	75
9	"9-out1897"	.13300	54	352	406
9	"9-out1898"	.54576	161	134	295
9	"9-out1899"	.43239	291	382	673
9	"9-out1900"	.16939	31	152	183
9	"9-out1901"	.61728	100	62	162
9	"9-out1902"	.99365	313	2	315
9	"9-out1903"	.53387	197	172	369
9	"9-out1904"	.98135	421	8	429
9	"9-out1905"	.40175	366	545	911
9	"9-out1906"	.24190	112	351	463
9	"9-out1907"	.35428	62	113	175
9	"9-out1908"	.59238	311	214	525
9	"9-out1909"	.10451	37	317	354
9	"9-out1910"	.14769	48	277	325
9	"9-out1911"	.75757	125	40	165
9	"9-out1912"	.17015	179	873	1052
9	"9-out1913"	.13448	78	502	580
9	"9-out1914"	.28621	162	404	566
9	"9-out1915"	.41573	74	104	178
9	"9-out1916"	.23166	139	461	600
9	"9-out1917"	.99356	309	2	311
9	"9-out1918"	.53333	144	126	270
9	"9-out1919"	.41463	102	144	246
9	"9-out1920"	.32437	169	352	521
9	"9-out1921"	.26058	283	803	1086
9	"9-out1922"	.32522	254	527	781
9	"9-out1923"	.35632	372	672	1044
9	"9-out1924"	.24524	245	754	999
9	"9-out1925"	.40782	73	106	179
9	"9-out1926"	.43800	431	553	984
9	"9-out1927"	.56321	245	190	435
9	"9-out1928"	.28419	160	403	563
9	"9-out1929"	.38297	72	116	188
9	"9-out1930"	.80000	112	28	140
9	"9-out1931"	.33913	39	76	115
9	"9-out1932"	.23583	129	418	547
9	"9-out1933"	.22150	103	362	465
9	"9-out1934"	.34163	398	767	1165
9	"9-out1935"	.32051	25	53	78
9	"9-out1936"	.29357	160	385	545
9	"9-out1937"	.35042	205	380	585
9	"9-out1938"	.39327	374	577	951
9	"9-out1939"	.34840	316	591	907
9	"9-out1940"	.99558	451	2	453
9	"9-out1941"	.31682	275	593	868
9	"9-out1942"	.44213	447	564	1011
9	"9-out1943"	.98544	474	7	481
9	"9-out1944"	.31697	155	334	489
9	"9-out1945"	.55342	808	652	1460
9	"9-out1946"	.99858	706	1	707
9	"9-out1947"	.99224	128	1	129
9	"9-out1948"	.46642	785	898	1683
9	"9-out1949"	.33214	186	374	560
9	"9-out1950"	.99921	1274	1	1275
9	"9-out1951"	.45644	262	312	574
9	"9-out1952"	.15300	28	155	183
9	"9-out1953"	.29687	266	630	896
9	"9-out1954"	.15686	96	516	612
9	"9-out1955"	.39321	197	304	501
9	"9-out1956"	.99500	398	2	400
9	"9-out1957"	.33211	182	366	548
9	"9-out1958"	.61081	226	144	370
9	"9-out1959"	.37651	93	154	247
9	"9-out1960"	.35000	70	130	200
9	"9-out1961"	.41881	227	315	542
9	"9-out1962"	.32078	213	451	664
9	"9-out1963"	.32949	229	466	695
9	"9-out1964"	.49532	212	216	428
9	"9-out1965"	.34079	137	265	402
9	"9-out1966"	.22758	33	112	145
9	"9-out1967"	.36928	202	345	547
9	"9-out1968"	.55188	1069	868	1937
9	"9-out1969"	.36040	71	126	197
9	"9-out1970"	.43855	339	434	773
9	"9-out1971"	.25469	217	635	852
9	"9-out1972"	.20674	184	706	890
9	"9-out1973"	.21386	182	669	851
9	"9-out1974"	.20942	120	453	573
9	"9-out1975"	.16913	114	560	674
9	"9-out1976"	.24750	149	453	602
9	"9-out1977"	.99577	943	4	947
9	"9-out1978"	.50894	256	247	503
9	"9-out1979"	.26875	215	585	800
9	"9-out1980"	.37658	119	197	316
9	"9-out1981"	.50840	121	117	238
9	"9-out1982"	.92622	339	27	366
9	"9-out1983"	.29622	165	392	557
9	"9-out1984"	.19834	72	291	363
9	"9-out1985"	.23152	94	312	406
9	"9-out1986"	.40350	161	238	399
9	"9-out1987"	.28019	58	149	207
9	"9-out1988"	.27958	189	487	676
9	"9-out1989"	.29100	220	536	756
9	"9-out1990"	.24175	88	276	364
9	"9-out1991"	.30565	589	1338	1927
9	"9-out1992"	.11680	41	310	351
9	"9-out1993"	.41715	214	299	513
9	"9-out1994"	.45569	144	172	316
9	"9-out1995"	.28955	194	476	670
9	"9-out1996"	.21212	42	156	198
9	"9-out1997"	.17187	110	530	640
9	"9-out1998"	.99839	1245	2	1247
9	"9-out1999"	.27733	794	2069	2863
9	"9-out2000"	.24801	187	567	754
9	"9-out2001"	.28400	71	179	250
9	"9-out2002"	.41194	393	561	954
9	"9-out2003"	.12067	122	889	1011
9	"9-out2004"	.30614	259	587	846
9	"9-out2005"	.99617	521	2	523
9	"9-out2006"	.34853	107	200	307
9	"9-out2007"	.29309	437	1054	1491
9	"9-out2008"	.34861	403	753	1156
9	"9-out2009"	.28885	210	517	727
9	"9-out2010"	.65317	113	60	173
9	"9-out2011"	.30735	142	320	462
9	"9-out2012"	.35319	990	1813	2803
9	"9-out2013"	.33744	164	322	486
9	"9-out2014"	.21875	35	125	160
9	"9-out2015"	.52100	62	57	119
9	"9-out2016"	.99663	889	3	892
9	"9-out2017"	.65993	654	337	991
9	"9-out2018"	.22974	224	751	975
9	"9-out2019"	.17679	96	447	543
9	"9-out2020"	.20967	104	392	496
9	"9-out2021"	.17068	85	413	498
9	"9-out2022"	.25586	109	317	426
9	"9-out2023"	.28610	416	1038	1454
9	"9-out2024"	.39036	162	253	415
9	"9-out2025"	.43103	75	99	174
9	"9-out2026"	.52918	417	371	788
9	"9-out2027"	.39110	343	534	877
9	"9-out2028"	.16287	43	221	264
9	"9-out2029"	.18806	186	803	989
9	"9-out2030"	.34351	45	86	131
9	"9-out2031"	.70224	125	53	178
9	"9-out2032"	.37339	87	146	233
9	"9-out2033"	.28767	105	260	365
9	"9-out2034"	.29598	140	333	473
9	"9-out2035"	.19122	218	922	1140
9	"9-out2036"	.44186	266	336	602
9	"9-out2037"	.99644	561	2	563
9	"9-out2038"	.49370	196	201	397
9	"9-out2039"	.96119	322	13	335
9	"9-out2040"	.38132	196	318	514
9	"9-out2041"	.41698	108	151	259
9	"9-out2042"	.99234	389	3	392
9	"9-out2043"	.38095	112	182	294
9	"9-out2044"	.39299	101	156	257
9	"9-out2045"	.47761	160	175	335
9	"9-out2046"	.29802	211	497	708
9	"9-out2047"	.32432	240	500	740
9	"9-out2048"	.41666	150	210	360
9	"9-out2049"	.46022	162	190	352
9	"9-out2050"	.43958	171	218	389
9	"9-out2051"	.99259	134	1	135
9	"9-out2052"	.38938	44	69	113
9	"9-out2053"	.16089	265	1382	1647
9	"9-out2054"	.97169	309	9	318
9	"9-out2055"	.27035	83	224	307
9	"9-out2056"	.48991	170	177	347
9	"9-out2057"	.31897	274	585	859
9	"9-out2058"	.54810	188	155	343
9	"9-out2059"	.98407	309	5	314
9	"9-out2060"	.79495	252	65	317
9	"9-out2061"	.78225	97	27	124
9	"9-out2062"	.43537	192	249	441
9	"9-out2063"	.47005	157	177	334
9	"9-out2064"	.30065	46	107	153
9	"9-out2065"	.33235	113	227	340
9	"9-out2066"	.31993	191	406	597
9	"9-out2067"	.29720	458	1083	1541
9	"9-out2068"	.26216	334	940	1274
9	"9-out2069"	.44000	231	294	525
9	"9-out2070"	.48880	131	137	268
9	"9-out2071"	.97058	66	2	68
9	"9-out2072"	.25426	149	437	586
9	"9-out2073"	.21614	83	301	384
9	"9-out2074"	.37790	130	214	344
9	"9-out2075"	.98728	233	3	236
9	"9-out2076"	.93859	107	7	114
9	"9-out2077"	.81355	96	22	118
9	"9-out2078"	.22222	44	154	198
9	"9-out2079"	.47826	88	96	184
9	"9-out2080"	.99386	162	1	163
9	"9-out2081"	.39428	69	106	175
9	"9-out2082"	.99431	175	1	176
9	"9-out2083"	.30398	183	419	602
9	"9-out2084"	.31250	25	55	80
9	"9-out2085"	.19464	80	331	411
9	"9-out2086"	.12600	47	326	373
9	"9-out2087"	.55421	184	148	332
9	"9-out2088"	.75748	253	81	334
9	"9-out2089"	.82831	275	57	332
9	"9-out2090"	.96575	141	5	146
9	"9-out2091"	.42973	211	280	491
9	"9-out2092"	.19161	128	540	668
9	"9-out2093"	.54617	207	172	379
9	"9-out2094"	.14832	62	356	418
9	"9-out2095"	.90983	333	33	366
9	"9-out2096"	.40740	110	160	270
9	"9-out2097"	.36413	67	117	184
9	"9-out2098"	.40000	88	132	220
9	"9-out2099"	.40291	442	655	1097
9	"9-out2100"	.34261	406	779	1185
9	"9-out2101"	.74915	221	74	295
9	"9-out2102"	.35682	319	575	894
9	"9-out2103"	.45411	193	232	425
9	"9-out2104"	.31205	44	97	141
9	"9-out2105"	.28155	58	148	206
9	"9-out2106"	.41305	601	854	1455
9	"9-out2107"	.37362	68	114	182
9	"9-out2108"	.91503	140	13	153
9	"9-out2109"	.28199	119	303	422
9	"9-out2110"	.69863	102	44	146
9	"9-out2111"	.32965	239	486	725
9	"9-out2112"	.27181	190	509	699
9	"9-out2113"	.46710	213	243	456
9	"9-out2114"	.97297	396	11	407
9	"9-out2115"	.30604	172	390	562
9	"9-out2116"	.28289	129	327	456
9	"9-out2117"	.45657	205	244	449
9	"9-out2118"	.43822	227	291	518
9	"9-out2119"	.31681	243	524	767
9	"9-out2120"	.38349	158	254	412
9	"9-out2121"	.24888	112	338	450
9	"9-out2122"	.94638	406	23	429
9	"9-out2123"	.84652	2129	386	2515
9	"9-out2124"	.98681	524	7	531
9	"9-out2125"	.29253	98	237	335
9	"9-out2126"	.30620	143	324	467
9	"9-out2127"	.30281	43	99	142
9	"9-out2128"	.81132	516	120	636
9	"9-out2129"	.44373	209	262	471
9	"9-out2130"	.99799	498	1	499
9	"9-out2131"	.22769	97	329	426
9	"9-out2132"	.94285	297	18	315
9	"9-out2133"	.34615	108	204	312
9	"9-out2134"	.94533	294	17	311
9	"9-out2135"	.28547	167	418	585
9	"9-out2136"	.26116	117	331	448
9	"9-out2137"	.41401	130	184	314
9	"9-out2138"	.28742	96	238	334
9	"9-out2139"	.29878	98	230	328
9	"9-out2140"	.86163	274	44	318
9	"9-out2141"	.86857	456	69	525
9	"9-out2142"	.25893	645	1846	2491
9	"9-out2143"	.44585	140	174	314
9	"9-out2144"	.28662	90	224	314
9	"9-out2145"	.92857	286	22	308
9	"9-out2146"	.92657	631	50	681
9	"9-out2147"	.98972	289	3	292
9	"9-out2148"	.99827	579	1	580
9	"9-out2149"	.27868	85	220	305
9	"9-out2150"	.98909	272	3	275
9	"9-out2151"	.18529	121	532	653
9	"9-out2152"	.32432	84	175	259
9	"9-out2153"	.35652	123	222	345
9	"9-out2154"	.18108	67	303	370
9	"9-out2155"	.78571	198	54	252
9	"9-out2156"	.98561	137	2	139
9	"9-out2157"	.37288	242	407	649
9	"9-out2158"	.31756	94	202	296
9	"9-out2159"	.27828	91	236	327
9	"9-out2160"	.98989	196	2	198
9	"9-out2161"	.24005	163	516	679
9	"9-out2162"	.23750	190	610	800
9	"9-out2163"	.75862	286	91	377
9	"9-out2164"	.23642	148	478	626
9	"9-out2165"	.30654	103	233	336
9	"9-out2166"	.56965	184	139	323
9	"9-out2167"	.30858	424	950	1374
9	"9-out2168"	.39933	242	364	606
9	"9-out2169"	.24752	150	456	606
9	"9-out2170"	.99002	397	4	401
9	"9-out2171"	.26567	89	246	335
9	"9-out2172"	.81097	133	31	164
9	"9-out2173"	.35977	381	678	1059
9	"9-out2174"	.12706	77	529	606
9	"9-out2175"	.37120	281	476	757
9	"9-out2176"	.33668	134	264	398
9	"9-out2177"	.31442	133	290	423
9	"9-out2178"	.41803	153	213	366
9	"9-out2179"	.27318	109	290	399
9	"9-out2180"	.27287	170	453	623
9	"9-out2181"	.46529	295	339	634
9	"9-out2182"	.43703	236	304	540
9	"9-out2183"	.24931	91	274	365
9	"9-out2184"	.25925	147	420	567
9	"9-out2185"	.25797	178	512	690
9	"9-out2186"	.54400	136	114	250
9	"9-out2187"	.32677	648	1335	1983
9	"9-out2188"	.48143	363	391	754
9	"9-out2189"	.78846	246	66	312
9	"9-out2190"	.25763	194	559	753
9	"9-out2191"	.98484	130	2	132
9	"9-out2192"	.39670	553	841	1394
9	"9-out2193"	.49279	171	176	347
9	"9-out2194"	.23369	43	141	184
9	"9-out2195"	.50144	174	173	347
9	"9-out2196"	.45644	131	156	287
9	"9-out2197"	.37900	260	426	686
9	"9-out2198"	.25490	78	228	306
9	"9-out2199"	.27435	307	812	1119
9	"9-out2200"	.47480	490	542	1032
9	"9-out2201"	.26072	79	224	303
9	"9-out2202"	.99319	146	1	147
9	"9-out2203"	.32432	72	150	222
9	"9-out2204"	.57990	127	92	219
9	"9-out2205"	.99264	135	1	136
9	"9-out2206"	.77118	182	54	236
9	"9-out2207"	.64225	456	254	710
9	"9-out2208"	.59323	684	469	1153
9	"9-out2209"	.41080	958	1374	2332
9	"9-out2210"	.30461	891	2034	2925
9	"9-out2211"	.40251	192	285	477
9	"9-out2212"	.27224	153	409	562
9	"9-out2213"	.18736	270	1171	1441
9	"9-out2214"	.30486	257	586	843
9	"9-out2215"	.37411	211	353	564
9	"9-out2216"	.73804	355	126	481
9	"9-out2217"	.35376	202	369	571
9	"9-out2218"	.20045	89	355	444
9	"9-out2219"	.99831	1183	2	1185
9	"9-out2220"	.22988	100	335	435
9	"9-out2221"	.14583	21	123	144
9	"9-out2222"	.57046	85	64	149
9	"9-out2223"	.40689	59	86	145
9	"9-out2224"	.31250	55	121	176
9	"9-out2225"	.79255	149	39	188
9	"9-out2226"	.27819	185	480	665
9	"9-out2227"	.37707	250	413	663
9	"9-out2228"	.18803	88	380	468
9	"9-out2229"	.29179	281	682	963
9	"9-out2230"	.20584	183	706	889
9	"9-out2231"	.32243	286	601	887
9	"9-out2232"	.24483	332	1024	1356
9	"9-out2233"	.26045	81	230	311
9	"9-out2234"	.36279	197	346	543
9	"9-out2235"	.84960	322	57	379
9	"9-out2236"	.27747	101	263	364
9	"9-out2237"	.22658	75	256	331
9	"9-out2238"	.28512	138	346	484
9	"9-out2239"	.99601	250	1	251
9	"9-out2240"	.67647	46	22	68
9	"9-out2241"	.47191	168	188	356
9	"9-out2242"	.97239	775	22	797
9	"9-out2243"	.96240	768	30	798
9	"9-out2244"	.86143	802	129	931
9	"9-out2245"	.94536	744	43	787
9	"9-out2246"	.13594	59	375	434
9	"9-out2247"	.29934	320	749	1069
9	"9-out2248"	.86590	833	129	962
9	"9-out2249"	.86512	821	128	949
9	"9-out2250"	.25183	206	612	818
9	"9-out2251"	.66165	528	270	798
9	"9-out2252"	.31640	81	175	256
9	"9-out2253"	.31714	111	239	350
9	"9-out2254"	.35372	133	243	376
9	"9-out2255"	.29342	174	419	593
9	"9-out2256"	.20000	69	276	345
9	"9-out2257"	.99728	367	1	368
9	"9-out2258"	.88380	464	61	525
9	"9-out2259"	.37209	240	405	645
9	"9-out2260"	.33333	173	346	519
9	"9-out2261"	.27250	112	299	411
9	"9-out2262"	.58863	787	550	1337
9	"9-out2263"	.34692	502	945	1447
9	"9-out2264"	.58139	275	198	473
9	"9-out2265"	.32307	126	264	390
9	"9-out2266"	.38766	88	139	227
9	"9-out2267"	.99253	399	3	402
9	"9-out2268"	.99864	737	1	738
9	"9-out2269"	.39184	317	492	809
9	"9-out2270"	.82939	491	101	592
9	"9-out2271"	.40845	261	378	639
9	"9-out2272"	.26415	154	429	583
9	"9-out2273"	.39476	422	647	1069
9	"9-out2274"	.42401	226	307	533
9	"9-out2275"	.26734	158	433	591
9	"9-out2276"	.24066	290	915	1205
9	"9-out2277"	.26463	226	628	854
9	"9-out2278"	.18768	64	277	341
9	"9-out2279"	.41156	833	1191	2024
9	"9-out2280"	.23906	153	487	640
9	"9-out2281"	.50140	179	178	357
9	"9-out2282"	.38039	1269	2067	3336
9	"9-out2283"	.25715	449	1297	1746
9	"9-out2284"	.38862	403	634	1037
9	"9-out2285"	.15550	65	353	418
9	"9-out2286"	.62570	443	265	708
9	"9-out2287"	.59890	109	73	182
9	"9-out2288"	.29372	89	214	303
9	"9-out2289"	.30000	39	91	130
9	"9-out2290"	.22337	86	299	385
9	"9-out2291"	.18055	78	354	432
9	"9-out2292"	.26979	201	544	745
9	"9-out2293"	.31307	376	825	1201
9	"9-out2294"	.32500	221	459	680
9	"9-out2295"	.28717	56	139	195
9	"9-out2296"	.99864	736	1	737
9	"9-out2297"	.35937	115	205	320
9	"9-out2298"	.76377	194	60	254
9	"9-out2299"	.45229	237	287	524
9	"9-out2300"	.56937	119	90	209
9	"9-out2301"	.92838	350	27	377
9	"9-out2302"	.26007	71	202	273
9	"9-out2303"	.17272	57	273	330
9	"9-out2304"	.22811	86	291	377
9	"9-out2305"	.67195	127	62	189
9	"9-out2306"	.83236	1435	289	1724
9	"9-out2307"	.10485	41	350	391
9	"9-out2308"	.22444	101	349	450
9	"9-out2309"	.57534	210	155	365
9	"9-out2310"	.96477	767	28	795
9	"9-out2311"	.95208	755	38	793
9	"9-out2312"	.29026	155	379	534
9	"9-out2313"	.97125	777	23	800
9	"9-out2314"	.96737	771	26	797
9	"9-out2315"	.40441	220	324	544
9	"9-out2316"	.86947	806	121	927
9	"9-out2317"	.96134	746	30	776
9	"9-out2318"	.86421	821	129	950
9	"9-out2319"	.85729	799	133	932
9	"9-out2320"	.86051	802	130	932
9	"9-out2321"	.55357	465	375	840
9	"9-out2322"	.86928	818	123	941
9	"9-out2323"	.31352	153	335	488
9	"9-out2324"	.63213	653	380	1033
9	"9-out2325"	.43335	556	727	1283
9	"9-out2326"	.37662	58	96	154
9	"9-out2327"	.99492	196	1	197
9	"9-out2328"	.37400	141	236	377
9	"9-out2329"	.25320	158	466	624
9	"9-out2330"	.33925	611	1190	1801
9	"9-out2331"	.34218	232	446	678
9	"9-out2332"	.17098	66	320	386
9	"9-out2333"	.41278	239	340	579
9	"9-out2334"	.22117	94	331	425
9	"9-out2335"	.27139	130	349	479
9	"9-out2336"	.57352	195	145	340
9	"9-out2337"	.32208	544	1145	1689
9	"9-out2338"	.32277	163	342	505
9	"9-out2339"	.96992	774	24	798
9	"9-out2340"	.57209	246	184	430
9	"9-out2341"	.86105	818	132	950
9	"9-out2342"	.19402	182	756	938
9	"9-out2343"	.83301	883	177	1060
9	"9-out2344"	.86587	807	125	932
9	"9-out2345"	.34085	136	263	399
9	"9-out2346"	.17045	120	584	704
9	"9-out2347"	.86497	820	128	948
9	"9-out2348"	.94974	756	40	796
9	"9-out2349"	.37190	225	380	605
9	"9-out2350"	.98258	395	7	402
9	"9-out2351"	.18156	65	293	358
9	"9-out2352"	.96256	180	7	187
9	"9-out2353"	.74647	212	72	284
9	"9-out2354"	.35344	246	450	696
9	"9-out2355"	.21621	56	203	259
9	"9-out2356"	.30191	189	437	626
9	"9-out2357"	.62337	96	58	154
9	"9-out2358"	.35612	349	631	980
9	"9-out2359"	.36532	118	205	323
9	"9-out2360"	.97761	131	3	134
9	"9-out2361"	.16794	131	649	780
9	"9-out2362"	.97883	185	4	189
9	"9-out2363"	.71650	2310	914	3224
9	"9-out2364"	.41757	385	537	922
9	"9-out2365"	.30256	59	136	195
9	"9-out2366"	.20055	72	287	359
9	"9-out2367"	.26020	51	145	196
9	"9-out2368"	.41167	261	373	634
9	"9-out2369"	.65000	260	140	400
9	"9-out2370"	.57881	224	163	387
9	"9-out2371"	.70377	746	314	1060
9	"9-out2372"	.26422	65	181	246
9	"9-out2373"	.36284	623	1094	1717
9	"9-out2374"	.99337	1200	8	1208
9	"9-out2375"	.33804	335	656	991
9	"9-out2376"	.99236	130	1	131
9	"9-out2377"	.21725	68	245	313
9	"9-out2378"	.25723	80	231	311
9	"9-out2379"	.84049	274	52	326
9	"9-out2380"	.95000	95	5	100
9	"9-out2381"	.25837	108	310	418
9	"9-out2382"	.33333	89	178	267
9	"9-out2383"	.96134	373	15	388
9	"9-out2384"	.33837	179	350	529
9	"9-out2385"	.26794	392	1071	1463
9	"9-out2386"	.27915	146	377	523
9	"9-out2387"	.27619	485	1271	1756
9	"9-out2388"	.25585	142	413	555
9	"9-out2389"	.81112	481	112	593
9	"9-out2390"	.79616	332	85	417
9	"9-out2391"	.15189	168	938	1106
9	"9-out2392"	.11961	25	184	209
9	"9-out2393"	.22569	130	446	576
9	"9-out2394"	.34525	193	366	559
9	"9-out2395"	.32905	231	471	702
9	"9-out2396"	.21428	84	308	392
9	"9-out2397"	.26329	99	277	376
9	"9-out2398"	.34038	193	374	567
9	"9-out2399"	.27773	348	905	1253
9	"9-out2400"	.96391	374	14	388
9	"9-out2401"	.53787	142	122	264
9	"9-out2402"	.90983	111	11	122
9	"9-out2403"	.35081	107	198	305
9	"9-out2404"	.34316	128	245	373
9	"9-out2405"	.25737	96	277	373
9	"9-out2406"	.37274	331	557	888
9	"9-out2407"	.26034	151	429	580
9	"9-out2408"	.97211	976	28	1004
9	"9-out2409"	.21837	221	791	1012
9	"9-out2410"	.85140	424	74	498
9	"9-out2411"	.23645	96	310	406
9	"9-out2412"	.23955	86	273	359
9	"9-out2413"	.20512	160	620	780
9	"9-out2414"	.39020	231	361	592
9	"9-out2415"	.18762	97	420	517
9	"9-out2416"	.52567	174	157	331
9	"9-out2417"	.44137	256	324	580
9	"9-out2418"	.42704	240	322	562
9	"9-out2419"	.96323	262	10	272
9	"9-out2420"	.33222	100	201	301
9	"9-out2421"	.60948	668	428	1096
9	"9-out2422"	.36047	735	1304	2039
9	"9-out2423"	.32768	329	675	1004
9	"9-out2424"	.24671	94	287	381
9	"9-out2425"	.33484	443	880	1323
9	"9-out2426"	.99773	441	1	442
9	"9-out2427"	.53416	172	150	322
9	"9-out2428"	.31365	372	814	1186
9	"9-out2429"	.29338	71	171	242
9	"9-out2430"	.25567	248	722	970
9	"9-out2431"	.29255	110	266	376
9	"9-out2432"	.22447	255	881	1136
9	"9-out2433"	.36345	181	317	498
9	"9-out2434"	.99367	157	1	158
9	"9-out2435"	.57142	336	252	588
9	"9-out2436"	.33905	237	462	699
9	"9-out2437"	.99145	348	3	351
9	"9-out2438"	.99417	853	5	858
9	"9-out2439"	.99947	3841	2	3843
9	"9-out2440"	.19707	202	823	1025
9	"9-out2441"	.24219	349	1092	1441
9	"9-out2442"	.34579	222	420	642
9	"9-out2443"	.30989	141	314	455
9	"9-out2444"	.29336	115	277	392
9	"9-out2445"	.48611	210	222	432
9	"9-out2446"	.35029	117	217	334
9	"9-out2447"	.92727	102	8	110
9	"9-out2448"	.82022	73	16	89
9	"9-out2449"	.95652	88	4	92
9	"9-out2450"	.35076	114	211	325
9	"9-out2451"	.34387	250	477	727
9	"9-out2452"	.39759	132	200	332
9	"9-out2453"	.31558	160	347	507
9	"9-out2454"	.22099	40	141	181
9	"9-out2455"	.73207	541	198	739
9	"9-out2456"	.58064	36	26	62
9	"9-out2457"	.99730	370	1	371
9	"9-out2458"	.20699	148	567	715
9	"9-out2459"	.34636	186	351	537
9	"9-out2460"	.30099	121	281	402
9	"9-out2461"	.33004	134	272	406
9	"9-out2462"	.34645	44	83	127
9	"9-out2463"	.26422	65	181	246
9	"9-out2464"	.31620	240	519	759
9	"9-out2465"	.38442	459	735	1194
9	"9-out2466"	.52272	138	126	264
9	"9-out2467"	.22754	38	129	167
9	"9-out2468"	.19137	111	469	580
9	"9-out2469"	.37721	192	317	509
9	"9-out2470"	.52511	115	104	219
9	"9-out2471"	.42495	252	341	593
9	"9-out2472"	.61538	200	125	325
9	"9-out2473"	.19941	68	273	341
9	"9-out2474"	.30861	154	345	499
9	"9-out2475"	.94274	461	28	489
9	"9-out2476"	.89648	433	50	483
9	"9-out2477"	.98996	592	6	598
9	"9-out2478"	.19789	94	381	475
9	"9-out2479"	.75491	653	212	865
9	"9-out2480"	.39325	70	108	178
9	"9-out2481"	.75598	158	51	209
9	"9-out2482"	.31043	226	502	728
9	"9-out2483"	.43393	289	377	666
9	"9-out2484"	.91168	320	31	351
9	"9-out2485"	.17692	69	321	390
9	"9-out2486"	.26196	104	293	397
9	"9-out2487"	.49370	196	201	397
9	"9-out2488"	.24137	28	88	116
9	"9-out2489"	.53260	245	215	460
9	"9-out2490"	.46907	182	206	388
9	"9-out2491"	.34198	224	431	655
9	"9-out2492"	.17730	125	580	705
9	"9-out2493"	.44247	100	126	226
9	"9-out2494"	.44329	86	108	194
9	"9-out2495"	.33427	118	235	353
9	"9-out2496"	.39215	260	403	663
9	"9-out2497"	.50290	173	171	344
9	"9-out2498"	.65861	436	226	662
9	"9-out2499"	.49618	65	66	131
9	"9-out2500"	.65610	145	76	221
9	"9-out2501"	.99404	167	1	168
9	"9-out2502"	.18006	56	255	311
9	"9-out2503"	.19101	68	288	356
9	"9-out2504"	.30263	69	159	228
9	"9-out2505"	.72951	917	340	1257
9	"9-out2506"	.29832	321	755	1076
9	"9-out2507"	.25277	114	337	451
9	"9-out2508"	.36559	170	295	465
9	"9-out2509"	.44539	208	259	467
9	"9-out2510"	.73658	302	108	410
9	"9-out2511"	.99553	446	2	448
9	"9-out2512"	.21118	34	127	161
9	"9-out2513"	.47774	161	176	337
9	"9-out2514"	.16666	47	235	282
9	"9-out2515"	.57142	24	18	42
9	"9-out2516"	.41224	202	288	490
9	"9-out2517"	.24550	369	1134	1503
9	"9-out2518"	.29319	112	270	382
9	"9-out2519"	.30375	178	408	586
9	"9-out2520"	.17976	151	689	840
9	"9-out2521"	.21014	87	327	414
9	"9-out2522"	.43536	229	297	526
9	"9-out2523"	.24242	40	125	165
9	"9-out2524"	.99180	121	1	122
9	"9-out2525"	.34482	120	228	348
9	"9-out2526"	.32156	164	346	510
9	"9-out2527"	.11881	24	178	202
9	"9-out2528"	.16774	104	516	620
9	"9-out2529"	.45608	270	322	592
9	"9-out2530"	.38709	144	228	372
9	"9-out2531"	.50626	323	315	638
9	"9-out2532"	.26622	320	882	1202
9	"9-out2533"	.24873	49	148	197
9	"9-out2534"	.49253	231	238	469
9	"9-out2535"	.99152	585	5	590
9	"9-out2536"	.42867	589	785	1374
9	"9-out2537"	.17415	62	294	356
9	"9-out2538"	.59793	1157	778	1935
9	"9-out2539"	.41621	154	216	370
9	"9-out2540"	.24547	190	584	774
9	"9-out2541"	.26717	140	384	524
9	"9-out2542"	.52442	161	146	307
9	"9-out2543"	.44186	152	192	344
9	"9-out2544"	.38235	104	168	272
9	"9-out2545"	.23618	188	608	796
9	"9-out2546"	.21304	49	181	230
9	"9-out2547"	.19127	57	241	298
9	"9-out2548"	.28435	149	375	524
9	"9-out2549"	.23235	135	446	581
9	"9-out2550"	.15427	110	603	713
9	"9-out2551"	.39128	1778	2766	4544
9	"9-out2552"	.26101	154	436	590
9	"9-out2553"	.98039	100	2	102
9	"9-out2554"	.33513	124	246	370
9	"9-out2555"	.27134	178	478	656
9	"9-out2556"	.42881	250	333	583
9	"9-out2557"	.33461	436	867	1303
9	"9-out2558"	.44193	392	495	887
9	"9-out2559"	.99333	149	1	150
9	"9-out2560"	.39694	701	1065	1766
9	"9-out2561"	.13034	64	427	491
9	"9-out2562"	.99371	158	1	159
9	"9-out2563"	.30891	97	217	314
9	"9-out2564"	.99581	238	1	239
9	"9-out2565"	.22031	154	545	699
9	"9-out2566"	.17908	173	793	966
9	"9-out2567"	.31050	195	433	628
9	"9-out2568"	.24932	93	280	373
9	"9-out2569"	.44537	212	264	476
9	"9-out2570"	.43750	77	99	176
9	"9-out2571"	.58471	176	125	301
9	"9-out2572"	.23019	186	622	808
9	"9-out2573"	.30198	167	386	553
9	"9-out2574"	.27114	234	629	863
9	"9-out2575"	.17438	128	606	734
9	"9-out2576"	.24852	84	254	338
9	"9-out2577"	.52582	560	505	1065
9	"9-out2578"	.57556	1074	792	1866
9	"9-out2579"	.41502	232	327	559
9	"9-out2580"	.28471	203	510	713
9	"9-out2581"	.31701	272	586	858
9	"9-out2582"	.99479	191	1	192
9	"9-out2583"	.28392	159	401	560
9	"9-out2584"	.30906	225	503	728
9	"9-out2585"	.72340	102	39	141
9	"9-out2586"	.57681	214	157	371
9	"9-out2587"	.99145	116	1	117
9	"9-out2588"	.99186	122	1	123
9	"9-out2589"	.99193	123	1	124
9	"9-out2590"	.98360	120	2	122
9	"9-out2591"	.99186	122	1	123
9	"9-out2592"	.34684	77	145	222
9	"9-out2593"	.34825	70	131	201
9	"9-out2594"	.41221	162	231	393
9	"9-out2595"	.60000	129	86	215
9	"9-out2596"	.28060	243	623	866
9	"9-out2597"	.42631	81	109	190
9	"9-out2598"	.30254	95	219	314
9	"9-out2599"	.98484	130	2	132
9	"9-out2600"	.54487	85	71	156
9	"9-out2601"	.24969	208	625	833
9	"9-out2602"	.33048	271	549	820
9	"9-out2603"	.50247	507	502	1009
9	"9-out2604"	.43641	151	195	346
9	"9-out2605"	.56647	196	150	346
9	"9-out2606"	.97406	338	9	347
9	"9-out2607"	.53703	174	150	324
9	"9-out2608"	.27985	450	1158	1608
9	"9-out2609"	.98407	309	5	314
9	"9-out2610"	.38287	322	519	841
9	"9-out2611"	.49771	436	440	876
9	"9-out2612"	.62762	209	124	333
9	"9-out2613"	.27795	358	930	1288
9	"9-out2614"	.25361	158	465	623
9	"9-out2615"	.99953	2155	1	2156
9	"9-out2616"	.31019	353	785	1138
9	"9-out2617"	.45454	110	132	242
9	"9-out2618"	.25268	141	417	558
9	"9-out2619"	.51859	237	220	457
9	"9-out2620"	.21212	56	208	264
9	"9-out2621"	.23076	123	410	533
9	"9-out2622"	.39779	360	545	905
9	"9-out2623"	.31606	122	264	386
9	"9-out2624"	.46846	260	295	555
9	"9-out2625"	.72000	90	35	125
9	"9-out2626"	.15434	96	526	622
9	"9-out2627"	.79338	672	175	847
9	"9-out2628"	.22600	73	250	323
9	"9-out2629"	.24226	94	294	388
9	"9-out2630"	.86206	150	24	174
9	"9-out2631"	.11475	7	54	61
9	"9-out2632"	.41200	103	147	250
9	"9-out2633"	.35521	211	383	594
9	"9-out2634"	.68591	297	136	433
9	"9-out2635"	.30713	297	670	967
9	"9-out2636"	.59322	140	96	236
9	"9-out2637"	.38317	287	462	749
9	"9-out2638"	.41201	96	137	233
9	"9-out2639"	.21689	190	686	876
9	"9-out2640"	.32900	76	155	231
9	"9-out2641"	.24371	97	301	398
9	"9-out2642"	.98405	432	7	439
9	"9-out2643"	.54639	106	88	194
9	"9-out2644"	.94770	598	33	631
9	"9-out2645"	.30192	141	326	467
9	"9-out2646"	.46785	917	1043	1960
9	"9-out2647"	.30656	294	665	959
9	"9-out2648"	.38974	76	119	195
9	"9-out2649"	.95953	166	7	173
9	"9-out2650"	.64903	135	73	208
9	"9-out2651"	.81456	123	28	151
9	"9-out2652"	.63372	109	63	172
9	"9-out2653"	.35441	269	490	759
9	"9-out2654"	.20367	421	1646	2067
9	"9-out2655"	.34677	129	243	372
9	"9-out2656"	.28344	125	316	441
9	"9-out2657"	.66871	543	269	812
9	"9-out2658"	.21926	107	381	488
9	"9-out2659"	.32398	104	217	321
9	"9-out2660"	.36981	196	334	530
9	"9-out2661"	.35760	275	494	769
9	"9-out2662"	.41401	260	368	628
9	"9-out2663"	.33070	210	425	635
9	"9-out2664"	.23316	90	296	386
9	"9-out2665"	.15335	48	265	313
9	"9-out2666"	.70905	329	135	464
9	"9-out2667"	.38906	242	380	622
9	"9-out2668"	.28745	1322	3277	4599
9	"9-out2669"	.23590	406	1315	1721
9	"9-out2670"	.99193	123	1	124
9	"9-out2671"	.99130	114	1	115
9	"9-out2672"	.99107	111	1	112
9	"9-out2673"	.30543	73	166	239
9	"9-out2674"	.99186	122	1	123
9	"9-out2675"	.28838	77	190	267
9	"9-out2676"	.29032	126	308	434
9	"9-out2677"	.15600	78	422	500
9	"9-out2678"	.44504	166	207	373
9	"9-out2679"	.78957	394	105	499
9	"9-out2680"	.96655	289	10	299
9	"9-out2681"	.90923	591	59	650
9	"9-out2682"	.38134	233	378	611
9	"9-out2683"	.39102	305	475	780
9	"9-out2684"	.17919	31	142	173
9	"9-out2685"	.99619	785	3	788
9	"9-out2686"	.31774	197	423	620
9	"9-out2687"	.29500	177	423	600
9	"9-out2688"	.39238	268	415	683
9	"9-out2689"	.98742	157	2	159
9	"9-out2690"	.30038	237	552	789
9	"9-out2691"	.15362	53	292	345
9	"9-out2692"	.40392	309	456	765
9	"9-out2693"	.42988	233	309	542
9	"9-out2694"	.17073	21	102	123
9	"9-out2695"	.25227	166	492	658
9	"9-out2696"	.99130	114	1	115
9	"9-out2697"	.99130	114	1	115
9	"9-out2698"	.19464	80	331	411
9	"9-out2699"	.31192	102	225	327
9	"9-out2700"	.30680	320	723	1043
9	"9-out2701"	.30192	330	763	1093
9	"9-out2702"	.25949	451	1287	1738
9	"9-out2703"	.99717	1059	3	1062
9	"9-out2704"	.99670	1210	4	1214
9	"9-out2705"	.21587	68	247	315
9	"9-out2706"	.24335	577	1794	2371
9	"9-out2707"	.92233	190	16	206
9	"9-out2708"	.41246	311	443	754
9	"9-out2709"	.23136	149	495	644
9	"9-out2710"	.33246	127	255	382
9	"9-out2711"	.26847	109	297	406
9	"9-out2712"	.15439	65	356	421
9	"9-out2713"	.98986	586	6	592
9	"9-out2714"	.40070	113	169	282
9	"9-out2715"	.25159	158	470	628
9	"9-out2716"	.95981	406	17	423
9	"9-out2717"	.63924	101	57	158
9	"9-out2718"	.16262	94	484	578
9	"9-out2719"	.47311	88	98	186
9	"9-out2720"	.90697	117	12	129
9	"9-out2721"	.94366	67	4	71
9	"9-out2722"	.21630	191	692	883
9	"9-out2723"	.28906	37	91	128
9	"9-out2724"	.43292	142	186	328
9	"9-out2725"	.39473	30	46	76
9	"9-out2726"	.42016	50	69	119
9	"9-out2727"	.35936	474	845	1319
9	"9-out2728"	.37573	381	633	1014
9	"9-out2729"	.82400	103	22	125
9	"9-out2730"	.22960	76	255	331
9	"9-out2731"	.21698	46	166	212
9	"9-out2732"	.22580	42	144	186
9	"9-out2733"	.26973	41	111	152
9	"9-out2734"	.61842	94	58	152
9	"9-out2735"	.28268	413	1048	1461
9	"9-out2736"	.27091	204	549	753
9	"9-out2737"	.48742	252	265	517
9	"9-out2738"	.32549	166	344	510
9	"9-out2739"	.22198	103	361	464
9	"9-out2740"	.16225	49	253	302
9	"9-out2741"	.27288	161	429	590
9	"9-out2742"	.29921	266	623	889
9	"9-out2743"	.48148	130	140	270
9	"9-out2744"	.37282	214	360	574
9	"9-out2745"	.22767	255	865	1120
9	"9-out2746"	.15796	118	629	747
9	"9-out2747"	.82746	729	152	881
9	"9-out2748"	.99441	178	1	179
9	"9-out2749"	.17842	43	198	241
9	"9-out2750"	.25418	76	223	299
9	"9-out2751"	.36295	531	932	1463
9	"9-out2752"	.24800	124	376	500
9	"9-out2753"	.29381	404	971	1375
9	"9-out2754"	.28930	230	565	795
9	"9-out2755"	.32974	306	622	928
9	"9-out2756"	.34048	254	492	746
9	"9-out2757"	.87475	454	65	519
9	"9-out2758"	.29835	435	1023	1458
9	"9-out2759"	.30183	214	495	709
9	"9-out2760"	.30921	47	105	152
9	"9-out2761"	.20638	84	323	407
9	"9-out2762"	.98230	111	2	113
9	"9-out2763"	.37428	195	326	521
9	"9-out2764"	.27804	57	148	205
9	"9-out2765"	.23606	72	233	305
9	"9-out2766"	.29431	259	621	880
9	"9-out2767"	.32640	110	227	337
9	"9-out2768"	.15808	89	474	563
9	"9-out2769"	.37373	407	682	1089
9	"9-out2770"	.41414	41	58	99
9	"9-out2771"	.54761	46	38	84
9	"9-out2772"	.84381	416	77	493
9	"9-out2773"	.99654	577	2	579
9	"9-out2774"	.30848	269	603	872
9	"9-out2775"	.49418	85	87	172
9	"9-out2776"	.66666	102	51	153
9	"9-out2777"	.95266	161	8	169
9	"9-out2778"	.90566	96	10	106
9	"9-out2779"	.39507	497	761	1258
9	"9-out2780"	.68075	145	68	213
9	"9-out2781"	.32352	77	161	238
9	"9-out2782"	.23479	305	994	1299
9	"9-out2783"	.47852	234	255	489
9	"9-out2784"	.31942	291	620	911
9	"9-out2785"	.24126	76	239	315
9	"9-out2786"	.19154	136	574	710
9	"9-out2787"	.21447	80	293	373
9	"9-out2788"	.38422	151	242	393
9	"9-out2789"	.99658	292	1	293
9	"9-out2790"	.16228	74	382	456
9	"9-out2791"	.26512	92	255	347
9	"9-out2792"	.37398	46	77	123
9	"9-out2793"	.61739	71	44	115
9	"9-out2794"	.41200	206	294	500
9	"9-out2795"	.76834	1937	584	2521
9	"9-out2796"	.64646	192	105	297
9	"9-out2797"	.25432	250	733	983
9	"9-out2798"	.40601	378	553	931
9	"9-out2799"	.31578	42	91	133
9	"9-out2800"	.39583	57	87	144
9	"9-out2801"	.20360	113	442	555
9	"9-out2802"	.17142	18	87	105
9	"9-out2803"	.36434	94	164	258
9	"9-out2804"	.23809	45	144	189
9	"9-out2805"	.30000	87	203	290
9	"9-out2806"	.51746	163	152	315
9	"9-out2807"	.36915	79	135	214
9	"9-out2808"	.98148	53	1	54
9	"9-out2809"	.31818	126	270	396
9	"9-out2810"	.33003	167	339	506
9	"9-out2811"	.36065	198	351	549
9	"9-out2812"	.24657	36	110	146
9	"9-out2813"	.35303	233	427	660
9	"9-out2814"	.38747	365	577	942
9	"9-out2815"	.29200	219	531	750
9	"9-out2816"	.24212	123	385	508
9	"9-out2817"	.49629	335	340	675
9	"9-out2818"	.42045	111	153	264
9	"9-out2819"	.41025	32	46	78
9	"9-out2820"	.24495	85	262	347
9	"9-out2821"	.50612	289	282	571
9	"9-out2822"	.27018	435	1175	1610
9	"9-out2823"	.61373	143	90	233
9	"9-out2824"	.48348	161	172	333
9	"9-out2825"	.97916	235	5	240
9	"9-out2826"	.91772	145	13	158
9	"9-out2827"	.46232	135	157	292
9	"9-out2828"	.37810	152	250	402
9	"9-out2829"	.33191	156	314	470
9	"9-out2830"	.30027	439	1023	1462
9	"9-out2831"	.97810	402	9	411
9	"9-out2832"	.24120	233	733	966
9	"9-out2833"	.36464	66	115	181
9	"9-out2834"	.30824	258	579	837
9	"9-out2835"	.32853	434	887	1321
9	"9-out2836"	.35362	122	223	345
9	"9-out2837"	.55131	231	188	419
9	"9-out2838"	.25160	393	1169	1562
9	"9-out2839"	.71875	92	36	128
9	"9-out2840"	.30581	200	454	654
9	"9-out2841"	.80311	824	202	1026
9	"9-out2842"	.17878	91	418	509
9	"9-out2843"	.24670	281	858	1139
9	"9-out2844"	.35761	54	97	151
9	"9-out2845"	.38785	83	131	214
9	"9-out2846"	.74226	216	75	291
9	"9-out2847"	.41242	73	104	177
9	"9-out2848"	.29063	211	515	726
9	"9-out2849"	.98969	96	1	97
9	"9-out2850"	.42440	160	217	377
9	"9-out2851"	.38639	534	848	1382
9	"9-out2852"	.18654	61	266	327
9	"9-out2853"	.58483	162	115	277
9	"9-out2854"	.20673	43	165	208
9	"9-out2855"	.71807	298	117	415
9	"9-out2856"	.35177	178	328	506
9	"9-out2857"	.40838	341	494	835
9	"9-out2858"	.40659	148	216	364
9	"9-out2859"	.30257	141	325	466
9	"9-out2860"	.51495	155	146	301
9	"9-out2861"	.34985	981	1823	2804
9	"9-out2862"	.41011	73	105	178
9	"9-out2863"	.32460	372	774	1146
9	"9-out2864"	.15481	74	404	478
9	"9-out2865"	.21182	172	640	812
9	"9-out2866"	.95329	449	22	471
9	"9-out2867"	.41843	472	656	1128
9	"9-out2868"	.99559	226	1	227
9	"9-out2869"	.99744	390	1	391
9	"9-out2870"	.99726	365	1	366
9	"9-out2871"	.12359	44	312	356
9	"9-out2872"	.33357	453	905	1358
9	"9-out2873"	.21875	91	325	416
9	"9-out2874"	.21301	36	133	169
9	"9-out2875"	.23888	129	411	540
9	"9-out2876"	.25613	167	485	652
9	"9-out2877"	.21031	53	199	252
9	"9-out2878"	.27762	103	268	371
9	"9-out2879"	.99270	136	1	137
9	"9-out2880"	.15532	137	745	882
9	"9-out2881"	.30813	269	604	873
9	"9-out2882"	.22894	87	293	380
9	"9-out2883"	.67441	116	56	172
9	"9-out2884"	.69818	192	83	275
9	"9-out2885"	.42372	300	408	708
9	"9-out2886"	.65614	769	403	1172
9	"9-out2887"	.34038	193	374	567
9	"9-out2888"	.33965	197	383	580
9	"9-out2889"	.42011	681	940	1621
9	"9-out2890"	.27675	256	669	925
9	"9-out2891"	.19759	82	333	415
9	"9-out2892"	.27479	266	702	968
9	"9-out2893"	.98947	94	1	95
9	"9-out2894"	.26833	739	2015	2754
9	"9-out2895"	.17105	65	315	380
9	"9-out2896"	.99668	301	1	302
9	"9-out2897"	.30573	336	763	1099
9	"9-out2898"	.29157	135	328	463
9	"9-out2899"	.65434	407	215	622
9	"9-out2900"	.98473	258	4	262
9	"9-out2901"	.79359	446	116	562
9	"9-out2902"	.39340	155	239	394
9	"9-out2903"	.26892	167	454	621
9	"9-out2904"	.37912	287	470	757
9	"9-out2905"	.43681	280	361	641
9	"9-out2906"	.42057	233	321	554
9	"9-out2907"	.30653	183	414	597
9	"9-out2908"	.26102	213	603	816
9	"9-out2909"	.67601	217	104	321
9	"9-out2910"	.90944	231	23	254
9	"9-out2911"	.45353	488	588	1076
9	"9-out2912"	.20766	65	248	313
9	"9-out2913"	.35206	332	611	943
9	"9-out2914"	.36199	80	141	221
9	"9-out2915"	.45219	227	275	502
9	"9-out2916"	.22105	63	222	285
9	"9-out2917"	.99618	261	1	262
9	"9-out2918"	.53620	311	269	580
9	"9-out2919"	.27547	173	455	628
9	"9-out2920"	.37058	63	107	170
9	"9-out2921"	.31417	481	1050	1531
9	"9-out2922"	.60917	279	179	458
9	"9-out2923"	.47063	561	631	1192
9	"9-out2924"	.30158	152	352	504
9	"9-out2925"	.24092	73	230	303
9	"9-out2926"	.62304	1157	700	1857
9	"9-out2927"	.46341	38	44	82
9	"9-out2928"	.36814	356	611	967
9	"9-out2929"	.52380	132	120	252
9	"9-out2930"	.28898	139	342	481
9	"9-out2931"	.53543	68	59	127
9	"9-out2932"	.80126	254	63	317
9	"9-out2933"	.46964	147	166	313
9	"9-out2934"	.96784	301	10	311
9	"9-out2935"	.98192	326	6	332
9	"9-out2936"	.46865	157	178	335
9	"9-out2937"	.32380	102	213	315
9	"9-out2938"	.46180	266	310	576
9	"9-out2939"	.40372	130	192	322
9	"9-out2940"	.39498	126	193	319
9	"9-out2941"	.31410	98	214	312
9	"9-out2942"	.63599	311	178	489
9	"9-out2943"	.82899	223	46	269
9	"9-out2944"	.48064	149	161	310
9	"9-out2945"	.85161	264	46	310
9	"9-out2946"	.69936	221	95	316
9	"9-out2947"	.35975	118	210	328
9	"9-out2948"	.43283	145	190	335
9	"9-out2949"	.69687	223	97	320
9	"9-out2950"	.90705	283	29	312
9	"9-out2951"	.91250	292	28	320
9	"9-out2952"	.86119	273	44	317
9	"9-out2953"	.93437	299	21	320
9	"9-out2954"	.94339	300	18	318
9	"9-out2955"	.93808	303	20	323
9	"9-out2956"	.93203	288	21	309
9	"9-out2957"	.43870	136	174	310
9	"9-out2958"	.45454	145	174	319
9	"9-out2959"	.41228	141	201	342
9	"9-out2960"	.33757	106	208	314
9	"9-out2961"	.35603	115	208	323
9	"9-out2962"	.24464	80	247	327
9	"9-out2963"	.40251	128	190	318
9	"9-out2964"	.94155	290	18	308
9	"9-out2965"	.69538	226	99	325
9	"9-out2966"	.67912	218	103	321
9	"9-out2967"	.41391	113	160	273
9	"9-out2968"	.26842	193	526	719
9	"9-out2969"	.99587	1450	6	1456
9	"9-out2970"	.34877	271	506	777
9	"9-out2971"	.25331	172	507	679
9	"9-out2972"	.21400	165	606	771
9	"9-out2973"	.22222	180	630	810
9	"9-out2974"	.59788	113	76	189
9	"9-out2975"	.27792	102	265	367
9	"9-out2976"	.34757	179	336	515
9	"9-out2977"	.25161	507	1508	2015
9	"9-out2978"	.36842	931	1596	2527
9	"9-out2979"	.32129	89	188	277
9	"9-out2980"	.25862	135	387	522
9	"9-out2981"	.76361	617	191	808
9	"9-out2982"	.30665	498	1126	1624
9	"9-out2983"	.14792	50	288	338
9	"9-out2984"	.99115	112	1	113
9	"9-out2985"	.46526	221	254	475
9	"9-out2986"	.38266	256	413	669
9	"9-out2987"	.34060	515	997	1512
9	"9-out2988"	.99193	123	1	124
9	"9-out2989"	.42968	110	146	256
9	"9-out2990"	.52418	336	305	641
9	"9-out2991"	.29903	311	729	1040
9	"9-out2992"	.30990	194	432	626
9	"9-out2993"	.40498	2992	4396	7388
9	"9-out2994"	.17929	71	325	396
9	"9-out2995"	.64659	247	135	382
9	"9-out2996"	.36246	282	496	778
9	"9-out2997"	.46407	155	179	334
9	"9-out2998"	.30181	249	576	825
9	"9-out2999"	.31570	209	453	662
9	"9-out3000"	.90422	963	102	1065
9	"9-out3001"	.38918	216	339	555
9	"9-out3002"	.28757	199	493	692
9	"9-out3003"	.26086	186	527	713
9	"9-out3004"	.21187	182	677	859
9	"9-out3005"	.18047	61	277	338
9	"9-out3006"	.33468	165	328	493
9	"9-out3007"	.19413	139	577	716
9	"9-out3008"	.99931	1452	1	1453
9	"9-out3009"	.22406	1043	3612	4655
9	"9-out3010"	.21858	127	454	581
9	"9-out3011"	.99487	194	1	195
9	"9-out3012"	.34545	266	504	770
9	"9-out3013"	.30131	574	1331	1905
9	"9-out3014"	.19900	321	1292	1613
9	"9-out3015"	.39236	339	525	864
9	"9-out3016"	.20000	72	288	360
9	"9-out3017"	.18248	25	112	137
9	"9-out3018"	.32800	41	84	125
9	"9-out3019"	.98989	98	1	99
9	"9-out3020"	.99180	121	1	122
9	"9-out3021"	.99166	119	1	120
9	"9-out3022"	.29245	155	375	530
9	"9-out3023"	.33912	1289	2512	3801
9	"9-out3024"	.99690	322	1	323
9	"9-out3025"	.68145	169	79	248
9	"9-out3026"	.93593	1417	97	1514
9	"9-out3027"	.31924	272	580	852
9	"9-out3028"	.34181	94	181	275
9	"9-out3029"	.97159	171	5	176
9	"9-out3030"	.32379	215	449	664
9	"9-out3031"	.33562	341	675	1016
9	"9-out3032"	.47602	705	776	1481
9	"9-out3033"	.19025	82	349	431
9	"9-out3034"	.15174	161	900	1061
9	"9-out3035"	.99137	230	2	232
9	"9-out3036"	.93085	175	13	188
9	"9-out3037"	.99344	303	2	305
9	"9-out3038"	.99743	389	1	390
9	"9-out3039"	.67294	393	191	584
9	"9-out3040"	.29411	30	72	102
9	"9-out3041"	.45263	86	104	190
9	"9-out3042"	.96153	150	6	156
9	"9-out3043"	.32336	789	1651	2440
9	"9-out3044"	.99734	752	2	754
9	"9-out3045"	.38351	349	561	910
9	"9-out3046"	.70661	342	142	484
9	"9-out3047"	.36294	143	251	394
9	"9-out3048"	.27356	209	555	764
9	"9-out3049"	.72413	42	16	58
9	"9-out3050"	.67039	120	59	179
9	"9-out3051"	.34951	72	134	206
9	"9-out3052"	.88926	779	97	876
9	"9-out3053"	.99607	1524	6	1530
9	"9-out3054"	.22812	146	494	640
9	"9-out3055"	.27378	541	1435	1976
9	"9-out3056"	.36058	172	305	477
9	"9-out3057"	.30337	135	310	445
9	"9-out3058"	.29973	345	806	1151
9	"9-out3059"	.23751	271	870	1141
9	"9-out3060"	.47210	220	246	466
9	"9-out3061"	.44461	851	1063	1914
9	"9-out3062"	.22768	250	848	1098
9	"9-out3063"	.29482	74	177	251
9	"9-out3064"	.32190	169	356	525
9	"9-out3065"	.72569	627	237	864
9	"9-out3066"	.72402	425	162	587
9	"9-out3067"	.80222	288	71	359
9	"9-out3068"	.19387	19	79	98
9	"9-out3069"	.34748	892	1675	2567
9	"9-out3070"	.41833	251	349	600
9	"9-out3071"	.24756	534	1623	2157
9	"9-out3072"	.27160	264	708	972
9	"9-out3073"	.89767	193	22	215
9	"9-out3074"	.41206	328	468	796
9	"9-out3075"	.32490	90	187	277
9	"9-out3076"	.77354	345	101	446
9	"9-out3077"	.39772	70	106	176
9	"9-out3078"	.35000	217	403	620
9	"9-out3079"	.32469	188	391	579
9	"9-out3080"	.38241	174	281	455
9	"9-out3081"	.31274	162	356	518
9	"9-out3082"	.67123	98	48	146
9	"9-out3083"	.56559	263	202	465
9	"9-out3084"	.30006	908	2118	3026
9	"9-out3085"	.28502	59	148	207
9	"9-out3086"	.25161	117	348	465
9	"9-out3087"	.98979	97	1	98
9	"9-out3088"	.99782	458	1	459
9	"9-out3089"	.30769	48	108	156
9	"9-out3090"	.49733	466	471	937
9	"9-out3091"	.17803	47	217	264
9	"9-out3092"	.28153	250	638	888
9	"9-out3093"	.15040	37	209	246
9	"9-out3094"	.39102	122	190	312
9	"9-out3095"	.99649	284	1	285
9	"9-out3096"	.23229	82	271	353
9	"9-out3097"	.52270	875	799	1674
9	"9-out3098"	.31545	500	1085	1585
9	"9-out3099"	.71396	941	377	1318
9	"9-out3100"	.99860	718	1	719
9	"9-out3101"	.22894	329	1108	1437
9	"9-out3102"	.49966	751	752	1503
9	"9-out3103"	.83263	199	40	239
9	"9-out3104"	.40171	374	557	931
9	"9-out3105"	.33407	302	602	904
9	"9-out3106"	.95302	426	21	447
9	"9-out3107"	.33500	67	133	200
9	"9-out3108"	.20285	142	558	700
9	"9-out3109"	.33233	663	1332	1995
9	"9-out3110"	.40322	100	148	248
9	"9-out3111"	.40415	331	488	819
9	"9-out3112"	.25000	56	168	224
9	"9-out3113"	.25117	267	796	1063
9	"9-out3114"	.21348	38	140	178
9	"9-out3115"	.35471	282	513	795
9	"9-out3116"	.45141	223	271	494
9	"9-out3117"	.38378	284	456	740
9	"9-out3118"	.70161	174	74	248
9	"9-out3119"	.91629	208	19	227
9	"9-out3120"	.25120	52	155	207
9	"9-out3121"	.99549	1106	5	1111
9	"9-out3122"	.24870	144	435	579
9	"9-out3123"	.32165	303	639	942
9	"9-out3124"	.31991	596	1267	1863
9	"9-out3125"	.44907	291	357	648
9	"9-out3126"	.34175	257	495	752
9	"9-out3127"	.83495	86	17	103
9	"9-out3128"	.59453	261	178	439
9	"9-out3129"	.29479	51	122	173
9	"9-out3130"	.23020	218	729	947
9	"9-out3131"	.42172	132	181	313
9	"9-out3132"	.48865	948	992	1940
9	"9-out3133"	.32130	276	583	859
9	"9-out3134"	.32024	359	762	1121
9	"9-out3135"	.99367	157	1	158
9	"9-out3136"	.44475	161	201	362
9	"9-out3137"	.34295	297	569	866
9	"9-out3138"	.20493	108	419	527
9	"9-out3139"	.32360	122	255	377
9	"9-out3140"	.99424	864	5	869
9	"9-out3141"	.23417	185	605	790
9	"9-out3142"	.28370	404	1020	1424
9	"9-out3143"	.25288	285	842	1127
9	"9-out3144"	.29180	602	1461	2063
9	"9-out3145"	.30757	199	448	647
9	"9-out3146"	.97435	114	3	117
9	"9-out3147"	.97435	114	3	117
9	"9-out3148"	.42936	465	618	1083
9	"9-out3149"	.30149	161	373	534
9	"9-out3150"	.30329	212	487	699
9	"9-out3151"	.29680	214	507	721
9	"9-out3152"	.23236	168	555	723
9	"9-out3153"	.30010	289	674	963
9	"9-out3154"	.15527	25	136	161
9	"9-out3155"	.81318	74	17	91
9	"9-out3156"	.99159	118	1	119
9	"9-out3157"	.98290	115	2	117
9	"9-out3158"	.31506	46	100	146
9	"9-out3159"	.61263	223	141	364
9	"9-out3160"	.99045	2801	27	2828
9	"9-out3161"	.99019	202	2	204
9	"9-out3162"	.13135	137	906	1043
9	"9-out3163"	.38013	842	1373	2215
9	"9-out3164"	.30158	57	132	189
9	"9-out3165"	.89509	657	77	734
9	"9-out3166"	.37796	669	1101	1770
9	"9-out3167"	.19781	199	807	1006
9	"9-out3168"	.23575	240	778	1018
9	"9-out3169"	.17799	165	762	927
9	"9-out3170"	.80903	394	93	487
9	"9-out3171"	.98139	211	4	215
9	"9-out3172"	.63843	588	333	921
9	"9-out3173"	.43750	147	189	336
9	"9-out3174"	.42081	186	256	442
9	"9-out3175"	.33591	347	686	1033
9	"9-out3176"	.27432	203	537	740
9	"9-out3177"	.29376	292	702	994
9	"9-out3178"	.23416	281	919	1200
9	"9-out3179"	.32947	57	116	173
9	"9-out3180"	.99344	303	2	305
9	"9-out3181"	.99656	290	1	291
9	"9-out3182"	.85913	677	111	788
9	"9-out3183"	.99923	5203	4	5207
9	"9-out3184"	.42483	65	88	153
9	"9-out3185"	.32962	1542	3136	4678
9	"9-out3186"	.24733	232	706	938
9	"9-out3187"	.56105	1089	852	1941
9	"9-out3188"	.36012	466	828	1294
9	"9-out3189"	.40909	54	78	132
9	"9-out3190"	.69412	792	349	1141
9	"9-out3191"	.21271	271	1003	1274
9	"9-out3192"	.32093	414	876	1290
9	"9-out3193"	.45048	373	455	828
9	"9-out3194"	.98809	83	1	84
9	"9-out3195"	.36165	630	1112	1742
9	"9-out3196"	.15697	162	870	1032
9	"9-out3197"	.33755	80	157	237
9	"9-out3198"	.26200	60	169	229
9	"9-out3199"	.36941	331	565	896
9	"9-out3200"	.31551	307	666	973
9	"9-out3201"	.99755	408	1	409
9	"9-out3202"	.29941	103	241	344
9	"9-out3203"	.99795	978	2	980
9	"9-out3204"	.21183	222	826	1048
9	"9-out3205"	.78082	228	64	292
9	"9-out3206"	.18115	25	113	138
9	"9-out3207"	.35087	160	296	456
9	"9-out3208"	.99342	302	2	304
9	"9-out3209"	.32232	605	1272	1877
9	"9-out3210"	.34328	115	220	335
9	"9-out3211"	.41530	76	107	183
9	"9-out3212"	.29979	149	348	497
9	"9-out3213"	.51898	41	38	79
9	"9-out3214"	.99489	195	1	196
9	"9-out3215"	.70476	222	93	315
9	"9-out3216"	.33185	224	451	675
9	"9-out3217"	.57084	278	209	487
9	"9-out3218"	.37821	191	314	505
9	"9-out3219"	.71319	373	150	523
9	"9-out3220"	.61320	195	123	318
9	"9-out3221"	.84768	128	23	151
9	"9-out3222"	.78616	250	68	318
9	"9-out3223"	.30618	94	213	307
9	"9-out3224"	.35714	110	198	308
9	"9-out3225"	.40223	72	107	179
9	"9-out3226"	.94855	295	16	311
9	"9-out3227"	.29302	63	152	215
9	"9-out3228"	.80314	102	25	127
9	"9-out3229"	.99367	157	1	158
9	"9-out3230"	.68387	212	98	310
9	"9-out3231"	.31888	103	220	323
9	"9-out3232"	.66139	209	107	316
9	"9-out3233"	.69207	227	101	328
9	"9-out3234"	.94533	294	17	311
9	"9-out3235"	.92880	287	22	309
9	"9-out3236"	.41346	129	183	312
9	"9-out3237"	.88524	270	35	305
9	"9-out3238"	.92307	288	24	312
9	"9-out3239"	.93290	292	21	313
9	"9-out3240"	.91373	286	27	313
9	"9-out3241"	.49679	155	157	312
9	"9-out3242"	.86538	270	42	312
9	"9-out3243"	.28391	90	227	317
9	"9-out3244"	.41082	129	185	314
9	"9-out3245"	.37500	117	195	312
9	"9-out3246"	.38957	127	199	326
9	"9-out3247"	.41447	126	178	304
9	"9-out3248"	.41772	132	184	316
9	"9-out3249"	.48717	152	160	312
9	"9-out3250"	.87767	287	40	327
9	"9-out3251"	.69009	216	97	313
9	"9-out3252"	.58437	187	133	320
9	"9-out3253"	.93750	195	13	208
9	"9-out3254"	.21237	103	382	485
9	"9-out3255"	.30909	85	190	275
9	"9-out3256"	.23269	242	798	1040
9	"9-out3257"	.30594	756	1715	2471
9	"9-out3258"	.29766	676	1595	2271
9	"9-out3259"	.50000	184	184	368
9	"9-out3260"	.42466	606	821	1427
9	"9-out3261"	.29429	98	235	333
9	"9-out3262"	.33499	403	800	1203
9	"9-out3263"	.55932	165	130	295
9	"9-out3264"	.20945	195	736	931
9	"9-out3265"	.28887	457	1125	1582
9	"9-out3266"	.11392	9	70	79
9	"9-out3267"	.91218	509	49	558
9	"9-out3268"	.25054	342	1023	1365
9	"9-out3269"	.18678	65	283	348
9	"9-out3270"	.99386	162	1	163
9	"9-out3271"	.28735	25	62	87
9	"9-out3272"	.90853	149	15	164
9	"9-out3273"	.53462	193	168	361
9	"9-out3274"	.15116	26	146	172
9	"9-out3275"	.33522	118	234	352
9	"9-out3276"	.32517	226	469	695
9	"9-out3277"	.26898	85	231	316
9	"9-out3278"	.99009	200	2	202
9	"9-out3279"	.38216	180	291	471
9	"9-out3280"	.17783	69	319	388
9	"9-out3281"	.28877	108	266	374
9	"9-out3282"	.38596	132	210	342
9	"9-out3283"	.41807	148	206	354
9	"9-out3284"	.09115	34	339	373
9	"9-out3285"	.34186	494	951	1445
9	"9-out3286"	.36277	267	469	736
9	"9-out3287"	.38983	276	432	708
9	"9-out3288"	.39673	292	444	736
9	"9-out3289"	.28136	74	189	263
9	"9-out3290"	.99580	475	2	477
9	"9-out3291"	.42873	364	485	849
9	"9-out3292"	.99868	760	1	761
9	"9-out3293"	.43256	170	223	393
9	"9-out3294"	.24705	168	512	680
9	"9-out3295"	.20063	127	506	633
9	"9-out3296"	.24861	180	544	724
9	"9-out3297"	.30494	222	506	728
9	"9-out3298"	.24324	36	112	148
9	"9-out3299"	.99746	393	1	394
9	"9-out3300"	.18115	25	113	138
9	"9-out3301"	.42091	165	227	392
9	"9-out3302"	.82091	518	113	631
9	"9-out3303"	.47826	308	336	644
9	"9-out3304"	.42931	164	218	382
9	"9-out3305"	.38005	282	460	742
9	"9-out3306"	.35746	237	426	663
9	"9-out3307"	.22839	111	375	486
9	"9-out3308"	.28915	192	472	664
9	"9-out3309"	.33108	98	198	296
9	"9-out3310"	.37500	93	155	248
9	"9-out3311"	.97838	679	15	694
9	"9-out3312"	.99811	530	1	531
9	"9-out3313"	.50450	56	55	111
9	"9-out3314"	.19642	77	315	392
9	"9-out3315"	.29931	132	309	441
9	"9-out3316"	.60958	89	57	146
9	"9-out3317"	.99099	110	1	111
9	"9-out3318"	.31858	36	77	113
9	"9-out3319"	.70526	67	28	95
9	"9-out3320"	.92307	312	26	338
9	"9-out3321"	.23577	29	94	123
9	"9-out3322"	.98538	472	7	479
9	"9-out3323"	.25688	140	405	545
9	"9-out3324"	.53244	279	245	524
9	"9-out3325"	.70389	416	175	591
9	"9-out3326"	.95121	156	8	164
9	"9-out3327"	.95121	156	8	164
9	"9-out3328"	.96951	159	5	164
9	"9-out3329"	.32040	380	806	1186
9	"9-out3330"	.41431	573	810	1383
9	"9-out3331"	.33245	126	253	379
9	"9-out3332"	.29198	113	274	387
9	"9-out3333"	.38628	231	367	598
9	"9-out3334"	.24755	152	462	614
9	"9-out3335"	.81500	163	37	200
9	"9-out3336"	.33666	236	465	701
9	"9-out3337"	.29813	96	226	322
9	"9-out3338"	.53066	199	176	375
9	"9-out3339"	.69625	706	308	1014
9	"9-out3340"	.54069	186	158	344
9	"9-out3341"	.36020	143	254	397
9	"9-out3342"	.24745	170	517	687
9	"9-out3343"	.19086	71	301	372
9	"9-out3344"	.24731	92	280	372
9	"9-out3345"	.99570	232	1	233
9	"9-out3346"	.40130	368	549	917
9	"9-out3347"	.32025	400	849	1249
9	"9-out3348"	.18589	87	381	468
9	"9-out3349"	.50000	110	110	220
9	"9-out3350"	.96078	49	2	51
9	"9-out3351"	.27157	129	346	475
9	"9-out3352"	.85444	904	154	1058
9	"9-out3353"	.46029	313	367	680
9	"9-out3354"	.30662	88	199	287
9	"9-out3355"	.99687	319	1	320
9	"9-out3356"	.98360	60	1	61
9	"9-out3357"	.13492	17	109	126
9	"9-out3358"	.24810	327	991	1318
9	"9-out3359"	.54531	349	291	640
9	"9-out3360"	.40398	284	419	703
9	"9-out3361"	.96551	56	2	58
9	"9-out3362"	.35825	254	455	709
9	"9-out3363"	.99431	175	1	176
9	"9-out3364"	.29007	114	279	393
9	"9-out3365"	.25423	30	88	118
9	"9-out3366"	.48203	161	173	334
9	"9-out3367"	.99593	245	1	246
9	"9-out3368"	.68644	81	37	118
9	"9-out3369"	.24242	40	125	165
9	"9-out3370"	.51680	123	115	238
9	"9-out3371"	.18652	36	157	193
9	"9-out3372"	.43478	90	117	207
9	"9-out3373"	.26666	44	121	165
9	"9-out3374"	.26360	281	785	1066
9	"9-out3375"	.99619	262	1	263
9	"9-out3376"	.99065	106	1	107
9	"9-out3377"	.99408	168	1	169
9	"9-out3378"	.46236	43	50	93
9	"9-out3379"	.55445	56	45	101
9	"9-out3380"	.37637	411	681	1092
9	"9-out3381"	.75659	258	83	341
9	"9-out3382"	.30161	840	1945	2785
9	"9-out3383"	.44354	55	69	124
9	"9-out3384"	.99832	596	1	597
9	"9-out3385"	.42346	296	403	699
9	"9-out3386"	.26229	112	315	427
9	"9-out3387"	.99173	120	1	121
9	"9-out3388"	.99462	185	1	186
9	"9-out3389"	.49568	115	117	232
9	"9-out3390"	.27057	263	709	972
9	"9-out3391"	.16149	26	135	161
9	"9-out3392"	.76219	125	39	164
9	"9-out3393"	.38022	400	652	1052
9	"9-out3394"	.30612	45	102	147
9	"9-out3395"	.23174	165	547	712
9	"9-out3396"	.39091	439	684	1123
9	"9-out3397"	.30745	301	678	979
9	"9-out3398"	.99720	357	1	358
9	"9-out3399"	.28613	97	242	339
9	"9-out3400"	.48430	108	115	223
9	"9-out3401"	.31972	141	300	441
9	"9-out3402"	.22290	146	509	655
9	"9-out3403"	.99635	273	1	274
9	"9-out3404"	.98484	520	8	528
9	"9-out3405"	.24038	75	237	312
9	"9-out3406"	.98301	521	9	530
9	"9-out3407"	.66449	204	103	307
9	"9-out3408"	.52112	74	68	142
9	"9-out3409"	.25530	397	1158	1555
9	"9-out3410"	.35314	517	947	1464
9	"9-out3411"	.70074	562	240	802
9	"9-out3412"	.44654	142	176	318
9	"9-out3413"	.39082	281	438	719
9	"9-out3414"	.97924	519	11	530
9	"9-out3415"	.45692	244	290	534
9	"9-out3416"	.99590	243	1	244
9	"9-out3417"	.99186	244	2	246
9	"9-out3418"	.48360	118	126	244
9	"9-out3419"	.99700	333	1	334
9	"9-out3420"	.95121	234	12	246
9	"9-out3421"	.31467	326	710	1036
9	"9-out3422"	.30508	144	328	472
9	"9-out3423"	.22083	106	374	480
9	"9-out3424"	.32610	722	1492	2214
9	"9-out3425"	.36238	395	695	1090
9	"9-out3426"	.25529	241	703	944
9	"9-out3427"	.28356	264	667	931
9	"9-out3428"	.36980	169	288	457
9	"9-out3429"	.42049	669	922	1591
9	"9-out3430"	.45559	118	141	259
9	"9-out3431"	.32304	272	570	842
9	"9-out3432"	.19622	187	766	953
9	"9-out3433"	.26489	698	1937	2635
9	"9-out3434"	.23419	763	2495	3258
9	"9-out3435"	.32469	263	547	810
9	"9-out3436"	.95389	600	29	629
9	"9-out3437"	.33300	1008	2019	3027
9	"9-out3438"	.32853	137	280	417
9	"9-out3439"	.40792	175	254	429
9	"9-out3440"	.43140	239	315	554
9	"9-out3441"	.69313	323	143	466
9	"9-out3442"	.20212	38	150	188
9	"9-out3443"	.43030	71	94	165
9	"9-out3444"	.26250	42	118	160
9	"9-out3445"	.28930	46	113	159
9	"9-out3446"	.25938	152	434	586
9	"9-out3447"	.35749	291	523	814
9	"9-out3448"	.29059	34	83	117
9	"9-out3449"	.88549	696	90	786
9	"9-out3450"	.30943	82	183	265
9	"9-out3451"	.28040	83	213	296
9	"9-out3452"	.66401	500	253	753
9	"9-out3453"	.32808	125	256	381
9	"9-out3454"	.99781	912	2	914
9	"9-out3455"	.30015	377	879	1256
9	"9-out3456"	.99683	630	2	632
9	"9-out3457"	.45140	274	333	607
9	"9-out3458"	.26769	401	1097	1498
9	"9-out3459"	.27463	131	346	477
9	"9-out3460"	.38577	282	449	731
9	"9-out3461"	.87987	293	40	333
9	"9-out3462"	.22912	118	397	515
9	"9-out3463"	.15789	69	368	437
9	"9-out3464"	.35064	54	100	154
9	"9-out3465"	.32409	117	244	361
9	"9-out3466"	.28996	234	573	807
9	"9-out3467"	.28697	293	728	1021
9	"9-out3468"	.43293	255	334	589
9	"9-out3469"	.56807	242	184	426
9	"9-out3470"	.95823	390	17	407
9	"9-out3471"	.33649	71	140	211
9	"9-out3472"	.83595	372	73	445
9	"9-out3473"	.28828	96	237	333
9	"9-out3474"	.20599	55	212	267
9	"9-out3475"	.32901	127	259	386
9	"9-out3476"	.66344	412	209	621
9	"9-out3477"	.98534	538	8	546
9	"9-out3478"	.26334	74	207	281
9	"9-out3479"	.48812	185	194	379
9	"9-out3480"	.44444	196	245	441
9	"9-out3481"	.26550	351	971	1322
9	"9-out3482"	.50972	131	126	257
9	"9-out3483"	.99856	698	1	699
9	"9-out3484"	.29695	117	277	394
9	"9-out3485"	.35120	321	593	914
9	"9-out3486"	.53951	314	268	582
9	"9-out3487"	.38069	209	340	549
9	"9-out3488"	.25517	37	108	145
9	"9-out3489"	.23183	67	222	289
9	"9-out3490"	.21311	65	240	305
9	"9-out3491"	.68292	224	104	328
9	"9-out3492"	.61750	247	153	400
9	"9-out3493"	.99855	692	1	693
9	"9-out3494"	.99855	692	1	693
9	"9-out3495"	.99668	601	2	603
9	"9-out3496"	.99497	594	3	597
9	"9-out3497"	.99767	429	1	430
9	"9-out3498"	.34249	349	670	1019
9	"9-out3499"	.35761	162	291	453
9	"9-out3500"	.36363	180	315	495
9	"9-out3501"	.19565	18	74	92
9	"9-out3502"	.31000	31	69	100
9	"9-out3503"	.33333	154	308	462
9	"9-out3504"	.28680	113	281	394
9	"9-out3505"	.26590	117	323	440
9	"9-out3506"	.26548	120	332	452
9	"9-out3507"	.99851	674	1	675
9	"9-out3508"	.49600	124	126	250
9	"9-out3509"	.59433	126	86	212
9	"9-out3510"	.99242	131	1	132
9	"9-out3511"	.31347	100	219	319
9	"9-out3512"	.96514	360	13	373
9	"9-out3513"	.43202	143	188	331
9	"9-out3514"	.40170	378	563	941
9	"9-out3515"	.22500	216	744	960
9	"9-out3516"	.52547	165	149	314
9	"9-out3517"	.42600	213	287	500
9	"9-out3518"	.25531	72	210	282
9	"9-out3519"	.84854	437	78	515
9	"9-out3520"	.14166	51	309	360
9	"9-out3521"	.61838	222	137	359
9	"9-out3522"	.31233	119	262	381
9	"9-out3523"	.36604	138	239	377
9	"9-out3524"	.30140	107	248	355
9	"9-out3525"	.50534	189	185	374
9	"9-out3526"	.95108	175	9	184
9	"9-out3527"	.50268	281	278	559
9	"9-out3528"	.61059	265	169	434
9	"9-out3529"	.32949	143	291	434
9	"9-out3530"	.50691	220	214	434
9	"9-out3531"	.69080	248	111	359
9	"9-out3532"	.19491	69	285	354
9	"9-out3533"	.33676	229	451	680
9	"9-out3534"	.99855	692	1	693
9	"9-out3535"	.25724	222	641	863
9	"9-out3536"	.27110	167	449	616
9	"9-out3537"	.40948	285	411	696
9	"9-out3538"	.27272	132	352	484
9	"9-out3539"	.31415	142	310	452
9	"9-out3540"	.22997	89	298	387
9	"9-out3541"	.78246	464	129	593
9	"9-out3542"	.64252	275	153	428
9	"9-out3543"	.28992	118	289	407
9	"9-out3544"	.35842	100	179	279
9	"9-out3545"	.46250	333	387	720
9	"9-out3546"	.99683	315	1	316
9	"9-out3547"	.25000	69	207	276
9	"9-out3548"	.99767	429	1	430
9	"9-out3549"	.33142	290	585	875
9	"9-out3550"	.85628	858	144	1002
9	"9-out3551"	.41793	932	1298	2230
9	"9-out3552"	.98347	119	2	121
9	"9-out3553"	.33890	142	277	419
9	"9-out3554"	.99750	400	1	401
9	"9-out3555"	.99248	396	3	399
9	"9-out3556"	.42281	126	172	298
9	"9-out3557"	.67326	68	33	101
9	"9-out3558"	.22607	189	647	836
9	"9-out3559"	.18006	177	806	983
9	"9-out3560"	.30827	41	92	133
9	"9-out3561"	.32293	383	803	1186
9	"9-out3562"	.15384	26	143	169
9	"9-out3563"	.21385	287	1055	1342
9	"9-out3564"	.23301	223	734	957
9	"9-out3565"	.34320	429	821	1250
9	"9-out3566"	.36613	253	438	691
9	"9-out3567"	.65254	231	123	354
9	"9-out3568"	.44695	198	245	443
9	"9-out3569"	.49358	77	79	156
9	"9-out3570"	.47058	720	810	1530
9	"9-out3571"	.58461	76	54	130
9	"9-out3572"	.38159	253	410	663
9	"9-out3573"	.99264	135	1	136
9	"9-out3574"	.86458	581	91	672
9	"9-out3575"	.42450	149	202	351
9	"9-out3576"	.32437	326	679	1005
9	"9-out3577"	.23383	170	557	727
9	"9-out3578"	.23467	333	1086	1419
9	"9-out3579"	.20000	106	424	530
9	"9-out3580"	.29449	139	333	472
9	"9-out3581"	.30167	162	375	537
9	"9-out3582"	.58426	52	37	89
9	"9-out3583"	.69047	145	65	210
9	"9-out3584"	.31336	1261	2763	4024
9	"9-out3585"	.98275	114	2	116
9	"9-out3586"	.53672	95	82	177
9	"9-out3587"	.25005	1118	3353	4471
9	"9-out3588"	.41841	100	139	239
9	"9-out3589"	.37640	201	333	534
9	"9-out3590"	.25230	137	406	543
9	"9-out3591"	.99780	911	2	913
9	"9-out3592"	.96078	343	14	357
9	"9-out3593"	.16346	34	174	208
9	"9-out3594"	.16468	97	492	589
9	"9-out3595"	.40701	232	338	570
9	"9-out3596"	.99828	583	1	584
9	"9-out3597"	.56578	43	33	76
9	"9-out3598"	.99476	190	1	191
9	"9-out3599"	.99585	480	2	482
9	"9-out3600"	.99464	557	3	560
9	"9-out3601"	.99856	698	1	699
9	"9-out3602"	.99856	697	1	698
9	"9-out3603"	.99489	585	3	588
9	"9-out3604"	.99848	660	1	661
9	"9-out3605"	.98775	242	3	245
9	"9-out3606"	.47509	124	137	261
9	"9-out3607"	.23163	82	272	354
9	"9-out3608"	.39503	175	268	443
9	"9-out3609"	.99591	244	1	245
9	"9-out3610"	.39209	238	369	607
9	"9-out3611"	.18644	55	240	295
9	"9-out3612"	.35795	126	226	352
9	"9-out3613"	.19346	71	296	367
9	"9-out3614"	.13684	52	328	380
9	"9-out3615"	.98534	538	8	546
9	"9-out3616"	.20000	54	216	270
9	"9-out3617"	.34085	272	526	798
9	"9-out3618"	.27787	152	395	547
9	"9-out3619"	.95762	113	5	118
9	"9-out3620"	.33788	99	194	293
9	"9-out3621"	.98984	2243	23	2266
9	"9-out3622"	.31839	135	289	424
9	"9-out3623"	.30120	25	58	83
9	"9-out3624"	.17293	46	220	266
9	"9-out3625"	.32075	85	180	265
9	"9-out3626"	.96330	315	12	327
9	"9-out3627"	.25638	502	1456	1958
9	"9-out3628"	.32824	86	176	262
9	"9-out3629"	.21852	217	776	993
9	"9-out3630"	.35897	378	675	1053
9	"9-out3631"	.10191	16	141	157
9	"9-out3632"	.37301	94	158	252
9	"9-out3633"	.62774	371	220	591
9	"9-out3634"	.73084	353	130	483
9	"9-out3635"	.99668	301	1	302
9	"9-out3636"	.99668	301	1	302
9	"9-out3637"	.10317	52	452	504
9	"9-out3638"	.20243	83	327	410
9	"9-out3639"	.98479	518	8	526
9	"9-out3640"	.23924	89	283	372
9	"9-out3641"	.28795	165	408	573
9	"9-out3642"	.32075	170	360	530
9	"9-out3643"	.70422	100	42	142
9	"9-out3644"	.23943	34	108	142
9	"9-out3645"	.29690	288	682	970
9	"9-out3646"	.99367	157	1	158
9	"9-out3647"	.28095	118	302	420
9	"9-out3648"	.09855	34	311	345
9	"9-out3649"	.20977	73	275	348
9	"9-out3650"	.22807	195	660	855
9	"9-out3651"	.85300	412	71	483
9	"9-out3652"	.81969	541	119	660
9	"9-out3653"	.91688	2427	220	2647
9	"9-out3654"	.19811	63	255	318
9	"9-out3655"	.37074	109	185	294
9	"9-out3656"	.37742	214	353	567
9	"9-out3657"	.17717	59	274	333
9	"9-out3658"	.99641	556	2	558
9	"9-out3659"	.17131	270	1306	1576
9	"9-out3660"	.80314	1020	250	1270
9	"9-out3661"	.87862	333	46	379
9	"9-out3662"	.14099	54	329	383
9	"9-out3663"	.69498	1677	736	2413
9	"9-out3664"	.32832	131	268	399
9	"9-out3665"	.32190	291	613	904
9	"9-out3666"	.95689	111	5	116
9	"9-out3667"	.35363	180	329	509
9	"9-out3668"	.43672	245	316	561
9	"9-out3669"	.35912	181	323	504
9	"9-out3670"	.40935	140	202	342
9	"9-out3671"	.36784	135	232	367
9	"9-out3672"	.54466	378	316	694
9	"9-out3673"	.14717	73	423	496
9	"9-out3674"	.24271	25	78	103
9	"9-out3675"	.19487	137	566	703
9	"9-out3676"	.97272	321	9	330
9	"9-out3677"	.51680	569	532	1101
9	"9-out3678"	.38809	463	730	1193
9	"9-out3679"	.20461	213	828	1041
9	"9-out3680"	.30607	131	297	428
9	"9-out3681"	.40232	173	257	430
9	"9-out3682"	.57278	181	135	316
9	"9-out3683"	.30036	82	191	273
9	"9-out3684"	.26210	184	518	702
9	"9-out3685"	.38547	138	220	358
9	"9-out3686"	.25833	62	178	240
9	"9-out3687"	.28517	75	188	263
9	"9-out3688"	.51335	346	328	674
9	"9-out3689"	.81769	462	103	565
9	"9-out3690"	.31216	1298	2860	4158
9	"9-out3691"	.54802	97	80	177
9	"9-out3692"	.38357	1186	1906	3092
9	"9-out3693"	.34357	123	235	358
9	"9-out3694"	.32835	66	135	201
9	"9-out3695"	.45830	698	825	1523
9	"9-out3696"	.34622	188	355	543
9	"9-out3697"	.29696	49	116	165
9	"9-out3698"	.37187	119	201	320
9	"9-out3699"	.13770	168	1052	1220
9	"9-out3700"	.33890	142	277	419
9	"9-out3701"	.35969	191	340	531
9	"9-out3702"	.40255	126	187	313
9	"9-out3703"	.44640	354	439	793
9	"9-out3704"	.26653	137	377	514
9	"9-out3705"	.42929	85	113	198
9	"9-out3706"	.32692	34	70	104
9	"9-out3707"	.38284	183	295	478
9	"9-out3708"	.29580	289	688	977
9	"9-out3709"	.22916	22	74	96
9	"9-out3710"	.24034	168	531	699
9	"9-out3711"	.99056	420	4	424
9	"9-out3712"	.97969	193	4	197
9	"9-out3713"	.88201	613	82	695
9	"9-out3714"	.25815	190	546	736
9	"9-out3715"	.30392	62	142	204
9	"9-out3716"	.32633	451	931	1382
9	"9-out3717"	.14041	82	502	584
9	"9-out3718"	.22360	36	125	161
9	"9-out3719"	.99576	235	1	236
9	"9-out3720"	.62844	137	81	218
9	"9-out3721"	.09192	33	326	359
9	"9-out3722"	.22766	186	631	817
9	"9-out3723"	.66150	299	153	452
9	"9-out3724"	.23801	288	922	1210
9	"9-out3725"	.36474	240	418	658
9	"9-out3726"	.30463	375	856	1231
9	"9-out3727"	.50442	57	56	113
9	"9-out3728"	.80496	454	110	564
9	"9-out3729"	.38053	172	280	452
9	"9-out3730"	.34782	104	195	299
9	"9-out3731"	.20000	163	652	815
9	"9-out3732"	.31808	285	611	896
9	"9-out3733"	.28186	555	1414	1969
9	"9-out3734"	.47509	124	137	261
9	"9-out3735"	.46846	624	708	1332
9	"9-out3736"	.33898	280	546	826
9	"9-out3737"	.32972	335	681	1016
9	"9-out3738"	.36292	278	488	766
9	"9-out3739"	.31436	359	783	1142
9	"9-out3740"	.33471	81	161	242
9	"9-out3741"	.35666	265	478	743
9	"9-out3742"	.39121	196	305	501
9	"9-out3743"	.88000	308	42	350
9	"9-out3744"	.69727	205	89	294
9	"9-out3745"	.24305	70	218	288
9	"9-out3746"	.49728	275	278	553
9	"9-out3747"	.30912	166	371	537
9	"9-out3748"	.20795	115	438	553
9	"9-out3749"	.26146	154	435	589
9	"9-out3750"	.99438	177	1	178
9	"9-out3751"	.42251	289	395	684
9	"9-out3752"	.98773	161	2	163
9	"9-out3753"	.52261	104	95	199
9	"9-out3754"	.80370	217	53	270
9	"9-out3755"	.66666	240	120	360
9	"9-out3756"	.11363	45	351	396
9	"9-out3757"	.31692	103	222	325
9	"9-out3758"	.99521	208	1	209
9	"9-out3759"	.37435	73	122	195
9	"9-out3760"	.33540	108	214	322
9	"9-out3761"	.31557	237	514	751
9	"9-out3762"	.19834	48	194	242
9	"9-out3763"	.31506	46	100	146
9	"9-out3764"	.24299	182	567	749
9	"9-out3765"	.51046	122	117	239
9	"9-out3766"	.66666	160	80	240
9	"9-out3767"	.24766	53	161	214
9	"9-out3768"	.26548	60	166	226
9	"9-out3769"	.55686	142	113	255
9	"9-out3770"	.22439	46	159	205
9	"9-out3771"	.41314	88	125	213
9	"9-out3772"	.51680	123	115	238
9	"9-out3773"	.29385	67	161	228
9	"9-out3774"	.99736	379	1	380
9	"9-out3775"	.26557	81	224	305
9	"9-out3776"	.98734	78	1	79
9	"9-out3777"	.98734	78	1	79
9	"9-out3778"	.99295	141	1	142
9	"9-out3779"	.29059	102	249	351
9	"9-out3780"	.64485	69	38	107
9	"9-out3781"	.56538	147	113	260
9	"9-out3782"	.32861	232	474	706
9	"9-out3783"	.18984	101	431	532
9	"9-out3784"	.40399	162	239	401
9	"9-out3785"	.22291	107	373	480
9	"9-out3786"	.97872	92	2	94
9	"9-out3787"	.32440	884	1841	2725
9	"9-out3788"	.39705	27	41	68
9	"9-out3789"	.32822	257	526	783
9	"9-out3790"	.38080	123	200	323
9	"9-out3791"	.23839	77	246	323
9	"9-out3792"	.26560	268	741	1009
9	"9-out3793"	.25510	325	949	1274
9	"9-out3794"	.55897	327	258	585
9	"9-out3795"	.17278	207	991	1198
9	"9-out3796"	.27888	70	181	251
9	"9-out3797"	.98947	94	1	95
9	"9-out3798"	.17857	30	138	168
9	"9-out3799"	.27299	92	245	337
9	"9-out3800"	.15653	121	652	773
9	"9-out3801"	.17823	131	604	735
9	"9-out3802"	.34000	102	198	300
9	"9-out3803"	.23548	73	237	310
9	"9-out3804"	.99706	340	1	341
9	"9-out3805"	.72448	71	27	98
9	"9-out3806"	.36551	53	92	145
9	"9-out3807"	.57731	56	41	97
9	"9-out3808"	.98507	66	1	67
9	"9-out3809"	.30529	363	826	1189
9	"9-out3810"	.30621	621	1407	2028
9	"9-out3811"	.98630	72	1	73
9	"9-out3812"	.28666	172	428	600
9	"9-out3813"	.48854	192	201	393
9	"9-out3814"	.62171	189	115	304
9	"9-out3815"	.24804	190	576	766
9	"9-out3816"	.16712	61	304	365
9	"9-out3817"	.26325	685	1917	2602
9	"9-out3818"	.51699	882	824	1706
9	"9-out3819"	.28157	136	347	483
9	"9-out3820"	.19813	255	1032	1287
9	"9-out3821"	.33081	175	354	529
9	"9-out3822"	.35319	166	304	470
9	"9-out3823"	.89090	147	18	165
9	"9-out3824"	.63402	123	71	194
9	"9-out3825"	.98437	63	1	64
9	"9-out3826"	.26741	215	589	804
9	"9-out3827"	.98571	69	1	70
9	"9-out3828"	.33024	356	722	1078
9	"9-out3829"	.83928	141	27	168
9	"9-out3830"	.84523	71	13	84
9	"9-out3831"	.39393	156	240	396
9	"9-out3832"	.17765	97	449	546
9	"9-out3833"	.21052	84	315	399
9	"9-out3834"	.16491	188	952	1140
9	"9-out3835"	.16100	147	766	913
9	"9-out3836"	.26439	225	626	851
9	"9-out3837"	.38702	358	567	925
9	"9-out3838"	.84000	84	16	100
9	"9-out3839"	.35179	216	398	614
9	"9-out3840"	.52920	906	806	1712
9	"9-out3841"	.61428	43	27	70
9	"9-out3842"	.43445	348	453	801
9	"9-out3843"	.33620	312	616	928
9	"9-out3844"	.95314	773	38	811
9	"9-out3845"	.38297	90	145	235
9	"9-out3846"	.35868	382	683	1065
9	"9-out3847"	.16421	78	397	475
9	"9-out3848"	.24107	162	510	672
9	"9-out3849"	.37777	153	252	405
9	"9-out3850"	.40094	510	762	1272
9	"9-out3851"	.23255	120	396	516
9	"9-out3852"	.25628	51	148	199
9	"9-out3853"	.31283	173	380	553
9	"9-out3854"	.91208	249	24	273
9	"9-out3855"	.77215	122	36	158
9	"9-out3856"	.23471	284	926	1210
9	"9-out3857"	.98717	77	1	78
9	"9-out3858"	.52207	272	249	521
9	"9-out3859"	.98924	92	1	93
9	"9-out3860"	.45558	159	190	349
9	"9-out3861"	.99718	354	1	355
9	"9-out3862"	.40973	202	291	493
9	"9-out3863"	.34134	355	685	1040
9	"9-out3864"	.99894	949	1	950
9	"9-out3865"	.35522	119	216	335
9	"9-out3866"	.33049	310	628	938
9	"9-out3867"	.29723	140	331	471
9	"9-out3868"	.55603	129	103	232
9	"9-out3869"	.37019	318	541	859
9	"9-out3870"	.38230	229	370	599
9	"9-out3871"	.57666	346	254	600
9	"9-out3872"	.29594	219	521	740
9	"9-out3873"	.97872	92	2	94
9	"9-out3874"	.38610	239	380	619
9	"9-out3875"	.42718	352	472	824
9	"9-out3876"	.34238	353	678	1031
9	"9-out3877"	.26213	135	380	515
9	"9-out3878"	.40740	165	240	405
9	"9-out3879"	.29137	294	715	1009
9	"9-out3880"	.34061	546	1057	1603
9	"9-out3881"	.30188	64	148	212
9	"9-out3882"	.39274	130	201	331
9	"9-out3883"	.64792	219	119	338
9	"9-out3884"	.72115	225	87	312
9	"9-out3885"	.21803	266	954	1220
9	"9-out3886"	.74946	706	236	942
9	"9-out3887"	.57065	420	316	736
9	"9-out3888"	.25168	187	556	743
9	"9-out3889"	.61679	705	438	1143
9	"9-out3890"	.29350	113	272	385
9	"9-out3891"	.39024	112	175	287
9	"9-out3892"	.59860	258	173	431
9	"9-out3893"	.32191	451	950	1401
9	"9-out3894"	.38917	151	237	388
9	"9-out3895"	.29283	229	553	782
9	"9-out3896"	.81250	247	57	304
9	"9-out3897"	.49352	305	313	618
9	"9-out3898"	.40966	195	281	476
9	"9-out3899"	.28416	131	330	461
9	"9-out3900"	.34347	158	302	460
9	"9-out3901"	.13529	23	147	170
9	"9-out3902"	.27868	68	176	244
9	"9-out3903"	.23232	92	304	396
9	"9-out3904"	.27400	117	310	427
9	"9-out3905"	.22347	139	483	622
9	"9-out3906"	.05031	16	302	318
9	"9-out3907"	.62967	488	287	775
9	"9-out3908"	.45065	274	334	608
9	"9-out3909"	.49372	118	121	239
9	"9-out3910"	.71951	236	92	328
9	"9-out3911"	.76902	859	258	1117
9	"9-out3912"	.44642	125	155	280
9	"9-out3913"	.35119	354	654	1008
9	"9-out3914"	.23177	213	706	919
9	"9-out3915"	.29818	345	812	1157
9	"9-out3916"	.77406	603	176	779
9	"9-out3917"	.25223	565	1675	2240
9	"9-out3918"	.31041	483	1073	1556
9	"9-out3919"	.34126	258	498	756
9	"9-out3920"	.25806	88	253	341
9	"9-out3921"	.42857	150	200	350
9	"9-out3922"	.64876	157	85	242
9	"9-out3923"	.27721	275	717	992
9	"9-out3924"	.19889	144	580	724
9	"9-out3925"	.98630	72	1	73
9	"9-out3926"	.40137	291	434	725
9	"9-out3927"	.31974	102	217	319
9	"9-out3928"	.96000	648	27	675
9	"9-out3929"	.70262	508	215	723
9	"9-out3930"	.98611	71	1	72
9	"9-out3931"	.38731	232	367	599
9	"9-out3932"	.48578	376	398	774
9	"9-out3933"	.69330	321	142	463
9	"9-out3934"	.93113	311	23	334
9	"9-out3935"	.45934	226	266	492
9	"9-out3936"	.41004	253	364	617
9	"9-out3937"	.31849	93	199	292
9	"9-out3938"	.40163	98	146	244
9	"9-out3939"	.55789	106	84	190
9	"9-out3940"	.76470	78	24	102
9	"9-out3941"	.28070	80	205	285
9	"9-out3942"	.29759	297	701	998
9	"9-out3943"	.99253	133	1	134
9	"9-out3944"	.77476	571	166	737
9	"9-out3945"	.84571	740	135	875
9	"9-out3946"	.27707	87	227	314
9	"9-out3947"	.19018	62	264	326
9	"9-out3948"	.25663	145	420	565
9	"9-out3949"	.19340	88	367	455
9	"9-out3950"	.24021	307	971	1278
9	"9-out3951"	.17335	134	639	773
9	"9-out3952"	.31262	151	332	483
9	"9-out3953"	.28176	204	520	724
9	"9-out3954"	.70694	468	194	662
9	"9-out3955"	.99896	969	1	970
9	"9-out3956"	.66117	482	247	729
9	"9-out3957"	.97872	92	2	94
9	"9-out3958"	.89711	218	25	243
9	"9-out3959"	.80468	412	100	512
9	"9-out3960"	.99494	197	1	198
9	"9-out3961"	.28542	427	1069	1496
9	"9-out3962"	.36773	702	1207	1909
9	"9-out3963"	.48841	295	309	604
9	"9-out3964"	.21907	85	303	388
9	"9-out3965"	.99545	219	1	220
9	"9-out3966"	.95161	531	27	558
9	"9-out3967"	.20958	70	264	334
9	"9-out3968"	.98461	64	1	65
9	"9-out3969"	.23659	75	242	317
9	"9-out3970"	.19094	135	572	707
9	"9-out3971"	.99719	356	1	357
9	"9-out3972"	.99371	158	1	159
9	"9-out3973"	.29506	311	743	1054
9	"9-out3974"	.34865	91	170	261
9	"9-out3975"	.23598	80	259	339
9	"9-out3976"	.21257	169	626	795
9	"9-out3977"	.40074	428	640	1068
9	"9-out3978"	.99889	906	1	907
9	"9-out3979"	.99290	140	1	141
9	"9-out3980"	.90780	128	13	141
9	"9-out3981"	.31662	240	518	758
9	"9-out3982"	.36507	69	120	189
9	"9-out3983"	.57516	88	65	153
9	"9-out3984"	.52941	54	48	102
9	"9-out3985"	.53658	44	38	82
9	"9-out3986"	.98863	87	1	88
9	"9-out3987"	.42857	33	44	77
9	"9-out3988"	.44769	107	132	239
9	"9-out3989"	.44787	116	143	259
9	"9-out3990"	.48396	166	177	343
9	"9-out3991"	.48374	253	270	523
9	"9-out3992"	.29090	32	78	110
9	"9-out3993"	.79150	205	54	259
9	"9-out3994"	.45147	107	130	237
9	"9-out3995"	.36382	171	299	470
9	"9-out3996"	.40333	363	537	900
9	"9-out3997"	.30098	214	497	711
9	"9-out3998"	.27010	215	581	796
9	"9-out3999"	.24074	130	410	540
9	"9-out4000"	.55705	371	295	666
9	"9-out4001"	.39144	247	384	631
9	"9-out4002"	.29965	264	617	881
9	"9-out4003"	.93283	625	45	670
9	"9-out4004"	.25228	138	409	547
9	"9-out4005"	.60807	256	165	421
9	"9-out4006"	.30847	91	204	295
9	"9-out4007"	.39143	667	1037	1704
9	"9-out4008"	.93596	190	13	203
9	"9-out4009"	.68181	90	42	132
9	"9-out4010"	.19578	130	534	664
9	"9-out4011"	.62500	140	84	224
9	"9-out4012"	.45454	75	90	165
9	"9-out4013"	.46608	213	244	457
9	"9-out4014"	.98469	193	3	196
9	"9-out4015"	.99549	221	1	222
9	"9-out4016"	.57207	127	95	222
9	"9-out4017"	.79487	155	40	195
9	"9-out4018"	.20408	40	156	196
9	"9-out4019"	.38369	160	257	417
9	"9-out4020"	.89285	100	12	112
9	"9-out4021"	.33937	206	401	607
9	"9-out4022"	.21854	33	118	151
9	"9-out4023"	.39447	200	307	507
9	"9-out4024"	.39685	379	576	955
9	"9-out4025"	.39312	160	247	407
9	"9-out4026"	.23843	134	428	562
9	"9-out4027"	.52767	143	128	271
9	"9-out4028"	.46749	151	172	323
9	"9-out4029"	.24872	146	441	587
9	"9-out4030"	.31788	144	309	453
9	"9-out4031"	.54935	256	210	466
9	"9-out4032"	.30447	102	233	335
9	"9-out4033"	.35250	141	259	400
9	"9-out4034"	.28349	256	647	903
9	"9-out4035"	.40256	188	279	467
9	"9-out4036"	.39830	94	142	236
9	"9-out4037"	.16666	30	150	180
9	"9-out4038"	.93884	261	17	278
9	"9-out4039"	.82702	153	32	185
9	"9-out4040"	.29015	56	137	193
9	"9-out4041"	.36507	69	120	189
9	"9-out4042"	.30505	471	1073	1544
9	"9-out4043"	.23572	194	629	823
9	"9-out4044"	.15555	28	152	180
9	"9-out4045"	.21059	151	566	717
9	"9-out4046"	.26742	211	578	789
9	"9-out4047"	.55462	264	212	476
9	"9-out4048"	.15521	61	332	393
9	"9-out4049"	.31808	146	313	459
9	"9-out4050"	.25854	121	347	468
9	"9-out4051"	.50825	154	149	303
9	"9-out4052"	.31770	61	131	192
9	"9-out4053"	.30800	150	337	487
9	"9-out4054"	.23989	457	1448	1905
9	"9-out4055"	.32780	237	486	723
9	"9-out4056"	.18718	111	482	593
9	"9-out4057"	.25590	206	599	805
9	"9-out4058"	.59782	55	37	92
9	"9-out4059"	.21336	198	730	928
9	"9-out4060"	.18652	72	314	386
9	"9-out4061"	.40051	157	235	392
9	"9-out4062"	.26943	156	423	579
9	"9-out4063"	.98809	83	1	84
9	"9-out4064"	.52112	74	68	142
9	"9-out4065"	.99559	226	1	227
9	"9-out4066"	.34787	311	583	894
9	"9-out4067"	.60424	768	503	1271
9	"9-out4068"	.96511	166	6	172
9	"9-out4069"	.33473	238	473	711
9	"9-out4070"	.92826	854	66	920
9	"9-out4071"	.44186	57	72	129
9	"9-out4072"	.62280	71	43	114
9	"9-out4073"	.99846	650	1	651
9	"9-out4074"	.20388	84	328	412
9	"9-out4075"	.21484	110	402	512
9	"9-out4076"	.47509	248	274	522
9	"9-out4077"	.87155	570	84	654
9	"9-out4078"	.34078	61	118	179
9	"9-out4079"	.99576	235	1	236
9	"9-out4080"	.99400	497	3	500
9	"9-out4081"	.25346	128	377	505
9	"9-out4082"	.31798	145	311	456
9	"9-out4083"	.24458	192	593	785
9	"9-out4084"	.07500	15	185	200
9	"9-out4085"	.56198	68	53	121
9	"9-out4086"	.27659	52	136	188
9	"9-out4087"	.33333	94	188	282
9	"9-out4088"	.18518	10	44	54
9	"9-out4089"	.22819	157	531	688
9	"9-out4090"	.24046	82	259	341
9	"9-out4091"	.27947	256	660	916
9	"9-out4092"	.40697	245	357	602
9	"9-out4093"	.44600	95	118	213
9	"9-out4094"	.52702	117	105	222
9	"9-out4095"	.36480	85	148	233
9	"9-out4096"	.94736	162	9	171
9	"9-out4097"	.47263	95	106	201
9	"9-out4098"	.35099	159	294	453
9	"9-out4099"	.27463	223	589	812
9	"9-out4100"	.34558	47	89	136
9	"9-out4101"	.15544	97	527	624
9	"9-out4102"	.74162	310	108	418
9	"9-out4103"	.88571	186	24	210
9	"9-out4104"	.38624	73	116	189
9	"9-out4105"	.27027	80	216	296
9	"9-out4106"	.50993	308	296	604
9	"9-out4107"	.40296	272	403	675
9	"9-out4108"	.99047	104	1	105
9	"9-out4109"	.85328	221	38	259
9	"9-out4110"	.84112	90	17	107
9	"9-out4111"	.22107	107	377	484
9	"9-out4112"	.72584	556	210	766
9	"9-out4113"	.33861	278	543	821
9	"9-out4114"	.23966	174	552	726
9	"9-out4115"	.26403	174	485	659
9	"9-out4116"	.61454	338	212	550
9	"9-out4117"	.49317	253	260	513
9	"9-out4118"	.24861	45	136	181
9	"9-out4119"	.99230	129	1	130
9	"9-out4120"	.22614	109	373	482
9	"9-out4121"	.89021	373	46	419
9	"9-out4122"	.55686	142	113	255
9	"9-out4123"	.10714	9	75	84
9	"9-out4124"	.39301	90	139	229
9	"9-out4125"	.73809	186	66	252
9	"9-out4126"	.99315	145	1	146
9	"9-out4127"	.28783	97	240	337
9	"9-out4128"	.34432	188	358	546
9	"9-out4129"	.39799	238	360	598
9	"9-out4130"	.35804	256	459	715
9	"9-out4131"	.98620	143	2	145
9	"9-out4132"	.21683	371	1340	1711
9	"9-out4133"	.22754	190	645	835
9	"9-out4134"	.31524	151	328	479
9	"9-out4135"	.31428	66	144	210
9	"9-out4136"	.33663	68	134	202
9	"9-out4137"	.38248	83	134	217
9	"9-out4138"	.28400	119	300	419
9	"9-out4139"	.21052	52	195	247
9	"9-out4140"	.99616	260	1	261
9	"9-out4141"	.34167	273	526	799
9	"9-out4142"	.51328	425	403	828
9	"9-out4143"	.49063	262	272	534
9	"9-out4144"	.39192	165	256	421
9	"9-out4145"	.40935	70	101	171
9	"9-out4146"	.24557	125	384	509
9	"9-out4147"	.88135	104	14	118
9	"9-out4148"	.99633	272	1	273
9	"9-out4149"	.32843	67	137	204
9	"9-out4150"	.85840	485	80	565
9	"9-out4151"	.14229	36	217	253
9	"9-out4152"	.18144	395	1782	2177
9	"9-out4153"	.15282	149	826	975
9	"9-out4154"	.99595	492	2	494
9	"9-out4155"	.28735	25	62	87
9	"9-out4156"	.94278	379	23	402
9	"9-out4157"	.44488	113	141	254
9	"9-out4158"	.29220	90	218	308
9	"9-out4159"	.38185	202	327	529
9	"9-out4160"	.25143	262	780	1042
9	"9-out4161"	.32432	300	625	925
9	"9-out4162"	.25240	131	388	519
9	"9-out4163"	.24067	445	1404	1849
9	"9-out4164"	.46551	189	217	406
9	"9-out4165"	.24948	243	731	974
9	"9-out4166"	.95723	470	21	491
9	"9-out4167"	.60563	86	56	142
9	"9-out4168"	.34725	158	297	455
9	"9-out4169"	.22405	95	329	424
9	"9-out4170"	.31266	121	266	387
9	"9-out4171"	.20663	81	311	392
9	"9-out4172"	.78195	416	116	532
9	"9-out4173"	.23930	263	836	1099
9	"9-out4174"	.37878	150	246	396
9	"9-out4175"	.10948	15	122	137
9	"9-out4176"	.27710	69	180	249
9	"9-out4177"	.45808	235	278	513
9	"9-out4178"	.35175	1381	2545	3926
9	"9-out4179"	.81702	192	43	235
9	"9-out4180"	.25316	60	177	237
9	"9-out4181"	.21316	230	849	1079
9	"9-out4182"	.36923	72	123	195
9	"9-out4183"	.98571	483	7	490
9	"9-out4184"	.29745	105	248	353
9	"9-out4185"	.99465	186	1	187
9	"9-out4186"	.27856	1353	3504	4857
9	"9-out4187"	.14285	51	306	357
9	"9-out4188"	.94527	380	22	402
9	"9-out4189"	.20875	143	542	685
9	"9-out4190"	.46996	133	150	283
9	"9-out4191"	.42391	78	106	184
9	"9-out4192"	.79173	1015	267	1282
9	"9-out4193"	.47899	57	62	119
9	"9-out4194"	.99137	115	1	116
9	"9-out4195"	.98771	643	8	651
9	"9-out4196"	.27440	149	394	543
9	"9-out4197"	.34817	430	805	1235
9	"9-out4198"	.26511	114	316	430
9	"9-out4199"	.25862	135	387	522
9	"9-out4200"	.45318	1549	1869	3418
9	"9-out4201"	.29084	178	434	612
9	"9-out4202"	.30072	332	772	1104
9	"9-out4203"	.37523	394	656	1050
9	"9-out4204"	.35391	384	701	1085
9	"9-out4205"	.99862	724	1	725
9	"9-out4206"	.85344	99	17	116
9	"9-out4207"	.93333	210	15	225
9	"9-out4208"	.98432	628	10	638
9	"9-out4209"	.43526	158	205	363
9	"9-out4210"	.99797	493	1	494
9	"9-out4211"	.26598	104	287	391
9	"9-out4212"	.80232	138	34	172
9	"9-out4213"	.36697	520	897	1417
9	"9-out4214"	.20556	229	885	1114
9	"9-out4215"	.70810	131	54	185
9	"9-out4216"	.15720	155	831	986
9	"9-out4217"	.33176	211	425	636
9	"9-out4218"	.41552	91	128	219
9	"9-out4219"	.43949	138	176	314
9	"9-out4220"	.37619	79	131	210
9	"9-out4221"	.99159	354	3	357
9	"9-out4222"	.29523	31	74	105
9	"9-out4223"	.92627	691	55	746
9	"9-out4224"	.20703	53	203	256
9	"9-out4225"	.51969	1583	1463	3046
9	"9-out4226"	.98666	74	1	75
9	"9-out4227"	.26006	84	239	323
9	"9-out4228"	.54347	400	336	736
9	"9-out4229"	.44630	561	696	1257
9	"9-out4230"	.85092	508	89	597
9	"9-out4231"	.36666	66	114	180
9	"9-out4232"	.37854	120	197	317
9	"9-out4233"	.25560	57	166	223
9	"9-out4234"	.23384	228	747	975
9	"9-out4235"	.52000	260	240	500
9	"9-out4236"	.52510	251	227	478
9	"9-out4237"	.44943	80	98	178
9	"9-out4238"	.89600	112	13	125
9	"9-out4239"	.29515	469	1120	1589
9	"9-out4240"	.57621	189	139	328
9	"9-out4241"	.23287	119	392	511
9	"9-out4242"	.37429	198	331	529
9	"9-out4243"	.78610	430	117	547
9	"9-out4244"	.28125	45	115	160
9	"9-out4245"	.49038	765	795	1560
9	"9-out4246"	.26984	136	368	504
9	"9-out4247"	.61290	133	84	217
9	"9-out4248"	.28628	144	359	503
9	"9-out4249"	.12135	25	181	206
9	"9-out4250"	.54629	59	49	108
9	"9-out4251"	.28082	82	210	292
9	"9-out4252"	.54263	630	531	1161
9	"9-out4253"	.29395	107	257	364
9	"9-out4254"	.30781	189	425	614
9	"9-out4255"	.29896	87	204	291
9	"9-out4256"	.41921	192	266	458
9	"9-out4257"	.22466	133	459	592
9	"9-out4258"	.99310	144	1	145
9	"9-out4259"	.28838	231	570	801
9	"9-out4260"	.24874	99	299	398
9	"9-out4261"	.14717	112	649	761
9	"9-out4262"	.24382	296	918	1214
9	"9-out4263"	.33333	134	268	402
9	"9-out4264"	.42531	205	277	482
9	"9-out4265"	.37341	59	99	158
9	"9-out4266"	.34163	96	185	281
9	"9-out4267"	.27387	195	517	712
9	"9-out4268"	.98830	507	6	513
9	"9-out4269"	.99310	144	1	145
9	"9-out4270"	.17857	25	115	140
9	"9-out4271"	.48218	433	465	898
9	"9-out4272"	.34349	124	237	361
9	"9-out4273"	.46385	77	89	166
9	"9-out4274"	.24673	170	519	689
9	"9-out4275"	.19292	120	502	622
9	"9-out4276"	.27250	112	299	411
9	"9-out4277"	.64893	61	33	94
9	"9-out4278"	.21272	117	433	550
9	"9-out4279"	.98765	80	1	81
9	"9-out4280"	.30042	70	163	233
9	"9-out4281"	.35340	223	408	631
9	"9-out4282"	.52117	160	147	307
9	"9-out4283"	.64070	255	143	398
9	"9-out4284"	.41795	135	188	323
9	"9-out4285"	.26760	95	260	355
9	"9-out4286"	.42586	247	333	580
9	"9-out4287"	.38235	143	231	374
9	"9-out4288"	.15775	59	315	374
9	"9-out4289"	.18518	70	308	378
9	"9-out4290"	.26777	241	659	900
9	"9-out4291"	.26986	197	533	730
9	"9-out4292"	.99792	481	1	482
9	"9-out4293"	.98238	781	14	795
9	"9-out4294"	.15923	50	264	314
9	"9-out4295"	.83760	98	19	117
9	"9-out4296"	.38997	140	219	359
9	"9-out4297"	.62295	38	23	61
9	"9-out4298"	.32314	74	155	229
9	"9-out4299"	.36330	202	354	556
9	"9-out4300"	.82584	441	93	534
9	"9-out4301"	.51351	171	162	333
9	"9-out4302"	.40000	248	372	620
9	"9-out4303"	.09363	25	242	267
9	"9-out4304"	.26072	79	224	303
9	"9-out4305"	.34506	353	670	1023
9	"9-out4306"	.38167	500	810	1310
9	"9-out4307"	.35883	136	243	379
9	"9-out4308"	.37755	111	183	294
9	"9-out4309"	.53174	67	59	126
9	"9-out4310"	.68627	70	32	102
9	"9-out4311"	.92395	486	40	526
9	"9-out4312"	.53933	1337	1142	2479
9	"9-out4313"	.22388	105	364	469
9	"9-out4314"	.38227	427	690	1117
9	"9-out4315"	.22000	44	156	200
9	"9-out4316"	.22588	96	329	425
9	"9-out4317"	.71375	192	77	269
9	"9-out4318"	.92592	250	20	270
9	"9-out4319"	.31218	123	271	394
9	"9-out4320"	.19251	36	151	187
9	"9-out4321"	.26337	128	358	486
9	"9-out4322"	.41927	161	223	384
9	"9-out4323"	.27000	81	219	300
9	"9-out4324"	.28666	43	107	150
9	"9-out4325"	.90484	542	57	599
9	"9-out4326"	.37855	399	655	1054
9	"9-out4327"	.31194	175	386	561
9	"9-out4328"	.25202	218	647	865
9	"9-out4329"	.65073	490	263	753
9	"9-out4330"	.58582	157	111	268
9	"9-out4331"	.46120	214	250	464
9	"9-out4332"	.37453	100	167	267
9	"9-out4333"	.78187	233	65	298
9	"9-out4334"	.32364	245	512	757
9	"9-out4335"	.45896	274	323	597
9	"9-out4336"	.40119	67	100	167
9	"9-out4337"	.54121	302	256	558
9	"9-out4338"	.99230	129	1	130
9	"9-out4339"	.37428	131	219	350
9	"9-out4340"	.99630	270	1	271
9	"9-out4341"	.99152	117	1	118
9	"9-out4342"	.36042	235	417	652
9	"9-out4343"	.65702	159	83	242
9	"9-out4344"	.94736	72	4	76
9	"9-out4345"	.99462	185	1	186
9	"9-out4346"	.54330	69	58	127
9	"9-out4347"	.27857	39	101	140
9	"9-out4348"	.42233	783	1071	1854
9	"9-out4349"	.99551	222	1	223
9	"9-out4350"	.64543	2057	1130	3187
9	"9-out4351"	.28548	177	443	620
9	"9-out4352"	.31707	52	112	164
9	"9-out4353"	.51839	155	144	299
9	"9-out4354"	.45454	115	138	253
9	"9-out4355"	.34715	452	850	1302
9	"9-out4356"	.59119	94	65	159
9	"9-out4357"	.11749	45	338	383
9	"9-out4358"	.27004	64	173	237
9	"9-out4359"	.56410	198	153	351
9	"9-out4360"	.53741	158	136	294
9	"9-out4361"	.37575	62	103	165
9	"9-out4362"	.28648	53	132	185
9	"9-out4363"	.51565	494	464	958
9	"9-out4364"	.99509	203	1	204
9	"9-out4365"	.31404	76	166	242
9	"9-out4366"	.33454	92	183	275
9	"9-out4367"	.43582	163	211	374
9	"9-out4368"	.48312	458	490	948
9	"9-out4369"	.45217	52	63	115
9	"9-out4370"	.46464	46	53	99
9	"9-out4371"	.48275	112	120	232
9	"9-out4372"	.30952	104	232	336
9	"9-out4373"	.29394	102	245	347
9	"9-out4374"	.99459	184	1	185
9	"9-out4375"	.21827	172	616	788
9	"9-out4376"	.86650	714	110	824
9	"9-out4377"	.18850	82	353	435
9	"9-out4378"	.28270	134	340	474
9	"9-out4379"	.62655	151	90	241
9	"9-out4380"	.38095	96	156	252
9	"9-out4381"	.25084	222	663	885
9	"9-out4382"	.74869	143	48	191
9	"9-out4383"	.15056	67	378	445
9	"9-out4384"	.94366	268	16	284
9	"9-out4385"	.63377	379	219	598
9	"9-out4386"	.24832	74	224	298
9	"9-out4387"	.44318	78	98	176
9	"9-out4388"	.95643	1515	69	1584
9	"9-out4389"	.99716	352	1	353
9	"9-out4390"	.99551	222	1	223
9	"9-out4391"	.24406	72	223	295
9	"9-out4392"	.30233	582	1343	1925
9	"9-out4393"	.54410	512	429	941
9	"9-out4394"	.49538	161	164	325
9	"9-out4395"	.66552	388	195	583
9	"9-out4396"	.39473	60	92	152
9	"9-out4397"	.27089	94	253	347
9	"9-out4398"	.48979	144	150	294
9	"9-out4399"	.50000	77	77	154
9	"9-out4400"	.97860	183	4	187
9	"9-out4401"	.39453	202	310	512
9	"9-out4402"	.26470	144	400	544
9	"9-out4403"	.36000	180	320	500
9	"9-out4404"	.41769	1020	1422	2442
9	"9-out4405"	.92485	480	39	519
9	"9-out4406"	.99705	339	1	340
9	"9-out4407"	.19055	113	480	593
9	"9-out4408"	.34131	57	110	167
9	"9-out4409"	.31578	36	78	114
9	"9-out4410"	.27507	192	506	698
9	"9-out4411"	.97674	84	2	86
9	"9-out4412"	.99447	180	1	181
9	"9-out4413"	.39124	268	417	685
9	"9-out4414"	.98518	133	2	135
9	"9-out4415"	.19026	86	366	452
9	"9-out4416"	.31049	426	946	1372
9	"9-out4417"	.59927	166	111	277
9	"9-out4418"	.24190	112	351	463
9	"9-out4419"	.39169	132	205	337
9	"9-out4420"	.94528	311	18	329
9	"9-out4421"	.99743	389	1	390
9	"9-out4422"	.39228	295	457	752
9	"9-out4423"	.79464	445	115	560
9	"9-out4424"	.93932	387	25	412
9	"9-out4425"	.27272	108	288	396
9	"9-out4426"	.99751	401	1	402
9	"9-out4427"	.99115	112	1	113
9	"9-out4428"	.39041	114	178	292
9	"9-out4429"	.36296	49	86	135
9	"9-out4430"	.23600	59	191	250
9	"9-out4431"	.99386	162	1	163
9	"9-out4432"	.33693	187	368	555
9	"9-out4433"	.38114	186	302	488
9	"9-out4434"	.48140	453	488	941
9	"9-out4435"	.23529	28	91	119
9	"9-out4436"	.36720	159	274	433
9	"9-out4437"	.92542	273	22	295
9	"9-out4438"	.30523	105	239	344
9	"9-out4439"	.40484	117	172	289
9	"9-out4440"	.24681	194	592	786
9	"9-out4441"	.29295	104	251	355
9	"9-out4442"	.99106	776	7	783
9	"9-out4443"	.24505	62	191	253
9	"9-out4444"	.34591	385	728	1113
9	"9-out4445"	.99644	280	1	281
9	"9-out4446"	.33619	196	387	583
9	"9-out4447"	.17256	39	187	226
9	"9-out4448"	.33262	157	315	472
9	"9-out4449"	.27272	60	160	220
9	"9-out4450"	.47112	155	174	329
9	"9-out4451"	.56598	193	148	341
9	"9-out4452"	.26836	95	259	354
9	"9-out4453"	.36377	243	425	668
9	"9-out4454"	.42958	363	482	845
9	"9-out4455"	.43935	163	208	371
9	"9-out4456"	.49056	130	135	265
9	"9-out4457"	.13592	28	178	206
9	"9-out4458"	.25471	54	158	212
9	"9-out4459"	.37367	565	947	1512
9	"9-out4460"	.36985	962	1639	2601
9	"9-out4461"	.51724	135	126	261
9	"9-out4462"	.30872	46	103	149
9	"9-out4463"	.33269	345	692	1037
9	"9-out4464"	.15517	18	98	116
9	"9-out4465"	.31863	224	479	703
9	"9-out4466"	.23448	136	444	580
9	"9-out4467"	.47852	312	340	652
9	"9-out4468"	.37500	84	140	224
9	"9-out4469"	.16585	34	171	205
9	"9-out4470"	.36691	244	421	665
9	"9-out4471"	.45398	74	89	163
9	"9-out4472"	.36068	523	927	1450
9	"9-out4473"	.96216	178	7	185
9	"9-out4474"	.16143	36	187	223
9	"9-out4475"	.40449	216	318	534
9	"9-out4476"	.45769	119	141	260
9	"9-out4477"	.19072	37	157	194
9	"9-out4478"	.57583	224	165	389
9	"9-out4479"	.36858	122	209	331
9	"9-out4480"	.45000	45	55	100
9	"9-out4481"	.57894	143	104	247
9	"9-out4482"	.67326	136	66	202
9	"9-out4483"	.15833	57	303	360
9	"9-out4484"	.10793	34	281	315
9	"9-out4485"	.22448	22	76	98
9	"9-out4486"	.20543	68	263	331
9	"9-out4487"	.36000	54	96	150
9	"9-out4488"	.39770	173	262	435
9	"9-out4489"	.81720	304	68	372
9	"9-out4490"	.42140	319	438	757
9	"9-out4491"	.46022	162	190	352
9	"9-out4492"	.25068	182	544	726
9	"9-out4493"	.25724	71	205	276
9	"9-out4494"	.22277	45	157	202
9	"9-out4495"	.71428	260	104	364
9	"9-out4496"	.27976	94	242	336
9	"9-out4497"	.45136	232	282	514
9	"9-out4498"	.40912	502	725	1227
9	"9-out4499"	.34615	90	170	260
9	"9-out4500"	.21616	107	388	495
9	"9-out4501"	.40170	141	210	351
9	"9-out4502"	.23606	72	233	305
9	"9-out4503"	.38844	195	307	502
9	"9-out4504"	.55307	198	160	358
9	"9-out4505"	.62318	86	52	138
9	"9-out4506"	.40255	126	187	313
9	"9-out4507"	.36787	71	122	193
9	"9-out4508"	.32291	568	1191	1759
9	"9-out4509"	.20383	85	332	417
9	"9-out4510"	.29550	125	298	423
9	"9-out4511"	.38985	538	842	1380
9	"9-out4512"	.54932	245	201	446
9	"9-out4513"	.24834	225	681	906
9	"9-out4514"	.41455	245	346	591
9	"9-out4515"	.92669	493	39	532
9	"9-out4516"	.38321	105	169	274
9	"9-out4517"	.30718	47	106	153
9	"9-out4518"	.52356	100	91	191
9	"9-out4519"	.23505	59	192	251
9	"9-out4520"	.36096	344	609	953
9	"9-out4521"	.32317	106	222	328
9	"9-out4522"	.31986	293	623	916
9	"9-out4523"	.30740	83	187	270
9	"9-out4524"	.27848	88	228	316
9	"9-out4525"	.42610	173	233	406
9	"9-out4526"	.99624	265	1	266
9	"9-out4527"	.37946	85	139	224
9	"9-out4528"	.32091	155	328	483
9	"9-out4529"	.52607	232	209	441
9	"9-out4530"	.17164	23	111	134
9	"9-out4531"	.99082	108	1	109
9	"9-out4532"	.31944	138	294	432
9	"9-out4533"	.59944	217	145	362
9	"9-out4534"	.46379	647	748	1395
9	"9-out4535"	.44423	231	289	520
9	"9-out4536"	.33142	116	234	350
9	"9-out4537"	.25732	79	228	307
9	"9-out4538"	.61951	127	78	205
9	"9-out4539"	.41689	153	214	367
9	"9-out4540"	.18067	43	195	238
9	"9-out4541"	.23868	58	185	243
9	"9-out4542"	.18681	34	148	182
9	"9-out4543"	.38427	176	282	458
9	"9-out4544"	.16228	37	191	228
9	"9-out4545"	.31716	85	183	268
9	"9-out4546"	.22933	197	662	859
9	"9-out4547"	.21341	35	129	164
9	"9-out4548"	.36868	73	125	198
9	"9-out4549"	.35574	164	297	461
9	"9-out4550"	.13095	22	146	168
9	"9-out4551"	.41020	217	312	529
9	"9-out4552"	.26212	389	1095	1484
9	"9-out4553"	.81088	283	66	349
9	"9-out4554"	.18115	25	113	138
9	"9-out4555"	.40000	322	483	805
9	"9-out4556"	.20275	103	405	508
9	"9-out4557"	.74637	103	35	138
9	"9-out4558"	.23879	698	2225	2923
9	"9-out4559"	.36407	75	131	206
9	"9-out4560"	.71523	108	43	151
9	"9-out4561"	.50121	617	614	1231
9	"9-out4562"	.43804	251	322	573
9	"9-out4563"	.34121	231	446	677
9	"9-out4564"	.99183	486	4	490
9	"9-out4565"	.87455	1227	176	1403
9	"9-out4566"	.39869	61	92	153
9	"9-out4567"	.79577	113	29	142
9	"9-out4568"	.63366	128	74	202
9	"9-out4569"	.35498	153	278	431
9	"9-out4570"	.27635	173	453	626
9	"9-out4571"	.19749	205	833	1038
9	"9-out4572"	.25553	254	740	994
9	"9-out4573"	.47500	133	147	280
9	"9-out4574"	.23516	111	361	472
9	"9-out4575"	.21428	42	154	196
9	"9-out4576"	.62598	159	95	254
9	"9-out4577"	.16911	69	339	408
9	"9-out4578"	.18595	135	591	726
9	"9-out4579"	.36585	90	156	246
9	"9-out4580"	.26284	486	1363	1849
9	"9-out4581"	.70538	249	104	353
9	"9-out4582"	.98809	83	1	84
9	"9-out4583"	.40350	69	102	171
9	"9-out4584"	.88323	295	39	334
9	"9-out4585"	.23529	68	221	289
9	"9-out4586"	.37154	94	159	253
9	"9-out4587"	.99547	220	1	221
9	"9-out4588"	.85674	311	52	363
9	"9-out4589"	.40128	250	373	623
9	"9-out4590"	.40184	393	585	978
9	"9-out4591"	.54448	153	128	281
9	"9-out4592"	.99449	361	2	363
9	"9-out4593"	.31645	25	54	79
9	"9-out4594"	.46090	112	131	243
9	"9-out4595"	.56756	210	160	370
9	"9-out4596"	.38732	55	87	142
9	"9-out4597"	.19038	99	421	520
9	"9-out4598"	.25822	204	586	790
9	"9-out4599"	.27590	213	559	772
9	"9-out4600"	.29801	270	636	906
9	"9-out4601"	.44807	151	186	337
9	"9-out4602"	.18122	166	750	916
9	"9-out4603"	.38875	159	250	409
9	"9-out4604"	.64516	280	154	434
9	"9-out4605"	.35950	174	310	484
9	"9-out4606"	.28382	86	217	303
9	"9-out4607"	.37071	119	202	321
9	"9-out4608"	.43131	157	207	364
9	"9-out4609"	.19734	104	423	527
9	"9-out4610"	.32024	106	225	331
9	"9-out4611"	.96844	399	13	412
9	"9-out4612"	.14814	24	138	162
9	"9-out4613"	.51030	99	95	194
9	"9-out4614"	.38461	80	128	208
9	"9-out4615"	.27351	157	417	574
9	"9-out4616"	.98561	137	2	139
9	"9-out4617"	.77966	230	65	295
9	"9-out4618"	.27716	250	652	902
9	"9-out4619"	.15990	67	352	419
9	"9-out4620"	.31568	316	685	1001
9	"9-out4621"	.17495	88	415	503
9	"9-out4622"	.19753	32	130	162
9	"9-out4623"	.44776	90	111	201
9	"9-out4624"	.37135	140	237	377
9	"9-out4625"	.23509	71	231	302
9	"9-out4626"	.36965	346	590	936
9	"9-out4627"	.99657	291	1	292
9	"9-out4628"	.67829	175	83	258
9	"9-out4629"	.99326	295	2	297
9	"9-out4630"	.58152	321	231	552
9	"9-out4631"	.49134	426	441	867
9	"9-out4632"	.46190	97	113	210
9	"9-out4633"	.49370	353	362	715
9	"9-out4634"	.99736	379	1	380
9	"9-out4635"	.30018	166	387	553
9	"9-out4636"	.64879	242	131	373
9	"9-out4637"	.77734	398	114	512
9	"9-out4638"	.59230	154	106	260
9	"9-out4639"	.74080	423	148	571
9	"9-out4640"	.36458	35	61	96
9	"9-out4641"	.31958	31	66	97
9	"9-out4642"	.32283	41	86	127
9	"9-out4643"	.48056	136	147	283
9	"9-out4644"	.28455	105	264	369
9	"9-out4645"	.98947	94	1	95
9	"9-out4646"	.28787	19	47	66
9	"9-out4647"	.43718	87	112	199
9	"9-out4648"	.80549	352	85	437
9	"9-out4649"	.21331	141	520	661
9	"9-out4650"	.30833	74	166	240
9	"9-out4651"	.19531	25	103	128
9	"9-out4652"	.25287	66	195	261
9	"9-out4653"	.40540	135	198	333
9	"9-out4654"	.60377	448	294	742
9	"9-out4655"	.15789	27	144	171
9	"9-out4656"	.45957	108	127	235
9	"9-out4657"	.23830	107	342	449
9	"9-out4658"	.28643	171	426	597
9	"9-out4659"	.69948	135	58	193
9	"9-out4660"	.43750	91	117	208
9	"9-out4661"	.28489	149	374	523
9	"9-out4662"	.74288	1748	605	2353
9	"9-out4663"	.45209	1005	1218	2223
9	"9-out4664"	.40305	185	274	459
9	"9-out4665"	.26934	87	236	323
9	"9-out4666"	.26896	117	318	435
9	"9-out4667"	.90625	116	12	128
9	"9-out4668"	.35873	113	202	315
9	"9-out4669"	.31764	54	116	170
9	"9-out4670"	.27340	438	1164	1602
9	"9-out4671"	.25781	165	475	640
9	"9-out4672"	.26039	357	1014	1371
9	"9-out4673"	.22051	129	456	585
9	"9-out4674"	.32156	82	173	255
9	"9-out4675"	.31732	152	327	479
9	"9-out4676"	.48727	134	141	275
9	"9-out4677"	.26086	78	221	299
9	"9-out4678"	.24489	264	814	1078
9	"9-out4679"	.99082	216	2	218
9	"9-out4680"	.36170	119	210	329
9	"9-out4681"	.93251	152	11	163
9	"9-out4682"	.24105	101	318	419
9	"9-out4683"	.25356	249	733	982
9	"9-out4684"	.22707	52	177	229
9	"9-out4685"	.17967	99	452	551
9	"9-out4686"	.17967	99	452	551
9	"9-out4687"	.21649	21	76	97
9	"9-out4688"	.45487	126	151	277
9	"9-out4689"	.40067	238	356	594
9	"9-out4690"	.54539	805	671	1476
9	"9-out4691"	.99746	394	1	395
9	"9-out4692"	.37078	99	168	267
9	"9-out4693"	.48830	710	744	1454
9	"9-out4694"	.62279	672	407	1079
9	"9-out4695"	.23515	103	335	438
9	"9-out4696"	.37634	35	58	93
9	"9-out4697"	.32089	86	182	268
9	"9-out4698"	.48529	264	280	544
9	"9-out4699"	.35687	192	346	538
9	"9-out4700"	.17667	150	699	849
9	"9-out4701"	.94823	403	22	425
9	"9-out4702"	.98901	90	1	91
9	"9-out4703"	.48659	381	402	783
9	"9-out4704"	.69230	261	116	377
9	"9-out4705"	.32175	213	449	662
9	"9-out4706"	.23102	70	233	303
9	"9-out4707"	.24031	93	294	387
9	"9-out4708"	.80419	230	56	286
9	"9-out4709"	.32104	296	626	922
9	"9-out4710"	.56886	190	144	334
9	"9-out4711"	.38888	63	99	162
9	"9-out4712"	.99074	107	1	108
9	"9-out4713"	.38461	45	72	117
9	"9-out4714"	.19525	173	713	886
9	"9-out4715"	.40625	52	76	128
9	"9-out4716"	.37781	436	718	1154
9	"9-out4717"	.50298	337	333	670
9	"9-out4718"	.22222	40	140	180
9	"9-out4719"	.28874	177	436	613
9	"9-out4720"	.34313	455	871	1326
9	"9-out4721"	.48228	531	570	1101
9	"9-out4722"	.77165	196	58	254
9	"9-out4723"	.60805	166	107	273
9	"9-out4724"	.52615	171	154	325
9	"9-out4725"	.47500	95	105	200
9	"9-out4726"	.29052	181	442	623
9	"9-out4727"	.49848	164	165	329
9	"9-out4728"	.48370	460	491	951
9	"9-out4729"	.98888	89	1	90
9	"9-out4730"	.99305	143	1	144
9	"9-out4731"	.85631	1186	199	1385
9	"9-out4732"	.91304	84	8	92
9	"9-out4733"	.41666	40	56	96
9	"9-out4734"	.38421	73	117	190
9	"9-out4735"	.26050	93	264	357
9	"9-out4736"	.26666	124	341	465
9	"9-out4737"	.30277	109	251	360
9	"9-out4738"	.52845	195	174	369
9	"9-out4739"	.43069	174	230	404
9	"9-out4740"	.97580	242	6	248
9	"9-out4741"	.43389	128	167	295
9	"9-out4742"	.96675	349	12	361
9	"9-out4743"	.39169	566	879	1445
9	"9-out4744"	.19343	53	221	274
9	"9-out4745"	.98924	92	1	93
9	"9-out4746"	.15243	25	139	164
9	"9-out4747"	.46118	101	118	219
9	"9-out4748"	.35945	133	237	370
9	"9-out4749"	.18644	44	192	236
9	"9-out4750"	.69841	264	114	378
9	"9-out4751"	.99447	360	2	362
9	"9-out4752"	.13740	18	113	131
9	"9-out4753"	.55089	92	75	167
9	"9-out4754"	.99218	127	1	128
9	"9-out4755"	.41184	320	457	777
9	"9-out4756"	.32018	633	1344	1977
9	"9-out4757"	.97377	297	8	305
9	"9-out4758"	.52206	414	379	793
9	"9-out4759"	.21515	142	518	660
9	"9-out4760"	.17010	66	322	388
9	"9-out4761"	.21264	74	274	348
9	"9-out4762"	.27479	338	892	1230
9	"9-out4763"	.25685	103	298	401
9	"9-out4764"	.19747	141	573	714
9	"9-out4765"	.24492	157	484	641
9	"9-out4766"	.40265	91	135	226
9	"9-out4767"	.17340	103	491	594
9	"9-out4768"	.25531	84	245	329
9	"9-out4769"	.36591	146	253	399
9	"9-out4770"	.82167	235	51	286
9	"9-out4771"	.69333	104	46	150
9	"9-out4772"	.50381	66	65	131
9	"9-out4773"	.26754	61	167	228
9	"9-out4774"	.53012	88	78	166
9	"9-out4775"	.27294	116	309	425
9	"9-out4776"	.12826	54	367	421
9	"9-out4777"	.24108	257	809	1066
9	"9-out4778"	.32279	143	300	443
9	"9-out4779"	.21615	99	359	458
9	"9-out4780"	.28497	55	138	193
9	"9-out4781"	.18716	70	304	374
9	"9-out4782"	.28214	689	1753	2442
9	"9-out4783"	.30042	143	333	476
9	"9-out4784"	.30831	378	848	1226
9	"9-out4785"	.25949	123	351	474
9	"9-out4786"	.99841	629	1	630
9	"9-out4787"	.99746	394	1	395
9	"9-out4788"	.98529	67	1	68
9	"9-out4789"	.31158	530	1171	1701
9	"9-out4790"	.67190	342	167	509
9	"9-out4791"	.31313	93	204	297
9	"9-out4792"	.79759	398	101	499
9	"9-out4793"	.19814	64	259	323
9	"9-out4794"	.28078	114	292	406
9	"9-out4795"	.43502	231	300	531
9	"9-out4796"	.25965	168	479	647
9	"9-out4797"	.17368	33	157	190
9	"9-out4798"	.36693	91	157	248
9	"9-out4799"	.99565	229	1	230
9	"9-out4800"	.40189	170	253	423
9	"9-out4801"	.58682	196	138	334
9	"9-out4802"	.99354	770	5	775
9	"9-out4803"	.35805	280	502	782
9	"9-out4804"	.14634	48	280	328
9	"9-out4805"	.34527	106	201	307
9	"9-out4806"	.99310	288	2	290
9	"9-out4807"	.30730	181	408	589
9	"9-out4808"	.18395	133	590	723
9	"9-out4809"	.31452	184	401	585
9	"9-out4810"	.42052	127	175	302
9	"9-out4811"	.27664	109	285	394
9	"9-out4812"	.30298	559	1286	1845
9	"9-out4813"	.53648	375	324	699
9	"9-out4814"	.36122	259	458	717
9	"9-out4815"	.24770	243	738	981
9	"9-out4816"	.50574	88	86	174
9	"9-out4817"	.27015	258	697	955
9	"9-out4818"	.35915	51	91	142
9	"9-out4819"	.96969	32	1	33
9	"9-out4820"	.19953	86	345	431
9	"9-out4821"	.26984	34	92	126
9	"9-out4822"	.05737	7	115	122
9	"9-out4823"	.99621	263	1	264
9	"9-out4824"	.97222	280	8	288
9	"9-out4825"	.81939	245	54	299
9	"9-out4826"	.66666	140	70	210
9	"9-out4827"	.49137	598	619	1217
9	"9-out4828"	.54884	309	254	563
9	"9-out4829"	.42247	406	555	961
9	"9-out4830"	.20689	54	207	261
9	"9-out4831"	.24275	67	209	276
9	"9-out4832"	.98326	764	13	777
9	"9-out4833"	.43049	96	127	223
9	"9-out4834"	.88235	300	40	340
9	"9-out4835"	.69863	102	44	146
9	"9-out4836"	.34776	249	467	716
9	"9-out4837"	.12790	33	225	258
9	"9-out4838"	.82107	413	90	503
9	"9-out4839"	.44736	51	63	114
9	"9-out4840"	.44170	269	340	609
9	"9-out4841"	.88293	709	94	803
9	"9-out4842"	.32456	333	693	1026
9	"9-out4843"	.28131	146	373	519
9	"9-out4844"	.98283	2004	35	2039
9	"9-out4845"	.97756	305	7	312
9	"9-out4846"	.37986	166	271	437
9	"9-out4847"	.99029	408	4	412
9	"9-out4848"	.41418	181	256	437
9	"9-out4849"	.78924	367	98	465
9	"9-out4850"	.60204	118	78	196
9	"9-out4851"	.66666	116	58	174
9	"9-out4852"	.28571	52	130	182
9	"9-out4853"	.57425	58	43	101
9	"9-out4854"	.43364	183	239	422
9	"9-out4855"	.78073	381	107	488
9	"9-out4856"	.85423	1723	294	2017
9	"9-out4857"	.27960	85	219	304
9	"9-out4858"	.99651	286	1	287
9	"9-out4859"	.31632	217	469	686
9	"9-out4860"	.20800	104	396	500
9	"9-out4861"	.34545	171	324	495
9	"9-out4862"	.25691	65	188	253
9	"9-out4863"	.42144	169	232	401
9	"9-out4864"	.13294	23	150	173
9	"9-out4865"	.28289	43	109	152
9	"9-out4866"	.31355	37	81	118
9	"9-out4867"	.30769	36	81	117
9	"9-out4868"	.32193	113	238	351
9	"9-out4869"	.19617	41	168	209
9	"9-out4870"	.50387	65	64	129
9	"9-out4871"	.99494	197	1	198
9	"9-out4872"	.53676	73	63	136
9	"9-out4873"	.20892	103	390	493
9	"9-out4874"	.99019	101	1	102
9	"9-out4875"	.73557	612	220	832
9	"9-out4876"	.37411	211	353	564
9	"9-out4877"	.13294	23	150	173
9	"9-out4878"	.23437	60	196	256
9	"9-out4879"	.33574	186	368	554
9	"9-out4880"	.99539	216	1	217
9	"9-out4881"	.43750	63	81	144
9	"9-out4882"	.80562	315	76	391
9	"9-out4883"	.35569	509	922	1431
9	"9-out4884"	.31114	374	828	1202
9	"9-out4885"	.84143	329	62	391
9	"9-out4886"	.46315	132	153	285
9	"9-out4887"	.52749	259	232	491
9	"9-out4888"	.14723	48	278	326
9	"9-out4889"	.78901	273	73	346
9	"9-out4890"	.98795	164	2	166
9	"9-out4891"	.98148	530	10	540
9	"9-out4892"	.28191	53	135	188
9	"9-out4893"	.43750	42	54	96
9	"9-out4894"	.46258	649	754	1403
9	"9-out4895"	.37728	206	340	546
9	"9-out4896"	.39846	312	471	783
9	"9-out4897"	.41330	553	785	1338
9	"9-out4898"	.29871	210	493	703
9	"9-out4899"	.72392	118	45	163
9	"9-out4900"	.99512	204	1	205
9	"9-out4901"	.32105	122	258	380
9	"9-out4902"	.39519	658	1007	1665
9	"9-out4903"	.82083	197	43	240
9	"9-out4904"	.28755	67	166	233
9	"9-out4905"	.32673	66	136	202
9	"9-out4906"	.98787	163	2	165
9	"9-out4907"	.59641	133	90	223
9	"9-out4908"	.99009	100	1	101
9	"9-out4909"	.25693	139	402	541
9	"9-out4910"	.34320	139	266	405
9	"9-out4911"	.98913	91	1	92
9	"9-out4912"	.34677	86	162	248
9	"9-out4913"	.38034	89	145	234
9	"9-out4914"	.34529	77	146	223
9	"9-out4915"	.21965	38	135	173
9	"9-out4916"	.42105	64	88	152
9	"9-out4917"	.37237	124	209	333
9	"9-out4918"	.87261	274	40	314
9	"9-out4919"	.62222	56	34	90
9	"9-out4920"	.33333	19	38	57
9	"9-out4921"	.99805	512	1	513
9	"9-out4922"	.22118	213	750	963
9	"9-out4923"	.26181	133	375	508
9	"9-out4924"	.47468	75	83	158
9	"9-out4925"	.94615	492	28	520
9	"9-out4926"	.99798	496	1	497
9	"9-out4927"	.92292	455	38	493
9	"9-out4928"	.19765	101	410	511
9	"9-out4929"	.34025	295	572	867
9	"9-out4930"	.42094	213	293	506
9	"9-out4931"	.57852	291	212	503
9	"9-out4932"	.36460	171	298	469
9	"9-out4933"	.32807	187	383	570
9	"9-out4934"	.43636	120	155	275
9	"9-out4935"	.98571	69	1	70
9	"9-out4936"	.39949	157	236	393
9	"9-out4937"	.51006	76	73	149
9	"9-out4938"	.14413	129	766	895
9	"9-out4939"	.25561	273	795	1068
9	"9-out4940"	.29292	29	70	99
9	"9-out4941"	.74626	50	17	67
9	"9-out4942"	.36842	35	60	95
9	"9-out4943"	.39436	28	43	71
9	"9-out4944"	.63050	186	109	295
9	"9-out4945"	.27848	44	114	158
9	"9-out4946"	.23587	96	311	407
9	"9-out4947"	.28455	175	440	615
9	"9-out4948"	.59000	354	246	600
9	"9-out4949"	.92709	585	46	631
9	"9-out4950"	.27370	153	406	559
9	"9-out4951"	.32229	146	307	453
9	"9-out4952"	.39528	134	205	339
9	"9-out4953"	.60691	281	182	463
9	"9-out4954"	.15789	54	288	342
9	"9-out4955"	.49790	356	359	715
9	"9-out4956"	.39354	305	470	775
9	"9-out4957"	.43333	182	238	420
9	"9-out4958"	.18694	63	274	337
9	"9-out4959"	.59393	411	281	692
9	"9-out4960"	.68681	125	57	182
9	"9-out4961"	.08991	33	334	367
9	"9-out4962"	.73430	351	127	478
9	"9-out4963"	.77035	369	110	479
9	"9-out4964"	.18596	53	232	285
9	"9-out4965"	.31360	53	116	169
9	"9-out4966"	.67439	553	267	820
9	"9-out4967"	.21243	41	152	193
9	"9-out4968"	.25323	137	404	541
9	"9-out4969"	.18738	98	425	523
9	"9-out4970"	.27500	44	116	160
9	"9-out4971"	.35294	48	88	136
9	"9-out4972"	.98850	86	1	87
9	"9-out4973"	.24637	17	52	69
9	"9-out4974"	.18421	14	62	76
9	"9-out4975"	.98924	552	6	558
9	"9-out4976"	.21365	97	357	454
9	"9-out4977"	.40404	200	295	495
9	"9-out4978"	.26433	249	693	942
9	"9-out4979"	.18378	136	604	740
9	"9-out4980"	.21604	140	508	648
9	"9-out4981"	.20786	37	141	178
9	"9-out4982"	.25268	47	139	186
9	"9-out4983"	.33577	321	635	956
9	"9-out4984"	.32357	420	878	1298
9	"9-out4985"	.22077	34	120	154
9	"9-out4986"	.98571	69	1	70
9	"9-out4987"	.59016	36	25	61
9	"9-out4988"	.43283	29	38	67
9	"9-out4989"	.25135	93	277	370
9	"9-out4990"	.27065	95	256	351
9	"9-out4991"	.57093	491	369	860
9	"9-out4992"	.87717	1564	219	1783
9	"9-out4993"	.79467	507	131	638
9	"9-out4994"	.26975	157	425	582
9	"9-out4995"	.38769	126	199	325
9	"9-out4996"	.20000	60	240	300
9	"9-out4997"	.99734	375	1	376
9	"9-out4998"	.98461	64	1	65
9	"9-out4999"	.99340	753	5	758
9	"9-out5000"	.40437	74	109	183
9	"9-out5001"	.31325	130	285	415
9	"9-out5002"	.06862	7	95	102
9	"9-out5003"	.44715	55	68	123
9	"9-out5004"	.98484	65	1	66
9	"9-out5005"	.20512	16	62	78
9	"9-out5006"	.99358	155	1	156
9	"9-out5007"	.32432	36	75	111
9	"9-out5008"	.99324	147	1	148
9	"9-out5009"	.41265	163	232	395
9	"9-out5010"	.29227	159	385	544
9	"9-out5011"	.87415	389	56	445
9	"9-out5012"	.52307	170	155	325
9	"9-out5013"	.39363	235	362	597
9	"9-out5014"	.22685	49	167	216
9	"9-out5015"	.37307	194	326	520
9	"9-out5016"	.16883	39	192	231
9	"9-out5017"	.46715	704	803	1507
9	"9-out5018"	.43067	205	271	476
9	"9-out5019"	.22114	320	1127	1447
9	"9-out5020"	.20930	135	510	645
9	"9-out5021"	.15830	41	218	259
9	"9-out5022"	.22361	89	309	398
9	"9-out5023"	.26530	26	72	98
9	"9-out5024"	.32318	361	756	1117
9	"9-out5025"	.50306	82	81	163
9	"9-out5026"	.97933	237	5	242
9	"9-out5027"	.37532	143	238	381
9	"9-out5028"	.36464	198	345	543
9	"9-out5029"	.99523	418	2	420
9	"9-out5030"	.23809	140	448	588
9	"9-out5031"	.55357	155	125	280
9	"9-out5032"	.30088	34	79	113
9	"9-out5033"	.31351	232	508	740
9	"9-out5034"	.97849	728	16	744
9	"9-out5035"	.98765	480	6	486
9	"9-out5036"	.98100	568	11	579
9	"9-out5037"	.90504	610	64	674
9	"9-out5038"	.24651	106	324	430
9	"9-out5039"	.23636	338	1092	1430
9	"9-out5040"	.66973	436	215	651
9	"9-out5041"	.50862	177	171	348
9	"9-out5042"	.25126	99	295	394
9	"9-out5043"	.99487	194	1	195
9	"9-out5044"	.98162	374	7	381
9	"9-out5045"	.42339	152	207	359
9	"9-out5046"	.60890	383	246	629
9	"9-out5047"	.33628	38	75	113
9	"9-out5048"	.98773	161	2	163
9	"9-out5049"	.29480	227	543	770
9	"9-out5050"	.26250	105	295	400
9	"9-out5051"	.40904	416	601	1017
9	"9-out5052"	.80851	114	27	141
9	"9-out5053"	.47319	256	285	541
9	"9-out5054"	.99526	420	2	422
9	"9-out5055"	.29066	243	593	836
9	"9-out5056"	.99883	854	1	855
9	"9-out5057"	.99270	136	1	137
9	"9-out5058"	.33382	227	453	680
9	"9-out5059"	.33127	376	759	1135
9	"9-out5060"	.29038	160	391	551
9	"9-out5061"	.55111	124	101	225
9	"9-out5062"	.52912	218	194	412
9	"9-out5063"	.32904	128	261	389
9	"9-out5064"	.87862	333	46	379
9	"9-out5065"	.22262	248	866	1114
9	"9-out5066"	.40307	131	194	325
9	"9-out5067"	.65197	281	150	431
9	"9-out5068"	.43909	155	198	353
9	"9-out5069"	.32571	57	118	175
9	"9-out5070"	.65071	136	73	209
9	"9-out5071"	.48924	91	95	186
9	"9-out5072"	.33734	56	110	166
9	"9-out5073"	.98550	136	2	138
9	"9-out5074"	.35796	218	391	609
9	"9-out5075"	.41240	339	483	822
9	"9-out5076"	.12350	31	220	251
9	"9-out5077"	.26526	126	349	475
9	"9-out5078"	.39032	452	706	1158
9	"9-out5079"	.34206	248	477	725
9	"9-out5080"	.34204	157	302	459
9	"9-out5081"	.41700	103	144	247
9	"9-out5082"	.86111	434	70	504
9	"9-out5083"	.54854	113	93	206
9	"9-out5084"	.97575	322	8	330
9	"9-out5085"	.55086	444	362	806
9	"9-out5086"	.61595	332	207	539
9	"9-out5087"	.90137	1051	115	1166
9	"9-out5088"	.17620	77	360	437
9	"9-out5089"	.26846	309	842	1151
9	"9-out5090"	.28279	166	421	587
9	"9-out5091"	.58356	213	152	365
9	"9-out5092"	.35714	135	243	378
9	"9-out5093"	.27785	212	551	763
9	"9-out5094"	.96060	317	13	330
9	"9-out5095"	.21160	186	693	879
9	"9-out5096"	.25590	130	378	508
9	"9-out5097"	.32113	158	334	492
9	"9-out5098"	.24266	769	2400	3169
9	"9-out5099"	.52242	431	394	825
9	"9-out5100"	.37192	212	358	570
9	"9-out5101"	.28252	139	353	492
9	"9-out5102"	.08634	43	455	498
9	"9-out5103"	.33018	175	355	530
9	"9-out5104"	.93500	187	13	200
9	"9-out5105"	.31182	58	128	186
9	"9-out5106"	.27596	93	244	337
9	"9-out5107"	.16010	61	320	381
9	"9-out5108"	.99180	121	1	122
9	"9-out5109"	.28397	140	353	493
9	"9-out5110"	.42826	397	530	927
9	"9-out5111"	.61626	644	401	1045
9	"9-out5112"	.25000	157	471	628
9	"9-out5113"	.19268	137	574	711
9	"9-out5114"	.78723	148	40	188
9	"9-out5115"	.34782	128	240	368
9	"9-out5116"	.39347	181	279	460
9	"9-out5117"	.66820	290	144	434
9	"9-out5118"	.35333	106	194	300
9	"9-out5119"	.31818	105	225	330
9	"9-out5120"	.96242	333	13	346
9	"9-out5121"	.39787	150	227	377
9	"9-out5122"	.27250	224	598	822
9	"9-out5123"	.70103	136	58	194
9	"9-out5124"	.34065	481	931	1412
9	"9-out5125"	.62841	115	68	183
9	"9-out5126"	.97512	196	5	201
9	"9-out5127"	.67921	1624	767	2391
9	"9-out5128"	.28037	120	308	428
9	"9-out5129"	.19414	73	303	376
9	"9-out5130"	.24010	176	557	733
9	"9-out5131"	.32259	581	1220	1801
9	"9-out5132"	.51840	169	157	326
9	"9-out5133"	.29187	176	427	603
9	"9-out5134"	.43561	159	206	365
9	"9-out5135"	.99212	504	4	508
9	"9-out5136"	.14256	70	421	491
9	"9-out5137"	.38770	145	229	374
9	"9-out5138"	.25446	741	2171	2912
9	"9-out5139"	.84005	562	107	669
9	"9-out5140"	.30319	275	632	907
9	"9-out5141"	.99307	574	4	578
9	"9-out5142"	.89630	510	59	569
9	"9-out5143"	.72832	126	47	173
9	"9-out5144"	.27596	186	488	674
9	"9-out5145"	.78313	130	36	166
9	"9-out5146"	.62229	201	122	323
9	"9-out5147"	.20746	495	1891	2386
9	"9-out5148"	.43548	216	280	496
9	"9-out5149"	.40410	118	174	292
9	"9-out5150"	.34351	90	172	262
9	"9-out5151"	.57342	699	520	1219
9	"9-out5152"	.94912	541	29	570
9	"9-out5153"	.68750	154	70	224
9	"9-out5154"	.98876	88	1	89
9	"9-out5155"	.22243	117	409	526
9	"9-out5156"	.99115	224	2	226
9	"9-out5157"	.53725	137	118	255
9	"9-out5158"	.94238	229	14	243
9	"9-out5159"	.50738	275	267	542
9	"9-out5160"	.23823	81	259	340
9	"9-out5161"	.31777	1171	2514	3685
9	"9-out5162"	.22327	919	3197	4116
9	"9-out5163"	.26557	1228	3396	4624
9	"9-out5164"	.21265	988	3658	4646
9	"9-out5165"	.33068	208	421	629
9	"9-out5166"	.50755	1780	1727	3507
9	"9-out5167"	.18302	110	491	601
9	"9-out5168"	.30961	161	359	520
9	"9-out5169"	.16470	56	284	340
9	"9-out5170"	.57752	257	188	445
9	"9-out5171"	.28571	136	340	476
9	"9-out5172"	.66769	217	108	325
9	"9-out5173"	.99224	256	2	258
9	"9-out5174"	.30277	218	502	720
9	"9-out5175"	.25339	168	495	663
9	"9-out5176"	.82343	527	113	640
9	"9-out5177"	.39546	157	240	397
9	"9-out5178"	.43312	136	178	314
9	"9-out5179"	.25748	86	248	334
9	"9-out5180"	.24961	162	487	649
9	"9-out5181"	.42625	289	389	678
9	"9-out5182"	.23108	171	569	740
9	"9-out5183"	.99606	253	1	254
9	"9-out5184"	.58785	184	129	313
9	"9-out5185"	.36942	174	297	471
9	"9-out5186"	.36842	196	336	532
9	"9-out5187"	.31775	102	219	321
9	"9-out5188"	.20093	86	342	428
9	"9-out5189"	.84095	386	73	459
9	"9-out5190"	.42342	94	128	222
9	"9-out5191"	.34789	422	791	1213
9	"9-out5192"	.48199	830	892	1722
9	"9-out5193"	.25966	282	804	1086
9	"9-out5194"	.18949	101	432	533
9	"9-out5195"	.92760	410	32	442
9	"9-out5196"	.22767	51	173	224
9	"9-out5197"	.45624	464	553	1017
9	"9-out5198"	.77037	775	231	1006
9	"9-out5199"	.73333	363	132	495
9	"9-out5200"	.54202	187	158	345
9	"9-out5201"	.99498	1785	9	1794
9	"9-out5202"	.22314	459	1598	2057
9	"9-out5203"	.26009	483	1374	1857
9	"9-out5204"	.92140	340	29	369
9	"9-out5205"	.33561	98	194	292
9	"9-out5206"	.41975	272	376	648
9	"9-out5207"	.26885	139	378	517
9	"9-out5208"	.99331	297	2	299
9	"9-out5209"	.26475	350	972	1322
9	"9-out5210"	.52325	180	164	344
9	"9-out5211"	.82634	276	58	334
9	"9-out5212"	.27047	109	294	403
9	"9-out5213"	.24180	118	370	488
9	"9-out5214"	.30172	140	324	464
9	"9-out5215"	.34696	246	463	709
9	"9-out5216"	.99651	286	1	287
9	"9-out5217"	.21059	151	566	717
9	"9-out5218"	.33333	129	258	387
9	"9-out5219"	.36903	255	436	691
9	"9-out5220"	.08099	26	295	321
9	"9-out5221"	.27858	229	593	822
9	"9-out5222"	.24644	52	159	211
9	"9-out5223"	.35288	373	684	1057
9	"9-out5224"	.25063	98	293	391
9	"9-out5225"	.13054	53	353	406
9	"9-out5226"	.40772	95	138	233
9	"9-out5227"	.27891	41	106	147
9	"9-out5228"	.47849	89	97	186
9	"9-out5229"	.16593	76	382	458
9	"9-out5230"	.99081	647	6	653
9	"9-out5231"	.40384	126	186	312
9	"9-out5232"	.62500	140	84	224
9	"9-out5233"	.20071	56	223	279
9	"9-out5234"	.28406	246	620	866
9	"9-out5235"	.24974	248	745	993
9	"9-out5236"	.66384	942	477	1419
9	"9-out5237"	.99724	362	1	363
9	"9-out5238"	.36075	228	404	632
9	"9-out5239"	.38636	187	297	484
9	"9-out5240"	.43269	90	118	208
9	"9-out5241"	.54107	191	162	353
9	"9-out5242"	.32114	246	520	766
9	"9-out5243"	.14868	62	355	417
9	"9-out5244"	.80676	167	40	207
9	"9-out5245"	.42259	101	138	239
9	"9-out5246"	.21478	61	223	284
9	"9-out5247"	.20673	43	165	208
9	"9-out5248"	.24969	205	616	821
9	"9-out5249"	.99696	329	1	330
9	"9-out5250"	.37445	428	715	1143
9	"9-out5251"	.32008	145	308	453
9	"9-out5252"	.55148	241	196	437
9	"9-out5253"	.32323	160	335	495
9	"9-out5254"	.18518	235	1034	1269
9	"9-out5255"	.20353	23	90	113
9	"9-out5256"	.19532	92	379	471
9	"9-out5257"	.18111	117	529	646
9	"9-out5258"	.92090	163	14	177
9	"9-out5259"	.99319	146	1	147
9	"9-out5260"	.55230	264	214	478
9	"9-out5261"	.18523	138	607	745
9	"9-out5262"	.34567	280	530	810
9	"9-out5263"	.95475	211	10	221
9	"9-out5264"	.90740	98	10	108
9	"9-out5265"	.61773	202	125	327
9	"9-out5266"	.29934	138	323	461
9	"9-out5267"	.25352	36	106	142
9	"9-out5268"	.27631	147	385	532
9	"9-out5269"	.98876	88	1	89
9	"9-out5270"	.29571	304	724	1028
9	"9-out5271"	.42071	130	179	309
9	"9-out5272"	.85940	434	71	505
9	"9-out5273"	.31714	111	239	350
9	"9-out5274"	.72961	170	63	233
9	"9-out5275"	.84285	177	33	210
9	"9-out5276"	.92124	386	33	419
9	"9-out5277"	.61224	300	190	490
9	"9-out5278"	.88684	337	43	380
9	"9-out5279"	.57058	97	73	170
9	"9-out5280"	.27160	66	177	243
9	"9-out5281"	.42339	619	843	1462
9	"9-out5282"	.53140	110	97	207
9	"9-out5283"	.32870	71	145	216
9	"9-out5284"	.24626	66	202	268
9	"9-out5285"	.27233	317	847	1164
9	"9-out5286"	.55483	86	69	155
9	"9-out5287"	.43127	91	120	211
9	"9-out5288"	.26486	49	136	185
9	"9-out5289"	.21993	128	454	582
9	"9-out5290"	.48148	52	56	108
9	"9-out5291"	.14899	52	297	349
9	"9-out5292"	.17477	79	373	452
9	"9-out5293"	.98876	88	1	89
9	"9-out5294"	.25000	36	108	144
9	"9-out5295"	.94234	474	29	503
9	"9-out5296"	.68983	645	290	935
9	"9-out5297"	.23715	60	193	253
9	"9-out5298"	.28571	70	175	245
9	"9-out5299"	.33682	289	569	858
9	"9-out5300"	.60486	199	130	329
9	"9-out5301"	.32014	89	189	278
9	"9-out5302"	.30103	87	202	289
9	"9-out5303"	.51758	103	96	199
9	"9-out5304"	.04142	7	162	169
9	"9-out5305"	.10439	19	163	182
9	"9-out5306"	.99193	123	1	124
9	"9-out5307"	.59310	86	59	145
9	"9-out5308"	.25806	40	115	155
9	"9-out5309"	.99931	1467	1	1468
9	"9-out5310"	.28676	78	194	272
9	"9-out5311"	.37866	181	297	478
9	"9-out5312"	.33990	69	134	203
9	"9-out5313"	.46049	1154	1352	2506
9	"9-out5314"	.30909	68	152	220
9	"9-out5315"	.32920	770	1569	2339
9	"9-out5316"	.12911	102	688	790
9	"9-out5317"	.42276	156	213	369
9	"9-out5318"	.27853	61	158	219
9	"9-out5319"	.21777	174	625	799
9	"9-out5320"	.38339	314	505	819
9	"9-out5321"	.30351	190	436	626
9	"9-out5322"	.39606	141	215	356
9	"9-out5323"	.20426	67	261	328
9	"9-out5324"	.29378	104	250	354
9	"9-out5325"	.43269	135	177	312
9	"9-out5326"	.21428	66	242	308
9	"9-out5327"	.30939	56	125	181
9	"9-out5328"	.92968	357	27	384
9	"9-out5329"	.30872	46	103	149
9	"9-out5330"	.87157	414	61	475
9	"9-out5331"	.39527	117	179	296
9	"9-out5332"	.27238	146	390	536
9	"9-out5333"	.27645	81	212	293
9	"9-out5334"	.26253	89	250	339
9	"9-out5335"	.97468	77	2	79
9	"9-out5336"	.34932	182	339	521
9	"9-out5337"	.36624	204	353	557
9	"9-out5338"	.31707	91	196	287
9	"9-out5339"	.67267	224	109	333
9	"9-out5340"	.30084	142	330	472
9	"9-out5341"	.36286	172	302	474
9	"9-out5342"	.25531	36	105	141
9	"9-out5343"	.18656	100	436	536
9	"9-out5344"	.46680	225	257	482
9	"9-out5345"	.19397	103	428	531
9	"9-out5346"	.35433	180	328	508
9	"9-out5347"	.45631	282	336	618
9	"9-out5348"	.98783	406	5	411
9	"9-out5349"	.35582	116	210	326
9	"9-out5350"	.24640	120	367	487
9	"9-out5351"	.17238	216	1037	1253
9	"9-out5352"	.33174	139	280	419
9	"9-out5353"	.41666	55	77	132
9	"9-out5354"	.63304	295	171	466
9	"9-out5355"	.63738	341	194	535
9	"9-out5356"	.33597	127	251	378
9	"9-out5357"	.29844	345	811	1156
9	"9-out5358"	.31440	299	652	951
9	"9-out5359"	.49159	117	121	238
9	"9-out5360"	.30368	198	454	652
9	"9-out5361"	.26829	66	180	246
9	"9-out5362"	.19841	50	202	252
9	"9-out5363"	.25872	126	361	487
9	"9-out5364"	.34814	564	1056	1620
9	"9-out5365"	.23451	265	865	1130
9	"9-out5366"	.18698	204	887	1091
9	"9-out5367"	.13861	14	87	101
9	"9-out5368"	.99487	194	1	195
9	"9-out5369"	.99526	210	1	211
9	"9-out5370"	.35169	300	553	853
9	"9-out5371"	.30057	52	121	173
9	"9-out5372"	.25396	224	658	882
9	"9-out5373"	.20512	688	2666	3354
9	"9-out5374"	.38565	172	274	446
9	"9-out5375"	.98116	573	11	584
9	"9-out5376"	.99367	157	1	158
9	"9-out5377"	.26984	34	92	126
9	"9-out5378"	.98412	310	5	315
9	"9-out5379"	.33368	319	637	956
9	"9-out5380"	.54919	307	252	559
9	"9-out5381"	.28045	221	567	788
9	"9-out5382"	.33333	103	206	309
9	"9-out5383"	.50476	159	156	315
9	"9-out5384"	.29389	77	185	262
9	"9-out5385"	.79852	650	164	814
9	"9-out5386"	.17630	61	285	346
9	"9-out5387"	.48806	225	236	461
9	"9-out5388"	.16566	83	418	501
9	"9-out5389"	.98799	1234	15	1249
9	"9-out5390"	.22310	56	195	251
9	"9-out5391"	.98888	89	1	90
9	"9-out5392"	.81062	351	82	433
9	"9-out5393"	.45671	364	433	797
9	"9-out5394"	.83471	202	40	242
9	"9-out5395"	.24519	102	314	416
9	"9-out5396"	.20224	36	142	178
9	"9-out5397"	.74468	525	180	705
9	"9-out5398"	.30370	123	282	405
9	"9-out5399"	.49808	130	131	261
9	"9-out5400"	.28604	125	312	437
9	"9-out5401"	.38095	48	78	126
9	"9-out5402"	.83471	202	40	242
9	"9-out5403"	.34845	315	589	904
9	"9-out5404"	.31066	233	517	750
9	"9-out5405"	.34706	851	1601	2452
9	"9-out5406"	.45161	126	153	279
9	"9-out5407"	.53319	249	218	467
9	"9-out5408"	.59646	473	320	793
9	"9-out5409"	.23529	140	455	595
9	"9-out5410"	.47922	323	351	674
9	"9-out5411"	.95628	175	8	183
9	"9-out5412"	.20434	160	623	783
9	"9-out5413"	.97572	201	5	206
9	"9-out5414"	.24137	42	132	174
9	"9-out5415"	.99658	292	1	293
9	"9-out5416"	.14736	42	243	285
9	"9-out5417"	.39530	236	361	597
9	"9-out5418"	.77032	815	243	1058
9	"9-out5419"	.47107	57	64	121
9	"9-out5420"	.98958	95	1	96
9	"9-out5421"	.99206	125	1	126
9	"9-out5422"	.23144	53	176	229
9	"9-out5423"	.35071	222	411	633
9	"9-out5424"	.25000	164	492	656
9	"9-out5425"	.33318	740	1481	2221
9	"9-out5426"	.28846	240	592	832
9	"9-out5427"	.26700	212	582	794
9	"9-out5428"	.30880	256	573	829
9	"9-out5429"	.28428	199	501	700
9	"9-out5430"	.30994	212	472	684
9	"9-out5431"	.29637	401	952	1353
9	"9-out5432"	.29116	336	818	1154
9	"9-out5433"	.99122	226	2	228
9	"9-out5434"	.80445	325	79	404
9	"9-out5435"	.18681	34	148	182
9	"9-out5436"	.19104	64	271	335
9	"9-out5437"	.36015	273	485	758
9	"9-out5438"	.31378	107	234	341
9	"9-out5439"	.44772	424	523	947
9	"9-out5440"	.90891	479	48	527
9	"9-out5441"	.46224	202	235	437
9	"9-out5442"	.99838	1235	2	1237
9	"9-out5443"	.82113	303	66	369
9	"9-out5444"	.81043	295	69	364
9	"9-out5445"	.26100	83	235	318
9	"9-out5446"	.26308	181	507	688
9	"9-out5447"	.67138	237	116	353
9	"9-out5448"	.16996	43	210	253
9	"9-out5449"	.70464	167	70	237
9	"9-out5450"	.36734	54	93	147
9	"9-out5451"	.43169	79	104	183
9	"9-out5452"	.31964	109	232	341
9	"9-out5453"	.36744	79	136	215
9	"9-out5454"	.29118	76	185	261
9	"9-out5455"	.23574	186	603	789
9	"9-out5456"	.28728	366	908	1274
9	"9-out5457"	.27135	108	290	398
9	"9-out5458"	.27817	116	301	417
9	"9-out5459"	.26065	214	607	821
9	"9-out5460"	.27354	183	486	669
9	"9-out5461"	.25385	329	967	1296
9	"9-out5462"	.46812	470	534	1004
9	"9-out5463"	.11815	151	1127	1278
9	"9-out5464"	.33823	161	315	476
9	"9-out5465"	.22211	235	823	1058
9	"9-out5466"	.82262	640	138	778
9	"9-out5467"	.32130	579	1223	1802
9	"9-out5468"	.99601	250	1	251
9	"9-out5469"	.76494	371	114	485
9	"9-out5470"	.42015	221	305	526
9	"9-out5471"	.99426	520	3	523
9	"9-out5472"	.98976	580	6	586
9	"9-out5473"	.46938	46	52	98
9	"9-out5474"	.99408	168	1	169
9	"9-out5475"	.98979	97	1	98
9	"9-out5476"	.47328	124	138	262
9	"9-out5477"	.99949	1981	1	1982
9	"9-out5478"	.49847	163	164	327
9	"9-out5479"	.55401	200	161	361
9	"9-out5480"	.31958	62	132	194
9	"9-out5481"	.33582	45	89	134
9	"9-out5482"	.99462	185	1	186
9	"9-out5483"	.34347	395	755	1150
9	"9-out5484"	.36727	101	174	275
9	"9-out5485"	.39613	328	500	828
9	"9-out5486"	.19095	152	644	796
9	"9-out5487"	.99438	709	4	713
9	"9-out5488"	.38115	906	1471	2377
9	"9-out5489"	.48846	233	244	477
9	"9-out5490"	.31994	215	457	672
9	"9-out5491"	.26315	160	448	608
9	"9-out5492"	.22541	188	646	834
9	"9-out5493"	.25787	131	377	508
9	"9-out5494"	.15519	106	577	683
9	"9-out5495"	.87162	129	19	148
9	"9-out5496"	.23788	108	346	454
9	"9-out5497"	.26609	62	171	233
9	"9-out5498"	.31562	101	219	320
9	"9-out5499"	.27972	280	721	1001
9	"9-out5500"	.96518	305	11	316
9	"9-out5501"	.43076	112	148	260
9	"9-out5502"	.99929	1426	1	1427
9	"9-out5503"	.96819	487	16	503
9	"9-out5504"	.99290	140	1	141
9	"9-out5505"	.35099	510	943	1453
9	"9-out5506"	.59233	170	117	287
9	"9-out5507"	.97457	115	3	118
9	"9-out5508"	.25480	53	155	208
9	"9-out5509"	.88181	97	13	110
9	"9-out5510"	.31034	225	500	725
9	"9-out5511"	.22483	67	231	298
9	"9-out5512"	.45754	97	115	212
9	"9-out5513"	.27490	138	364	502
9	"9-out5514"	.98837	85	1	86
9	"9-out5515"	.25939	145	414	559
9	"9-out5516"	.40730	145	211	356
9	"9-out5517"	.34878	158	295	453
9	"9-out5518"	.43222	169	222	391
9	"9-out5519"	.58974	299	208	507
9	"9-out5520"	.28070	112	287	399
9	"9-out5521"	.41042	559	803	1362
9	"9-out5522"	.31761	101	217	318
9	"9-out5523"	.33333	137	274	411
9	"9-out5524"	.26141	315	890	1205
9	"9-out5525"	.48015	121	131	252
9	"9-out5526"	.51060	578	554	1132
9	"9-out5527"	.81684	388	87	475
9	"9-out5528"	.97897	326	7	333
9	"9-out5529"	.31428	77	168	245
9	"9-out5530"	.34234	76	146	222
9	"9-out5531"	.36312	256	449	705
9	"9-out5532"	.30689	89	201	290
9	"9-out5533"	.19387	114	474	588
9	"9-out5534"	.33445	198	394	592
9	"9-out5535"	.40603	942	1378	2320
9	"9-out5536"	.33118	617	1246	1863
9	"9-out5537"	.21932	168	598	766
9	"9-out5538"	.68571	360	165	525
9	"9-out5539"	.99560	453	2	455
9	"9-out5540"	.99656	290	1	291
9	"9-out5541"	.21739	110	396	506
9	"9-out5542"	.18213	53	238	291
9	"9-out5543"	.19531	75	309	384
9	"9-out5544"	.31226	168	370	538
9	"9-out5545"	.98198	327	6	333
9	"9-out5546"	.44966	402	492	894
9	"9-out5547"	.57482	242	179	421
9	"9-out5548"	.35775	249	447	696
9	"9-out5549"	.40926	963	1390	2353
9	"9-out5550"	.35600	356	644	1000
9	"9-out5551"	.32458	136	283	419
9	"9-out5552"	.24000	84	266	350
9	"9-out5553"	.26385	300	837	1137
9	"9-out5554"	.25628	51	148	199
9	"9-out5555"	.59036	49	34	83
9	"9-out5556"	.29365	37	89	126
9	"9-out5557"	.61250	245	155	400
9	"9-out5558"	.42222	114	156	270
9	"9-out5559"	.99736	379	1	380
9	"9-out5560"	.29956	207	484	691
9	"9-out5561"	.31392	124	271	395
9	"9-out5562"	.30020	148	345	493
9	"9-out5563"	.25335	586	1727	2313
9	"9-out5564"	.32091	267	565	832
9	"9-out5565"	.24434	108	334	442
9	"9-out5566"	.24161	36	113	149
9	"9-out5567"	.30872	46	103	149
9	"9-out5568"	.30490	454	1035	1489
9	"9-out5569"	.45622	99	118	217
9	"9-out5570"	.34776	257	482	739
9	"9-out5571"	.35177	178	328	506
9	"9-out5572"	.41863	301	418	719
9	"9-out5573"	.32103	261	552	813
9	"9-out5574"	.38549	271	432	703
9	"9-out5575"	.27101	187	503	690
9	"9-out5576"	.37058	63	107	170
9	"9-out5577"	.32299	229	480	709
9	"9-out5578"	.29281	330	797	1127
9	"9-out5579"	.33574	93	184	277
9	"9-out5580"	.35852	370	662	1032
9	"9-out5581"	.29079	180	439	619
9	"9-out5582"	.80141	226	56	282
9	"9-out5583"	.26487	187	519	706
9	"9-out5584"	.52713	136	122	258
9	"9-out5585"	.32795	122	250	372
9	"9-out5586"	.39774	247	374	621
9	"9-out5587"	.32532	203	421	624
9	"9-out5588"	.12639	34	235	269
9	"9-out5589"	.17283	42	201	243
9	"9-out5590"	.62601	77	46	123
9	"9-out5591"	.52901	155	138	293
9	"9-out5592"	.30612	30	68	98
9	"9-out5593"	.99200	124	1	125
9	"9-out5594"	.53888	97	83	180
9	"9-out5595"	.49557	56	57	113
9	"9-out5596"	.24864	552	1668	2220
9	"9-out5597"	.37080	409	694	1103
9	"9-out5598"	.25206	122	362	484
9	"9-out5599"	.77272	85	25	110
9	"9-out5600"	.18851	151	650	801
9	"9-out5601"	.14649	115	670	785
9	"9-out5602"	.24201	523	1638	2161
9	"9-out5603"	.33231	109	219	328
9	"9-out5604"	.23837	82	262	344
9	"9-out5605"	.29299	92	222	314
9	"9-out5606"	.28076	73	187	260
9	"9-out5607"	.17732	147	682	829
9	"9-out5608"	.48895	155	162	317
9	"9-out5609"	.23086	181	603	784
9	"9-out5610"	.52482	74	67	141
9	"9-out5611"	.24239	454	1419	1873
9	"9-out5612"	.43911	119	152	271
9	"9-out5613"	.18729	112	486	598
9	"9-out5614"	.31632	62	134	196
9	"9-out5615"	.25342	37	109	146
9	"9-out5616"	.81102	103	24	127
9	"9-out5617"	.32086	163	345	508
9	"9-out5618"	.30744	380	856	1236
9	"9-out5619"	.95303	1035	51	1086
9	"9-out5620"	.30472	142	324	466
9	"9-out5621"	.97601	407	10	417
9	"9-out5622"	.41626	174	244	418
9	"9-out5623"	.24866	326	985	1311
9	"9-out5624"	.99137	115	1	116
9	"9-out5625"	.99145	116	1	117
9	"9-out5626"	.99849	665	1	666
9	"9-out5627"	.34643	326	615	941
9	"9-out5628"	.99849	665	1	666
9	"9-out5629"	.40000	64	96	160
9	"9-out5630"	.20754	33	126	159
9	"9-out5631"	.28007	156	401	557
9	"9-out5632"	.99404	167	1	168
9	"9-out5633"	.25366	173	509	682
9	"9-out5634"	.38578	787	1253	2040
9	"9-out5635"	.26412	547	1524	2071
9	"9-out5636"	.43541	209	271	480
9	"9-out5637"	.28384	130	328	458
9	"9-out5638"	.51655	234	219	453
9	"9-out5639"	.39285	187	289	476
9	"9-out5640"	.34166	82	158	240
9	"9-out5641"	.98709	153	2	155
9	"9-out5642"	.51551	432	406	838
9	"9-out5643"	.67536	233	112	345
9	"9-out5644"	.16331	73	374	447
9	"9-out5645"	.28443	159	400	559
9	"9-out5646"	.42857	84	112	196
9	"9-out5647"	.23553	57	185	242
9	"9-out5648"	.36311	126	221	347
9	"9-out5649"	.93162	109	8	117
9	"9-out5650"	.97142	34	1	35
9	"9-out5651"	.36065	88	156	244
9	"9-out5652"	.15136	94	527	621
9	"9-out5653"	.23398	84	275	359
9	"9-out5654"	.25352	108	318	426
9	"9-out5655"	.44052	200	254	454
9	"9-out5656"	.21863	122	436	558
9	"9-out5657"	.23270	74	244	318
9	"9-out5658"	.21594	260	944	1204
9	"9-out5659"	.29355	556	1338	1894
9	"9-out5660"	.35042	82	152	234
9	"9-out5661"	.62264	132	80	212
9	"9-out5662"	.23765	77	247	324
9	"9-out5663"	.78300	433	120	553
9	"9-out5664"	.31578	120	260	380
9	"9-out5665"	.53634	214	185	399
9	"9-out5666"	.59574	224	152	376
9	"9-out5667"	.32352	220	460	680
9	"9-out5668"	.68100	190	89	279
9	"9-out5669"	.19439	201	833	1034
9	"9-out5670"	.97714	171	4	175
9	"9-out5671"	.49809	131	132	263
9	"9-out5672"	.90232	194	21	215
9	"9-out5673"	.39923	525	790	1315
9	"9-out5674"	.28969	104	255	359
9	"9-out5675"	.44169	125	158	283
9	"9-out5676"	.90322	280	30	310
9	"9-out5677"	.18602	221	967	1188
9	"9-out5678"	.99570	232	1	233
9	"9-out5679"	.30704	109	246	355
9	"9-out5680"	.32662	146	301	447
9	"9-out5681"	.35483	55	100	155
9	"9-out5682"	.19621	83	340	423
9	"9-out5683"	.28121	250	639	889
9	"9-out5684"	.44414	326	408	734
9	"9-out5685"	.91919	182	16	198
9	"9-out5686"	.39146	211	328	539
9	"9-out5687"	.43003	126	167	293
9	"9-out5688"	.32814	232	475	707
9	"9-out5689"	.30936	185	413	598
9	"9-out5690"	.30638	72	163	235
9	"9-out5691"	.99428	174	1	175
9	"9-out5692"	.17424	115	545	660
9	"9-out5693"	.15408	100	549	649
9	"9-out5694"	.39607	101	154	255
9	"9-out5695"	.14534	25	147	172
9	"9-out5696"	.31795	193	414	607
9	"9-out5697"	.95913	446	19	465
9	"9-out5698"	.97596	406	10	416
9	"9-out5699"	.42830	227	303	530
9	"9-out5700"	.45000	63	77	140
9	"9-out5701"	.44478	145	181	326
9	"9-out5702"	.99137	115	1	116
9	"9-out5703"	.99090	109	1	110
9	"9-out5704"	.24521	141	434	575
9	"9-out5705"	.33620	39	77	116
9	"9-out5706"	.99850	666	1	667
9	"9-out5707"	.38108	133	216	349
9	"9-out5708"	.55974	178	140	318
9	"9-out5709"	.99425	173	1	174
9	"9-out5710"	.34121	231	446	677
9	"9-out5711"	.49924	329	330	659
9	"9-out5712"	.38746	136	215	351
9	"9-out5713"	.23253	932	3076	4008
9	"9-out5714"	.95435	460	22	482
9	"9-out5715"	.38759	50	79	129
9	"9-out5716"	.21581	161	585	746
9	"9-out5717"	.48623	53	56	109
9	"9-out5718"	.99596	494	2	496
9	"9-out5719"	.19480	60	248	308
9	"9-out5720"	.99582	477	2	479
9	"9-out5721"	.15497	106	578	684
9	"9-out5722"	.33333	29	58	87
9	"9-out5723"	.99438	177	1	178
9	"9-out5724"	.67368	64	31	95
9	"9-out5725"	.24521	141	434	575
9	"9-out5726"	.36743	176	303	479
9	"9-out5727"	.26301	96	269	365
9	"9-out5728"	.99849	665	1	666
9	"9-out5729"	.96475	438	16	454
9	"9-out5730"	.26589	138	381	519
9	"9-out5731"	.40000	88	132	220
9	"9-out5732"	.38505	201	321	522
9	"9-out5733"	.20689	72	276	348
9	"9-out5734"	.55819	235	186	421
9	"9-out5735"	.97028	653	20	673
9	"9-out5736"	.69372	188	83	271
9	"9-out5737"	.52351	256	233	489
9	"9-out5738"	.97196	104	3	107
9	"9-out5739"	.43960	222	283	505
9	"9-out5740"	.98701	152	2	154
9	"9-out5741"	.83155	311	63	374
9	"9-out5742"	.99415	340	2	342
9	"9-out5743"	.23800	124	397	521
9	"9-out5744"	.30364	208	477	685
9	"9-out5745"	.29356	187	450	637
9	"9-out5746"	.31415	213	465	678
9	"9-out5747"	.22591	129	442	571
9	"9-out5748"	.26068	61	173	234
9	"9-out5749"	.36713	525	905	1430
9	"9-out5750"	.27010	1313	3548	4861
9	"9-out5751"	.65928	3187	1647	4834
9	"9-out5752"	.31015	165	367	532
9	"9-out5753"	.38363	422	678	1100
9	"9-out5754"	.36036	200	355	555
9	"9-out5755"	.27295	327	871	1198
9	"9-out5756"	.19773	122	495	617
9	"9-out5757"	.95476	401	19	420
9	"9-out5758"	.98405	432	7	439
9	"9-out5759"	.55419	363	292	655
9	"9-out5760"	.22377	128	444	572
9	"9-out5761"	.98941	187	2	189
9	"9-out5762"	.39972	291	437	728
9	"9-out5763"	.35253	153	281	434
9	"9-out5764"	.70111	502	214	716
9	"9-out5765"	.97596	406	10	416
9	"9-out5766"	.43651	306	395	701
9	"9-out5767"	.17977	16	73	89
9	"9-out5768"	.34963	379	705	1084
9	"9-out5769"	.32113	158	334	492
9	"9-out5770"	.19733	414	1684	2098
9	"9-out5771"	.37869	128	210	338
9	"9-out5772"	.61676	309	192	501
9	"9-out5773"	.92266	692	58	750
9	"9-out5774"	.53825	204	175	379
9	"9-out5775"	.65315	290	154	444
9	"9-out5776"	.29099	181	441	622
9	"9-out5777"	.71712	289	114	403
9	"9-out5778"	.39387	347	534	881
9	"9-out5779"	.23665	102	329	431
9	"9-out5780"	.99640	277	1	278
9	"9-out5781"	.99645	281	1	282
9	"9-out5782"	.99640	277	1	278
9	"9-out5783"	.90710	166	17	183
9	"9-out5784"	.26485	798	2215	3013
9	"9-out5785"	.27810	606	1573	2179
9	"9-out5786"	.64223	517	288	805
9	"9-out5787"	.30352	241	553	794
9	"9-out5788"	.61674	383	238	621
9	"9-out5789"	.24517	165	508	673
9	"9-out5790"	.39666	119	181	300
9	"9-out5791"	.97601	407	10	417
9	"9-out5792"	.81337	292	67	359
9	"9-out5793"	.99849	665	1	666
9	"9-out5794"	.19512	24	99	123
9	"9-out5795"	.14075	67	409	476
9	"9-out5796"	.26554	269	744	1013
9	"9-out5797"	.26725	395	1083	1478
9	"9-out5798"	.82115	528	115	643
9	"9-out5799"	.99690	322	1	323
9	"9-out5800"	.32467	175	364	539
9	"9-out5801"	.94011	989	63	1052
9	"9-out5802"	.33542	107	212	319
9	"9-out5803"	.15867	96	509	605
9	"9-out5804"	.33463	86	171	257
9	"9-out5805"	.40582	209	306	515
9	"9-out5806"	.28405	196	494	690
9	"9-out5807"	.17777	40	185	225
9	"9-out5808"	.41632	102	143	245
9	"9-out5809"	.69169	175	78	253
9	"9-out5810"	.72093	186	72	258
9	"9-out5811"	.12037	26	190	216
9	"9-out5812"	.32770	466	956	1422
9	"9-out5813"	.78888	213	57	270
9	"9-out5814"	.27536	209	550	759
9	"9-out5815"	.23214	65	215	280
9	"9-out5816"	.65151	387	207	594
9	"9-out5817"	.23026	35	117	152
9	"9-out5818"	.25870	52	149	201
9	"9-out5819"	.29383	62	149	211
9	"9-out5820"	.28884	132	325	457
9	"9-out5821"	.49747	197	199	396
9	"9-out5822"	.29706	172	407	579
9	"9-out5823"	.43220	204	268	472
9	"9-out5824"	.75097	193	64	257
9	"9-out5825"	.19860	114	460	574
9	"9-out5826"	.99687	319	1	320
9	"9-out5827"	.22243	351	1227	1578
9	"9-out5828"	.36554	261	453	714
9	"9-out5829"	.19603	99	406	505
9	"9-out5830"	.26446	224	623	847
9	"9-out5831"	.23546	81	263	344
9	"9-out5832"	.48588	3356	3551	6907
9	"9-out5833"	.37603	91	151	242
9	"9-out5834"	.29813	192	452	644
9	"9-out5835"	.41141	137	196	333
9	"9-out5836"	.99845	646	1	647
9	"9-out5837"	.22829	142	480	622
9	"9-out5838"	.16666	57	285	342
9	"9-out5839"	.50904	197	190	387
9	"9-out5840"	.25742	26	75	101
9	"9-out5841"	.33962	90	175	265
9	"9-out5842"	.50555	91	89	180
9	"9-out5843"	.68571	120	55	175
9	"9-out5844"	.22008	217	769	986
9	"9-out5845"	.25475	134	392	526
9	"9-out5846"	.28030	333	855	1188
9	"9-out5847"	.25778	207	596	803
9	"9-out5848"	.41436	75	106	181
9	"9-out5849"	.38043	70	114	184
9	"9-out5850"	.40274	323	479	802
9	"9-out5851"	.59039	209	145	354
9	"9-out5852"	.88324	174	23	197
9	"9-out5853"	.95480	169	8	177
9	"9-out5854"	.95365	535	26	561
9	"9-out5855"	.44073	554	703	1257
9	"9-out5856"	.30042	140	326	466
9	"9-out5857"	.29831	142	334	476
9	"9-out5858"	.62062	337	206	543
9	"9-out5859"	.41104	201	288	489
9	"9-out5860"	.41949	383	530	913
9	"9-out5861"	.29890	272	638	910
9	"9-out5862"	.18337	139	619	758
9	"9-out5863"	.38606	205	326	531
9	"9-out5864"	.29868	250	587	837
9	"9-out5865"	.17241	55	264	319
9	"9-out5866"	.42445	795	1078	1873
9	"9-out5867"	.35842	100	179	279
9	"9-out5868"	.99897	1942	2	1944
9	"9-out5869"	.32361	111	232	343
9	"9-out5870"	.24462	91	281	372
9	"9-out5871"	.42105	136	187	323
9	"9-out5872"	.94610	158	9	167
9	"9-out5873"	.24309	44	137	181
9	"9-out5874"	.44011	599	762	1361
9	"9-out5875"	.35906	200	357	557
9	"9-out5876"	.35195	63	116	179
9	"9-out5877"	.50537	94	92	186
9	"9-out5878"	.47386	281	312	593
9	"9-out5879"	.52427	216	196	412
9	"9-out5880"	.42911	563	749	1312
9	"9-out5881"	.19021	35	149	184
9	"9-out5882"	.51837	395	367	762
9	"9-out5883"	.42542	348	470	818
9	"9-out5884"	.67021	189	93	282
9	"9-out5885"	.34107	235	454	689
9	"9-out5886"	.36811	321	551	872
9	"9-out5887"	.96026	145	6	151
9	"9-out5888"	.13636	15	95	110
9	"9-out5889"	.29350	587	1413	2000
9	"9-out5890"	.28454	556	1398	1954
9	"9-out5891"	.25009	679	2036	2715
9	"9-out5892"	.32447	940	1957	2897
9	"9-out5893"	.27777	165	429	594
9	"9-out5894"	.42687	467	627	1094
9	"9-out5895"	.25584	186	541	727
9	"9-out5896"	.49595	184	187	371
9	"9-out5897"	.38219	73	118	191
9	"9-out5898"	.20666	217	833	1050
9	"9-out5899"	.24163	195	612	807
9	"9-out5900"	.32142	27	57	84
9	"9-out5901"	.25386	82	241	323
9	"9-out5902"	.09885	43	392	435
9	"9-out5903"	.24040	144	455	599
9	"9-out5904"	.33161	129	260	389
9	"9-out5905"	.25579	254	739	993
9	"9-out5906"	.20817	107	407	514
9	"9-out5907"	.89958	215	24	239
9	"9-out5908"	.86216	319	51	370
9	"9-out5909"	.24512	88	271	359
9	"9-out5910"	.43719	355	457	812
9	"9-out5911"	.88921	305	38	343
9	"9-out5912"	.21176	72	268	340
9	"9-out5913"	.37139	322	545	867
9	"9-out5914"	.37455	209	349	558
9	"9-out5915"	.55140	59	48	107
9	"9-out5916"	.41950	185	256	441
9	"9-out5917"	.52542	62	56	118
9	"9-out5918"	.38128	652	1058	1710
9	"9-out5919"	.23990	719	2278	2997
9	"9-out5920"	.31258	236	519	755
9	"9-out5921"	.30878	1409	3154	4563
9	"9-out5922"	.27067	72	194	266
9	"9-out5923"	.97819	314	7	321
9	"9-out5924"	.18042	94	427	521
9	"9-out5925"	.29834	54	127	181
9	"9-out5926"	.32485	115	239	354
9	"9-out5927"	.54545	168	140	308
9	"9-out5928"	.36296	245	430	675
9	"9-out5929"	.35521	276	501	777
9	"9-out5930"	.28768	437	1082	1519
9	"9-out5931"	.32718	195	401	596
9	"9-out5932"	.23790	349	1118	1467
9	"9-out5933"	.37618	515	854	1369
9	"9-out5934"	.34065	62	120	182
9	"9-out5935"	.35465	793	1443	2236
9	"9-out5936"	.90500	181	19	200
9	"9-out5937"	.97860	183	4	187
9	"9-out5938"	.30769	268	603	871
9	"9-out5939"	.30788	125	281	406
9	"9-out5940"	.26817	343	936	1279
9	"9-out5941"	.76811	530	160	690
9	"9-out5942"	.94677	1512	85	1597
9	"9-out5943"	.60745	554	358	912
9	"9-out5944"	.23639	365	1179	1544
9	"9-out5945"	.24732	208	633	841
9	"9-out5946"	.88300	317	42	359
9	"9-out5947"	.97280	322	9	331
9	"9-out5948"	.22448	44	152	196
9	"9-out5949"	.41666	85	119	204
9	"9-out5950"	.44134	79	100	179
9	"9-out5951"	.67748	334	159	493
9	"9-out5952"	.32828	195	399	594
9	"9-out5953"	.21621	48	174	222
9	"9-out5954"	.96240	256	10	266
9	"9-out5955"	.99447	360	2	362
9	"9-out5956"	.99447	360	2	362
9	"9-out5957"	.31297	123	270	393
9	"9-out5958"	.95890	350	15	365
9	"9-out5959"	.31333	94	206	300
9	"9-out5960"	.30902	267	597	864
9	"9-out5961"	.28163	158	403	561
9	"9-out5962"	.99513	819	4	823
9	"9-out5963"	.28611	101	252	353
9	"9-out5964"	.79515	361	93	454
9	"9-out5965"	.17407	47	223	270
9	"9-out5966"	.15337	50	276	326
9	"9-out5967"	.27176	128	343	471
9	"9-out5968"	.25536	321	936	1257
9	"9-out5969"	.42136	142	195	337
9	"9-out5970"	.42570	212	286	498
9	"9-out5971"	.28316	143	362	505
9	"9-out5972"	.99109	1002	9	1011
9	"9-out5973"	.93975	234	15	249
9	"9-out5974"	.47659	224	246	470
9	"9-out5975"	.67408	333	161	494
9	"9-out5976"	.98863	261	3	264
9	"9-out5977"	.12690	50	344	394
9	"9-out5978"	.17684	165	768	933
9	"9-out5979"	.91584	555	51	606
9	"9-out5980"	.85276	139	24	163
9	"9-out5981"	.31055	100	222	322
9	"9-out5982"	.39175	190	295	485
9	"9-out5983"	.99130	342	3	345
9	"9-out5984"	.32288	103	216	319
9	"9-out5985"	.57142	300	225	525
9	"9-out5986"	.23935	118	375	493
9	"9-out5987"	.33993	223	433	656
9	"9-out5988"	.92456	1581	129	1710
9	"9-out5989"	.21508	211	770	981
9	"9-out5990"	.38609	161	256	417
9	"9-out5991"	.33612	321	634	955
9	"9-out5992"	.23205	97	321	418
9	"9-out5993"	.28653	149	371	520
9	"9-out5994"	.15841	16	85	101
9	"9-out5995"	.37149	159	269	428
9	"9-out5996"	.21793	316	1134	1450
9	"9-out5997"	.99793	483	1	484
9	"9-out5998"	.39292	389	601	990
9	"9-out5999"	.95247	481	24	505
9	"9-out6000"	.28229	118	300	418
9	"9-out6001"	.26944	97	263	360
9	"9-out6002"	.32612	407	841	1248
9	"9-out6003"	.34645	88	166	254
9	"9-out6004"	.15618	154	832	986
9	"9-out6005"	.19881	168	677	845
9	"9-out6006"	.24349	103	320	423
9	"9-out6007"	.27403	114	302	416
9	"9-out6008"	.71502	138	55	193
9	"9-out6009"	.97137	509	15	524
9	"9-out6010"	.98734	156	2	158
9	"9-out6011"	.69879	58	25	83
9	"9-out6012"	.27260	208	555	763
9	"9-out6013"	.63741	276	157	433
9	"9-out6014"	.26530	91	252	343
9	"9-out6015"	.32558	168	348	516
9	"9-out6016"	.99513	819	4	823
9	"9-out6017"	.29082	187	456	643
9	"9-out6018"	.54104	145	123	268
9	"9-out6019"	.38775	171	270	441
9	"9-out6020"	.26030	202	574	776
9	"9-out6021"	.27696	208	543	751
9	"9-out6022"	.29479	102	244	346
9	"9-out6023"	.97781	617	14	631
9	"9-out6024"	.49095	217	225	442
9	"9-out6025"	.25352	36	106	142
9	"9-out6026"	.40823	109	158	267
9	"9-out6027"	.99661	294	1	295
9	"9-out6028"	.75728	156	50	206
9	"9-out6029"	.26073	85	241	326
9	"9-out6030"	.88821	437	55	492
9	"9-out6031"	.27917	256	661	917
9	"9-out6032"	.53472	231	201	432
9	"9-out6033"	.35061	257	476	733
9	"9-out6034"	.37837	224	368	592
9	"9-out6035"	.32786	180	369	549
9	"9-out6036"	.36850	220	377	597
9	"9-out6037"	.30359	211	484	695
9	"9-out6038"	.34312	257	492	749
9	"9-out6039"	.34380	186	355	541
9	"9-out6040"	.21978	80	284	364
9	"9-out6041"	.99145	116	1	117
9	"9-out6042"	.99145	116	1	117
9	"9-out6043"	.07792	12	142	154
9	"9-out6044"	.23283	139	458	597
9	"9-out6045"	.23744	208	668	876
9	"9-out6046"	.23413	214	700	914
9	"9-out6047"	.18614	86	376	462
9	"9-out6048"	.40784	239	347	586
9	"9-out6049"	.31944	23	49	72
9	"9-out6050"	.98550	68	1	69
9	"9-out6051"	.43806	145	186	331
9	"9-out6052"	.25848	396	1136	1532
9	"9-out6053"	.35355	169	309	478
9	"9-out6054"	.24078	98	309	407
9	"9-out6055"	.35714	110	198	308
9	"9-out6056"	.84946	316	56	372
9	"9-out6057"	.37762	162	267	429
9	"9-out6058"	.17857	65	299	364
9	"9-out6059"	.26000	65	185	250
9	"9-out6060"	.25748	129	372	501
9	"9-out6061"	.44395	202	253	455
9	"9-out6062"	.60222	271	179	450
9	"9-out6063"	.21467	158	578	736
9	"9-out6064"	.27526	128	337	465
9	"9-out6065"	.99119	563	5	568
9	"9-out6066"	.99310	144	1	145
9	"9-out6067"	.99310	144	1	145
9	"9-out6068"	.96577	254	9	263
9	"9-out6069"	.99619	262	1	263
9	"9-out6070"	.98479	259	4	263
9	"9-out6071"	.98113	104	2	106
9	"9-out6072"	.98113	104	2	106
9	"9-out6073"	.95098	194	10	204
9	"9-out6074"	.25855	219	628	847
9	"9-out6075"	.94690	107	6	113
9	"9-out6076"	.97142	102	3	105
9	"9-out6077"	.37121	294	498	792
9	"9-out6078"	.40159	151	225	376
9	"9-out6079"	.42747	389	521	910
9	"9-out6080"	.94565	87	5	92
9	"9-out6081"	.22500	45	155	200
9	"9-out6082"	.74660	165	56	221
9	"9-out6083"	.80295	163	40	203
9	"9-out6084"	.40358	90	133	223
9	"9-out6085"	.19534	42	173	215
9	"9-out6086"	.25630	122	354	476
9	"9-out6087"	.36231	75	132	207
9	"9-out6088"	.60768	443	286	729
9	"9-out6089"	.96078	49	2	51
9	"9-out6090"	.96252	411	16	427
9	"9-out6091"	.35176	299	551	850
9	"9-out6092"	.89928	750	84	834
9	"9-out6093"	.61373	143	90	233
9	"9-out6094"	.33512	125	248	373
9	"9-out6095"	.18041	35	159	194
9	"9-out6096"	.68067	486	228	714
9	"9-out6097"	.38461	85	136	221
9	"9-out6098"	.21940	52	185	237
9	"9-out6099"	.39170	85	132	217
9	"9-out6100"	.85446	182	31	213
9	"9-out6101"	.88537	224	29	253
9	"9-out6102"	.23680	193	622	815
9	"9-out6103"	.68627	245	112	357
9	"9-out6104"	.40336	192	284	476
9	"9-out6105"	.17995	79	360	439
9	"9-out6106"	.89312	585	70	655
9	"9-out6107"	.96236	895	35	930
9	"9-out6108"	.42253	90	123	213
9	"9-out6109"	.33009	102	207	309
9	"9-out6110"	.39547	367	561	928
9	"9-out6111"	.12807	26	177	203
9	"9-out6112"	.35937	92	164	256
9	"9-out6113"	.97849	91	2	93
9	"9-out6114"	.33033	110	223	333
9	"9-out6115"	.11111	24	192	216
9	"9-out6116"	.18009	38	173	211
9	"9-out6117"	.30412	59	135	194
9	"9-out6118"	.31506	69	150	219
9	"9-out6119"	.54368	112	94	206
9	"9-out6120"	.19230	40	168	208
9	"9-out6121"	.83858	213	41	254
9	"9-out6122"	.86614	220	34	254
9	"9-out6123"	.81592	164	37	201
9	"9-out6124"	.99497	198	1	199
9	"9-out6125"	.40597	231	338	569
9	"9-out6126"	.35416	68	124	192
9	"9-out6127"	.77812	491	140	631
9	"9-out6128"	.35151	174	321	495
9	"9-out6129"	.37652	494	818	1312
9	"9-out6130"	.23694	177	570	747
9	"9-out6131"	.42018	179	247	426
9	"9-out6132"	.93052	375	28	403
9	"9-out6133"	.29084	89	217	306
9	"9-out6134"	.27964	533	1373	1906
9	"9-out6135"	.31393	178	389	567
9	"9-out6136"	.56310	116	90	206
9	"9-out6137"	.71195	131	53	184
9	"9-out6138"	.21352	60	221	281
9	"9-out6139"	.98132	788	15	803
9	"9-out6140"	.48763	493	518	1011
9	"9-out6141"	.39903	83	125	208
9	"9-out6142"	.33128	108	218	326
9	"9-out6143"	.25856	83	238	321
9	"9-out6144"	.27207	114	305	419
9	"9-out6145"	.28932	309	759	1068
9	"9-out6146"	.27515	309	814	1123
9	"9-out6147"	.34791	167	313	480
9	"9-out6148"	.09119	29	289	318
9	"9-out6149"	.50100	249	248	497
9	"9-out6150"	.99479	191	1	192
9	"9-out6151"	.29518	441	1053	1494
9	"9-out6152"	.34886	322	601	923
9	"9-out6153"	.27093	466	1254	1720
9	"9-out6154"	.32730	217	446	663
9	"9-out6155"	.16666	11	55	66
9	"9-out6156"	.99333	596	4	600
9	"9-out6157"	.35409	108	197	305
9	"9-out6158"	.37797	127	209	336
9	"9-out6159"	.29729	99	234	333
9	"9-out6160"	.30337	108	248	356
9	"9-out6161"	.18400	69	306	375
9	"9-out6162"	.38684	147	233	380
9	"9-out6163"	.64345	231	128	359
9	"9-out6164"	.43216	172	226	398
9	"9-out6165"	.20076	105	418	523
9	"9-out6166"	.24113	68	214	282
9	"9-out6167"	.37345	121	203	324
9	"9-out6168"	.24535	66	203	269
9	"9-out6169"	.34069	108	209	317
9	"9-out6170"	.20891	75	284	359
9	"9-out6171"	.34236	139	267	406
9	"9-out6172"	.45557	241	288	529
9	"9-out6173"	.35733	134	241	375
9	"9-out6174"	.26076	109	309	418
9	"9-out6175"	.16225	135	697	832
9	"9-out6176"	.81088	566	132	698
9	"9-out6177"	.88067	524	71	595
9	"9-out6178"	.99747	395	1	396
9	"9-out6179"	.99512	408	2	410
9	"9-out6180"	.20812	41	156	197
9	"9-out6181"	.98366	542	9	551
9	"9-out6182"	.80085	374	93	467
9	"9-out6183"	.38314	300	483	783
9	"9-out6184"	.87159	224	33	257
9	"9-out6185"	.24605	78	239	317
9	"9-out6186"	.98245	112	2	114
9	"9-out6187"	.28467	195	490	685
9	"9-out6188"	.29180	89	216	305
9	"9-out6189"	.75000	144	48	192
9	"9-out6190"	.21718	182	656	838
9	"9-out6191"	.43989	322	410	732
9	"9-out6192"	.16326	24	123	147
9	"9-out6193"	.32659	97	200	297
9	"9-out6194"	.30913	115	257	372
9	"9-out6195"	.15540	23	125	148
9	"9-out6196"	.97902	280	6	286
9	"9-out6197"	.32899	177	361	538
9	"9-out6198"	.34969	57	106	163
9	"9-out6199"	.24190	284	890	1174
9	"9-out6200"	.99130	114	1	115
9	"9-out6201"	.37795	48	79	127
9	"9-out6202"	.36210	193	340	533
9	"9-out6203"	.36494	254	442	696
9	"9-out6204"	.46347	184	213	397
9	"9-out6205"	.24965	182	547	729
9	"9-out6206"	.92021	173	15	188
9	"9-out6207"	.45890	134	158	292
9	"9-out6208"	.46067	82	96	178
9	"9-out6209"	.24218	31	97	128
9	"9-out6210"	.20356	80	313	393
9	"9-out6211"	.18947	72	308	380
9	"9-out6212"	.47635	141	155	296
9	"9-out6213"	.65853	270	140	410
9	"9-out6214"	.26315	150	420	570
9	"9-out6215"	.29819	198	466	664
9	"9-out6216"	.32000	112	238	350
9	"9-out6217"	.55128	86	70	156
9	"9-out6218"	.41505	193	272	465
9	"9-out6219"	.19767	51	207	258
9	"9-out6220"	.99523	418	2	420
9	"9-out6221"	.83152	153	31	184
9	"9-out6222"	.26984	34	92	126
9	"9-out6223"	.31518	110	239	349
9	"9-out6224"	.33544	106	210	316
9	"9-out6225"	.99494	197	1	198
9	"9-out6226"	.27956	78	201	279
9	"9-out6227"	.28900	113	278	391
9	"9-out6228"	.49744	195	197	392
9	"9-out6229"	.29805	107	252	359
9	"9-out6230"	.38344	227	365	592
9	"9-out6231"	.24291	60	187	247
9	"9-out6232"	.99346	152	1	153
9	"9-out6233"	.41666	80	112	192
9	"9-out6234"	.99841	630	1	631
9	"9-out6235"	.99591	244	1	245
9	"9-out6236"	.74042	174	61	235
9	"9-out6237"	.58128	118	85	203
9	"9-out6238"	.49565	114	116	230
9	"9-out6239"	.31075	211	468	679
9	"9-out6240"	.37130	88	149	237
9	"9-out6241"	.60000	132	88	220
9	"9-out6242"	.41155	235	336	571
9	"9-out6243"	.99342	151	1	152
9	"9-out6244"	.99705	339	1	340
9	"9-out6245"	.35227	93	171	264
9	"9-out6246"	.90551	345	36	381
9	"9-out6247"	.14381	43	256	299
9	"9-out6248"	.81379	354	81	435
9	"9-out6249"	.28240	61	155	216
9	"9-out6250"	.73828	189	67	256
9	"9-out6251"	.27715	148	386	534
9	"9-out6252"	.18705	260	1130	1390
9	"9-out6253"	.27818	417	1082	1499
9	"9-out6254"	.18796	25	108	133
9	"9-out6255"	.34170	476	917	1393
9	"9-out6256"	.30547	223	507	730
9	"9-out6257"	.86176	879	141	1020
9	"9-out6258"	.85632	298	50	348
9	"9-out6259"	.23577	29	94	123
9	"9-out6260"	.82026	251	55	306
9	"9-out6261"	.93203	96	7	103
9	"9-out6262"	.46875	60	68	128
9	"9-out6263"	.22018	72	255	327
9	"9-out6264"	.48058	99	107	206
9	"9-out6265"	.46341	95	110	205
9	"9-out6266"	.46601	96	110	206
9	"9-out6267"	.31648	119	257	376
9	"9-out6268"	.24039	169	534	703
9	"9-out6269"	.36581	259	449	708
9	"9-out6270"	.95081	290	15	305
9	"9-out6271"	.42105	200	275	475
9	"9-out6272"	.35451	357	650	1007
9	"9-out6273"	.35410	125	228	353
9	"9-out6274"	.96860	216	7	223
9	"9-out6275"	.69594	103	45	148
9	"9-out6276"	.33717	234	460	694
9	"9-out6277"	.45454	125	150	275
9	"9-out6278"	.25292	108	319	427
9	"9-out6279"	.92024	150	13	163
9	"9-out6280"	.38990	170	266	436
9	"9-out6281"	.24365	144	447	591
9	"9-out6282"	.40119	536	800	1336
9	"9-out6283"	.83962	178	34	212
9	"9-out6284"	.36823	211	362	573
9	"9-out6285"	.23657	185	597	782
9	"9-out6286"	.35261	256	470	726
9	"9-out6287"	.18666	28	122	150
9	"9-out6288"	.99473	189	1	190
9	"9-out6289"	.29756	61	144	205
9	"9-out6290"	.31034	81	180	261
9	"9-out6291"	.80869	93	22	115
9	"9-out6292"	.34693	51	96	147
9	"9-out6293"	.54482	395	330	725
9	"9-out6294"	.91666	341	31	372
9	"9-out6295"	.91509	194	18	212
9	"9-out6296"	.74137	43	15	58
9	"9-out6297"	.99130	114	1	115
9	"9-out6298"	.59296	236	162	398
9	"9-out6299"	.97540	119	3	122
9	"9-out6300"	.99523	209	1	210
9	"9-out6301"	.37560	77	128	205
9	"9-out6302"	.52131	318	292	610
9	"9-out6303"	.33012	103	209	312
9	"9-out6304"	.35159	77	142	219
9	"9-out6305"	.33179	72	145	217
9	"9-out6306"	.99539	216	1	217
9	"9-out6307"	.99310	144	1	145
9	"9-out6308"	.89051	122	15	137
9	"9-out6309"	.98305	58	1	59
9	"9-out6310"	.99621	263	1	264
9	"9-out6311"	.99588	242	1	243
9	"9-out6312"	.99489	195	1	196
9	"9-out6313"	.37313	50	84	134
9	"9-out6314"	.26705	231	634	865
9	"9-out6315"	.28784	135	334	469
9	"9-out6316"	.99000	594	6	600
9	"9-out6317"	.78330	535	148	683
9	"9-out6318"	.15240	187	1040	1227
9	"9-out6319"	.90361	150	16	166
9	"9-out6320"	.40411	491	724	1215
9	"9-out6321"	.34382	153	292	445
9	"9-out6322"	.78326	206	57	263
9	"9-out6323"	.88292	181	24	205
9	"9-out6324"	.46086	53	62	115
9	"9-out6325"	.27320	103	274	377
9	"9-out6326"	.24620	146	447	593
9	"9-out6327"	.24022	43	136	179
9	"9-out6328"	.21222	250	928	1178
9	"9-out6329"	.63917	62	35	97
9	"9-out6330"	.99596	494	2	496
9	"9-out6331"	.34451	113	215	328
9	"9-out6332"	.32307	63	132	195
9	"9-out6333"	.26381	210	586	796
9	"9-out6334"	.13793	36	225	261
9	"9-out6335"	.40073	109	163	272
9	"9-out6336"	.23877	404	1288	1692
9	"9-out6337"	.29064	118	288	406
9	"9-out6338"	.73778	287	102	389
9	"9-out6339"	.96744	208	7	215
9	"9-out6340"	.92553	174	14	188
9	"9-out6341"	.99264	135	1	136
9	"9-out6342"	.22304	60	209	269
9	"9-out6343"	.84112	180	34	214
9	"9-out6344"	.98029	199	4	203
9	"9-out6345"	.98461	128	2	130
9	"9-out6346"	.99578	472	2	474
9	"9-out6347"	.99578	472	2	474
9	"9-out6348"	.99579	474	2	476
9	"9-out6349"	.99789	473	1	474
9	"9-out6350"	.46268	310	360	670
9	"9-out6351"	.66622	1004	503	1507
9	"9-out6352"	.99547	220	1	221
9	"9-out6353"	.99547	220	1	221
9	"9-out6354"	.93990	391	25	416
9	"9-out6355"	.97087	300	9	309
9	"9-out6356"	.54985	772	632	1404
9	"9-out6357"	.20599	165	636	801
9	"9-out6358"	.77232	173	51	224
9	"9-out6359"	.99450	181	1	182
9	"9-out6360"	.17534	165	776	941
9	"9-out6361"	.95652	132	6	138
9	"9-out6362"	.40209	269	400	669
9	"9-out6363"	.97907	468	10	478
9	"9-out6364"	.17772	75	347	422
9	"9-out6365"	.29675	311	737	1048
9	"9-out6366"	.37741	117	193	310
9	"9-out6367"	.99431	175	1	176
9	"9-out6368"	.89552	300	35	335
9	"9-out6369"	.93192	397	29	426
9	"9-out6370"	.33803	623	1220	1843
9	"9-out6371"	.63142	221	129	350
9	"9-out6372"	.48484	128	136	264
9	"9-out6373"	.21138	26	97	123
9	"9-out6374"	.48631	373	394	767
9	"9-out6375"	.43019	151	200	351
9	"9-out6376"	.26403	127	354	481
9	"9-out6377"	.27070	134	361	495
9	"9-out6378"	.32541	137	284	421
9	"9-out6379"	.24007	272	861	1133
9	"9-out6380"	.26100	83	235	318
9	"9-out6381"	.99038	103	1	104
9	"9-out6382"	.33272	182	365	547
9	"9-out6383"	.99047	104	1	105
9	"9-out6384"	.32878	217	443	660
9	"9-out6385"	.47266	268	299	567
9	"9-out6386"	.99736	379	1	380
9	"9-out6387"	.33480	378	751	1129
9	"9-out6388"	.24044	107	338	445
9	"9-out6389"	.28413	77	194	271
9	"9-out6390"	.27682	129	337	466
9	"9-out6391"	.30859	237	531	768
9	"9-out6392"	.09487	37	353	390
9	"9-out6393"	.34491	268	509	777
9	"9-out6394"	.40669	85	124	209
9	"9-out6395"	.34237	265	509	774
9	"9-out6396"	.88095	333	45	378
9	"9-out6397"	.56530	277	213	490
9	"9-out6398"	.99227	642	5	647
9	"9-out6399"	.17800	157	725	882
9	"9-out6400"	.20610	54	208	262
9	"9-out6401"	.99544	1750	8	1758
9	"9-out6402"	.29331	171	412	583
9	"9-out6403"	.44025	70	89	159
9	"9-out6404"	.36185	148	261	409
9	"9-out6405"	.47508	143	158	301
9	"9-out6406"	.80769	609	145	754
9	"9-out6407"	.33540	54	107	161
9	"9-out6408"	.17307	9	43	52
9	"9-out6409"	.35908	172	307	479
9	"9-out6410"	.23471	142	463	605
9	"9-out6411"	.31258	236	519	755
9	"9-out6412"	.36784	167	287	454
9	"9-out6413"	.49767	214	216	430
9	"9-out6414"	.33333	124	248	372
9	"9-out6415"	.52685	363	326	689
9	"9-out6416"	.81431	728	166	894
9	"9-out6417"	.99791	478	1	479
9	"9-out6418"	.35077	248	459	707
9	"9-out6419"	.99803	508	1	509
9	"9-out6420"	.31629	328	709	1037
9	"9-out6421"	.99581	476	2	478
9	"9-out6422"	.70707	140	58	198
9	"9-out6423"	.32191	517	1089	1606
9	"9-out6424"	.47089	89	100	189
9	"9-out6425"	.99951	4126	2	4128
9	"9-out6426"	.57723	355	260	615
9	"9-out6427"	.17180	39	188	227
9	"9-out6428"	.61702	58	36	94
9	"9-out6429"	.25782	173	498	671
9	"9-out6430"	.28333	153	387	540
9	"9-out6431"	.21705	28	101	129
9	"9-out6432"	.37960	175	286	461
9	"9-out6433"	.46760	267	304	571
9	"9-out6434"	.30555	110	250	360
9	"9-out6435"	.38907	114	179	293
9	"9-out6436"	.94052	253	16	269
9	"9-out6437"	.94476	325	19	344
9	"9-out6438"	.99719	355	1	356
9	"9-out6439"	.95227	419	21	440
9	"9-out6440"	.24496	73	225	298
9	"9-out6441"	.31464	174	379	553
9	"9-out6442"	.21012	83	312	395
9	"9-out6443"	.98507	594	9	603
9	"9-out6444"	.29045	70	171	241
9	"9-out6445"	.26808	63	172	235
9	"9-out6446"	.23739	273	877	1150
9	"9-out6447"	.33898	320	624	944
9	"9-out6448"	.32101	252	533	785
9	"9-out6449"	.65140	185	99	284
9	"9-out6450"	.46995	305	344	649
9	"9-out6451"	.85887	213	35	248
9	"9-out6452"	.31864	405	866	1271
9	"9-out6453"	.24817	34	103	137
9	"9-out6454"	.20499	156	605	761
9	"9-out6455"	.42180	89	122	211
9	"9-out6456"	.32128	80	169	249
9	"9-out6457"	.31314	305	669	974
9	"9-out6458"	.36261	388	682	1070
9	"9-out6459"	.45593	238	284	522
9	"9-out6460"	.19828	185	748	933
9	"9-out6461"	.48837	84	88	172
9	"9-out6462"	.91237	177	17	194
9	"9-out6463"	.31404	369	806	1175
9	"9-out6464"	.42687	216	290	506
9	"9-out6465"	.23404	88	288	376
9	"9-out6466"	.48780	100	105	205
9	"9-out6467"	.25688	112	324	436
9	"9-out6468"	.51436	197	186	383
9	"9-out6469"	.21839	133	476	609
9	"9-out6470"	1.00000	969	0	969
9	"9-out6471"	1.00000	812	0	812
9	"9-out6472"	1.00000	1459	0	1459
9	"9-out6473"	.22141	153	538	691
9	"9-out6474"	.14367	100	596	696
9	"9-out6475"	.51797	317	295	612
9	"9-out6476"	.26223	225	633	858
9	"9-out6477"	.36842	56	96	152
9	"9-out6478"	.38281	245	395	640
9	"9-out6479"	.82727	91	19	110
9	"9-out6480"	.55430	148	119	267
9	"9-out6481"	.48132	116	125	241
9	"9-out6482"	.99669	302	1	303
9	"9-out6483"	.14027	62	380	442
9	"9-out6484"	.98888	267	3	270
9	"9-out6485"	.37588	106	176	282
9	"9-out6486"	.99488	1749	9	1758
9	"9-out6487"	.40484	117	172	289
9	"9-out6488"	.52384	758	689	1447
9	"9-out6489"	.22604	92	315	407
9	"9-out6490"	.34086	196	379	575
9	"9-out6491"	.50306	164	162	326
9	"9-out6492"	.48043	307	332	639
9	"9-out6493"	.76923	80	24	104
9	"9-out6494"	.42560	123	166	289
9	"9-out6495"	.30830	78	175	253
9	"9-out6496"	.35483	121	220	341
9	"9-out6497"	.98437	126	2	128
9	"9-out6498"	.26618	148	408	556
9	"9-out6499"	.42140	126	173	299
9	"9-out6500"	.26144	257	726	983
9	"9-out6501"	.31136	567	1254	1821
9	"9-out6502"	.32009	129	274	403
9	"9-out6503"	.19626	147	602	749
9	"9-out6504"	.34713	478	899	1377
9	"9-out6505"	.99090	436	4	440
9	"9-out6506"	.99663	296	1	297
9	"9-out6507"	.31702	324	698	1022
9	"9-out6508"	.24137	119	374	493
9	"9-out6509"	.53571	240	208	448
9	"9-out6510"	.20287	113	444	557
9	"9-out6511"	.99749	398	1	399
9	"9-out6512"	.80944	514	121	635
9	"9-out6513"	.99509	203	1	204
9	"9-out6514"	.25779	91	262	353
9	"9-out6515"	.40042	187	280	467
9	"9-out6516"	.65238	137	73	210
9	"9-out6517"	.94964	132	7	139
9	"9-out6518"	.21893	74	264	338
9	"9-out6519"	.30827	82	184	266
9	"9-out6520"	.85982	503	82	585
9	"9-out6521"	.81889	208	46	254
9	"9-out6522"	.23048	251	838	1089
9	"9-out6523"	.29166	126	306	432
9	"9-out6524"	.26785	225	615	840
9	"9-out6525"	.89024	73	9	82
9	"9-out6526"	.15757	52	278	330
9	"9-out6527"	.39050	148	231	379
9	"9-out6528"	.28682	1217	3026	4243
9	"9-out6529"	.94026	488	31	519
9	"9-out6530"	.98976	387	4	391
9	"9-out6531"	.24963	1017	3057	4074
9	"9-out6532"	.90285	158	17	175
9	"9-out6533"	.27215	43	115	158
9	"9-out6534"	.28860	400	986	1386
9	"9-out6535"	.42356	133	181	314
9	"9-out6536"	.46712	412	470	882
9	"9-out6537"	.44047	111	141	252
9	"9-out6538"	.21825	165	591	756
9	"9-out6539"	.35504	109	198	307
9	"9-out6540"	.23762	24	77	101
9	"9-out6541"	.40080	99	148	247
9	"9-out6542"	.38133	188	305	493
9	"9-out6543"	.34439	83	158	241
9	"9-out6544"	.21007	196	737	933
9	"9-out6545"	.42340	199	271	470
9	"9-out6546"	.80310	155	38	193
9	"9-out6547"	.31174	284	627	911
9	"9-out6548"	.32133	1411	2980	4391
9	"9-out6549"	.45454	1150	1380	2530
9	"9-out6550"	.34768	210	394	604
9	"9-out6551"	.47002	196	221	417
9	"9-out6552"	.22933	86	289	375
9	"9-out6553"	.50467	162	159	321
9	"9-out6554"	.36395	103	180	283
9	"9-out6555"	.32539	123	255	378
9	"9-out6556"	.39789	491	743	1234
9	"9-out6557"	.39524	183	280	463
9	"9-out6558"	.53731	288	248	536
9	"9-out6559"	.20077	52	207	259
9	"9-out6560"	.98214	165	3	168
9	"9-out6561"	.99481	192	1	193
9	"9-out6562"	.43902	108	138	246
9	"9-out6563"	.15991	75	394	469
9	"9-out6564"	.30616	139	315	454
9	"9-out6565"	.22368	153	531	684
9	"9-out6566"	.25563	295	859	1154
9	"9-out6567"	.26853	192	523	715
9	"9-out6568"	.09448	24	230	254
9	"9-out6569"	.16527	99	500	599
9	"9-out6570"	.33163	65	131	196
9	"9-out6571"	.56502	126	97	223
9	"9-out6572"	.84615	110	20	130
9	"9-out6573"	.36628	604	1045	1649
9	"9-out6574"	.25328	193	569	762
9	"9-out6575"	.70552	115	48	163
9	"9-out6576"	.18061	41	186	227
9	"9-out6577"	.46173	181	211	392
9	"9-out6578"	.35240	1004	1845	2849
9	"9-out6579"	.21039	85	319	404
9	"9-out6580"	.40353	320	473	793
9	"9-out6581"	.39346	253	390	643
9	"9-out6582"	.32826	259	530	789
9	"9-out6583"	.29881	176	413	589
9	"9-out6584"	.30183	230	532	762
9	"9-out6585"	.32648	397	819	1216
9	"9-out6586"	.61680	837	520	1357
9	"9-out6587"	.98201	273	5	278
9	"9-out6588"	.19400	97	403	500
9	"9-out6589"	.98913	91	1	92
9	"9-out6590"	.22000	66	234	300
9	"9-out6591"	.51870	208	193	401
9	"9-out6592"	.36220	46	81	127
9	"9-out6593"	.35068	128	237	365
9	"9-out6594"	.92000	207	18	225
9	"9-out6595"	.16346	17	87	104
9	"9-out6596"	.35350	111	203	314
9	"9-out6597"	.21649	63	228	291
9	"9-out6598"	.99942	1731	1	1732
9	"9-out6599"	.31279	467	1026	1493
9	"9-out6600"	.52980	160	142	302
9	"9-out6601"	.31543	47	102	149
9	"9-out6602"	.58108	129	93	222
9	"9-out6603"	.36093	449	795	1244
9	"9-out6604"	.33209	448	901	1349
9	"9-out6605"	.27364	379	1006	1385
9	"9-out6606"	.31801	256	549	805
9	"9-out6607"	.44551	278	346	624
9	"9-out6608"	.26155	232	655	887
9	"9-out6609"	.24299	78	243	321
9	"9-out6610"	.26039	144	409	553
9	"9-out6611"	.31907	194	414	608
9	"9-out6612"	.36540	433	752	1185
9	"9-out6613"	.46855	231	262	493
9	"9-out6614"	.73333	594	216	810
9	"9-out6615"	.18102	229	1036	1265
9	"9-out6616"	.38559	546	870	1416
9	"9-out6617"	.90753	1698	173	1871
9	"9-out6618"	.99826	577	1	578
9	"9-out6619"	.61675	243	151	394
9	"9-out6620"	.50453	167	164	331
9	"9-out6621"	.56000	70	55	125
9	"9-out6622"	.33388	407	812	1219
9	"9-out6623"	.26582	210	580	790
9	"9-out6624"	.29411	125	300	425
9	"9-out6625"	.34318	383	733	1116
9	"9-out6626"	.32228	107	225	332
9	"9-out6627"	.99621	1052	4	1056
9	"9-out6628"	.81142	142	33	175
9	"9-out6629"	.29616	255	606	861
9	"9-out6630"	.36147	167	295	462
9	"9-out6631"	.42432	443	601	1044
9	"9-out6632"	.25706	182	526	708
9	"9-out6633"	.90634	3900	403	4303
9	"9-out6634"	.66486	123	62	185
9	"9-out6635"	.31690	45	97	142
9	"9-out6636"	.65675	287	150	437
9	"9-out6637"	.22811	99	335	434
9	"9-out6638"	.28806	649	1604	2253
9	"9-out6639"	.31020	152	338	490
9	"9-out6640"	.42582	155	209	364
9	"9-out6641"	.18759	242	1048	1290
9	"9-out6642"	.26816	454	1239	1693
9	"9-out6643"	.28949	317	778	1095
9	"9-out6644"	.34161	385	742	1127
9	"9-out6645"	.99690	322	1	323
9	"9-out6646"	.15081	46	259	305
9	"9-out6647"	.20357	148	579	727
9	"9-out6648"	.34871	257	480	737
9	"9-out6649"	.22899	169	569	738
9	"9-out6650"	.34124	647	1249	1896
9	"9-out6651"	.99333	149	1	150
9	"9-out6652"	.40597	775	1134	1909
9	"9-out6653"	.31441	493	1075	1568
9	"9-out6654"	.99656	1742	6	1748
9	"9-out6655"	.99628	536	2	538
9	"9-out6656"	.99376	1754	11	1765
9	"9-out6657"	.60115	104	69	173
9	"9-out6658"	.99122	113	1	114
9	"9-out6659"	.14761	62	358	420
9	"9-out6660"	.23407	180	589	769
9	"9-out6661"	.79219	1258	330	1588
9	"9-out6662"	.43628	493	637	1130
9	"9-out6663"	.21608	43	156	199
9	"9-out6664"	.24675	57	174	231
9	"9-out6665"	.17173	254	1225	1479
9	"9-out6666"	.34342	431	824	1255
9	"9-out6667"	.25000	178	534	712
9	"9-out6668"	.99746	788	2	790
9	"9-out6669"	.52165	277	254	531
9	"9-out6670"	.27906	36	93	129
9	"9-out6671"	.41967	128	177	305
9	"9-out6672"	.21173	166	618	784
9	"9-out6673"	.29081	57	139	196
9	"9-out6674"	.27383	112	297	409
9	"9-out6675"	.28967	345	846	1191
9	"9-out6676"	.40677	432	630	1062
9	"9-out6677"	.44329	129	162	291
9	"9-out6678"	.25806	352	1012	1364
9	"9-out6679"	.98666	296	4	300
9	"9-out6680"	.64569	503	276	779
9	"9-out6681"	.24620	276	845	1121
9	"9-out6682"	.35517	103	187	290
9	"9-out6683"	.34229	140	269	409
9	"9-out6684"	.34285	168	322	490
9	"9-out6685"	.37615	811	1345	2156
9	"9-out6686"	.36686	124	214	338
9	"9-out6687"	.26183	282	795	1077
9	"9-out6688"	.38565	86	137	223
9	"9-out6689"	.19387	38	158	196
9	"9-out6690"	.33402	320	638	958
9	"9-out6691"	.41037	174	250	424
9	"9-out6692"	.22902	445	1498	1943
9	"9-out6693"	.30920	252	563	815
9	"9-out6694"	.59586	432	293	725
9	"9-out6695"	.94563	487	28	515
9	"9-out6696"	.96808	273	9	282
9	"9-out6697"	.34492	119	226	345
9	"9-out6698"	.50000	135	135	270
9	"9-out6699"	.46240	412	479	891
9	"9-out6700"	.16666	116	580	696
9	"9-out6701"	.11360	96	749	845
9	"9-out6702"	.35516	347	630	977
9	"9-out6703"	.34886	292	545	837
9	"9-out6704"	.15240	146	812	958
9	"9-out6705"	.30904	246	550	796
9	"9-out6706"	.29809	454	1069	1523
9	"9-out6707"	.41503	276	389	665
9	"9-out6708"	.50784	259	251	510
9	"9-out6709"	.26041	125	355	480
9	"9-out6710"	.25609	126	366	492
9	"9-out6711"	.30888	80	179	259
9	"9-out6712"	.48122	141	152	293
9	"9-out6713"	.31322	135	296	431
9	"9-out6714"	.38304	131	211	342
9	"9-out6715"	.47490	123	136	259
9	"9-out6716"	.35157	167	308	475
9	"9-out6717"	.42621	387	521	908
9	"9-out6718"	.28330	353	893	1246
9	"9-out6719"	.93037	147	11	158
9	"9-out6720"	.52849	510	455	965
9	"9-out6721"	.97546	159	4	163
9	"9-out6722"	.41127	343	491	834
9	"9-out6723"	.28195	225	573	798
9	"9-out6724"	.32530	189	392	581
9	"9-out6725"	.51656	608	569	1177
9	"9-out6726"	.34328	115	220	335
9	"9-out6727"	.43975	146	186	332
9	"9-out6728"	.99242	131	1	132
9	"9-out6729"	.41901	238	330	568
9	"9-out6730"	.38726	225	356	581
9	"9-out6731"	.36771	82	141	223
9	"9-out6732"	.45517	264	316	580
9	"9-out6733"	.23255	40	132	172
9	"9-out6734"	.60784	372	240	612
9	"9-out6735"	.97807	223	5	228
9	"9-out6736"	.19017	120	511	631
9	"9-out6737"	.30028	209	487	696
9	"9-out6738"	.99285	278	2	280
9	"9-out6739"	.95151	157	8	165
9	"9-out6740"	.24390	60	186	246
9	"9-out6741"	.52924	190	169	359
9	"9-out6742"	.48995	122	127	249
9	"9-out6743"	.98930	370	4	374
9	"9-out6744"	.45364	137	165	302
9	"9-out6745"	.18882	71	305	376
9	"9-out6746"	.25876	214	613	827
9	"9-out6747"	.70875	494	203	697
9	"9-out6748"	.60975	200	128	328
9	"9-out6749"	.97920	471	10	481
9	"9-out6750"	.39080	306	477	783
9	"9-out6751"	.26781	248	678	926
9	"9-out6752"	.98717	77	1	78
9	"9-out6753"	.26086	24	68	92
9	"9-out6754"	.47252	43	48	91
9	"9-out6755"	.22193	170	596	766
9	"9-out6756"	.85384	111	19	130
9	"9-out6757"	.98947	94	1	95
9	"9-out6758"	.98181	54	1	55
9	"9-out6759"	.32683	218	449	667
9	"9-out6760"	.98305	58	1	59
9	"9-out6761"	.98591	70	1	71
9	"9-out6762"	.99029	102	1	103
9	"9-out6763"	.99242	131	1	132
9	"9-out6764"	.98823	84	1	85
9	"9-out6765"	.98924	92	1	93
9	"9-out6766"	.23754	124	398	522
9	"9-out6767"	.27568	110	289	399
9	"9-out6768"	.29750	119	281	400
9	"9-out6769"	.87745	179	25	204
9	"9-out6770"	.89449	195	23	218
9	"9-out6771"	.91984	241	21	262
9	"9-out6772"	.26137	339	958	1297
9	"9-out6773"	.89447	356	42	398
9	"9-out6774"	.94886	167	9	176
9	"9-out6775"	.29182	546	1325	1871
9	"9-out6776"	.99029	102	1	103
9	"9-out6777"	.35526	162	294	456
9	"9-out6778"	.38028	297	484	781
9	"9-out6779"	.45098	115	140	255
9	"9-out6780"	.97520	118	3	121
9	"9-out6781"	.43689	180	232	412
9	"9-out6782"	.32590	117	242	359
9	"9-out6783"	.32911	104	212	316
9	"9-out6784"	.34782	288	540	828
9	"9-out6785"	.62030	281	172	453
9	"9-out6786"	.77154	385	114	499
9	"9-out6787"	.80993	375	88	463
9	"9-out6788"	.25132	332	989	1321
9	"9-out6789"	.41545	86	121	207
9	"9-out6790"	.40997	189	272	461
9	"9-out6791"	.91891	68	6	74
9	"9-out6792"	.98214	55	1	56
9	"9-out6793"	.20447	64	249	313
9	"9-out6794"	.27005	101	273	374
9	"9-out6795"	.29065	370	903	1273
9	"9-out6796"	.23063	268	894	1162
9	"9-out6797"	.14968	47	267	314
9	"9-out6798"	.42258	131	179	310
9	"9-out6799"	.29859	106	249	355
9	"9-out6800"	.50709	143	139	282
9	"9-out6801"	.85867	559	92	651
9	"9-out6802"	.38578	76	121	197
9	"9-out6803"	.98966	383	4	387
9	"9-out6804"	.47397	173	192	365
9	"9-out6805"	.30503	485	1105	1590
9	"9-out6806"	.22627	93	318	411
9	"9-out6807"	.50510	742	727	1469
9	"9-out6808"	.31578	156	338	494
9	"9-out6809"	.31818	42	90	132
9	"9-out6810"	.81290	126	29	155
9	"9-out6811"	.55049	278	227	505
9	"9-out6812"	.28986	489	1198	1687
9	"9-out6813"	.52269	737	673	1410
9	"9-out6814"	.36328	283	496	779
9	"9-out6815"	.30676	254	574	828
9	"9-out6816"	.78260	702	195	897
9	"9-out6817"	.31449	128	279	407
9	"9-out6818"	.21212	28	104	132
9	"9-out6819"	.40038	414	620	1034
9	"9-out6820"	.39419	231	355	586
9	"9-out6821"	.20886	344	1303	1647
9	"9-out6822"	.30496	86	196	282
9	"9-out6823"	.37962	205	335	540
9	"9-out6824"	.84523	71	13	84
9	"9-out6825"	.37185	74	125	199
9	"9-out6826"	.36752	129	222	351
9	"9-out6827"	.31140	71	157	228
9	"9-out6828"	.28695	66	164	230
9	"9-out6829"	.21624	245	888	1133
9	"9-out6830"	.50083	1202	1198	2400
9	"9-out6831"	.16916	192	943	1135
9	"9-out6832"	.34313	70	134	204
9	"9-out6833"	.13872	48	298	346
9	"9-out6834"	.83802	119	23	142
9	"9-out6835"	.17309	175	836	1011
9	"9-out6836"	.34978	560	1041	1601
9	"9-out6837"	.28071	361	925	1286
9	"9-out6838"	.46031	145	170	315
9	"9-out6839"	.36612	201	348	549
9	"9-out6840"	.32075	136	288	424
9	"9-out6841"	.31300	154	338	492
9	"9-out6842"	.98743	393	5	398
9	"9-out6843"	.19522	90	371	461
9	"9-out6844"	.98738	313	4	317
9	"9-out6845"	.52955	215	191	406
9	"9-out6846"	.50259	290	287	577
9	"9-out6847"	.34715	201	378	579
9	"9-out6848"	.32323	160	335	495
9	"9-out6849"	.10857	19	156	175
9	"9-out6850"	.34036	113	219	332
9	"9-out6851"	.19642	22	90	112
9	"9-out6852"	.29710	41	97	138
9	"9-out6853"	.80124	129	32	161
9	"9-out6854"	.23896	157	500	657
9	"9-out6855"	.33984	261	507	768
9	"9-out6856"	.45420	243	292	535
9	"9-out6857"	.27745	96	250	346
9	"9-out6858"	.14840	84	482	566
9	"9-out6859"	.99696	328	1	329
9	"9-out6860"	.86217	538	86	624
9	"9-out6861"	.82700	392	82	474
9	"9-out6862"	.25490	117	342	459
9	"9-out6863"	.41743	91	127	218
9	"9-out6864"	.18000	27	123	150
9	"9-out6865"	.96491	220	8	228
9	"9-out6866"	.86425	191	30	221
9	"9-out6867"	.18377	77	342	419
9	"9-out6868"	.14195	45	272	317
9	"9-out6869"	.31355	259	567	826
9	"9-out6870"	.53416	172	150	322
9	"9-out6871"	.22859	315	1063	1378
9	"9-out6872"	.35374	491	897	1388
9	"9-out6873"	.22714	318	1082	1400
9	"9-out6874"	.90094	191	21	212
9	"9-out6875"	.95726	112	5	117
9	"9-out6876"	.26865	18	49	67
9	"9-out6877"	.65311	273	145	418
9	"9-out6878"	.35032	598	1109	1707
9	"9-out6879"	.32655	642	1324	1966
9	"9-out6880"	.98211	1208	22	1230
9	"9-out6881"	.24518	140	431	571
9	"9-out6882"	.30468	78	178	256
9	"9-out6883"	.53246	82	72	154
9	"9-out6884"	.41328	2152	3055	5207
9	"9-out6885"	.93333	168	12	180
9	"9-out6886"	.47115	147	165	312
9	"9-out6887"	.32506	118	245	363
9	"9-out6888"	.15679	45	242	287
9	"9-out6889"	.68072	226	106	332
9	"9-out6890"	.45454	115	138	253
9	"9-out6891"	.65017	368	198	566
9	"9-out6892"	.11931	21	155	176
9	"9-out6893"	.30116	103	239	342
9	"9-out6894"	.46153	186	217	403
9	"9-out6895"	.30215	252	582	834
9	"9-out6896"	.21069	67	251	318
9	"9-out6897"	.31343	63	138	201
9	"9-out6898"	.94712	412	23	435
9	"9-out6899"	.57361	300	223	523
9	"9-out6900"	.37850	81	133	214
9	"9-out6901"	.99669	302	1	303
9	"9-out6902"	.51655	78	73	151
9	"9-out6903"	.68613	94	43	137
9	"9-out6904"	.30978	114	254	368
9	"9-out6905"	.34536	134	254	388
9	"9-out6906"	.83571	117	23	140
9	"9-out6907"	.43965	51	65	116
9	"9-out6908"	.27906	36	93	129
9	"9-out6909"	.47572	196	216	412
9	"9-out6910"	.26631	102	281	383
9	"9-out6911"	.32862	93	190	283
9	"9-out6912"	.64920	285	154	439
9	"9-out6913"	.55402	241	194	435
9	"9-out6914"	.99375	477	3	480
9	"9-out6915"	.99509	203	1	204
9	"9-out6916"	.40860	190	275	465
9	"9-out6917"	.21814	113	405	518
9	"9-out6918"	.12835	67	455	522
9	"9-out6919"	.19653	68	278	346
9	"9-out6920"	.86763	780	119	899
9	"9-out6921"	.49615	129	131	260
9	"9-out6922"	.39183	96	149	245
9	"9-out6923"	.82033	242	53	295
9	"9-out6924"	.33886	143	279	422
9	"9-out6925"	.50746	204	198	402
9	"9-out6926"	.90745	353	36	389
9	"9-out6927"	.42490	116	157	273
9	"9-out6928"	.80530	182	44	226
9	"9-out6929"	.99122	113	1	114
9	"9-out6930"	.39583	418	638	1056
9	"9-out6931"	.30273	310	714	1024
9	"9-out6932"	.22308	172	599	771
9	"9-out6933"	.67567	125	60	185
9	"9-out6934"	.32269	273	573	846
9	"9-out6935"	.74427	195	67	262
9	"9-out6936"	.46884	316	358	674
9	"9-out6937"	.19680	37	151	188
9	"9-out6938"	.34826	171	320	491
9	"9-out6939"	.98148	53	1	54
9	"9-out6940"	.92886	457	35	492
9	"9-out6941"	.34210	481	925	1406
9	"9-out6942"	.39493	577	884	1461
9	"9-out6943"	.21473	274	1002	1276
9	"9-out6944"	.96451	299	11	310
9	"9-out6945"	.29021	626	1531	2157
9	"9-out6946"	.24121	199	626	825
9	"9-out6947"	.17845	111	511	622
9	"9-out6948"	.40036	221	331	552
9	"9-out6949"	.99219	636	5	641
9	"9-out6950"	.31925	189	403	592
9	"9-out6951"	.27500	110	290	400
9	"9-out6952"	.48221	122	131	253
9	"9-out6953"	.45662	100	119	219
9	"9-out6954"	.99466	373	2	375
9	"9-out6955"	.39024	128	200	328
9	"9-out6956"	.98850	86	1	87
9	"9-out6957"	.97124	304	9	313
9	"9-out6958"	.66281	287	146	433
9	"9-out6959"	.96428	270	10	280
9	"9-out6960"	.35593	147	266	413
9	"9-out6961"	.25153	82	244	326
9	"9-out6962"	.41625	169	237	406
9	"9-out6963"	.41399	142	201	343
9	"9-out6964"	.42960	119	158	277
9	"9-out6965"	.42857	216	288	504
9	"9-out6966"	.83039	754	154	908
9	"9-out6967"	.95815	229	10	239
9	"9-out6968"	.31454	173	377	550
9	"9-out6969"	.99099	110	1	111
9	"9-out6970"	.23529	24	78	102
9	"9-out6971"	.48366	74	79	153
9	"9-out6972"	.33293	277	555	832
9	"9-out6973"	.28629	71	177	248
9	"9-out6974"	.95562	646	30	676
9	"9-out6975"	.53125	68	60	128
9	"9-out6976"	.99702	1342	4	1346
9	"9-out6977"	.61538	136	85	221
9	"9-out6978"	.59817	131	88	219
9	"9-out6979"	.44117	135	171	306
9	"9-out6980"	.98636	217	3	220
9	"9-out6981"	.23011	81	271	352
9	"9-out6982"	.60937	156	100	256
9	"9-out6983"	.10227	27	237	264
9	"9-out6984"	.32812	84	172	256
9	"9-out6985"	.90692	380	39	419
9	"9-out6986"	.35532	70	127	197
9	"9-out6987"	.28740	73	181	254
9	"9-out6988"	.31948	100	213	313
9	"9-out6989"	.94584	262	15	277
9	"9-out6990"	.66071	222	114	336
9	"9-out6991"	.33622	155	306	461
9	"9-out6992"	.46250	259	301	560
9	"9-out6993"	.33333	173	346	519
9	"9-out6994"	.99285	139	1	140
9	"9-out6995"	.26452	132	367	499
9	"9-out6996"	.34705	118	222	340
9	"9-out6997"	.97169	309	9	318
9	"9-out6998"	.63003	579	340	919
9	"9-out6999"	.11872	26	193	219
9	"9-out7000"	.75438	344	112	456
9	"9-out7001"	.18046	133	604	737
9	"9-out7002"	.39361	74	114	188
9	"9-out7003"	.43795	120	154	274
9	"9-out7004"	.95945	142	6	148
9	"9-out7005"	.33504	196	389	585
9	"9-out7006"	.51778	131	122	253
9	"9-out7007"	.20574	86	332	418
9	"9-out7008"	.99697	330	1	331
9	"9-out7009"	.22821	55	186	241
9	"9-out7010"	.97826	180	4	184
9	"9-out7011"	.96010	361	15	376
9	"9-out7012"	.23611	51	165	216
9	"9-out7013"	.92488	394	32	426
9	"9-out7014"	.94444	306	18	324
9	"9-out7015"	.36825	232	398	630
9	"9-out7016"	.99581	476	2	478
9	"9-out7017"	.44200	423	534	957
9	"9-out7018"	.99789	473	1	474
9	"9-out7019"	.95810	343	15	358
9	"9-out7020"	.97716	214	5	219
9	"9-out7021"	.26388	209	583	792
9	"9-out7022"	.36958	452	771	1223
9	"9-out7023"	.98275	171	3	174
9	"9-out7024"	.39937	127	191	318
9	"9-out7025"	.31379	91	199	290
9	"9-out7026"	.36666	110	190	300
9	"9-out7027"	.14644	35	204	239
9	"9-out7028"	.18478	51	225	276
9	"9-out7029"	.43697	260	335	595
9	"9-out7030"	.85897	268	44	312
9	"9-out7031"	.99585	481	2	483
9	"9-out7032"	.99791	478	1	479
9	"9-out7033"	.99789	473	1	474
9	"9-out7034"	.99579	474	2	476
9	"9-out7035"	.25916	99	283	382
9	"9-out7036"	.99581	476	2	478
9	"9-out7037"	.99337	150	1	151
9	"9-out7038"	.99547	220	1	221
9	"9-out7039"	.99547	220	1	221
9	"9-out7040"	.99578	473	2	475
9	"9-out7041"	.45495	101	121	222
9	"9-out7042"	.37077	637	1081	1718
9	"9-out7043"	.32841	89	182	271
9	"9-out7044"	.43925	94	120	214
9	"9-out7045"	.36265	371	652	1023
9	"9-out7046"	.32797	306	627	933
9	"9-out7047"	.32258	150	315	465
9	"9-out7048"	.42781	243	325	568
9	"9-out7049"	.50387	65	64	129
9	"9-out7050"	.26066	55	156	211
9	"9-out7051"	.19133	181	765	946
9	"9-out7052"	.29879	173	406	579
9	"9-out7053"	.66137	125	64	189
9	"9-out7054"	.99619	262	1	263
9	"9-out7055"	.75938	344	109	453
9	"9-out7056"	.25647	792	2296	3088
9	"9-out7057"	.46363	51	59	110
9	"9-out7058"	.21610	51	185	236
9	"9-out7059"	.48654	235	248	483
9	"9-out7060"	.28947	66	162	228
9	"9-out7061"	.82591	427	90	517
9	"9-out7062"	.25080	235	702	937
9	"9-out7063"	.16012	151	792	943
9	"9-out7064"	.24091	126	397	523
9	"9-out7065"	.20638	97	373	470
9	"9-out7066"	.19305	100	418	518
9	"9-out7067"	.93167	300	22	322
9	"9-out7068"	.17096	106	514	620
9	"9-out7069"	.94117	368	23	391
9	"9-out7070"	.23497	43	140	183
9	"9-out7071"	.99047	104	1	105
9	"9-out7072"	.99047	104	1	105
9	"9-out7073"	.26364	256	715	971
9	"9-out7074"	.28475	211	530	741
9	"9-out7075"	.30175	223	516	739
9	"9-out7076"	.82585	460	97	557
9	"9-out7077"	.29353	59	142	201
9	"9-out7078"	.23412	59	193	252
9	"9-out7079"	.43921	112	143	255
9	"9-out7080"	.28015	72	185	257
9	"9-out7081"	.18518	35	154	189
9	"9-out7082"	.96682	204	7	211
9	"9-out7083"	.99397	165	1	166
9	"9-out7084"	.99397	165	1	166
9	"9-out7085"	.32214	403	848	1251
9	"9-out7086"	.35431	1109	2021	3130
9	"9-out7087"	.98606	283	4	287
9	"9-out7088"	.65224	377	201	578
9	"9-out7089"	.20661	75	288	363
9	"9-out7090"	.25751	120	346	466
9	"9-out7091"	.90220	286	31	317
9	"9-out7092"	.30439	298	681	979
9	"9-out7093"	.93375	296	21	317
9	"9-out7094"	.39816	260	393	653
9	"9-out7095"	.27439	374	989	1363
9	"9-out7096"	.75233	161	53	214
9	"9-out7097"	.38740	160	253	413
9	"9-out7098"	.46431	488	563	1051
9	"9-out7099"	.54945	200	164	364
9	"9-out7100"	.34283	373	715	1088
9	"9-out7101"	.22435	35	121	156
9	"9-out7102"	.93678	489	33	522
9	"9-out7103"	.33195	80	161	241
9	"9-out7104"	.77017	315	94	409
9	"9-out7105"	.23593	281	910	1191
9	"9-out7106"	.45110	143	174	317
9	"9-out7107"	.99047	104	1	105
9	"9-out7108"	.62189	125	76	201
9	"9-out7109"	.21560	746	2714	3460
9	"9-out7110"	.11688	72	544	616
9	"9-out7111"	.93630	147	10	157
9	"9-out7112"	.38304	244	393	637
9	"9-out7113"	.62962	136	80	216
9	"9-out7114"	.26293	315	883	1198
9	"9-out7115"	.27650	133	348	481
9	"9-out7116"	.29654	696	1651	2347
9	"9-out7117"	.34555	424	803	1227
9	"9-out7118"	.66212	243	124	367
9	"9-out7119"	.27615	66	173	239
9	"9-out7120"	.99186	244	2	246
9	"9-out7121"	.50531	190	186	376
9	"9-out7122"	.29325	100	241	341
9	"9-out7123"	.39399	617	949	1566
9	"9-out7124"	.43220	153	201	354
9	"9-out7125"	.39636	501	763	1264
9	"9-out7126"	.98606	283	4	287
9	"9-out7127"	.32859	185	378	563
9	"9-out7128"	.29373	314	755	1069
9	"9-out7129"	.33094	461	932	1393
9	"9-out7130"	.22151	35	123	158
9	"9-out7131"	.47422	230	255	485
9	"9-out7132"	.36534	194	337	531
9	"9-out7133"	.28650	104	259	363
9	"9-out7134"	.34000	68	132	200
9	"9-out7135"	.86776	105	16	121
9	"9-out7136"	.30882	105	235	340
9	"9-out7137"	.40062	514	769	1283
9	"9-out7138"	.40873	309	447	756
9	"9-out7139"	.31313	248	544	792
9	"9-out7140"	.38518	52	83	135
9	"9-out7141"	.71142	249	101	350
9	"9-out7142"	.64925	87	47	134
9	"9-out7143"	.41441	46	65	111
9	"9-out7144"	.27378	305	809	1114
9	"9-out7145"	.24685	98	299	397
9	"9-out7146"	.37369	429	719	1148
9	"9-out7147"	.25585	131	381	512
9	"9-out7148"	.22993	169	566	735
9	"9-out7149"	.19555	88	362	450
9	"9-out7150"	.27230	116	310	426
9	"9-out7151"	.66163	219	112	331
9	"9-out7152"	.38412	542	869	1411
9	"9-out7153"	.35389	109	199	308
9	"9-out7154"	.16356	44	225	269
9	"9-out7155"	.49169	385	398	783
9	"9-out7156"	.28826	258	637	895
9	"9-out7157"	.29340	289	696	985
9	"9-out7158"	.47863	168	183	351
9	"9-out7159"	.28539	129	323	452
9	"9-out7160"	.99438	177	1	178
9	"9-out7161"	.99526	210	1	211
9	"9-out7162"	.54875	287	236	523
9	"9-out7163"	.94864	314	17	331
9	"9-out7164"	.99295	282	2	284
9	"9-out7165"	.86076	1051	170	1221
9	"9-out7166"	.19458	79	327	406
9	"9-out7167"	.73459	310	112	422
9	"9-out7168"	.20930	162	612	774
9	"9-out7169"	.45221	265	321	586
9	"9-out7170"	.21923	57	203	260
9	"9-out7171"	.26615	70	193	263
9	"9-out7172"	.21300	154	569	723
9	"9-out7173"	.71518	452	180	632
9	"9-out7174"	.33603	207	409	616
9	"9-out7175"	.27231	119	318	437
9	"9-out7176"	.30280	281	647	928
9	"9-out7177"	.29268	60	145	205
9	"9-out7178"	.44751	81	100	181
9	"9-out7179"	.18855	89	383	472
9	"9-out7180"	.33939	168	327	495
9	"9-out7181"	.31111	56	124	180
9	"9-out7182"	.25547	35	102	137
9	"9-out7183"	.24269	83	259	342
9	"9-out7184"	.38875	166	261	427
9	"9-out7185"	.28358	57	144	201
9	"9-out7186"	.99619	524	2	526
9	"9-out7187"	.79629	215	55	270
9	"9-out7188"	.48314	172	184	356
9	"9-out7189"	.17758	84	389	473
9	"9-out7190"	.25619	93	270	363
9	"9-out7191"	.44072	171	217	388
9	"9-out7192"	.28947	44	108	152
9	"9-out7193"	.27488	58	153	211
9	"9-out7194"	.22830	171	578	749
9	"9-out7195"	.35674	193	348	541
9	"9-out7196"	.99065	106	1	107
9	"9-out7197"	.64233	88	49	137
9	"9-out7198"	.98598	211	3	214
9	"9-out7199"	.92600	438	35	473
9	"9-out7200"	.98245	224	4	228
9	"9-out7201"	.98245	224	4	228
9	"9-out7202"	.28251	189	480	669
9	"9-out7203"	.40526	77	113	190
9	"9-out7204"	.22291	214	746	960
9	"9-out7205"	.69080	248	111	359
9	"9-out7206"	.43297	365	478	843
9	"9-out7207"	.35650	359	648	1007
9	"9-out7208"	.69811	370	160	530
9	"9-out7209"	.39086	77	120	197
9	"9-out7210"	.69911	79	34	113
9	"9-out7211"	.99596	494	2	496
9	"9-out7212"	.25401	79	232	311
9	"9-out7213"	.99596	494	2	496
9	"9-out7214"	.99596	494	2	496
9	"9-out7215"	.23101	73	243	316
9	"9-out7216"	.99047	104	1	105
9	"9-out7217"	.96521	111	4	115
9	"9-out7218"	.47524	144	159	303
9	"9-out7219"	.31122	61	135	196
9	"9-out7220"	.20149	27	107	134
9	"9-out7221"	.23143	134	445	579
9	"9-out7222"	.32730	398	818	1216
9	"9-out7223"	.31879	95	203	298
9	"9-out7224"	.42924	546	726	1272
9	"9-out7225"	.45119	245	298	543
9	"9-out7226"	.98275	171	3	174
9	"9-out7227"	.75862	308	98	406
9	"9-out7228"	.19224	114	479	593
9	"9-out7229"	.25423	60	176	236
9	"9-out7230"	.24171	197	618	815
9	"9-out7231"	.99652	287	1	288
9	"9-out7232"	.33728	256	503	759
9	"9-out7233"	.37948	444	726	1170
9	"9-out7234"	.48398	136	145	281
9	"9-out7235"	.27253	254	678	932
9	"9-out7236"	.25469	95	278	373
9	"9-out7237"	.37037	40	68	108
9	"9-out7238"	.99596	494	2	496
9	"9-out7239"	.50151	166	165	331
9	"9-out7240"	.47402	520	577	1097
9	"9-out7241"	.94327	449	27	476
9	"9-out7242"	.22613	45	154	199
9	"9-out7243"	.15555	21	114	135
9	"9-out7244"	.31337	157	344	501
9	"9-out7245"	.42535	302	408	710
9	"9-out7246"	.99393	164	1	165
9	"9-out7247"	.99684	316	1	317
9	"9-out7248"	.28947	132	324	456
9	"9-out7249"	.66145	127	65	192
9	"9-out7250"	.61744	92	57	149
9	"9-out7251"	.99363	156	1	157
9	"9-out7252"	.99596	247	1	248
9	"9-out7253"	.97297	144	4	148
9	"9-out7254"	.99371	158	1	159
9	"9-out7255"	.37230	121	204	325
9	"9-out7256"	.52131	159	146	305
9	"9-out7257"	.40449	108	159	267
9	"9-out7258"	.17241	25	120	145
9	"9-out7259"	.38461	195	312	507
9	"9-out7260"	.67021	126	62	188
9	"9-out7261"	.27124	150	403	553
9	"9-out7262"	.31670	146	315	461
9	"9-out7263"	.29756	391	923	1314
9	"9-out7264"	.30000	141	329	470
9	"9-out7265"	.52389	559	508	1067
9	"9-out7266"	.39329	129	199	328
9	"9-out7267"	.61623	334	208	542
9	"9-out7268"	.99337	150	1	151
9	"9-out7269"	.41118	787	1127	1914
9	"9-out7270"	.18981	41	175	216
9	"9-out7271"	.86590	226	35	261
9	"9-out7272"	.63200	158	92	250
9	"9-out7273"	.24366	125	388	513
9	"9-out7274"	.61469	276	173	449
9	"9-out7275"	.36129	56	99	155
9	"9-out7276"	.34782	32	60	92
9	"9-out7277"	.92564	361	29	390
9	"9-out7278"	.82394	117	25	142
9	"9-out7279"	.25675	38	110	148
9	"9-out7280"	.41479	129	182	311
9	"9-out7281"	.32790	161	330	491
9	"9-out7282"	.17169	91	439	530
9	"9-out7283"	.57692	195	143	338
9	"9-out7284"	.16334	41	210	251
9	"9-out7285"	.72668	226	85	311
9	"9-out7286"	.34205	340	654	994
9	"9-out7287"	.14611	64	374	438
9	"9-out7288"	.91020	223	22	245
9	"9-out7289"	.61266	677	428	1105
9	"9-out7290"	.68831	106	48	154
9	"9-out7291"	.18589	29	127	156
9	"9-out7292"	.39130	504	784	1288
9	"9-out7293"	.26004	110	313	423
9	"9-out7294"	.32894	75	153	228
9	"9-out7295"	.25328	77	227	304
9	"9-out7296"	.40160	251	374	625
9	"9-out7297"	.50364	69	68	137
9	"9-out7298"	.16666	26	130	156
9	"9-out7299"	.38196	144	233	377
9	"9-out7300"	.22466	51	176	227
9	"9-out7301"	.79166	342	90	432
9	"9-out7302"	.57692	90	66	156
9	"9-out7303"	.33260	457	917	1374
9	"9-out7304"	.57627	340	250	590
9	"9-out7305"	.24660	127	388	515
9	"9-out7306"	.24018	104	329	433
9	"9-out7307"	.56809	609	463	1072
9	"9-out7308"	.73684	140	50	190
9	"9-out7309"	.30630	136	308	444
9	"9-out7310"	.36868	511	875	1386
9	"9-out7311"	.99624	265	1	266
9	"9-out7312"	.73750	295	105	400
9	"9-out7313"	.35593	252	456	708
9	"9-out7314"	.41824	243	338	581
9	"9-out7315"	.27162	135	362	497
9	"9-out7316"	.80519	62	15	77
9	"9-out7317"	.26046	56	159	215
9	"9-out7318"	.49230	32	33	65
9	"9-out7319"	.87481	580	83	663
9	"9-out7320"	.98757	159	2	161
9	"9-out7321"	.98795	246	3	249
9	"9-out7322"	.25101	186	555	741
9	"9-out7323"	.33271	180	361	541
9	"9-out7324"	.33662	273	538	811
9	"9-out7325"	.42144	684	939	1623
9	"9-out7326"	.17672	41	191	232
9	"9-out7327"	.13656	31	196	227
9	"9-out7328"	.09836	24	220	244
9	"9-out7329"	.41435	179	253	432
9	"9-out7330"	.65401	448	237	685
9	"9-out7331"	.42886	208	277	485
9	"9-out7332"	.52439	86	78	164
9	"9-out7333"	.23573	95	308	403
9	"9-out7334"	.22222	40	140	180
9	"9-out7335"	.41566	69	97	166
9	"9-out7336"	.79746	126	32	158
9	"9-out7337"	.99319	146	1	147
9	"9-out7338"	.39808	125	189	314
9	"9-out7339"	.22413	52	180	232
9	"9-out7340"	.22897	98	330	428
9	"9-out7341"	.68627	105	48	153
9	"9-out7342"	.35500	142	258	400
9	"9-out7343"	.41666	180	252	432
9	"9-out7344"	.36836	319	547	866
9	"9-out7345"	.37539	238	396	634
9	"9-out7346"	.35359	128	234	362
9	"9-out7347"	.21711	170	613	783
9	"9-out7348"	.34677	43	81	124
9	"9-out7349"	.04545	7	147	154
9	"9-out7350"	.27135	54	145	199
9	"9-out7351"	.22727	50	170	220
9	"9-out7352"	.40298	108	160	268
9	"9-out7353"	.35689	101	182	283
9	"9-out7354"	.57024	207	156	363
9	"9-out7355"	.39423	123	189	312
9	"9-out7356"	.39263	128	198	326
9	"9-out7357"	.29911	437	1024	1461
9	"9-out7358"	.55833	67	53	120
9	"9-out7359"	.06422	7	102	109
9	"9-out7360"	.65306	512	272	784
9	"9-out7361"	.15131	202	1133	1335
9	"9-out7362"	.48809	123	129	252
9	"9-out7363"	.58257	321	230	551
9	"9-out7364"	.99596	494	2	496
9	"9-out7365"	.33123	105	212	317
9	"9-out7366"	.99494	197	1	198
9	"9-out7367"	.42857	144	192	336
9	"9-out7368"	.99047	104	1	105
9	"9-out7369"	.33834	90	176	266
9	"9-out7370"	.22213	277	970	1247
9	"9-out7371"	.35702	221	398	619
9	"9-out7372"	.43734	171	220	391
9	"9-out7373"	.64814	70	38	108
9	"9-out7374"	.30294	103	237	340
9	"9-out7375"	.27083	195	525	720
9	"9-out7376"	.24347	28	87	115
9	"9-out7377"	.35757	59	106	165
9	"9-out7378"	.23052	148	494	642
9	"9-out7379"	.87032	396	59	455
9	"9-out7380"	.99811	529	1	530
9	"9-out7381"	.46532	255	293	548
9	"9-out7382"	.27983	68	175	243
9	"9-out7383"	.08648	16	169	185
9	"9-out7384"	.57187	183	137	320
9	"9-out7385"	.34674	181	341	522
9	"9-out7386"	.98504	461	7	468
9	"9-out7387"	.35502	180	327	507
9	"9-out7388"	.23167	237	786	1023
9	"9-out7389"	.12408	34	240	274
9	"9-out7390"	.76470	221	68	289
9	"9-out7391"	.46109	160	187	347
9	"9-out7392"	.26409	89	248	337
9	"9-out7393"	.33333	104	208	312
9	"9-out7394"	.49885	436	438	874
9	"9-out7395"	.27142	38	102	140
9	"9-out7396"	.99599	1244	5	1249
9	"9-out7397"	.99520	830	4	834
9	"9-out7398"	.99674	1225	4	1229
9	"9-out7399"	.75684	221	71	292
9	"9-out7400"	.30067	89	207	296
9	"9-out7401"	.27926	136	351	487
9	"9-out7402"	.26324	497	1391	1888
9	"9-out7403"	.85643	173	29	202
9	"9-out7404"	.32080	128	271	399
9	"9-out7405"	.24685	98	299	397
9	"9-out7406"	.21563	91	331	422
9	"9-out7407"	.43025	256	339	595
9	"9-out7408"	.25994	98	279	377
9	"9-out7409"	.25458	416	1218	1634
9	"9-out7410"	.42378	139	189	328
9	"9-out7411"	.99721	358	1	359
9	"9-out7412"	.40918	196	283	479
9	"9-out7413"	.43035	207	274	481
9	"9-out7414"	.24859	133	402	535
9	"9-out7415"	.20318	102	400	502
9	"9-out7416"	.40816	340	493	833
9	"9-out7417"	.47080	129	145	274
9	"9-out7418"	.95072	791	41	832
9	"9-out7419"	.23647	188	607	795
9	"9-out7420"	.26247	121	340	461
9	"9-out7421"	.38522	245	391	636
9	"9-out7422"	.17706	105	488	593
9	"9-out7423"	.51875	166	154	320
9	"9-out7424"	.38997	319	499	818
9	"9-out7425"	.88974	460	57	517
9	"9-out7426"	.31095	264	585	849
9	"9-out7427"	.54938	89	73	162
9	"9-out7428"	.95731	157	7	164
9	"9-out7429"	.95121	156	8	164
9	"9-out7430"	.95121	156	8	164
9	"9-out7431"	.95121	156	8	164
9	"9-out7432"	.61565	527	329	856
9	"9-out7433"	.47399	319	354	673
9	"9-out7434"	.35934	198	353	551
9	"9-out7435"	.13333	96	624	720
9	"9-out7436"	.22628	272	930	1202
9	"9-out7437"	.95424	292	14	306
9	"9-out7438"	.98717	77	1	78
9	"9-out7439"	.69879	58	25	83
9	"9-out7440"	.98901	90	1	91
9	"9-out7441"	.35353	35	64	99
9	"9-out7442"	.99152	117	1	118
9	"9-out7443"	.98947	94	1	95
9	"9-out7444"	.28358	19	48	67
9	"9-out7445"	.98518	133	2	135
9	"9-out7446"	.99418	171	1	172
9	"9-out7447"	.99342	151	1	152
9	"9-out7448"	.99019	101	1	102
9	"9-out7449"	.98924	92	1	93
9	"9-out7450"	.75344	657	215	872
9	"9-out7451"	.98529	67	1	68
9	"9-out7452"	.38675	403	639	1042
9	"9-out7453"	.32250	129	271	400
9	"9-out7454"	.31134	236	522	758
9	"9-out7455"	.26857	47	128	175
9	"9-out7456"	.47183	134	150	284
9	"9-out7457"	.43642	127	164	291
9	"9-out7458"	.36445	121	211	332
9	"9-out7459"	.99188	733	6	739
9	"9-out7460"	.40497	277	407	684
9	"9-out7461"	.36401	265	463	728
9	"9-out7462"	.90609	907	94	1001
9	"9-out7463"	.22290	181	631	812
9	"9-out7464"	.30915	277	619	896
9	"9-out7465"	.30642	205	464	669
9	"9-out7466"	.34573	223	422	645
9	"9-out7467"	.34264	184	353	537
9	"9-out7468"	.41370	465	659	1124
9	"9-out7469"	.24179	81	254	335
9	"9-out7470"	.25614	73	212	285
9	"9-out7471"	.41868	121	168	289
9	"9-out7472"	.30072	83	193	276
9	"9-out7473"	.21455	56	205	261
9	"9-out7474"	.42155	446	612	1058
9	"9-out7475"	.24068	368	1161	1529
9	"9-out7476"	.36194	447	788	1235
9	"9-out7477"	.88124	794	107	901
9	"9-out7478"	.96712	559	19	578
9	"9-out7479"	.28728	262	650	912
9	"9-out7480"	.13099	112	743	855
9	"9-out7481"	.55144	134	109	243
9	"9-out7482"	.22160	80	281	361
9	"9-out7483"	.30956	191	426	617
9	"9-out7484"	.24630	50	153	203
9	"9-out7485"	.40322	100	148	248
9	"9-out7486"	.24611	111	340	451
9	"9-out7487"	.73643	190	68	258
9	"9-out7488"	.24933	94	283	377
9	"9-out7489"	.99295	141	1	142
9	"9-out7490"	1.00000	2	0	2
9	"9-out7491"	.27746	149	388	537
9	"9-out7492"	.31250	140	308	448
9	"9-out7493"	.97808	491	11	502
9	"9-out7494"	.22222	34	119	153
9	"9-out7495"	.42151	145	199	344
9	"9-out7496"	.39873	63	95	158
9	"9-out7497"	.99453	182	1	183
9	"9-out7498"	.42639	84	113	197
9	"9-out7499"	.24164	94	295	389
9	"9-out7500"	.89189	66	8	74
9	"9-out7501"	.96157	926	37	963
9	"9-out7502"	.67567	250	120	370
9	"9-out7503"	.34473	131	249	380
9	"9-out7504"	.22428	205	709	914
9	"9-out7505"	.34274	898	1722	2620
9	"9-out7506"	.41401	378	535	913
9	"9-out7507"	.30785	290	652	942
9	"9-out7508"	.39926	325	489	814
9	"9-out7509"	.26679	278	764	1042
9	"9-out7510"	.27761	191	497	688
9	"9-out7511"	.32421	569	1186	1755
9	"9-out7512"	.26352	112	313	425
9	"9-out7513"	.36811	187	321	508
9	"9-out7514"	.34764	170	319	489
9	"9-out7515"	.88019	529	72	601
9	"9-out7516"	.27115	141	379	520
9	"9-out7517"	.66409	172	87	259
9	"9-out7518"	.26934	87	236	323
9	"9-out7519"	.20577	57	220	277
9	"9-out7520"	.96673	2470	85	2555
9	"9-out7521"	.14967	69	392	461
9	"9-out7522"	.24876	101	305	406
9	"9-out7523"	.47401	456	506	962
9	"9-out7524"	.14577	100	586	686
9	"9-out7525"	.27741	339	883	1222
9	"9-out7526"	.99519	207	1	208
9	"9-out7527"	.99778	451	1	452
9	"9-out7528"	.99035	308	3	311
9	"9-out7529"	.99834	603	1	604
9	"9-out7530"	.98571	138	2	140
9	"9-out7531"	.99453	182	1	183
9	"9-out7532"	.98924	92	1	93
9	"9-out7533"	.98692	151	2	153
9	"9-out7534"	.99386	162	1	163
9	"9-out7535"	.99551	222	1	223
9	"9-out7536"	.99567	230	1	231
9	"9-out7537"	.98734	78	1	79
9	"9-out7538"	.99728	368	1	369
9	"9-out7539"	.99280	138	1	139
9	"9-out7540"	.26813	340	928	1268
9	"9-out7541"	.24143	162	509	671
9	"9-out7542"	.21281	176	651	827
9	"9-out7543"	.59961	313	209	522
9	"9-out7544"	.99745	392	1	393
9	"9-out7545"	.99549	221	1	222
9	"9-out7546"	.42857	63	84	147
9	"9-out7547"	.73743	132	47	179
9	"9-out7548"	.81371	712	163	875
9	"9-out7549"	.32225	349	734	1083
9	"9-out7550"	.34210	169	325	494
9	"9-out7551"	.23893	135	430	565
9	"9-out7552"	.17024	103	502	605
9	"9-out7553"	.34689	469	883	1352
9	"9-out7554"	.70760	1135	469	1604
9	"9-out7555"	.24419	263	814	1077
9	"9-out7556"	.41159	419	599	1018
9	"9-out7557"	.35636	490	885	1375
9	"9-out7558"	.34975	362	673	1035
9	"9-out7559"	.24299	234	729	963
9	"9-out7560"	.22999	250	837	1087
9	"9-out7561"	.34296	368	705	1073
9	"9-out7562"	.21794	187	671	858
9	"9-out7563"	.22692	150	511	661
9	"9-out7564"	.76762	479	145	624
9	"9-out7565"	.22947	109	366	475
9	"9-out7566"	.12260	32	229	261
9	"9-out7567"	.41846	136	189	325
9	"9-out7568"	.99646	282	1	283
9	"9-out7569"	.32608	45	93	138
9	"9-out7570"	.57490	307	227	534
9	"9-out7571"	.73387	91	33	124
9	"9-out7572"	.39130	63	98	161
9	"9-out7573"	.19543	60	247	307
9	"9-out7574"	.31422	148	323	471
9	"9-out7575"	.31736	53	114	167
9	"9-out7576"	.38035	302	492	794
9	"9-out7577"	.47097	714	802	1516
9	"9-out7578"	.97839	317	7	324
9	"9-out7579"	.30769	176	396	572
9	"9-out7580"	.37185	74	125	199
9	"9-out7581"	.98947	94	1	95
9	"9-out7582"	.18000	18	82	100
9	"9-out7583"	.47517	67	74	141
9	"9-out7584"	.17105	91	441	532
9	"9-out7585"	.99545	219	1	220
9	"9-out7586"	.98550	68	1	69
9	"9-out7587"	.20156	103	408	511
9	"9-out7588"	.12682	26	179	205
9	"9-out7589"	.77031	218	65	283
9	"9-out7590"	.43964	1650	2103	3753
9	"9-out7591"	1.00000	156	0	156
9	"9-out7592"	.30145	186	431	617
9	"9-out7593"	.99610	256	1	257
9	"9-out7594"	.22838	103	348	451
9	"9-out7595"	.32272	71	149	220
9	"9-out7596"	.21813	89	319	408
9	"9-out7597"	.34259	111	213	324
9	"9-out7598"	.28365	59	149	208
9	"9-out7599"	.32589	73	151	224
9	"9-out7600"	.99373	317	2	319
9	"9-out7601"	.45722	155	184	339
9	"9-out7602"	.37345	121	203	324
9	"9-out7603"	.57575	95	70	165
9	"9-out7604"	.15865	33	175	208
9	"9-out7605"	.32413	141	294	435
9	"9-out7606"	.27350	96	255	351
9	"9-out7607"	.24454	56	173	229
9	"9-out7608"	.48062	62	67	129
9	"9-out7609"	.33183	221	445	666
9	"9-out7610"	.43385	223	291	514
9	"9-out7611"	.23529	32	104	136
9	"9-out7612"	.22802	96	325	421
9	"9-out7613"	.36419	59	103	162
9	"9-out7614"	.25087	143	427	570
9	"9-out7615"	.28750	69	171	240
9	"9-out7616"	.39639	220	335	555
9	"9-out7617"	.36551	53	92	145
9	"9-out7618"	.48263	139	149	288
9	"9-out7619"	.89655	182	21	203
9	"9-out7620"	.30238	114	263	377
9	"9-out7621"	.33630	113	223	336
9	"9-out7622"	.46153	72	84	156
9	"9-out7623"	.96356	238	9	247
9	"9-out7624"	.56906	103	78	181
9	"9-out7625"	.55456	498	400	898
9	"9-out7626"	.19175	172	725	897
9	"9-out7627"	.25072	86	257	343
9	"9-out7628"	.37894	108	177	285
9	"9-out7629"	.29133	74	180	254
9	"9-out7630"	.32971	91	185	276
9	"9-out7631"	.20018	219	875	1094
9	"9-out7632"	.33053	276	559	835
9	"9-out7633"	.24263	140	437	577
9	"9-out7634"	.32156	164	346	510
9	"9-out7635"	.41940	255	353	608
9	"9-out7636"	.36937	386	659	1045
9	"9-out7637"	.21678	217	784	1001
9	"9-out7638"	.29032	54	132	186
9	"9-out7639"	.74718	464	157	621
9	"9-out7640"	.49150	376	389	765
9	"9-out7641"	.99285	139	1	140
9	"9-out7642"	.33701	61	120	181
9	"9-out7643"	.29310	578	1394	1972
9	"9-out7644"	.99285	139	1	140
9	"9-out7645"	.37700	541	894	1435
9	"9-out7646"	.27901	125	323	448
9	"9-out7647"	.97892	511	11	522
9	"9-out7648"	.18902	217	931	1148
9	"9-out7649"	.99428	174	1	175
9	"9-out7650"	.72279	279	107	386
9	"9-out7651"	.34132	185	357	542
9	"9-out7652"	.99107	111	1	112
9	"9-out7653"	.99082	108	1	109
9	"9-out7654"	.99107	111	1	112
9	"9-out7655"	.99115	112	1	113
9	"9-out7656"	.99107	111	1	112
9	"9-out7657"	.99122	113	1	114
9	"9-out7658"	.99047	104	1	105
9	"9-out7659"	.98214	110	2	112
9	"9-out7660"	.99082	108	1	109
9	"9-out7661"	.98165	107	2	109
9	"9-out7662"	.99159	118	1	119
9	"9-out7663"	.98230	111	2	113
9	"9-out7664"	.99115	112	1	113
9	"9-out7665"	.99122	113	1	114
9	"9-out7666"	.98230	111	2	113
9	"9-out7667"	.99107	111	1	112
9	"9-out7668"	.99122	113	1	114
9	"9-out7669"	.99130	114	1	115
9	"9-out7670"	.99082	108	1	109
9	"9-out7671"	.99193	123	1	124
9	"9-out7672"	.98260	113	2	115
9	"9-out7673"	.97297	108	3	111
9	"9-out7674"	.99130	114	1	115
9	"9-out7675"	.99122	113	1	114
9	"9-out7676"	.99130	114	1	115
9	"9-out7677"	.99099	110	1	111
9	"9-out7678"	.99122	113	1	114
9	"9-out7679"	.98245	112	2	114
9	"9-out7680"	.99122	113	1	114
9	"9-out7681"	.99122	113	1	114
9	"9-out7682"	.99122	113	1	114
9	"9-out7683"	.54487	170	142	312
9	"9-out7684"	.46258	272	316	588
9	"9-out7685"	.32602	223	461	684
9	"9-out7686"	.72347	225	86	311
9	"9-out7687"	.98639	290	4	294
9	"9-out7688"	.88675	462	59	521
9	"9-out7689"	.56038	116	91	207
9	"9-out7690"	.15238	80	445	525
9	"9-out7691"	.56466	179	138	317
9	"9-out7692"	.24779	281	853	1134
9	"9-out7693"	.31050	136	302	438
9	"9-out7694"	.40588	69	101	170
9	"9-out7695"	.22186	69	242	311
9	"9-out7696"	.21142	111	414	525
9	"9-out7697"	.99746	394	1	395
9	"9-out7698"	.18093	93	421	514
9	"9-out7699"	.99719	356	1	357
9	"9-out7700"	.94011	471	30	501
9	"9-out7701"	.57370	144	107	251
9	"9-out7702"	.27380	230	610	840
9	"9-out7703"	1.00000	156	0	156
9	"9-out7704"	.45588	93	111	204
9	"9-out7705"	.37401	190	318	508
9	"9-out7706"	.73548	114	41	155
9	"9-out7707"	.87394	104	15	119
9	"9-out7708"	.95305	203	10	213
9	"9-out7709"	.51034	148	142	290
9	"9-out7710"	.45892	162	191	353
9	"9-out7711"	.99009	100	1	101
9	"9-out7712"	.34615	180	340	520
9	"9-out7713"	.61162	200	127	327
9	"9-out7714"	.36140	103	182	285
9	"9-out7715"	1.00000	156	0	156
9	"9-out7716"	1.00000	156	0	156
9	"9-out7717"	.55789	159	126	285
9	"9-out7718"	.28280	153	388	541
9	"9-out7719"	.52360	244	222	466
9	"9-out7720"	.38003	198	323	521
9	"9-out7721"	.88405	183	24	207
9	"9-out7722"	.41176	91	130	221
9	"9-out7723"	.33771	154	302	456
9	"9-out7724"	.23096	279	929	1208
9	"9-out7725"	.24827	252	763	1015
9	"9-out7726"	.35935	267	476	743
9	"9-out7727"	.20984	162	610	772
9	"9-out7728"	.76892	589	177	766
9	"9-out7729"	.33732	141	277	418
9	"9-out7730"	.22898	207	697	904
9	"9-out7731"	.24651	53	162	215
9	"9-out7732"	.99122	113	1	114
9	"9-out7733"	.24800	31	94	125
9	"9-out7734"	.23195	45	149	194
9	"9-out7735"	.92380	97	8	105
9	"9-out7736"	.40526	154	226	380
9	"9-out7737"	.48042	135	146	281
9	"9-out7738"	.32824	86	176	262
9	"9-out7739"	.35338	94	172	266
9	"9-out7740"	.77625	170	49	219
9	"9-out7741"	.34482	120	228	348
9	"9-out7742"	.30830	78	175	253
9	"9-out7743"	.44582	144	179	323
9	"9-out7744"	.98646	583	8	591
9	"9-out7745"	.99844	641	1	642
9	"9-out7746"	.28097	127	325	452
9	"9-out7747"	.36902	162	277	439
9	"9-out7748"	.40837	780	1130	1910
9	"9-out7749"	.27131	35	94	129
9	"9-out7750"	.23222	49	162	211
9	"9-out7751"	.20210	230	908	1138
9	"9-out7752"	.38725	237	375	612
9	"9-out7753"	.40952	430	620	1050
9	"9-out7754"	.25174	144	428	572
9	"9-out7755"	.99546	439	2	441
9	"9-out7756"	.30177	102	236	338
9	"9-out7757"	.54048	267	227	494
9	"9-out7758"	.45129	366	445	811
9	"9-out7759"	.52290	411	375	786
9	"9-out7760"	.46428	364	420	784
9	"9-out7761"	.19354	96	400	496
9	"9-out7762"	.36434	47	82	129
9	"9-out7763"	.90070	381	42	423
9	"9-out7764"	.39726	174	264	438
9	"9-out7765"	.49375	79	81	160
9	"9-out7766"	.32137	224	473	697
9	"9-out7767"	.23142	81	269	350
9	"9-out7768"	.16161	16	83	99
9	"9-out7769"	.48314	86	92	178
9	"9-out7770"	.40822	129	187	316
9	"9-out7771"	.23121	40	133	173
9	"9-out7772"	.20855	117	444	561
9	"9-out7773"	.40607	147	215	362
9	"9-out7774"	.99574	234	1	235
9	"9-out7775"	.38851	115	181	296
9	"9-out7776"	.71000	213	87	300
9	"9-out7777"	.99480	383	2	385
9	"9-out7778"	.20496	33	128	161
9	"9-out7779"	.23202	142	470	612
9	"9-out7780"	.30434	63	144	207
9	"9-out7781"	.27106	74	199	273
9	"9-out7782"	.33628	76	150	226
9	"9-out7783"	.25233	27	80	107
9	"9-out7784"	.26578	202	558	760
9	"9-out7785"	.30545	84	191	275
9	"9-out7786"	.30454	335	765	1100
9	"9-out7787"	.27752	184	479	663
9	"9-out7788"	.45864	61	72	133
9	"9-out7789"	.38102	245	398	643
9	"9-out7790"	.29471	145	347	492
9	"9-out7791"	.19047	44	187	231
9	"9-out7792"	.32743	74	152	226
9	"9-out7793"	.41630	97	136	233
9	"9-out7794"	.38617	95	151	246
9	"9-out7795"	.49685	79	80	159
9	"9-out7796"	.25573	78	227	305
9	"9-out7797"	.42857	60	80	140
9	"9-out7798"	.36477	232	404	636
9	"9-out7799"	.33134	111	224	335
9	"9-out7800"	.93793	136	9	145
9	"9-out7801"	.34683	531	1000	1531
9	"9-out7802"	.32172	157	331	488
9	"9-out7803"	.26131	329	930	1259
9	"9-out7804"	.93061	228	17	245
9	"9-out7805"	.19411	33	137	170
9	"9-out7806"	.46830	133	151	284
9	"9-out7807"	.24423	127	393	520
9	"9-out7808"	.32579	144	298	442
9	"9-out7809"	.99122	113	1	114
9	"9-out7810"	.98245	112	2	114
9	"9-out7811"	.98245	112	2	114
9	"9-out7812"	.99899	992	1	993
9	"9-out7813"	.27419	34	90	124
9	"9-out7814"	.23979	47	149	196
9	"9-out7815"	.42811	134	179	313
9	"9-out7816"	.99295	141	1	142
9	"9-out7817"	.45696	377	448	825
9	"9-out7818"	.23170	57	189	246
9	"9-out7819"	.64166	154	86	240
9	"9-out7820"	.37109	190	322	512
9	"9-out7821"	.77108	64	19	83
9	"9-out7822"	.32110	140	296	436
9	"9-out7823"	.98000	98	2	100
9	"9-out7824"	.31304	36	79	115
9	"9-out7825"	.22065	47	166	213
9	"9-out7826"	.13227	25	164	189
9	"9-out7827"	.25102	61	182	243
9	"9-out7828"	.22913	162	545	707
9	"9-out7829"	.98319	117	2	119
9	"9-out7830"	.55932	66	52	118
9	"9-out7831"	.41406	53	75	128
9	"9-out7832"	.23888	86	274	360
9	"9-out7833"	.89570	146	17	163
9	"9-out7834"	.40000	68	102	170
9	"9-out7835"	.50609	83	81	164
9	"9-out7836"	.27729	127	331	458
9	"9-out7837"	.16883	52	256	308
9	"9-out7838"	.98437	63	1	64
9	"9-out7839"	.37188	328	554	882
9	"9-out7840"	.24760	207	629	836
9	"9-out7841"	.33027	72	146	218
9	"9-out7842"	.46417	149	172	321
9	"9-out7843"	.98141	264	5	269
9	"9-out7844"	.32631	155	320	475
9	"9-out7845"	.31316	88	193	281
9	"9-out7846"	.28643	57	142	199
9	"9-out7847"	.16666	32	160	192
9	"9-out7848"	.34333	103	197	300
9	"9-out7849"	.41176	84	120	204
9	"9-out7850"	.29047	122	298	420
9	"9-out7851"	.19634	43	176	219
9	"9-out7852"	.23837	41	131	172
9	"9-out7853"	.16107	24	125	149
9	"9-out7854"	.17234	91	437	528
9	"9-out7855"	.32565	198	410	608
9	"9-out7856"	.57575	304	224	528
9	"9-out7857"	.84513	191	35	226
9	"9-out7858"	.62601	77	46	123
9	"9-out7859"	.32755	170	349	519
9	"9-out7860"	.98666	74	1	75
9	"9-out7861"	.99350	153	1	154
9	"9-out7862"	.80000	116	29	145
9	"9-out7863"	.21535	230	838	1068
9	"9-out7864"	.30645	76	172	248
9	"9-out7865"	.90033	271	30	301
9	"9-out7866"	.95689	111	5	116
9	"9-out7867"	.26288	51	143	194
9	"9-out7868"	.89896	694	78	772
9	"9-out7869"	.31627	68	147	215
9	"9-out7870"	.37402	288	482	770
9	"9-out7871"	.32575	86	178	264
9	"9-out7872"	.37914	80	131	211
9	"9-out7873"	.27314	59	157	216
9	"9-out7874"	.42702	79	106	185
9	"9-out7875"	.48672	55	58	113
9	"9-out7876"	.64261	187	104	291
9	"9-out7877"	.25247	51	151	202
9	"9-out7878"	.42889	377	502	879
9	"9-out7879"	.25558	103	300	403
9	"9-out7880"	.99543	218	1	219
9	"9-out7881"	.66139	209	107	316
9	"9-out7882"	.99280	138	1	139
9	"9-out7883"	.62780	140	83	223
9	"9-out7884"	.31797	69	148	217
9	"9-out7885"	.33944	37	72	109
9	"9-out7886"	.31891	177	378	555
9	"9-out7887"	.14468	34	201	235
9	"9-out7888"	.54777	86	71	157
9	"9-out7889"	.55857	329	260	589
9	"9-out7890"	.22025	174	616	790
9	"9-out7891"	.54950	111	91	202
9	"9-out7892"	.95238	200	10	210
9	"9-out7893"	.38512	176	281	457
9	"9-out7894"	.30737	75	169	244
9	"9-out7895"	.43533	138	179	317
9	"9-out7896"	.99290	280	2	282
9	"9-out7897"	.18579	34	149	183
9	"9-out7898"	.72142	202	78	280
9	"9-out7899"	.64133	270	151	421
9	"9-out7900"	.22727	40	136	176
9	"9-out7901"	.39711	110	167	277
9	"9-out7902"	.38759	100	158	258
9	"9-out7903"	.99638	276	1	277
9	"9-out7904"	.28632	67	167	234
9	"9-out7905"	.28205	517	1316	1833
9	"9-out7906"	.62655	151	90	241
9	"9-out7907"	.27536	95	250	345
9	"9-out7908"	.30549	139	316	455
9	"9-out7909"	.28633	132	329	461
9	"9-out7910"	.26274	67	188	255
9	"9-out7911"	.40047	167	250	417
9	"9-out7912"	.78378	58	16	74
9	"9-out7913"	.32686	101	208	309
9	"9-out7914"	.96675	349	12	361
9	"9-out7915"	.50980	416	400	816
9	"9-out7916"	.22321	50	174	224
9	"9-out7917"	.73053	122	45	167
9	"9-out7918"	.71034	206	84	290
9	"9-out7919"	.35172	51	94	145
9	"9-out7920"	.34363	812	1551	2363
9	"9-out7921"	.78629	195	53	248
9	"9-out7922"	.54852	390	321	711
9	"9-out7923"	.32530	243	504	747
9	"9-out7924"	.64864	168	91	259
9	"9-out7925"	1.00000	153	0	153
9	"9-out7926"	.35879	155	277	432
9	"9-out7927"	.23030	76	254	330
9	"9-out7928"	.59055	75	52	127
9	"9-out7929"	.97727	43	1	44
9	"9-out7930"	.92366	121	10	131
9	"9-out7931"	.30088	34	79	113
9	"9-out7932"	.43578	207	268	475
9	"9-out7933"	.64166	154	86	240
9	"9-out7934"	.35958	137	244	381
9	"9-out7935"	.50392	385	379	764
9	"9-out7936"	.36717	170	293	463
9	"9-out7937"	.27160	110	295	405
9	"9-out7938"	.58878	189	132	321
9	"9-out7939"	.30500	61	139	200
9	"9-out7940"	.98039	100	2	102
9	"9-out7941"	.24074	130	410	540
9	"9-out7942"	.48717	57	60	117
9	"9-out7943"	.99363	156	1	157
9	"9-out7944"	.56321	98	76	174
9	"9-out7945"	.72602	53	20	73
9	"9-out7946"	.27541	363	955	1318
9	"9-out7947"	.33068	375	759	1134
9	"9-out7948"	.20973	181	682	863
9	"9-out7949"	.32590	439	908	1347
9	"9-out7950"	.47388	372	413	785
9	"9-out7951"	.84461	674	124	798
9	"9-out7952"	.35066	344	637	981
9	"9-out7953"	.32227	340	715	1055
9	"9-out7954"	.90591	337	35	372
9	"9-out7955"	.34094	1209	2337	3546
9	"9-out7956"	.27567	365	959	1324
9	"9-out7957"	.42082	388	534	922
9	"9-out7958"	.99476	380	2	382
9	"9-out7959"	.34285	48	92	140
9	"9-out7960"	.08888	16	164	180
9	"9-out7961"	.99275	137	1	138
9	"9-out7962"	.69684	508	221	729
9	"9-out7963"	.41484	682	962	1644
9	"9-out7964"	.31806	375	804	1179
9	"9-out7965"	.99512	204	1	205
9	"9-out7966"	.99122	113	1	114
9	"9-out7967"	.99074	107	1	108
9	"9-out7968"	.99056	105	1	106
9	"9-out7969"	.99107	111	1	112
9	"9-out7970"	.99107	111	1	112
9	"9-out7971"	.99137	115	1	116
9	"9-out7972"	.99107	111	1	112
9	"9-out7973"	.99090	109	1	110
9	"9-out7974"	.99082	108	1	109
9	"9-out7975"	.99242	131	1	132
9	"9-out7976"	.98230	111	2	113
9	"9-out7977"	.99115	112	1	113
9	"9-out7978"	.99130	114	1	115
9	"9-out7979"	.99107	111	1	112
9	"9-out7980"	.99107	111	1	112
9	"9-out7981"	.99130	114	1	115
9	"9-out7982"	.99107	111	1	112
9	"9-out7983"	.99115	112	1	113
9	"9-out7984"	.99082	108	1	109
9	"9-out7985"	.99130	114	1	115
9	"9-out7986"	.99130	114	1	115
9	"9-out7987"	.99130	114	1	115
9	"9-out7988"	.99130	114	1	115
9	"9-out7989"	.99130	114	1	115
9	"9-out7990"	.99122	113	1	114
9	"9-out7991"	.98198	109	2	111
9	"9-out7992"	.99122	113	1	114
9	"9-out7993"	.99122	113	1	114
9	"9-out7994"	.99122	113	1	114
9	"9-out7995"	.99122	113	1	114
9	"9-out7996"	.99859	713	1	714
9	"9-out7997"	.27203	179	479	658
9	"9-out7998"	.97727	43	1	44
9	"9-out7999"	.45856	166	196	362
9	"9-out8000"	.51060	289	277	566
9	"9-out16001"	.33815	117	229	346
9	"9-out16002"	.42187	108	148	256
9	"9-out16003"	.57920	362	263	625
9	"9-out16004"	.19491	69	285	354
9	"9-out16005"	.22295	136	474	610
9	"9-out16006"	.29658	113	268	381
9	"9-out16007"	.26836	95	259	354
9	"9-out16008"	.98795	82	1	83
9	"9-out16009"	.23380	83	272	355
9	"9-out16010"	.15902	52	275	327
9	"9-out16011"	.79794	233	59	292
9	"9-out16012"	.26630	147	405	552
9	"9-out16013"	.39243	363	562	925
9	"9-out16014"	.99683	630	2	632
9	"9-out16015"	.99683	630	2	632
9	"9-out16016"	.67883	93	44	137
9	"9-out16017"	.77510	355	103	458
9	"9-out16018"	.39018	167	261	428
9	"9-out16019"	.22185	134	470	604
9	"9-out16020"	.86206	375	60	435
9	"9-out16021"	.29318	129	311	440
9	"9-out16022"	.28278	276	700	976
9	"9-out16023"	.88329	386	51	437
9	"9-out16024"	.34494	198	376	574
9	"9-out16025"	.20334	85	333	418
9	"9-out16026"	.47851	167	182	349
9	"9-out16027"	.24884	108	326	434
9	"9-out16028"	.39037	146	228	374
9	"9-out16029"	.47149	215	241	456
9	"9-out16030"	.49471	234	239	473
9	"9-out16031"	.46478	132	152	284
9	"9-out16032"	.36206	210	370	580
9	"9-out16033"	.28761	260	644	904
9	"9-out16034"	.34065	93	180	273
9	"9-out16035"	.80459	210	51	261
9	"9-out16036"	.17477	97	458	555
9	"9-out16037"	.30237	280	646	926
9	"9-out16038"	.41071	92	132	224
9	"9-out16039"	.21504	223	814	1037
9	"9-out16040"	.21042	218	818	1036
9	"9-out16041"	.11320	24	188	212
9	"9-out16042"	.34844	492	920	1412
9	"9-out16043"	.58503	86	61	147
9	"9-out16044"	.28932	103	253	356
9	"9-out16045"	.25966	215	613	828
9	"9-out16046"	.18965	55	235	290
9	"9-out16047"	.99748	793	2	795
9	"9-out16048"	.49712	346	350	696
9	"9-out16049"	.53832	295	253	548
9	"9-out16050"	.99047	104	1	105
9	"9-out16051"	.27456	95	251	346
9	"9-out16052"	.42857	207	276	483
9	"9-out16053"	.20886	99	375	474
9	"9-out16054"	.29263	139	336	475
9	"9-out16055"	.47863	224	244	468
9	"9-out16056"	.66321	384	195	579
9	"9-out16057"	.34903	163	304	467
9	"9-out16058"	.24069	97	306	403
9	"9-out16059"	.24716	109	332	441
9	"9-out16060"	.36609	339	587	926
9	"9-out16061"	.34729	141	265	406
9	"9-out16062"	.67672	718	343	1061
9	"9-out16063"	.75886	321	102	423
9	"9-out16064"	.15935	69	364	433
9	"9-out16065"	.99790	476	1	477
9	"9-out16066"	.44398	321	402	723
9	"9-out16067"	.50943	162	156	318
9	"9-out16068"	.34977	78	145	223
9	"9-out16069"	.27717	51	133	184
9	"9-out16070"	.93559	799	55	854
9	"9-out16071"	.99549	221	1	222
9	"9-out16072"	.28571	170	425	595
9	"9-out16073"	.19197	67	282	349
9	"9-out16074"	.29422	168	403	571
9	"9-out16075"	.65913	379	196	575
9	"9-out16076"	.23758	67	215	282
9	"9-out16077"	.14039	155	949	1104
9	"9-out16078"	.45711	421	500	921
9	"9-out16079"	.18961	168	718	886
9	"9-out16080"	.61879	573	353	926
9	"9-out16081"	.98305	58	1	59
9	"9-out16082"	.98305	58	1	59
9	"9-out16083"	.98305	58	1	59
9	"9-out16084"	.45345	151	182	333
9	"9-out16085"	.23176	143	474	617
9	"9-out16086"	.68888	62	28	90
9	"9-out16087"	.41338	105	149	254
9	"9-out16088"	.18140	80	361	441
9	"9-out16089"	.51247	226	215	441
9	"9-out16090"	.23041	50	167	217
9	"9-out16091"	.52727	87	78	165
9	"9-out16092"	.41964	188	260	448
9	"9-out16093"	.23798	99	317	416
9	"9-out16094"	.51105	208	199	407
9	"9-out16095"	.24144	120	377	497
9	"9-out16096"	.38105	173	281	454
9	"9-out16097"	.25020	302	905	1207
9	"9-out16098"	.29264	211	510	721
9	"9-out16099"	.20930	81	306	387
9	"9-out16100"	.44273	259	326	585
9	"9-out16101"	.28432	176	443	619
9	"9-out16102"	.17520	65	306	371
9	"9-out16103"	.51798	144	134	278
9	"9-out16104"	.53562	203	176	379
9	"9-out16105"	.20757	126	481	607
9	"9-out16106"	.28462	150	377	527
9	"9-out16107"	.31441	205	447	652
9	"9-out16108"	.36024	116	206	322
9	"9-out16109"	.44897	132	162	294
9	"9-out16110"	.33958	507	986	1493
9	"9-out16111"	.32828	130	266	396
9	"9-out16112"	.22171	290	1018	1308
9	"9-out16113"	.26168	56	158	214
9	"9-out16114"	.23251	133	439	572
9	"9-out16115"	.98237	223	4	227
9	"9-out16116"	.66233	561	286	847
9	"9-out16117"	.35633	253	457	710
9	"9-out16118"	.27466	103	272	375
9	"9-out16119"	.42724	367	492	859
9	"9-out16120"	.27419	153	405	558
9	"9-out16121"	.35223	323	594	917
9	"9-out16122"	.21860	47	168	215
9	"9-out16123"	.20382	213	832	1045
9	"9-out16124"	.23626	1084	3504	4588
9	"9-out16125"	.21782	1085	3896	4981
9	"9-out16126"	.37464	133	222	355
9	"9-out16127"	.24860	89	269	358
9	"9-out16128"	.30085	105	244	349
9	"9-out16129"	.33487	145	288	433
9	"9-out16130"	.35834	406	727	1133
9	"9-out16131"	.38691	272	431	703
9	"9-out16132"	.28462	337	847	1184
9	"9-out16133"	.18735	83	360	443
9	"9-out16134"	.36448	117	204	321
9	"9-out16135"	.39527	117	179	296
9	"9-out16136"	.40395	286	422	708
9	"9-out16137"	.99642	279	1	280
9	"9-out16138"	.17505	73	344	417
9	"9-out16139"	.31395	27	59	86
9	"9-out16140"	.81796	337	75	412
9	"9-out16141"	.28798	163	403	566
9	"9-out16142"	.28195	792	2017	2809
9	"9-out16143"	.27142	38	102	140
9	"9-out16144"	.30743	186	419	605
9	"9-out16145"	.26953	169	458	627
9	"9-out16146"	.40000	34	51	85
9	"9-out16147"	.71484	732	292	1024
9	"9-out16148"	.25000	32	96	128
9	"9-out16149"	.72727	96	36	132
9	"9-out16150"	.32575	43	89	132
9	"9-out16151"	.20338	36	141	177
9	"9-out16152"	.52222	94	86	180
9	"9-out16153"	.24449	100	309	409
9	"9-out16154"	.22257	71	248	319
9	"9-out16155"	.76685	273	83	356
9	"9-out16156"	.99699	332	1	333
9	"9-out16157"	.25740	113	326	439
9	"9-out16158"	.30450	169	386	555
9	"9-out16159"	.42506	156	211	367
9	"9-out16160"	.87381	277	40	317
9	"9-out16161"	.23981	106	336	442
9	"9-out16162"	.18394	55	244	299
9	"9-out16163"	.42400	371	504	875
9	"9-out16164"	.49454	136	139	275
9	"9-out16165"	.26742	165	452	617
9	"9-out16166"	.26430	97	270	367
9	"9-out16167"	.33769	129	253	382
9	"9-out16168"	.65966	157	81	238
9	"9-out16169"	.25765	101	291	392
9	"9-out16170"	.26951	259	702	961
9	"9-out16171"	.26564	174	481	655
9	"9-out16172"	.39772	35	53	88
9	"9-out16173"	.29147	65	158	223
9	"9-out16174"	.99305	286	2	288
9	"9-out16175"	.31758	168	361	529
9	"9-out16176"	.28476	299	751	1050
9	"9-out16177"	.77397	791	231	1022
9	"9-out16178"	.27197	99	265	364
9	"9-out16179"	.35845	176	315	491
9	"9-out16180"	.39285	110	170	280
9	"9-out16181"	.12019	25	183	208
9	"9-out16182"	.30798	247	555	802
9	"9-out16183"	.43835	96	123	219
9	"9-out16184"	.22009	46	163	209
9	"9-out16185"	.89165	3621	440	4061
9	"9-out16186"	.33940	149	290	439
9	"9-out16187"	.99295	141	1	142
9	"9-out16188"	.19117	52	220	272
9	"9-out16189"	.27948	109	281	390
9	"9-out16190"	.48000	84	91	175
9	"9-out16191"	.96202	76	3	79
9	"9-out16192"	.43087	321	424	745
9	"9-out16193"	.99450	181	1	182
9	"9-out16194"	.99275	137	1	138
9	"9-out16195"	.99242	131	1	132
9	"9-out16196"	.42162	78	107	185
9	"9-out16197"	.68780	141	64	205
9	"9-out16198"	.35728	179	322	501
9	"9-out16199"	.64556	51	28	79
9	"9-out16200"	.33469	82	163	245
9	"9-out16201"	.27138	184	494	678
9	"9-out16202"	.26222	177	498	675
9	"9-out16203"	.52941	36	32	68
9	"9-out16204"	.24631	117	358	475
9	"9-out16205"	.41964	47	65	112
9	"9-out16206"	.34782	240	450	690
9	"9-out16207"	.19126	127	537	664
9	"9-out16208"	.34826	902	1688	2590
9	"9-out16209"	.35175	280	516	796
9	"9-out16210"	.27235	134	358	492
9	"9-out16211"	.57394	423	314	737
9	"9-out16212"	.32245	247	519	766
9	"9-out16213"	.33294	288	577	865
9	"9-out16214"	.19599	176	722	898
9	"9-out16215"	.18539	160	703	863
9	"9-out16216"	.98657	294	4	298
9	"9-out16217"	.99371	158	1	159
9	"9-out16218"	.70394	214	90	304
9	"9-out16219"	.74137	86	30	116
9	"9-out16220"	.73298	140	51	191
9	"9-out16221"	.73012	303	112	415
9	"9-out16222"	.33496	137	272	409
9	"9-out16223"	.98989	98	1	99
9	"9-out16224"	.29268	300	725	1025
9	"9-out16225"	.19230	110	462	572
9	"9-out16226"	.21678	124	448	572
9	"9-out16227"	.16491	94	476	570
9	"9-out16228"	.67482	386	186	572
9	"9-out16229"	.24645	139	425	564
9	"9-out16230"	.95864	255	11	266
9	"9-out16231"	.97368	259	7	266
9	"9-out16232"	.97368	259	7	266
9	"9-out16233"	.48775	219	230	449
9	"9-out16234"	.31508	259	563	822
9	"9-out16235"	.35270	261	479	740
9	"9-out16236"	.39049	189	295	484
9	"9-out16237"	.15105	79	444	523
9	"9-out16238"	.32845	157	321	478
9	"9-out16239"	.31736	159	342	501
9	"9-out16240"	.33061	243	492	735
9	"9-out16241"	.30892	270	604	874
9	"9-out16242"	.49814	134	135	269
9	"9-out16243"	.32957	146	297	443
9	"9-out16244"	.22197	99	347	446
9	"9-out16245"	.16252	72	371	443
9	"9-out16246"	.22500	90	310	400
9	"9-out16247"	.66595	311	156	467
9	"9-out16248"	.80503	384	93	477
9	"9-out16249"	.39137	254	395	649
9	"9-out16250"	.87465	321	46	367
9	"9-out16251"	.14285	52	312	364
9	"9-out16252"	.43346	114	149	263
9	"9-out16253"	.72925	167	62	229
9	"9-out16254"	.10461	34	291	325
9	"9-out16255"	.44230	138	174	312
9	"9-out16256"	.93617	176	12	188
9	"9-out16257"	.03535	7	191	198
9	"9-out16258"	.99248	132	1	133
9	"9-out16259"	.97058	33	1	34
9	"9-out16260"	.37037	130	221	351
9	"9-out16261"	.56521	104	80	184
9	"9-out16262"	.58000	87	63	150
9	"9-out16263"	.04739	10	201	211
9	"9-out16264"	.35405	410	748	1158
9	"9-out16265"	.71590	126	50	176
9	"9-out16266"	.90476	57	6	63
9	"9-out16267"	.21703	107	386	493
9	"9-out16268"	.86594	239	37	276
9	"9-out16269"	.35609	146	264	410
9	"9-out16270"	.33969	1086	2111	3197
9	"9-out16271"	.73880	99	35	134
9	"9-out16272"	.26241	148	416	564
9	"9-out16273"	.16946	131	642	773
9	"9-out16274"	.26315	65	182	247
9	"9-out16275"	.83896	422	81	503
9	"9-out16276"	.97368	74	2	76
9	"9-out16277"	.99065	212	2	214
9	"9-out16278"	.71219	146	59	205
9	"9-out16279"	.41560	229	322	551
9	"9-out16280"	.99637	1649	6	1655
9	"9-out16281"	.28840	107	264	371
9	"9-out16282"	.43521	131	170	301
9	"9-out16283"	.14191	43	260	303
9	"9-out16284"	.21803	237	850	1087
9	"9-out16285"	.42948	67	89	156
9	"9-out16286"	.99099	110	1	111
9	"9-out16287"	.30739	241	543	784
9	"9-out16288"	.34722	50	94	144
9	"9-out16289"	.25462	358	1048	1406
9	"9-out16290"	.13714	24	151	175
9	"9-out16291"	.32081	188	398	586
9	"9-out16292"	.99720	357	1	358
9	"9-out16293"	.99082	108	1	109
9	"9-out16294"	.32115	211	446	657
9	"9-out16295"	.27247	100	267	367
9	"9-out16296"	.47792	433	473	906
9	"9-out16297"	.27464	195	515	710
9	"9-out16298"	.42809	384	513	897
9	"9-out16299"	.33738	222	436	658
9	"9-out16300"	.30402	121	277	398
9	"9-out16301"	.29924	79	185	264
9	"9-out16302"	.26344	534	1493	2027
9	"9-out16303"	.99324	147	1	148
9	"9-out16304"	.23189	221	732	953
9	"9-out16305"	.25256	197	583	780
9	"9-out16306"	.34269	61	117	178
9	"9-out16307"	.26204	321	904	1225
9	"9-out16308"	.32155	546	1152	1698
9	"9-out16309"	.99563	228	1	229
9	"9-out16310"	.38823	165	260	425
9	"9-out16311"	.99771	436	1	437
9	"9-out16312"	.31235	268	590	858
9	"9-out16313"	.34645	44	83	127
9	"9-out16314"	.30061	49	114	163
9	"9-out16315"	.35314	202	370	572
9	"9-out16316"	.73484	715	258	973
9	"9-out16317"	.43030	213	282	495
9	"9-out16318"	.99828	583	1	584
9	"9-out16319"	.99810	526	1	527
9	"9-out16320"	.69674	278	121	399
9	"9-out16321"	.36708	145	250	395
9	"9-out16322"	.48341	102	109	211
9	"9-out16323"	.36170	34	60	94
9	"9-out16324"	.44200	141	178	319
9	"9-out16325"	.48966	308	321	629
9	"9-out16326"	.27848	22	57	79
9	"9-out16327"	.97534	356	9	365
9	"9-out16328"	.95549	365	17	382
9	"9-out16329"	.94346	267	16	283
9	"9-out16330"	.42105	48	66	114
9	"9-out16331"	.40625	52	76	128
9	"9-out16332"	.22118	71	250	321
9	"9-out16333"	.55862	243	192	435
9	"9-out16334"	.35145	181	334	515
9	"9-out16335"	.17897	63	289	352
9	"9-out16336"	.23232	46	152	198
9	"9-out16337"	.77611	104	30	134
9	"9-out16338"	.98245	224	4	228
9	"9-out16339"	.91538	476	44	520
9	"9-out16340"	.39736	453	687	1140
9	"9-out16341"	.47704	239	262	501
9	"9-out16342"	.42800	3240	4330	7570
9	"9-out16343"	.99603	503	2	505
9	"9-out16344"	.39374	302	465	767
9	"9-out16345"	.26566	195	539	734
9	"9-out16346"	.89099	564	69	633
9	"9-out16347"	.74501	374	128	502
9	"9-out16348"	.98245	56	1	57
9	"9-out16349"	.54960	1036	849	1885
9	"9-out16350"	.22935	125	420	545
9	"9-out16351"	.25102	183	546	729
9	"9-out16352"	.10317	26	226	252
9	"9-out16353"	.27115	141	379	520
9	"9-out16354"	.57917	267	194	461
9	"9-out16355"	.32992	129	262	391
9	"9-out16356"	.30406	426	975	1401
9	"9-out16357"	.24251	154	481	635
9	"9-out16358"	.38051	250	407	657
9	"9-out16359"	.40068	470	703	1173
9	"9-out16360"	.27335	158	420	578
9	"9-out16361"	.28326	264	668	932
9	"9-out16362"	.35125	392	724	1116
9	"9-out16363"	.39642	377	574	951
9	"9-out16364"	.27178	315	844	1159
9	"9-out16365"	.24500	49	151	200
9	"9-out16366"	.35000	168	312	480
9	"9-out16367"	.72961	340	126	466
9	"9-out16368"	.27841	463	1200	1663
9	"9-out16369"	.35849	76	136	212
9	"9-out16370"	.36239	266	468	734
9	"9-out16371"	.99280	138	1	139
9	"9-out16372"	.99346	152	1	153
9	"9-out16373"	.99295	141	1	142
9	"9-out16374"	.63414	52	30	82
9	"9-out16375"	.48476	684	727	1411
9	"9-out16376"	.55782	246	195	441
9	"9-out16377"	.21792	124	445	569
9	"9-out16378"	.35233	136	250	386
9	"9-out16379"	.99783	461	1	462
9	"9-out16380"	.51804	402	374	776
9	"9-out16381"	.30909	778	1739	2517
9	"9-out16382"	.33625	307	606	913
9	"9-out16383"	.30769	84	189	273
9	"9-out16384"	.25675	38	110	148
9	"9-out16385"	.60264	91	60	151
9	"9-out16386"	.99411	169	1	170
9	"9-out16387"	.48591	69	73	142
9	"9-out16388"	.90039	226	25	251
9	"9-out16389"	.99644	280	1	281
9	"9-out16390"	.48678	442	466	908
9	"9-out16391"	.99696	329	1	330
9	"9-out16392"	.18482	134	591	725
9	"9-out16393"	.40254	190	282	472
9	"9-out16394"	.98734	78	1	79
9	"9-out16395"	.99367	157	1	158
9	"9-out16396"	.99367	157	1	158
9	"9-out16397"	.99305	143	1	144
9	"9-out16398"	.34517	68	129	197
9	"9-out16399"	.57023	341	257	598
9	"9-out16400"	.99453	182	1	183
9	"9-out16401"	.63953	55	31	86
9	"9-out16402"	.99801	502	1	503
9	"9-out16403"	.98863	87	1	88
9	"9-out16404"	.36648	199	344	543
9	"9-out16405"	.25663	58	168	226
9	"9-out16406"	.26726	89	244	333
9	"9-out16407"	.28947	77	189	266
9	"9-out16408"	.31135	85	188	273
9	"9-out16409"	.30167	108	250	358
9	"9-out16410"	.30651	80	181	261
9	"9-out16411"	.73476	205	74	279
9	"9-out16412"	.21259	54	200	254
9	"9-out16413"	.29569	110	262	372
9	"9-out16414"	.28286	71	180	251
9	"9-out16415"	.32867	94	192	286
9	"9-out16416"	.19251	36	151	187
9	"9-out16417"	.33373	278	555	833
9	"9-out16418"	.25000	160	480	640
9	"9-out16419"	.62053	695	425	1120
9	"9-out16420"	.58762	171	120	291
9	"9-out16421"	.39303	79	122	201
9	"9-out16422"	.89595	310	36	346
9	"9-out16423"	.18618	62	271	333
9	"9-out16424"	.49117	167	173	340
9	"9-out16425"	.23064	280	934	1214
9	"9-out16426"	.98033	1246	25	1271
9	"9-out16427"	.38730	122	193	315
9	"9-out16428"	.24657	72	220	292
9	"9-out16429"	.26538	69	191	260
9	"9-out16430"	.38114	93	151	244
9	"9-out16431"	.34576	306	579	885
9	"9-out16432"	.59313	812	557	1369
9	"9-out16433"	.73154	109	40	149
9	"9-out16434"	.56266	211	164	375
9	"9-out16435"	.20676	55	211	266
9	"9-out16436"	.24233	166	519	685
9	"9-out16437"	.27177	78	209	287
9	"9-out16438"	.12571	22	153	175
9	"9-out16439"	.41266	404	575	979
9	"9-out16440"	.61444	502	315	817
9	"9-out16441"	.41134	348	498	846
9	"9-out16442"	.28608	549	1370	1919
9	"9-out16443"	.49651	285	289	574
9	"9-out16444"	.17889	763	3502	4265
9	"9-out16445"	.42750	115	154	269
9	"9-out16446"	.20838	159	604	763
9	"9-out16447"	.32946	1419	2888	4307
9	"9-out16448"	.28144	1271	3245	4516
9	"9-out16449"	.95721	179	8	187
9	"9-out16450"	.42873	1913	2549	4462
9	"9-out16451"	.12414	73	515	588
9	"9-out16452"	.26105	242	685	927
9	"9-out16453"	.28571	134	335	469
9	"9-out16454"	.16176	55	285	340
9	"9-out16455"	.21264	185	685	870
9	"9-out16456"	.20882	71	269	340
9	"9-out16457"	.18987	165	704	869
9	"9-out16458"	.22962	124	416	540
9	"9-out16459"	.18560	116	509	625
9	"9-out16460"	.30963	135	301	436
9	"9-out16461"	.25296	128	378	506
9	"9-out16462"	.19393	518	2153	2671
9	"9-out16463"	.46962	201	227	428
9	"9-out16464"	.28538	125	313	438
9	"9-out16465"	.33774	153	300	453
9	"9-out16466"	.53488	230	200	430
9	"9-out16467"	.99456	366	2	368
9	"9-out16468"	.26496	239	663	902
9	"9-out16469"	.35832	325	582	907
9	"9-out16470"	.25487	170	497	667
9	"9-out16471"	.39843	408	616	1024
9	"9-out16472"	.44318	234	294	528
9	"9-out16473"	.30346	552	1267	1819
9	"9-out16474"	.48005	373	404	777
9	"9-out16475"	.35955	64	114	178
9	"9-out16476"	.95490	974	46	1020
9	"9-out16477"	.41191	166	237	403
9	"9-out16478"	.29420	203	487	690
9	"9-out16479"	.37431	274	458	732
9	"9-out16480"	.24394	151	468	619
9	"9-out16481"	.57050	352	265	617
9	"9-out16482"	.99796	490	1	491
9	"9-out16483"	.28366	158	399	557
9	"9-out16484"	.41772	66	92	158
9	"9-out16485"	.51250	82	78	160
9	"9-out16486"	.56175	141	110	251
9	"9-out16487"	.42290	96	131	227
9	"9-out16488"	.28781	137	339	476
9	"9-out16489"	.99837	615	1	616
9	"9-out16490"	.11627	25	190	215
9	"9-out16491"	.52727	116	104	220
9	"9-out16492"	.27762	98	255	353
9	"9-out16493"	.38636	153	243	396
9	"9-out16494"	.36319	150	263	413
9	"9-out16495"	.17907	89	408	497
9	"9-out16496"	.67194	297	145	442
9	"9-out16497"	.58041	480	347	827
9	"9-out16498"	.97258	674	19	693
9	"9-out16499"	.34860	137	256	393
9	"9-out16500"	.49302	106	109	215
9	"9-out16501"	.36018	152	270	422
9	"9-out16502"	.19101	34	144	178
9	"9-out16503"	.99038	103	1	104
9	"9-out16504"	.99462	185	1	186
9	"9-out16505"	.99549	221	1	222
9	"9-out16506"	.98501	723	11	734
9	"9-out16507"	.30258	164	378	542
9	"9-out16508"	.27509	222	585	807
9	"9-out16509"	.30200	241	557	798
9	"9-out16510"	.25190	132	392	524
9	"9-out16511"	.32835	88	180	268
9	"9-out16512"	.99500	398	2	400
9	"9-out16513"	.32850	68	139	207
9	"9-out16514"	.32285	113	237	350
9	"9-out16515"	.29049	269	657	926
9	"9-out16516"	.16222	73	377	450
9	"9-out16517"	.55079	244	199	443
9	"9-out16518"	.97540	357	9	366
9	"9-out16519"	.27522	90	237	327
9	"9-out16520"	.24363	67	208	275
9	"9-out16521"	.27272	72	192	264
9	"9-out16522"	.96116	198	8	206
9	"9-out16523"	.28415	965	2431	3396
9	"9-out16524"	.80310	155	38	193
9	"9-out16525"	.22164	43	151	194
9	"9-out16526"	.29383	181	435	616
9	"9-out16527"	.34013	50	97	147
9	"9-out16528"	.69811	111	48	159
9	"9-out16529"	.49019	75	78	153
9	"9-out16530"	.99484	193	1	194
9	"9-out16531"	.98941	187	2	189
9	"9-out16532"	.99470	188	1	189
9	"9-out16533"	.99470	188	1	189
9	"9-out16534"	.99470	188	1	189
9	"9-out16535"	.99470	188	1	189
9	"9-out16536"	.99470	188	1	189
9	"9-out16537"	.99470	188	1	189
9	"9-out16538"	.98750	158	2	160
9	"9-out16539"	.38512	352	562	914
9	"9-out16540"	.33333	221	442	663
9	"9-out16541"	.46905	341	386	727
9	"9-out16542"	.82696	368	77	445
9	"9-out16543"	.92885	692	53	745
9	"9-out16544"	.99367	157	1	158
9	"9-out16545"	.98326	764	13	777
9	"9-out16546"	.76616	154	47	201
9	"9-out16547"	.17633	79	369	448
9	"9-out16548"	.37519	245	408	653
9	"9-out16549"	.21621	136	493	629
9	"9-out16550"	.28109	174	445	619
9	"9-out16551"	.25000	67	201	268
9	"9-out16552"	.99788	471	1	472
9	"9-out16553"	.32456	259	539	798
9	"9-out16554"	.69252	241	107	348
9	"9-out16555"	.36699	189	326	515
9	"9-out16556"	.17665	171	797	968
9	"9-out16557"	.26229	112	315	427
9	"9-out16558"	.49382	40	41	81
9	"9-out16559"	.99285	139	1	140
9	"9-out16560"	.93243	69	5	74
9	"9-out16561"	.30769	136	306	442
9	"9-out16562"	.99393	164	1	165
9	"9-out16563"	.99668	301	1	302
9	"9-out16564"	.50124	1816	1807	3623
9	"9-out16565"	.99783	461	1	462
9	"9-out16566"	.33797	97	190	287
9	"9-out16567"	.99784	462	1	463
9	"9-out16568"	.33422	249	496	745
9	"9-out16569"	.34636	62	117	179
9	"9-out16570"	.30210	258	596	854
9	"9-out16571"	.48333	174	186	360
9	"9-out16572"	.46839	652	740	1392
9	"9-out16573"	.23580	54	175	229
9	"9-out16574"	.62666	94	56	150
9	"9-out16575"	.28160	245	625	870
9	"9-out16576"	.62500	60	36	96
9	"9-out16577"	.44249	227	286	513
9	"9-out16578"	.98636	217	3	220
9	"9-out16579"	.99479	191	1	192
9	"9-out16580"	.31315	238	522	760
9	"9-out16581"	.51313	332	315	647
9	"9-out16582"	.30325	121	278	399
9	"9-out16583"	.38947	74	116	190
9	"9-out16584"	.23809	25	80	105
9	"9-out16585"	.27708	133	347	480
9	"9-out16586"	.38790	154	243	397
9	"9-out16587"	.90294	307	33	340
9	"9-out16588"	.86896	126	19	145
9	"9-out16589"	.46601	144	165	309
9	"9-out16590"	.36507	184	320	504
9	"9-out16591"	.97794	266	6	272
9	"9-out16592"	.94094	239	15	254
9	"9-out16593"	.93725	239	16	255
9	"9-out16594"	.18688	134	583	717
9	"9-out16595"	.20803	88	335	423
9	"9-out16596"	.99748	397	1	398
9	"9-out16597"	.29002	125	306	431
9	"9-out16598"	.20588	49	189	238
9	"9-out16599"	.43693	97	125	222
9	"9-out16600"	.29527	75	179	254
9	"9-out16601"	.14522	35	206	241
9	"9-out16602"	.15412	86	472	558
9	"9-out16603"	.28818	100	247	347
9	"9-out16604"	.37400	141	236	377
9	"9-out16605"	.26262	52	146	198
9	"9-out16606"	.28872	192	473	665
9	"9-out16607"	.28065	103	264	367
9	"9-out16608"	.98930	370	4	374
9	"9-out16609"	.35362	151	276	427
9	"9-out16610"	.61600	77	48	125
9	"9-out16611"	.36390	246	430	676
9	"9-out16612"	.23807	1068	3418	4486
9	"9-out16613"	.41853	280	389	669
9	"9-out16614"	.39699	343	521	864
9	"9-out16615"	.40646	289	422	711
9	"9-out16616"	.21393	43	158	201
9	"9-out16617"	.34050	174	337	511
9	"9-out16618"	.09818	54	496	550
9	"9-out16619"	.99598	248	1	249
9	"9-out16620"	.33401	163	325	488
9	"9-out16621"	.20671	80	307	387
9	"9-out16622"	.20921	218	824	1042
9	"9-out16623"	.43434	172	224	396
9	"9-out16624"	.15989	59	310	369
9	"9-out16625"	.34217	129	248	377
9	"9-out16626"	.21405	67	246	313
9	"9-out16627"	.35423	113	206	319
9	"9-out16628"	.30893	211	472	683
9	"9-out16629"	.42920	97	129	226
9	"9-out16630"	.30982	224	499	723
9	"9-out16631"	.30142	529	1226	1755
9	"9-out16632"	.39005	149	233	382
9	"9-out16633"	.31499	332	722	1054
9	"9-out16634"	.26766	125	342	467
9	"9-out16635"	.32358	343	717	1060
9	"9-out16636"	.32577	230	476	706
9	"9-out16637"	.29582	234	557	791
9	"9-out16638"	.26959	258	699	957
9	"9-out16639"	.98070	610	12	622
9	"9-out16640"	.36486	270	470	740
9	"9-out16641"	.24717	153	466	619
9	"9-out16642"	.27727	61	159	220
9	"9-out16643"	.22821	110	372	482
9	"9-out16644"	.28823	98	242	340
9	"9-out16645"	.66101	195	100	295
9	"9-out16646"	.57142	124	93	217
9	"9-out16647"	.42056	180	248	428
9	"9-out16648"	.30555	121	275	396
9	"9-out16649"	.76470	156	48	204
9	"9-out16650"	.13494	39	250	289
9	"9-out16651"	.30496	86	196	282
9	"9-out16652"	.93518	303	21	324
9	"9-out16653"	.43026	145	192	337
9	"9-out16654"	.27298	95	253	348
9	"9-out16655"	.75766	247	79	326
9	"9-out16656"	.14655	34	198	232
9	"9-out16657"	.43049	96	127	223
9	"9-out16658"	.65700	408	213	621
9	"9-out16659"	.25103	121	361	482
9	"9-out16660"	.16666	68	340	408
9	"9-out16661"	.89552	300	35	335
9	"9-out16662"	.39113	203	316	519
9	"9-out16663"	.97701	255	6	261
9	"9-out16664"	.72761	195	73	268
9	"9-out16665"	.87544	246	35	281
9	"9-out16666"	.95217	219	11	230
9	"9-out16667"	.19488	61	252	313
9	"9-out16668"	.21604	105	381	486
9	"9-out16669"	.20300	54	212	266
9	"9-out16670"	.63610	222	127	349
9	"9-out16671"	.28732	102	253	355
9	"9-out16672"	.21098	73	273	346
9	"9-out16673"	.18767	67	290	357
9	"9-out16674"	.99805	514	1	515
9	"9-out16675"	.25270	70	207	277
9	"9-out16676"	.26158	79	223	302
9	"9-out16677"	.30072	578	1344	1922
9	"9-out16678"	.30825	209	469	678
9	"9-out16679"	.25544	305	889	1194
9	"9-out16680"	.28212	101	257	358
9	"9-out16681"	.25892	58	166	224
9	"9-out16682"	.10588	27	228	255
9	"9-out16683"	.47038	278	313	591
9	"9-out16684"	.83711	591	115	706
9	"9-out16685"	.34024	82	159	241
9	"9-out16686"	.23908	115	366	481
9	"9-out16687"	.73412	185	67	252
9	"9-out16688"	.97647	166	4	170
9	"9-out16689"	.99492	196	1	197
9	"9-out16690"	.27234	195	521	716
9	"9-out16691"	.88805	595	75	670
9	"9-out16692"	.97058	33	1	34
9	"9-out16693"	.99849	665	1	666
9	"9-out16694"	.49926	340	341	681
9	"9-out16695"	.37386	329	551	880
9	"9-out16696"	.39913	277	417	694
9	"9-out16697"	.27665	192	502	694
9	"9-out16698"	.98780	567	7	574
9	"9-out16699"	.19042	843	3584	4427
9	"9-out16700"	.27639	1241	3249	4490
9	"9-out16701"	.24719	22	67	89
9	"9-out16702"	.89380	101	12	113
9	"9-out16703"	.34470	283	538	821
9	"9-out16704"	.59793	58	39	97
9	"9-out16705"	.38580	250	398	648
9	"9-out16706"	.19906	85	342	427
9	"9-out16707"	.53882	340	291	631
9	"9-out16708"	.18150	53	239	292
9	"9-out16709"	.54133	203	172	375
9	"9-out16710"	.26680	766	2105	2871
9	"9-out16711"	.99545	219	1	220
9	"9-out16712"	.23388	185	606	791
9	"9-out16713"	.20333	61	239	300
9	"9-out16714"	.52222	141	129	270
9	"9-out16715"	.93884	261	17	278
9	"9-out16716"	.31096	431	955	1386
9	"9-out16717"	.21212	42	156	198
9	"9-out16718"	.19796	311	1260	1571
9	"9-out16719"	.25635	111	322	433
9	"9-out16720"	.26706	407	1117	1524
9	"9-out16721"	.28264	158	401	559
9	"9-out16722"	.34507	774	1469	2243
9	"9-out16723"	.24281	93	290	383
9	"9-out16724"	.10424	27	232	259
9	"9-out16725"	.38719	127	201	328
9	"9-out16726"	.33852	87	170	257
9	"9-out16727"	.30294	113	260	373
9	"9-out16728"	.92156	94	8	102
9	"9-out16729"	.26436	69	192	261
9	"9-out16730"	.34947	1061	1975	3036
9	"9-out16731"	.24600	369	1131	1500
9	"9-out16732"	.18163	91	410	501
9	"9-out16733"	.16940	175	858	1033
9	"9-out16734"	.30243	199	459	658
9	"9-out16735"	.95606	544	25	569
9	"9-out16736"	.45553	251	300	551
9	"9-out16737"	.99082	108	1	109
9	"9-out16738"	.31688	546	1177	1723
9	"9-out16739"	.74848	2223	747	2970
9	"9-out16740"	.58375	115	82	197
9	"9-out16741"	.39874	445	671	1116
9	"9-out16742"	.29553	245	584	829
9	"9-out16743"	.55555	55	44	99
9	"9-out16744"	.46896	136	154	290
9	"9-out16745"	.40476	170	250	420
9	"9-out16746"	.36666	165	285	450
9	"9-out16747"	.35198	151	278	429
9	"9-out16748"	.31142	199	440	639
9	"9-out16749"	.25060	103	308	411
9	"9-out16750"	.46531	161	185	346
9	"9-out16751"	.88256	248	33	281
9	"9-out16752"	.36781	64	110	174
9	"9-out16753"	.16459	53	269	322
9	"9-out16754"	.24131	250	786	1036
9	"9-out16755"	.30041	73	170	243
9	"9-out16756"	.99460	369	2	371
9	"9-out16757"	.22143	281	988	1269
9	"9-out16758"	.20317	179	702	881
9	"9-out16759"	.35124	353	652	1005
9	"9-out16760"	.31923	234	499	733
9	"9-out16761"	.42333	381	519	900
9	"9-out16762"	.99775	445	1	446
9	"9-out16763"	.30803	69	155	224
9	"9-out16764"	.44824	576	709	1285
9	"9-out16765"	.56666	68	52	120
9	"9-out16766"	.23076	186	620	806
9	"9-out16767"	.98717	77	1	78
9	"9-out16768"	.99212	126	1	127
9	"9-out16769"	.22299	128	446	574
9	"9-out16770"	.93464	143	10	153
9	"9-out16771"	.16428	92	468	560
9	"9-out16772"	.24410	870	2694	3564
9	"9-out16773"	.20848	727	2760	3487
9	"9-out16774"	.27164	1007	2700	3707
9	"9-out16775"	.31045	95	211	306
9	"9-out16776"	.92344	193	16	209
9	"9-out16777"	.54385	31	26	57
9	"9-out16778"	.22857	176	594	770
9	"9-out16779"	.31812	258	553	811
9	"9-out16780"	.35270	443	813	1256
9	"9-out16781"	.82306	628	135	763
9	"9-out16782"	.69409	329	145	474
9	"9-out16783"	.31164	91	201	292
9	"9-out16784"	.50495	153	150	303
9	"9-out16785"	.38674	210	333	543
9	"9-out16786"	.18134	35	158	193
9	"9-out16787"	.19757	114	463	577
9	"9-out16788"	.64827	94	51	145
9	"9-out16789"	.32782	119	244	363
9	"9-out16790"	.19979	191	765	956
9	"9-out16791"	.37404	98	164	262
9	"9-out16792"	.28484	47	118	165
9	"9-out16793"	.51677	77	72	149
9	"9-out16794"	.99019	101	1	102
9	"9-out16795"	.27782	327	850	1177
9	"9-out16796"	.34710	42	79	121
9	"9-out16797"	.99444	179	1	180
9	"9-out16798"	.98648	73	1	74
9	"9-out16799"	.98970	769	8	777
9	"9-out16800"	.98970	769	8	777
9	"9-out16801"	.99809	523	1	524
9	"9-out16802"	.39811	254	384	638
9	"9-out16803"	.13978	52	320	372
9	"9-out16804"	.28275	41	104	145
9	"9-out16805"	.45669	58	69	127
9	"9-out16806"	.27675	256	669	925
9	"9-out16807"	.45445	434	521	955
9	"9-out16808"	.57936	73	53	126
9	"9-out16809"	.25668	355	1028	1383
9	"9-out16810"	.32608	60	124	184
9	"9-out16811"	.37546	101	168	269
9	"9-out16812"	.98161	267	5	272
9	"9-out16813"	.98257	282	5	287
9	"9-out16814"	.49285	69	71	140
9	"9-out16815"	.35343	170	311	481
9	"9-out16816"	.25555	46	134	180
9	"9-out16817"	.19691	268	1093	1361
9	"9-out16818"	.44508	1386	1728	3114
9	"9-out16819"	.66801	165	82	247
9	"9-out16820"	.66400	332	168	500
9	"9-out16821"	.58028	618	447	1065
9	"9-out16822"	.21511	37	135	172
9	"9-out16823"	.43923	206	263	469
9	"9-out16824"	.28272	54	137	191
9	"9-out16825"	.38412	121	194	315
9	"9-out16826"	.34446	227	432	659
9	"9-out16827"	.32510	224	465	689
9	"9-out16828"	.99218	127	1	128
9	"9-out16829"	.43223	303	398	701
9	"9-out16830"	.40594	41	60	101
9	"9-out16831"	.49347	189	194	383
9	"9-out16832"	.41379	120	170	290
9	"9-out16833"	.46098	254	297	551
9	"9-out16834"	.39453	101	155	256
9	"9-out16835"	.32912	287	585	872
9	"9-out16836"	.98888	89	1	90
9	"9-out16837"	.98773	161	2	163
9	"9-out16838"	.50166	151	150	301
9	"9-out16839"	.32297	478	1002	1480
9	"9-out16840"	.99019	101	1	102
9	"9-out16841"	.32464	137	285	422
9	"9-out16842"	.33653	175	345	520
9	"9-out16843"	.42105	32	44	76
9	"9-out16844"	.32830	87	178	265
9	"9-out16845"	.99310	144	1	145
9	"9-out16846"	.27760	88	229	317
9	"9-out16847"	.32089	129	273	402
9	"9-out16848"	.27272	36	96	132
9	"9-out16849"	.31423	192	419	611
9	"9-out16850"	.98163	481	9	490
9	"9-out16851"	.98979	485	5	490
9	"9-out16852"	.99801	503	1	504
9	"9-out16853"	.90267	473	51	524
9	"9-out16854"	.88998	453	56	509
9	"9-out16855"	.29979	149	348	497
9	"9-out16856"	.53072	95	84	179
9	"9-out16857"	.44927	62	76	138
9	"9-out16858"	.21192	32	119	151
9	"9-out16859"	.27007	37	100	137
9	"9-out16860"	.60544	89	58	147
9	"9-out16861"	.54000	27	23	50
9	"9-out16862"	.24882	159	480	639
9	"9-out16863"	.99470	188	1	189
9	"9-out16864"	.99470	188	1	189
9	"9-out16865"	.99470	188	1	189
9	"9-out16866"	.46323	63	73	136
9	"9-out16867"	.99512	204	1	205
9	"9-out16868"	.57772	249	182	431
9	"9-out16869"	.29203	264	640	904
9	"9-out16870"	.32045	141	299	440
9	"9-out16871"	.37269	101	170	271
9	"9-out16872"	.35282	344	631	975
9	"9-out16873"	.98970	769	8	777
9	"9-out16874"	.41547	145	204	349
9	"9-out16875"	.26511	57	158	215
9	"9-out16876"	.16147	114	592	706
9	"9-out16877"	.41152	100	143	243
9	"9-out16878"	.26588	159	439	598
9	"9-out16879"	.26008	187	532	719
9	"9-out16880"	.31299	159	349	508
9	"9-out16881"	.99378	160	1	161
9	"9-out16882"	.84410	222	41	263
9	"9-out16883"	.90874	239	24	263
9	"9-out16884"	.99811	529	1	530
9	"9-out16885"	.23798	213	682	895
9	"9-out16886"	.27144	212	569	781
9	"9-out16887"	.44117	105	133	238
9	"9-out16888"	.08641	7	74	81
9	"9-out16889"	.98765	80	1	81
9	"9-out16890"	.38888	42	66	108
9	"9-out16891"	.45031	145	177	322
9	"9-out16892"	.15525	34	185	219
9	"9-out16893"	.58333	119	85	204
9	"9-out16894"	.96153	50	2	52
9	"9-out16895"	.99206	125	1	126
9	"9-out16896"	.98437	63	1	64
9	"9-out16897"	.98701	76	1	77
9	"9-out16898"	.98305	58	1	59
9	"9-out16899"	.98181	54	1	55
9	"9-out16900"	.34652	429	809	1238
9	"9-out16901"	.38671	297	471	768
9	"9-out16902"	.34743	271	509	780
9	"9-out16903"	.99555	224	1	225
9	"9-out16904"	.56164	246	192	438
9	"9-out16905"	.98387	61	1	62
9	"9-out16906"	.27781	417	1084	1501
9	"9-out16907"	.99200	124	1	125
9	"9-out16908"	.99416	511	3	514
9	"9-out16909"	.94495	103	6	109
9	"9-out16910"	.92342	205	17	222
9	"9-out16911"	.56701	55	42	97
9	"9-out16912"	.69277	230	102	332
9	"9-out16913"	.99074	107	1	108
9	"9-out16914"	.99074	107	1	108
9	"9-out16915"	.99425	173	1	174
9	"9-out16916"	.24688	218	665	883
9	"9-out16917"	.36842	133	228	361
9	"9-out16918"	.38591	137	218	355
9	"9-out16919"	.74698	62	21	83
9	"9-out16920"	.98765	80	1	81
9	"9-out16921"	.63157	72	42	114
9	"9-out16922"	.32748	112	230	342
9	"9-out16923"	.58571	205	145	350
9	"9-out16924"	.41704	93	130	223
9	"9-out16925"	.98130	105	2	107
9	"9-out16926"	.59292	67	46	113
9	"9-out16927"	.30105	286	664	950
9	"9-out16928"	.30674	200	452	652
9	"9-out16929"	.43037	204	270	474
9	"9-out16930"	.49541	162	165	327
9	"9-out16931"	.37818	104	171	275
9	"9-out16932"	.31542	135	293	428
9	"9-out16933"	.22972	102	342	444
9	"9-out16934"	.25806	24	69	93
9	"9-out16935"	.37500	45	75	120
9	"9-out16936"	.24919	77	232	309
9	"9-out16937"	.42222	114	156	270
9	"9-out16938"	.98837	340	4	344
9	"9-out16939"	.29912	102	239	341
9	"9-out16940"	.21133	179	668	847
9	"9-out16941"	.20533	77	298	375
9	"9-out16942"	.96250	77	3	80
9	"9-out16943"	.23333	70	230	300
9	"9-out16944"	.51030	198	190	388
9	"9-out16945"	.30000	168	392	560
9	"9-out16946"	.85891	347	57	404
9	"9-out16947"	.99523	209	1	210
9	"9-out16948"	.73892	617	218	835
9	"9-out16949"	.36180	72	127	199
9	"9-out16950"	.32203	171	360	531
9	"9-out16951"	.34494	198	376	574
9	"9-out16952"	.30516	65	148	213
9	"9-out16953"	.32996	98	199	297
9	"9-out16954"	.99468	187	1	188
9	"9-out16955"	.88372	228	30	258
9	"9-out16956"	.21378	121	445	566
9	"9-out16957"	.21925	41	146	187
9	"9-out16958"	.27272	138	368	506
9	"9-out16959"	.38513	228	364	592
9	"9-out16960"	.44385	759	951	1710
9	"9-out16961"	.21812	325	1165	1490
9	"9-out16962"	.35220	56	103	159
9	"9-out16963"	.28387	132	333	465
9	"9-out16964"	.21585	98	356	454
9	"9-out16965"	.68029	183	86	269
9	"9-out16966"	.21250	17	63	80
9	"9-out16967"	.57541	206	152	358
9	"9-out16968"	.40310	104	154	258
9	"9-out16969"	.40116	138	206	344
9	"9-out16970"	.99832	595	1	596
9	"9-out16971"	.97610	286	7	293
9	"9-out16972"	.34505	1040	1974	3014
9	"9-out16973"	.44247	150	189	339
9	"9-out16974"	.36333	109	191	300
9	"9-out16975"	.48722	1316	1385	2701
9	"9-out16976"	.20454	18	70	88
9	"9-out16977"	.21093	81	303	384
9	"9-out16978"	.35483	22	40	62
9	"9-out16979"	.95818	275	12	287
9	"9-out16980"	.53114	631	557	1188
9	"9-out16981"	.38524	94	150	244
9	"9-out16982"	.32890	99	202	301
9	"9-out16983"	.44680	147	182	329
9	"9-out16984"	.24020	276	873	1149
9	"9-out16985"	.19687	63	257	320
9	"9-out16986"	.28316	111	281	392
9	"9-out16987"	.40032	249	373	622
9	"9-out16988"	.35138	954	1761	2715
9	"9-out16989"	.48120	256	276	532
9	"9-out16990"	.99967	3095	1	3096
9	"9-out16991"	.54782	63	52	115
9	"9-out16992"	.32114	360	761	1121
9	"9-out16993"	.42207	130	178	308
9	"9-out16994"	.99019	101	1	102
9	"9-out16995"	.61070	331	211	542
9	"9-out16996"	.85000	85	15	100
9	"9-out16997"	.40677	240	350	590
9	"9-out16998"	.16384	29	148	177
9	"9-out16999"	.98770	241	3	244
9	"9-out17000"	.98765	80	1	81
9	"9-out17001"	.34293	238	456	694
9	"9-out17002"	.27478	158	417	575
9	"9-out17003"	.23745	142	456	598
9	"9-out17004"	.57723	639	468	1107
9	"9-out17005"	.99786	468	1	469
9	"9-out17006"	.37553	175	291	466
9	"9-out17007"	.14953	16	91	107
9	"9-out17008"	.18810	430	1856	2286
9	"9-out17009"	.39089	206	321	527
9	"9-out17010"	.41496	61	86	147
9	"9-out17011"	.33333	39	78	117
9	"9-out17012"	.26392	327	912	1239
9	"9-out17013"	.22886	111	374	485
9	"9-out17014"	.25649	375	1087	1462
9	"9-out17015"	.39104	131	204	335
9	"9-out17016"	.25565	147	428	575
9	"9-out17017"	.50404	249	245	494
9	"9-out17018"	.36888	332	568	900
9	"9-out17019"	.35687	192	346	538
9	"9-out17020"	.77146	1222	362	1584
9	"9-out17021"	.98734	78	1	79
9	"9-out17022"	.90579	500	52	552
9	"9-out17023"	.86153	280	45	325
9	"9-out17024"	.48466	316	336	652
9	"9-out17025"	.47777	172	188	360
9	"9-out17026"	.52808	94	84	178
9	"9-out17027"	.42934	316	420	736
9	"9-out17028"	.39692	362	550	912
9	"9-out17029"	.19460	166	687	853
9	"9-out17030"	.32901	127	259	386
9	"9-out17031"	.27266	430	1147	1577
9	"9-out17032"	.21163	342	1274	1616
9	"9-out17033"	.22947	109	366	475
9	"9-out17034"	.51149	89	85	174
9	"9-out17035"	.13611	49	311	360
9	"9-out17036"	.24376	88	273	361
9	"9-out17037"	.68211	206	96	302
9	"9-out17038"	.41471	124	175	299
9	"9-out17039"	.31147	95	210	305
9	"9-out17040"	.37200	93	157	250
9	"9-out17041"	.42490	116	157	273
9	"9-out17042"	.34309	750	1436	2186
9	"9-out17043"	.74577	1546	527	2073
9	"9-out17044"	.18500	74	326	400
9	"9-out17045"	.86407	356	56	412
9	"9-out17046"	.25469	475	1390	1865
9	"9-out17047"	.20765	380	1450	1830
9	"9-out17048"	.17832	362	1668	2030
9	"9-out17049"	.33672	662	1304	1966
9	"9-out17050"	.24759	463	1407	1870
9	"9-out17051"	.24474	501	1546	2047
9	"9-out17052"	.29579	633	1507	2140
9	"9-out17053"	.28489	598	1501	2099
9	"9-out17054"	.26582	550	1519	2069
9	"9-out17055"	.46688	141	161	302
9	"9-out17056"	.69438	334	147	481
9	"9-out17057"	.23058	95	317	412
9	"9-out17058"	.40725	202	294	496
9	"9-out17059"	.25460	83	243	326
9	"9-out17060"	.20915	64	242	306
9	"9-out17061"	.19033	63	268	331
9	"9-out17062"	.45436	229	275	504
9	"9-out17063"	.24349	131	407	538
9	"9-out17064"	.54416	308	258	566
9	"9-out17065"	.29574	729	1736	2465
9	"9-out17066"	.24978	574	1724	2298
9	"9-out17067"	.99152	117	1	118
9	"9-out17068"	.16531	102	515	617
9	"9-out17069"	.02941	7	231	238
9	"9-out17070"	.28041	431	1106	1537
9	"9-out17071"	.23615	81	262	343
9	"9-out17072"	.22187	71	249	320
9	"9-out17073"	.39069	277	432	709
9	"9-out17074"	.29819	198	466	664
9	"9-out17075"	.99186	122	1	123
9	"9-out17076"	.44615	116	144	260
9	"9-out17077"	.57751	149	109	258
9	"9-out17078"	.93604	161	11	172
9	"9-out17079"	.14285	29	174	203
9	"9-out17080"	.98783	406	5	411
9	"9-out17081"	.33539	163	323	486
9	"9-out17082"	.31557	154	334	488
9	"9-out17083"	.42368	161	219	380
9	"9-out17084"	.41269	156	222	378
9	"9-out17085"	.25282	112	331	443
9	"9-out17086"	.66053	323	166	489
9	"9-out17087"	.94871	74	4	78
9	"9-out17088"	.70731	58	24	82
9	"9-out17089"	.45964	131	154	285
9	"9-out17090"	.29213	78	189	267
9	"9-out17091"	.47566	215	237	452
9	"9-out17092"	.44230	115	145	260
9	"9-out17093"	.52380	44	40	84
9	"9-out17094"	.58695	54	38	92
9	"9-out17095"	.17117	38	184	222
9	"9-out17096"	.26428	74	206	280
9	"9-out17097"	.51685	46	43	89
9	"9-out17098"	.54464	61	51	112
9	"9-out17099"	.07729	16	191	207
9	"9-out17100"	.69918	86	37	123
9	"9-out17101"	.50000	232	232	464
9	"9-out17102"	.28054	124	318	442
9	"9-out17103"	.40816	60	87	147
9	"9-out17104"	.99537	215	1	216
9	"9-out17105"	.99618	261	1	262
9	"9-out17106"	.59426	145	99	244
9	"9-out17107"	.77207	542	160	702
9	"9-out17108"	.45376	211	254	465
9	"9-out17109"	.29222	109	264	373
9	"9-out17110"	.29326	122	294	416
9	"9-out17111"	.54181	149	126	275
9	"9-out17112"	.67328	509	247	756
9	"9-out17113"	.35802	29	52	81
9	"9-out17114"	.21052	12	45	57
9	"9-out17115"	.31066	201	446	647
9	"9-out17116"	.40000	208	312	520
9	"9-out17117"	.35672	122	220	342
9	"9-out17118"	.33202	253	509	762
9	"9-out17119"	.33248	131	263	394
9	"9-out17120"	.29465	226	541	767
9	"9-out17121"	.48689	130	137	267
9	"9-out17122"	.52287	240	219	459
9	"9-out17123"	.37548	193	321	514
9	"9-out17124"	.19633	150	614	764
9	"9-out17125"	.18652	36	157	193
9	"9-out17126"	.99242	131	1	132
9	"9-out17127"	.99563	228	1	229
9	"9-out17128"	.36681	84	145	229
9	"9-out17129"	.99565	229	1	230
9	"9-out17130"	.85479	312	53	365
9	"9-out17131"	.98930	185	2	187
9	"9-out17132"	.98787	163	2	165
9	"9-out17133"	.14970	25	142	167
9	"9-out17134"	.99145	116	1	117
9	"9-out17135"	.26128	110	311	421
9	"9-out17136"	.47938	93	101	194
9	"9-out17137"	.94334	333	20	353
9	"9-out17138"	.25915	191	546	737
9	"9-out17139"	.25394	1207	3546	4753
9	"9-out17140"	.36683	73	126	199
9	"9-out17141"	.15343	29	160	189
9	"9-out17142"	.81612	324	73	397
9	"9-out17143"	.19174	79	333	412
9	"9-out17144"	.50000	99	99	198
9	"9-out17145"	.63157	312	182	494
9	"9-out17146"	.98023	248	5	253
9	"9-out17147"	.89230	232	28	260
9	"9-out17148"	.23394	215	704	919
9	"9-out17149"	.17343	175	834	1009
9	"9-out17150"	.42700	389	522	911
9	"9-out17151"	.14201	24	145	169
9	"9-out17152"	.45604	83	99	182
9	"9-out17153"	.31693	58	125	183
9	"9-out17154"	.20129	249	988	1237
9	"9-out17155"	.50295	85	84	169
9	"9-out17156"	.31666	152	328	480
9	"9-out17157"	.37198	77	130	207
9	"9-out17158"	.99315	145	1	146
9	"9-out17159"	.33947	129	251	380
9	"9-out17160"	.32870	71	145	216
9	"9-out17161"	.24276	109	340	449
9	"9-out17162"	.34310	199	381	580
9	"9-out17163"	.98850	86	1	87
9	"9-out17164"	.36017	322	572	894
9	"9-out17165"	.38956	351	550	901
9	"9-out17166"	.42187	378	518	896
9	"9-out17167"	.20427	411	1601	2012
9	"9-out17168"	.20165	414	1639	2053
9	"9-out17169"	.42087	125	172	297
9	"9-out17170"	.72881	86	32	118
9	"9-out17171"	.36842	70	120	190
9	"9-out17172"	.68041	66	31	97
9	"9-out17173"	.99328	148	1	149
9	"9-out17174"	.29867	362	850	1212
9	"9-out17175"	.76931	737	221	958
9	"9-out17176"	.23164	243	806	1049
9	"9-out17177"	.36314	406	712	1118
9	"9-out17178"	.29129	291	708	999
9	"9-out17179"	.24903	259	781	1040
9	"9-out17180"	.26685	95	261	356
9	"9-out17181"	.64565	840	461	1301
9	"9-out17182"	.28955	355	871	1226
9	"9-out17183"	.07655	16	193	209
9	"9-out17184"	.52976	89	79	168
9	"9-out17185"	.41101	321	460	781
9	"9-out17186"	.29726	217	513	730
9	"9-out17187"	.22207	165	578	743
9	"9-out17188"	.15470	97	530	627
9	"9-out17189"	.90789	276	28	304
9	"9-out17190"	.78187	233	65	298
9	"9-out17191"	.48064	298	322	620
9	"9-out17192"	.99056	420	4	424
9	"9-out17193"	.99056	420	4	424
9	"9-out17194"	.99052	418	4	422
9	"9-out17195"	.99056	420	4	424
9	"9-out17196"	.99056	420	4	424
9	"9-out17197"	.99056	420	4	424
9	"9-out17198"	.49774	772	779	1551
9	"9-out17199"	.61369	950	598	1548
9	"9-out17200"	.18421	35	155	190
9	"9-out17201"	.99056	105	1	106
9	"9-out17202"	.58239	258	185	443
9	"9-out17203"	.26307	171	479	650
9	"9-out17204"	.26486	49	136	185
9	"9-out17205"	.46687	148	169	317
9	"9-out17206"	.33756	133	261	394
9	"9-out17207"	.18372	70	311	381
9	"9-out17208"	.90104	346	38	384
9	"9-out17209"	.60363	166	109	275
9	"9-out17210"	.47882	260	283	543
9	"9-out17211"	.40503	209	307	516
9	"9-out17212"	.43046	520	688	1208
9	"9-out17213"	.49501	149	152	301
9	"9-out17214"	.31471	169	368	537
9	"9-out17215"	.55093	795	648	1443
9	"9-out17216"	.27648	154	403	557
9	"9-out17217"	.26455	200	556	756
9	"9-out17218"	.46610	55	63	118
9	"9-out17219"	.58636	129	91	220
9	"9-out17220"	.79207	320	84	404
9	"9-out17221"	.23469	46	150	196
9	"9-out17222"	.22390	148	513	661
9	"9-out17223"	.31620	240	519	759
9	"9-out17224"	.29235	440	1065	1505
9	"9-out17225"	.41117	611	875	1486
9	"9-out17226"	.24217	147	460	607
9	"9-out17227"	.38125	61	99	160
9	"9-out17228"	.27586	80	210	290
9	"9-out17229"	.34567	84	159	243
9	"9-out17230"	.99248	132	1	133
9	"9-out17231"	.65765	73	38	111
9	"9-out17232"	.29568	89	212	301
9	"9-out17233"	.41184	619	884	1503
9	"9-out17234"	.50400	63	62	125
9	"9-out17235"	.65646	193	101	294
9	"9-out17236"	.46216	171	199	370
9	"9-out17237"	.99512	204	1	205
9	"9-out17238"	.56812	246	187	433
9	"9-out17239"	.88785	95	12	107
9	"9-out17240"	.37500	138	230	368
9	"9-out17241"	.46938	46	52	98
9	"9-out17242"	.63781	280	159	439
9	"9-out17243"	.47872	45	49	94
9	"9-out17244"	.39449	43	66	109
9	"9-out17245"	.39639	44	67	111
9	"9-out17246"	.57142	68	51	119
9	"9-out17247"	.16463	108	548	656
9	"9-out17248"	.19649	112	458	570
9	"9-out17249"	.85263	162	28	190
9	"9-out17250"	.26250	105	295	400
9	"9-out17251"	.27348	99	263	362
9	"9-out17252"	.40273	118	175	293
9	"9-out17253"	.52866	83	74	157
9	"9-out17254"	.28343	89	225	314
9	"9-out17255"	.19708	108	440	548
9	"9-out17256"	.99621	263	1	264
9	"9-out17257"	.86597	84	13	97
9	"9-out17258"	.48305	114	122	236
9	"9-out17259"	.17098	132	640	772
9	"9-out17260"	.99703	673	2	675
9	"9-out17261"	.29864	132	310	442
9	"9-out17262"	.30632	121	274	395
9	"9-out17263"	.28333	34	86	120
9	"9-out17264"	.70793	446	184	630
9	"9-out17265"	.46511	140	161	301
9	"9-out17266"	.53372	182	159	341
9	"9-out17267"	.55124	909	740	1649
9	"9-out17268"	.33333	115	230	345
9	"9-out17269"	.18307	93	415	508
9	"9-out17270"	.27252	121	323	444
9	"9-out17271"	.62857	110	65	175
9	"9-out17272"	.54022	94	80	174
9	"9-out17273"	.36772	335	576	911
9	"9-out17274"	.31487	273	594	867
9	"9-out17275"	.98701	76	1	77
9	"9-out17276"	.99519	207	1	208
9	"9-out17277"	.38709	84	133	217
9	"9-out17278"	.43373	108	141	249
9	"9-out17279"	.30204	74	171	245
9	"9-out17280"	.33608	285	563	848
9	"9-out17281"	.55835	354	280	634
9	"9-out17282"	.27948	173	446	619
9	"9-out17283"	.29765	89	210	299
9	"9-out17284"	.45454	60	72	132
9	"9-out17285"	.93911	617	40	657
9	"9-out17286"	.36227	242	426	668
9	"9-out17287"	.26959	86	233	319
9	"9-out17288"	.34076	107	207	314
9	"9-out17289"	.27993	166	427	593
9	"9-out17290"	.27469	267	705	972
9	"9-out17291"	.30000	78	182	260
9	"9-out17292"	.99539	216	1	217
9	"9-out17293"	.31818	266	570	836
9	"9-out17294"	.66492	127	64	191
9	"9-out17295"	.96846	215	7	222
9	"9-out17296"	.21666	52	188	240
9	"9-out17297"	.23255	50	165	215
9	"9-out17298"	.47727	63	69	132
9	"9-out17299"	.31617	86	186	272
9	"9-out17300"	.26108	106	300	406
9	"9-out17301"	.77605	1802	520	2322
9	"9-out17302"	.34452	195	371	566
9	"9-out17303"	.40372	260	384	644
9	"9-out17304"	.24282	203	633	836
9	"9-out17305"	.38029	305	497	802
9	"9-out17306"	.99052	209	2	211
9	"9-out17307"	.20379	118	461	579
9	"9-out17308"	.45205	66	80	146
9	"9-out17309"	.26388	95	265	360
9	"9-out17310"	.98138	738	14	752
9	"9-out17311"	.95953	332	14	346
9	"9-out17312"	.44421	219	274	493
9	"9-out17313"	.30547	446	1014	1460
9	"9-out17314"	.29310	289	697	986
9	"9-out17315"	.83430	287	57	344
9	"9-out17316"	.33797	485	950	1435
9	"9-out17317"	.73333	253	92	345
9	"9-out17318"	.71003	191	78	269
9	"9-out17319"	.99595	246	1	247
9	"9-out17320"	.60880	761	489	1250
9	"9-out17321"	.53639	280	242	522
9	"9-out17322"	.30639	163	369	532
9	"9-out17323"	.33228	106	213	319
9	"9-out17324"	.99378	160	1	161
9	"9-out17325"	.28240	61	155	216
9	"9-out17326"	.83520	522	103	625
9	"9-out17327"	.28094	261	668	929
9	"9-out17328"	.99290	140	1	141
9	"9-out17329"	.34586	46	87	133
9	"9-out17330"	.29017	65	159	224
9	"9-out17331"	.29750	155	366	521
9	"9-out17332"	.32206	162	341	503
9	"9-out17333"	.36166	366	646	1012
9	"9-out17334"	.30952	143	319	462
9	"9-out17335"	.41366	448	635	1083
9	"9-out17336"	.99190	490	4	494
9	"9-out17337"	.78435	411	113	524
9	"9-out17338"	.22451	467	1613	2080
9	"9-out17339"	.99805	514	1	515
9	"9-out17340"	.33217	192	386	578
9	"9-out17341"	.31781	239	513	752
9	"9-out17342"	.24628	116	355	471
9	"9-out17343"	.47879	271	295	566
9	"9-out17344"	.33653	140	276	416
9	"9-out17345"	.91730	477	43	520
9	"9-out17346"	.50840	121	117	238
9	"9-out17347"	.55772	285	226	511
9	"9-out17348"	.42565	146	197	343
9	"9-out17349"	.42696	228	306	534
9	"9-out17350"	.57995	243	176	419
9	"9-out17351"	.29166	35	85	120
9	"9-out17352"	.45278	187	226	413
9	"9-out17353"	.49698	165	167	332
9	"9-out17354"	.77222	278	82	360
9	"9-out17355"	.36486	108	188	296
9	"9-out17356"	.31477	147	320	467
9	"9-out17357"	.99616	779	3	782
9	"9-out17358"	.80288	167	41	208
9	"9-out17359"	.99792	481	1	482
9	"9-out17360"	.25432	456	1337	1793
9	"9-out17361"	.98936	93	1	94
9	"9-out17362"	.28516	148	371	519
9	"9-out17363"	.38709	72	114	186
9	"9-out17364"	.98230	111	2	113
9	"9-out17365"	.27532	106	279	385
9	"9-out17366"	.28819	83	205	288
9	"9-out17367"	.20640	58	223	281
9	"9-out17368"	.99502	200	1	201
9	"9-out17369"	.29890	191	448	639
9	"9-out17370"	.56849	166	126	292
9	"9-out17371"	.34437	52	99	151
9	"9-out17372"	.81012	256	60	316
9	"9-out17373"	.92948	145	11	156
9	"9-out17374"	.86956	140	21	161
9	"9-out17375"	.33858	859	1678	2537
9	"9-out17376"	.60000	69	46	115
9	"9-out17377"	.80555	203	49	252
9	"9-out17378"	.33912	371	723	1094
9	"9-out17379"	.34937	1089	2028	3117
9	"9-out17380"	.64150	170	95	265
9	"9-out17381"	.90869	418	42	460
9	"9-out17382"	.90370	244	26	270
9	"9-out17383"	.42191	543	744	1287
9	"9-out17384"	.30658	149	337	486
9	"9-out17385"	.91946	137	12	149
9	"9-out17386"	.98161	267	5	272
9	"9-out17387"	.32185	1066	2246	3312
9	"9-out17388"	.67942	284	134	418
9	"9-out17389"	.33589	131	259	390
9	"9-out17390"	.50000	61	61	122
9	"9-out17391"	.34693	102	192	294
9	"9-out17392"	.46084	153	179	332
9	"9-out17393"	.65104	250	134	384
9	"9-out17394"	.43436	182	237	419
9	"9-out17395"	.99152	117	1	118
9	"9-out17396"	.34936	138	257	395
9	"9-out17397"	.53296	97	85	182
9	"9-out17398"	.35407	404	737	1141
9	"9-out17399"	.99206	125	1	126
9	"9-out17400"	.25099	126	376	502
9	"9-out17401"	.41828	215	299	514
9	"9-out17402"	.29943	159	372	531
9	"9-out17403"	.27755	136	354	490
9	"9-out17404"	.34476	181	344	525
9	"9-out17405"	.98073	509	10	519
9	"9-out17406"	.97614	491	12	503
9	"9-out17407"	.34271	268	514	782
9	"9-out17408"	.82835	111	23	134
9	"9-out17409"	.59195	103	71	174
9	"9-out17410"	.85520	189	32	221
9	"9-out17411"	.99290	140	1	141
9	"9-out17412"	.34701	93	175	268
9	"9-out17413"	.62962	153	90	243
9	"9-out17414"	.20779	32	122	154
9	"9-out17415"	.98947	94	1	95
9	"9-out17416"	.99107	111	1	112
9	"9-out17417"	.30855	83	186	269
9	"9-out17418"	.16587	35	176	211
9	"9-out17419"	.67148	186	91	277
9	"9-out17420"	.28283	351	890	1241
9	"9-out17421"	.28333	68	172	240
9	"9-out17422"	.61224	240	152	392
9	"9-out17423"	.27555	62	163	225
9	"9-out17424"	.46363	51	59	110
9	"9-out17425"	.24783	229	695	924
9	"9-out17426"	.18750	84	364	448
9	"9-out17427"	.22338	107	372	479
9	"9-out17428"	.29323	117	282	399
9	"9-out17429"	.28895	204	502	706
9	"9-out17430"	.39520	66	101	167
9	"9-out17431"	.39534	34	52	86
9	"9-out17432"	.43515	463	601	1064
9	"9-out17433"	.24468	23	71	94
9	"9-out17434"	.37091	477	809	1286
9	"9-out17435"	.41772	33	46	79
9	"9-out17436"	.50000	42	42	84
9	"9-out17437"	.26077	121	343	464
9	"9-out17438"	.99740	384	1	385
9	"9-out17439"	.98863	87	1	88
9	"9-out17440"	.31512	300	652	952
9	"9-out17441"	.31212	260	573	833
9	"9-out17442"	.35438	101	184	285
9	"9-out17443"	.23353	312	1024	1336
9	"9-out17444"	.18699	233	1013	1246
9	"9-out17445"	.18114	73	330	403
9	"9-out17446"	.31419	104	227	331
9	"9-out17447"	.99683	315	1	316
9	"9-out17448"	.28530	99	248	347
9	"9-out17449"	.98989	98	1	99
9	"9-out17450"	.32943	563	1146	1709
9	"9-out17451"	.35932	364	649	1013
9	"9-out17452"	.33429	232	462	694
9	"9-out17453"	.23733	384	1234	1618
9	"9-out17454"	.22823	422	1427	1849
9	"9-out17455"	.36290	634	1113	1747
9	"9-out17456"	.41848	498	692	1190
9	"9-out17457"	.44863	262	322	584
9	"9-out17458"	.36490	262	456	718
9	"9-out17459"	.27530	136	358	494
9	"9-out17460"	.24655	1234	3771	5005
9	"9-out17461"	.70750	283	117	400
9	"9-out17462"	.81183	384	89	473
9	"9-out17463"	.30896	131	293	424
9	"9-out17464"	.83796	362	70	432
9	"9-out17465"	.39333	177	273	450
9	"9-out17466"	.97209	418	12	430
9	"9-out17467"	.79432	448	116	564
9	"9-out17468"	.81205	458	106	564
9	"9-out17469"	.65423	772	408	1180
9	"9-out17470"	.47945	245	266	511
9	"9-out17471"	.40375	258	381	639
9	"9-out17472"	.51417	272	257	529
9	"9-out17473"	.48757	314	330	644
9	"9-out17474"	.93788	453	30	483
9	"9-out17475"	.28408	298	751	1049
9	"9-out17476"	.54423	406	340	746
9	"9-out17477"	.29671	208	493	701
9	"9-out17478"	.46198	158	184	342
9	"9-out17479"	.44444	104	130	234
9	"9-out17480"	.35215	131	241	372
9	"9-out17481"	.21039	85	319	404
9	"9-out17482"	.26315	50	140	190
9	"9-out17483"	.37704	138	228	366
9	"9-out17484"	.36318	219	384	603
9	"9-out17485"	.43673	107	138	245
9	"9-out17486"	.99470	376	2	378
9	"9-out17487"	.99470	376	2	378
9	"9-out17488"	.45901	112	132	244
9	"9-out17489"	.25819	63	181	244
9	"9-out17490"	.25063	99	296	395
9	"9-out17491"	.57215	226	169	395
9	"9-out17492"	.29457	38	91	129
9	"9-out17493"	.28644	112	279	391
9	"9-out17494"	.99744	1564	4	1568
9	"9-out17495"	.89759	149	17	166
9	"9-out17496"	.32075	34	72	106
9	"9-out17497"	.36255	153	269	422
9	"9-out17498"	.57466	381	282	663
9	"9-out17499"	.34836	85	159	244
9	"9-out17500"	.39712	166	252	418
9	"9-out17501"	.18941	68	291	359
9	"9-out17502"	.98039	50	1	51
9	"9-out17503"	.30712	125	282	407
9	"9-out17504"	.15340	54	298	352
9	"9-out17505"	.30798	81	182	263
9	"9-out17506"	.26571	93	257	350
9	"9-out17507"	.99689	642	2	644
9	"9-out17508"	.61372	313	197	510
9	"9-out17509"	.22294	103	359	462
9	"9-out17510"	.22435	234	809	1043
9	"9-out17511"	.31660	164	354	518
9	"9-out17512"	.36798	354	608	962
9	"9-out17513"	.46551	54	62	116
9	"9-out17514"	.26195	230	648	878
9	"9-out17515"	.36630	100	173	273
9	"9-out17516"	.29166	98	238	336
9	"9-out17517"	.71309	256	103	359
9	"9-out17518"	.24170	51	160	211
9	"9-out17519"	.29424	281	674	955
9	"9-out17520"	.37632	356	590	946
9	"9-out17521"	.28989	198	485	683
9	"9-out17522"	.26640	138	380	518
9	"9-out17523"	.29342	125	301	426
9	"9-out17524"	.19813	106	429	535
9	"9-out17525"	.43589	34	44	78
9	"9-out17526"	.76315	58	18	76
9	"9-out17527"	.93028	387	29	416
9	"9-out17528"	.38871	379	596	975
9	"9-out17529"	.38836	374	589	963
9	"9-out17530"	.25716	278	803	1081
9	"9-out17531"	.85838	891	147	1038
9	"9-out17532"	.38187	396	641	1037
9	"9-out17533"	.97073	199	6	205
9	"9-out17534"	.91219	187	18	205
9	"9-out17535"	.42769	210	281	491
9	"9-out17536"	.25594	140	407	547
9	"9-out17537"	.25862	105	301	406
9	"9-out17538"	.40119	134	200	334
9	"9-out17539"	.85121	246	43	289
9	"9-out17540"	.98655	807	11	818
9	"9-out17541"	.27338	190	505	695
9	"9-out17542"	.38048	78	127	205
9	"9-out17543"	.64024	105	59	164
9	"9-out17544"	.37012	57	97	154
9	"9-out17545"	.62837	93	55	148
9	"9-out17546"	.27653	284	743	1027
9	"9-out17547"	.99800	500	1	501
9	"9-out17548"	.28050	331	849	1180
9	"9-out17549"	.52538	621	561	1182
9	"9-out17550"	.24140	400	1257	1657
9	"9-out17551"	.27161	443	1188	1631
9	"9-out17552"	.34813	196	367	563
9	"9-out17553"	.33249	263	528	791
9	"9-out17554"	.28020	167	429	596
9	"9-out17555"	.16307	53	272	325
9	"9-out17556"	.37798	364	599	963
9	"9-out17557"	.18534	129	567	696
9	"9-out17558"	.21282	146	540	686
9	"9-out17559"	.35024	435	807	1242
9	"9-out17560"	.46188	618	720	1338
9	"9-out17561"	.86513	340	53	393
9	"9-out17562"	.32653	160	330	490
9	"9-out17563"	.34117	29	56	85
9	"9-out17564"	.28865	28	69	97
9	"9-out17565"	.52325	45	41	86
9	"9-out17566"	.32869	118	241	359
9	"9-out17567"	.24161	180	565	745
9	"9-out17568"	.24299	104	324	428
9	"9-out17569"	.53590	306	265	571
9	"9-out17570"	.36912	110	188	298
9	"9-out17571"	.29009	161	394	555
9	"9-out17572"	.46896	136	154	290
9	"9-out17573"	.99145	116	1	117
9	"9-out17574"	.77826	179	51	230
9	"9-out17575"	.18987	105	448	553
9	"9-out17576"	.38483	132	211	343
9	"9-out17577"	.41568	281	395	676
9	"9-out17578"	.99145	116	1	117
9	"9-out17579"	.99173	120	1	121
9	"9-out17580"	.99166	119	1	120
9	"9-out17581"	.24621	65	199	264
9	"9-out17582"	.32619	137	283	420
9	"9-out17583"	.34192	146	281	427
9	"9-out17584"	.99145	116	1	117
9	"9-out17585"	.16117	93	484	577
9	"9-out17586"	.88313	529	70	599
9	"9-out17587"	.60460	315	206	521
9	"9-out17588"	.30134	157	364	521
9	"9-out17589"	.80933	416	98	514
9	"9-out17590"	.32265	403	846	1249
9	"9-out17591"	.30674	150	339	489
9	"9-out17592"	.26706	90	247	337
9	"9-out17593"	.22727	105	357	462
9	"9-out17594"	.98166	589	11	600
9	"9-out17595"	.54832	278	229	507
9	"9-out17596"	.28292	174	441	615
9	"9-out17597"	.29161	240	583	823
9	"9-out17598"	.26836	179	488	667
9	"9-out17599"	.50111	224	223	447
9	"9-out17600"	.24696	122	372	494
9	"9-out17601"	.37741	117	193	310
9	"9-out17602"	.19930	230	924	1154
9	"9-out17603"	.26649	105	289	394
9	"9-out17604"	.66235	461	235	696
9	"9-out17605"	.35828	268	480	748
9	"9-out17606"	.29516	348	831	1179
9	"9-out17607"	.31880	373	797	1170
9	"9-out17608"	.54466	189	158	347
9	"9-out17609"	.30380	679	1556	2235
9	"9-out17610"	.50501	403	395	798
9	"9-out17611"	.27196	291	779	1070
9	"9-out17612"	.39358	405	624	1029
9	"9-out17613"	.25961	135	385	520
9	"9-out17614"	.30750	369	831	1200
9	"9-out17615"	.99242	262	2	264
9	"9-out17616"	.51754	236	220	456
9	"9-out17617"	.81737	461	103	564
9	"9-out17618"	.57361	300	223	523
9	"9-out17619"	.79567	331	85	416
9	"9-out17620"	.36899	776	1327	2103
9	"9-out17621"	.53148	287	253	540
9	"9-out17622"	.51211	296	282	578
9	"9-out17623"	.92963	436	33	469
9	"9-out17624"	.18110	46	208	254
9	"9-out17625"	.43973	135	172	307
9	"9-out17626"	.39254	179	277	456
9	"9-out17627"	.23659	203	655	858
9	"9-out17628"	.30994	159	354	513
9	"9-out17629"	.36200	181	319	500
9	"9-out17630"	.27216	482	1289	1771
9	"9-out17631"	.70158	355	151	506
9	"9-out17632"	.26153	442	1248	1690
9	"9-out17633"	.25240	105	311	416
9	"9-out17634"	.48516	229	243	472
9	"9-out17635"	.99521	208	1	209
9	"9-out17636"	.35849	114	204	318
9	"9-out17637"	.36098	396	701	1097
9	"9-out17638"	.25072	261	780	1041
9	"9-out17639"	.97560	200	5	205
9	"9-out17640"	.99504	201	1	202
9	"9-out17641"	.38013	222	362	584
9	"9-out17642"	.42826	197	263	460
9	"9-out17643"	.30945	108	241	349
9	"9-out17644"	.25942	117	334	451
9	"9-out17645"	.28112	140	358	498
9	"9-out17646"	.55279	267	216	483
9	"9-out17647"	.99224	128	1	129
9	"9-out17648"	.24786	29	88	117
9	"9-out17649"	.29438	640	1534	2174
9	"9-out17650"	.17924	38	174	212
9	"9-out17651"	.58333	84	60	144
9	"9-out17652"	.28500	57	143	200
9	"9-out17653"	.27192	372	996	1368
9	"9-out17654"	.37313	100	168	268
9	"9-out17655"	.47945	70	76	146
9	"9-out17656"	.28930	138	339	477
9	"9-out17657"	.99663	296	1	297
9	"9-out17658"	.75792	263	84	347
9	"9-out17659"	.99460	553	3	556
9	"9-out17660"	.39091	353	550	903
9	"9-out17661"	.70853	598	246	844
9	"9-out17662"	.27090	81	218	299
9	"9-out17663"	.28187	84	214	298
9	"9-out17664"	.35089	273	505	778
9	"9-out17665"	.39092	181	282	463
9	"9-out17666"	.35638	67	121	188
9	"9-out17667"	.34951	36	67	103
9	"9-out17668"	.30569	177	402	579
9	"9-out17669"	.29990	305	712	1017
9	"9-out17670"	.23279	230	758	988
9	"9-out17671"	.38531	383	611	994
9	"9-out17672"	.27088	214	576	790
9	"9-out17673"	.29876	242	568	810
9	"9-out17674"	.77059	954	284	1238
9	"9-out17675"	.36809	60	103	163
9	"9-out17676"	.33303	377	755	1132
9	"9-out17677"	.57524	474	350	824
9	"9-out17678"	.39772	105	159	264
9	"9-out17679"	.54777	344	284	628
9	"9-out17680"	.23684	45	145	190
9	"9-out17681"	.33548	468	927	1395
9	"9-out17682"	.27985	300	772	1072
9	"9-out17683"	.46793	270	307	577
9	"9-out17684"	.24717	482	1468	1950
9	"9-out17685"	.47792	617	674	1291
9	"9-out17686"	.99491	783	4	787
9	"9-out17687"	.87541	1581	225	1806
9	"9-out17688"	.35340	452	827	1279
9	"9-out17689"	.62011	444	272	716
9	"9-out17690"	.46581	218	250	468
9	"9-out17691"	.37068	172	292	464
9	"9-out17692"	.33178	143	288	431
9	"9-out17693"	.41252	257	366	623
9	"9-out17694"	.98422	624	10	634
9	"9-out17695"	.50892	228	220	448
9	"9-out17696"	.63793	407	231	638
9	"9-out17697"	.51361	283	268	551
9	"9-out17698"	.42692	222	298	520
9	"9-out17699"	.42990	230	305	535
9	"9-out17700"	.34897	119	222	341
9	"9-out17701"	.53980	339	289	628
9	"9-out17702"	.45318	242	292	534
9	"9-out17703"	.31250	95	209	304
9	"9-out17704"	.22444	112	387	499
9	"9-out17705"	.24600	77	236	313
9	"9-out17706"	.26102	71	201	272
9	"9-out17707"	.34404	182	347	529
9	"9-out17708"	.59533	153	104	257
9	"9-out17709"	.25229	110	326	436
9	"9-out17710"	.99307	287	2	289
9	"9-out17711"	.27064	236	636	872
9	"9-out17712"	.16080	64	334	398
9	"9-out17713"	.16467	69	350	419
9	"9-out17714"	.39788	339	513	852
9	"9-out17715"	.27462	290	766	1056
9	"9-out17716"	.31362	419	917	1336
9	"9-out17717"	.24093	372	1172	1544
9	"9-out17718"	.70128	1094	466	1560
9	"9-out17719"	.36214	595	1048	1643
9	"9-out17720"	.59793	174	117	291
9	"9-out17721"	.94880	278	15	293
9	"9-out17722"	.21366	297	1093	1390
9	"9-out17723"	.20562	117	452	569
9	"9-out17724"	.72924	369	137	506
9	"9-out17725"	.37813	166	273	439
9	"9-out17726"	.77058	571	170	741
9	"9-out17727"	.26027	76	216	292
9	"9-out17728"	.32967	120	244	364
9	"9-out17729"	.37532	286	476	762
9	"9-out17730"	.99159	118	1	119
9	"9-out17731"	.43079	249	329	578
9	"9-out17732"	.28028	280	719	999
9	"9-out17733"	.99152	117	1	118
9	"9-out17734"	.99159	118	1	119
9	"9-out17735"	.14790	46	265	311
9	"9-out17736"	.33602	125	247	372
9	"9-out17737"	.16393	60	306	366
9	"9-out17738"	.35567	69	125	194
9	"9-out17739"	.20519	79	306	385
9	"9-out17740"	.70048	290	124	414
9	"9-out17741"	.72670	117	44	161
9	"9-out17742"	.45739	102	121	223
9	"9-out17743"	.99818	549	1	550
9	"9-out17744"	.40888	267	386	653
9	"9-out17745"	.54487	85	71	156
9	"9-out17746"	.38597	479	762	1241
9	"9-out17747"	.99567	230	1	231
9	"9-out17748"	.18400	23	102	125
9	"9-out17749"	.61382	151	95	246
9	"9-out17750"	.56178	441	344	785
9	"9-out17751"	.37837	56	92	148
9	"9-out17752"	.98498	328	5	333
9	"9-out17753"	.34920	110	205	315
9	"9-out17754"	.99346	152	1	153
9	"9-out17755"	.53321	297	260	557
9	"9-out17756"	.18229	35	157	192
9	"9-out17757"	.28214	79	201	280
9	"9-out17758"	.67605	96	46	142
9	"9-out17759"	.25301	63	186	249
9	"9-out17760"	.19259	26	109	135
9	"9-out17761"	.56967	139	105	244
9	"9-out17762"	.37953	115	188	303
9	"9-out17763"	.33016	347	704	1051
9	"9-out17764"	.23569	280	908	1188
9	"9-out17765"	.32994	260	528	788
9	"9-out17766"	.33716	381	749	1130
9	"9-out17767"	.29389	154	370	524
9	"9-out17768"	.38972	182	285	467
9	"9-out17769"	.37972	191	312	503
9	"9-out17770"	.29342	125	301	426
9	"9-out17771"	.35416	170	310	480
9	"9-out17772"	.23492	113	368	481
9	"9-out17773"	.37569	68	113	181
9	"9-out17774"	.26966	168	455	623
9	"9-out17775"	.27130	121	325	446
9	"9-out17776"	.87012	134	20	154
9	"9-out17777"	.38289	188	303	491
9	"9-out17778"	.28431	1591	4005	5596
9	"9-out17779"	.33750	27	53	80
9	"9-out17780"	.99393	164	1	165
9	"9-out17781"	.21546	39	142	181
9	"9-out17782"	.17191	60	289	349
9	"9-out17783"	.38046	487	793	1280
9	"9-out17784"	.77319	75	22	97
9	"9-out17785"	.58571	82	58	140
9	"9-out17786"	.99512	204	1	205
9	"9-out17787"	.46563	210	241	451
9	"9-out17788"	.99572	233	1	234
9	"9-out17789"	.76642	210	64	274
9	"9-out17790"	.84916	304	54	358
9	"9-out17791"	.25405	47	138	185
9	"9-out17792"	.24932	93	280	373
9	"9-out17793"	.94212	2051	126	2177
9	"9-out17794"	.99731	372	1	373
9	"9-out17795"	.59049	261	181	442
9	"9-out17796"	.79200	297	78	375
9	"9-out17797"	.18125	118	533	651
9	"9-out17798"	.39500	237	363	600
9	"9-out17799"	.20902	176	666	842
9	"9-out17800"	.25205	307	911	1218
9	"9-out17801"	.38582	980	1560	2540
9	"9-out17802"	.26183	271	764	1035
9	"9-out17803"	.68733	798	363	1161
9	"9-out17804"	.55194	85	69	154
9	"9-out17805"	.26736	308	844	1152
9	"9-out17806"	.30343	318	730	1048
9	"9-out17807"	.48550	67	71	138
9	"9-out17808"	.99600	249	1	250
9	"9-out17809"	.41891	403	559	962
9	"9-out17810"	.40342	165	244	409
9	"9-out17811"	.54123	210	178	388
9	"9-out17812"	.99145	116	1	117
9	"9-out17813"	.99152	117	1	118
9	"9-out17814"	.47938	93	101	194
9	"9-out17815"	.99333	149	1	150
9	"9-out17816"	.55454	61	49	110
9	"9-out17817"	.99145	116	1	117
9	"9-out17818"	.99285	139	1	140
9	"9-out17819"	.20000	33	132	165
9	"9-out17820"	.30519	282	642	924
9	"9-out17821"	.76371	181	56	237
9	"9-out17822"	.30839	202	453	655
9	"9-out17823"	.40556	919	1347	2266
9	"9-out17824"	.83299	818	164	982
9	"9-out17825"	.34951	72	134	206
9	"9-out17826"	.35426	361	658	1019
9	"9-out17827"	.17647	21	98	119
9	"9-out17828"	.67241	78	38	116
9	"9-out17829"	.74449	169	58	227
9	"9-out17830"	.38766	88	139	227
9	"9-out17831"	.64099	466	261	727
9	"9-out17832"	.80483	466	113	579
9	"9-out17833"	.23369	43	141	184
9	"9-out17834"	.29514	152	363	515
9	"9-out17835"	.24035	374	1182	1556
9	"9-out17836"	.36219	205	361	566
9	"9-out17837"	.52671	69	62	131
9	"9-out17838"	.41726	58	81	139
9	"9-out17839"	.83750	134	26	160
9	"9-out17840"	.23708	156	502	658
9	"9-out17841"	.76531	737	226	963
9	"9-out17842"	.29440	300	719	1019
9	"9-out17843"	.34076	321	621	942
9	"9-out17844"	.20657	220	845	1065
9	"9-out17845"	.31048	666	1479	2145
9	"9-out17846"	.38022	273	445	718
9	"9-out17847"	.94146	193	12	205
9	"9-out17848"	.74080	443	155	598
9	"9-out17849"	.27682	129	337	466
9	"9-out17850"	.14018	15	92	107
9	"9-out17851"	.47169	75	84	159
9	"9-out17852"	.32055	92	195	287
9	"9-out17853"	.23052	222	741	963
9	"9-out17854"	.54771	815	673	1488
9	"9-out17855"	.30285	477	1098	1575
9	"9-out17856"	.52439	43	39	82
9	"9-out17857"	.99859	711	1	712
9	"9-out17858"	.29600	185	440	625
9	"9-out17859"	.29879	173	406	579
9	"9-out17860"	.18812	244	1053	1297
9	"9-out17861"	.20405	282	1100	1382
9	"9-out17862"	.33333	45	90	135
9	"9-out17863"	.40845	87	126	213
9	"9-out17864"	.30315	365	839	1204
9	"9-out17865"	.24794	543	1647	2190
9	"9-out17866"	.73504	430	155	585
9	"9-out17867"	.40040	400	599	999
9	"9-out17868"	.78453	142	39	181
9	"9-out17869"	.23293	58	191	249
9	"9-out17870"	.17763	54	250	304
9	"9-out17871"	.36752	129	222	351
9	"9-out17872"	.29502	652	1558	2210
9	"9-out17873"	.99765	426	1	427
9	"9-out17874"	.46072	217	254	471
9	"9-out17875"	.38743	487	770	1257
9	"9-out17876"	.62874	315	186	501
9	"9-out17877"	.82080	426	93	519
9	"9-out17878"	.36834	263	451	714
9	"9-out17879"	.28699	353	877	1230
9	"9-out17880"	.37860	184	302	486
9	"9-out17881"	.20430	133	518	651
9	"9-out17882"	.15865	33	175	208
9	"9-out17883"	.20430	323	1258	1581
9	"9-out17884"	.32307	126	264	390
9	"9-out17885"	.27941	95	245	340
9	"9-out17886"	.27280	308	821	1129
9	"9-out17887"	.46064	357	418	775
9	"9-out17888"	.95994	695	29	724
9	"9-out17889"	.69578	446	195	641
9	"9-out17890"	.67942	284	134	418
9	"9-out17891"	.28662	135	336	471
9	"9-out17892"	.99159	118	1	119
9	"9-out17893"	.99145	116	1	117
9	"9-out17894"	.99145	116	1	117
9	"9-out17895"	.30897	93	208	301
9	"9-out17896"	.99145	116	1	117
9	"9-out17897"	.42727	141	189	330
9	"9-out17898"	.33910	196	382	578
9	"9-out17899"	.28387	44	111	155
9	"9-out17900"	.39112	97	151	248
9	"9-out17901"	.59206	209	144	353
9	"9-out17902"	.79200	99	26	125
9	"9-out17903"	.87218	116	17	133
9	"9-out17904"	.60817	357	230	587
9	"9-out17905"	.68879	332	150	482
9	"9-out17906"	.49264	134	138	272
9	"9-out17907"	.31939	550	1172	1722
9	"9-out17908"	.38559	273	435	708
9	"9-out17909"	.29750	119	281	400
9	"9-out17910"	.60869	182	117	299
9	"9-out17911"	.33772	205	402	607
9	"9-out17912"	.49206	155	160	315
9	"9-out17913"	.23245	53	175	228
9	"9-out17914"	.96296	182	7	189
9	"9-out17915"	.91005	172	17	189
9	"9-out17916"	.97354	184	5	189
9	"9-out17917"	.30481	57	130	187
9	"9-out17918"	.49158	292	302	594
9	"9-out17919"	.95500	191	9	200
9	"9-out17920"	.99489	195	1	196
9	"9-out17921"	.99441	178	1	179
9	"9-out17922"	.55907	265	209	474
9	"9-out17923"	.13888	20	124	144
9	"9-out17924"	.33169	270	544	814
9	"9-out17925"	.13899	190	1177	1367
9	"9-out17926"	.98387	122	2	124
9	"9-out17927"	.24460	306	945	1251
9	"9-out17928"	1.00000	384	0	384
9	"9-out17929"	.32704	52	107	159
9	"9-out17930"	.98113	104	2	106
9	"9-out17931"	.86384	184	29	213
9	"9-out17932"	.87131	325	48	373
9	"9-out17933"	.26910	243	660	903
9	"9-out17934"	.27604	53	139	192
9	"9-out17935"	.24925	333	1003	1336
9	"9-out17936"	.74874	894	300	1194
9	"9-out17937"	.38574	157	250	407
9	"9-out17938"	.96016	458	19	477
9	"9-out17939"	.35151	290	535	825
9	"9-out17940"	.39869	61	92	153
9	"9-out17941"	.33333	60	120	180
9	"9-out17942"	.29259	158	382	540
9	"9-out17943"	.18439	78	345	423
9	"9-out17944"	.22390	133	461	594
9	"9-out17945"	.67968	261	123	384
9	"9-out17946"	.42510	105	142	247
9	"9-out17947"	.44556	176	219	395
9	"9-out17948"	.99305	143	1	144
9	"9-out17949"	.38392	215	345	560
9	"9-out17950"	.24500	49	151	200
9	"9-out17951"	.38565	258	411	669
9	"9-out17952"	.47039	143	161	304
9	"9-out17953"	.99074	107	1	108
9	"9-out17954"	.23897	168	535	703
9	"9-out17955"	.27319	53	141	194
9	"9-out17956"	.25791	57	164	221
9	"9-out17957"	.19469	44	182	226
9	"9-out17958"	.99145	116	1	117
9	"9-out17959"	.99145	116	1	117
9	"9-out17960"	.37500	117	195	312
9	"9-out17961"	.99861	723	1	724
9	"9-out17962"	.41907	145	201	346
9	"9-out17963"	.66938	164	81	245
9	"9-out17964"	.58169	89	64	153
9	"9-out17965"	.30453	483	1103	1586
9	"9-out17966"	.19172	51	215	266
9	"9-out17967"	.27741	172	448	620
9	"9-out17968"	.37600	47	78	125
9	"9-out17969"	1.00000	326	0	326
9	"9-out17970"	.85074	285	50	335
9	"9-out17971"	.26582	42	116	158
9	"9-out17972"	.99390	163	1	164
9	"9-out17973"	.96226	102	4	106
9	"9-out17974"	.99206	375	3	378
9	"9-out17975"	.14309	86	515	601
9	"9-out17976"	.26666	112	308	420
9	"9-out17977"	.68954	633	285	918
9	"9-out17978"	.28880	147	362	509
9	"9-out17979"	.26361	121	338	459
9	"9-out17980"	.39393	39	60	99
9	"9-out17981"	.26388	38	106	144
9	"9-out17982"	.30586	167	379	546
9	"9-out17983"	.36932	236	403	639
9	"9-out17984"	.28571	112	280	392
9	"9-out17985"	.57925	201	146	347
9	"9-out17986"	.35567	260	471	731
9	"9-out17987"	.46333	278	322	600
9	"9-out17988"	.29885	260	610	870
9	"9-out17989"	.99402	333	2	335
9	"9-out17990"	.23157	88	292	380
9	"9-out17991"	.33333	405	810	1215
9	"9-out17992"	.59109	292	202	494
9	"9-out17993"	.30311	107	246	353
9	"9-out17994"	.59763	202	136	338
9	"9-out17995"	.61138	247	157	404
9	"9-out17996"	.32432	108	225	333
9	"9-out17997"	.61884	440	271	711
9	"9-out17998"	.37155	162	274	436
9	"9-out17999"	.47058	240	270	510
9	"9-out18000"	.17266	163	781	944
9	"9-out18001"	.45652	399	475	874
9	"9-out18002"	.26837	84	229	313
9	"9-out18003"	.66343	274	139	413
9	"9-out18004"	.68206	251	117	368
9	"9-out18005"	.10000	7	63	70
9	"9-out18006"	.89527	530	62	592
9	"9-out18007"	.68125	436	204	640
9	"9-out18008"	.21854	99	354	453
9	"9-out18009"	.29850	20	47	67
9	"9-out18010"	.12280	56	400	456
9	"9-out18011"	.17187	88	424	512
9	"9-out18012"	.67042	1129	555	1684
9	"9-out18013"	.40119	134	200	334
9	"9-out18014"	.42713	85	114	199
9	"9-out18015"	.24456	45	139	184
9	"9-out18016"	.25698	46	133	179
9	"9-out18017"	.36893	76	130	206
9	"9-out18018"	.21468	38	139	177
9	"9-out18019"	.62008	142	87	229
9	"9-out18020"	.25382	116	341	457
9	"9-out18021"	.72781	123	46	169
9	"9-out18022"	.79904	167	42	209
9	"9-out18023"	.30769	144	324	468
9	"9-out18024"	.99040	516	5	521
9	"9-out18025"	.34564	131	248	379
9	"9-out18026"	.11061	50	402	452
9	"9-out18027"	.99640	554	2	556
9	"9-out18028"	.17565	101	474	575
9	"9-out18029"	.64746	281	153	434
9	"9-out18030"	.18416	100	443	543
9	"9-out18031"	.25970	87	248	335
9	"9-out18032"	.85529	1123	190	1313
9	"9-out18033"	.35195	126	232	358
9	"9-out18034"	.23099	158	526	684
9	"9-out18035"	.40000	64	96	160
9	"9-out18036"	.21487	52	190	242
9	"9-out18037"	.34677	86	162	248
9	"9-out18038"	.44895	840	1031	1871
9	"9-out18039"	.99410	337	2	339
9	"9-out18040"	.25404	157	461	618
9	"9-out18041"	.56944	328	248	576
9	"9-out18042"	.49174	596	616	1212
9	"9-out18043"	.38403	202	324	526
9	"9-out18044"	.48126	334	360	694
9	"9-out18045"	.99849	665	1	666
9	"9-out18046"	.18656	50	218	268
9	"9-out18047"	.27837	130	337	467
9	"9-out18048"	.43103	150	198	348
9	"9-out18049"	.13333	10	65	75
9	"9-out18050"	.23869	95	303	398
9	"9-out18051"	.21818	72	258	330
9	"9-out18052"	.37874	392	643	1035
9	"9-out18053"	.27863	90	233	323
9	"9-out18054"	.31320	166	364	530
9	"9-out18055"	.32233	127	267	394
9	"9-out18056"	.19047	16	68	84
9	"9-out18057"	.38575	130	207	337
9	"9-out18058"	.99082	108	1	109
9	"9-out18059"	.99850	667	1	668
9	"9-out18060"	.26856	405	1103	1508
9	"9-out18061"	.38515	166	265	431
9	"9-out18062"	.26298	81	227	308
9	"9-out18063"	.93125	149	11	160
9	"9-out18064"	.35036	144	267	411
9	"9-out18065"	.40067	238	356	594
9	"9-out18066"	.22246	103	360	463
9	"9-out18067"	.22397	71	246	317
9	"9-out18068"	.24754	126	383	509
9	"9-out18069"	.98994	197	2	199
9	"9-out18070"	.33789	74	145	219
9	"9-out18071"	.33536	110	218	328
9	"9-out18072"	.50617	82	80	162
9	"9-out18073"	.04516	7	148	155
9	"9-out18074"	.33678	65	128	193
9	"9-out18075"	.20903	37	140	177
9	"9-out18076"	.42280	241	329	570
9	"9-out18077"	.31734	86	185	271
9	"9-out18078"	.48643	269	284	553
9	"9-out18079"	.39886	211	318	529
9	"9-out18080"	.27881	75	194	269
9	"9-out18081"	.32236	49	103	152
9	"9-out18082"	.38664	220	349	569
9	"9-out18083"	.25988	46	131	177
9	"9-out18084"	.19318	34	142	176
9	"9-out18085"	.24721	133	405	538
9	"9-out18086"	.42105	72	99	171
9	"9-out18087"	.38235	104	168	272
9	"9-out18088"	.80500	450	109	559
9	"9-out18089"	.99728	368	1	369
9	"9-out18090"	.16891	50	246	296
9	"9-out18091"	.75367	462	151	613
9	"9-out18092"	.29623	189	449	638
9	"9-out18093"	.22051	86	304	390
9	"9-out18094"	.57520	283	209	492
9	"9-out18095"	.99561	227	1	228
9	"9-out18096"	.99242	131	1	132
9	"9-out18097"	.91534	173	16	189
9	"9-out18098"	.98412	186	3	189
9	"9-out18099"	.99470	188	1	189
9	"9-out18100"	.28817	117	289	406
9	"9-out18101"	.45180	75	91	166
9	"9-out18102"	.99500	199	1	200
9	"9-out18103"	.29711	134	317	451
9	"9-out18104"	.35526	108	196	304
9	"9-out18105"	.46893	317	359	676
9	"9-out18106"	.37948	74	121	195
9	"9-out18107"	.74444	134	46	180
9	"9-out18108"	.34929	124	231	355
9	"9-out18109"	.91369	307	29	336
9	"9-out18110"	.39819	88	133	221
9	"9-out18111"	.35517	103	187	290
9	"9-out18112"	.60162	148	98	246
9	"9-out18113"	.19322	114	476	590
9	"9-out18114"	.30174	277	641	918
9	"9-out18115"	.89655	182	21	203
9	"9-out18116"	.27750	169	440	609
9	"9-out18117"	.84444	190	35	225
9	"9-out18118"	.32279	337	707	1044
9	"9-out18119"	.32887	566	1155	1721
9	"9-out18120"	.36547	163	283	446
9	"9-out18121"	.41451	354	500	854
9	"9-out18122"	.39877	65	98	163
9	"9-out18123"	.99305	143	1	144
9	"9-out18124"	.10655	39	327	366
9	"9-out18125"	.27493	102	269	371
9	"9-out18126"	.35057	183	339	522
9	"9-out18127"	.27332	208	553	761
9	"9-out18128"	.47972	142	154	296
9	"9-out18129"	.54802	97	80	177
9	"9-out18130"	.68461	267	123	390
9	"9-out18131"	.16107	144	750	894
9	"9-out18132"	.60000	72	48	120
9	"9-out18133"	.69834	1565	676	2241
9	"9-out18134"	.39130	54	84	138
9	"9-out18135"	.20286	85	334	419
9	"9-out18136"	.40425	190	280	470
9	"9-out18137"	.99409	505	3	508
9	"9-out18138"	.53530	326	283	609
9	"9-out18139"	.32800	267	547	814
9	"9-out18140"	.48148	39	42	81
9	"9-out18141"	.19344	59	246	305
9	"9-out18142"	.37662	174	288	462
9	"9-out18143"	.18147	96	433	529
9	"9-out18144"	.25170	148	440	588
9	"9-out18145"	.19099	174	737	911
9	"9-out18146"	.73467	695	251	946
9	"9-out18147"	.24382	217	673	890
9	"9-out18148"	.24516	228	702	930
9	"9-out18149"	.26252	110	309	419
9	"9-out18150"	.29834	108	254	362
9	"9-out18151"	.20000	124	496	620
9	"9-out18152"	.42559	143	193	336
9	"9-out18153"	.53035	166	147	313
9	"9-out18154"	.96610	114	4	118
9	"9-out18155"	.23005	124	415	539
9	"9-out18156"	.30434	105	240	345
9	"9-out18157"	.99121	564	5	569
9	"9-out18158"	.72142	202	78	280
9	"9-out18159"	.30977	206	459	665
9	"9-out18160"	.99539	216	1	217
9	"9-out18161"	.29940	50	117	167
9	"9-out18162"	.83057	201	41	242
9	"9-out18163"	.40265	182	270	452
9	"9-out18164"	.45338	248	299	547
9	"9-out18165"	.30188	16	37	53
9	"9-out18166"	.98113	104	2	106
9	"9-out18167"	.35651	364	657	1021
9	"9-out18168"	.34854	84	157	241
9	"9-out18169"	.20796	94	358	452
9	"9-out18170"	.26219	43	121	164
9	"9-out18171"	.28297	118	299	417
9	"9-out18172"	.37603	91	151	242
9	"9-out18173"	.31689	212	457	669
9	"9-out18174"	.53951	157	134	291
9	"9-out18175"	.28597	159	397	556
9	"9-out18176"	.27272	168	448	616
9	"9-out18177"	.30434	168	384	552
9	"9-out18178"	.24621	130	398	528
9	"9-out18179"	.26415	56	156	212
9	"9-out18180"	.36914	134	229	363
9	"9-out18181"	.80968	468	110	578
9	"9-out18182"	.28592	193	482	675
9	"9-out18183"	.26666	88	242	330
9	"9-out18184"	.24427	64	198	262
9	"9-out18185"	.18609	99	433	532
9	"9-out18186"	.17405	157	745	902
9	"9-out18187"	.23284	95	313	408
9	"9-out18188"	.12512	126	881	1007
9	"9-out18189"	.17406	153	726	879
9	"9-out18190"	.20702	165	632	797
9	"9-out18191"	.24960	156	469	625
9	"9-out18192"	.32269	283	594	877
9	"9-out18193"	.95380	351	17	368
9	"9-out18194"	.15995	147	772	919
9	"9-out18195"	.32709	297	611	908
9	"9-out18196"	.33995	325	631	956
9	"9-out18197"	.41935	91	126	217
9	"9-out18198"	.28469	279	701	980
9	"9-out18199"	.81001	550	129	679
9	"9-out18200"	.29211	789	1912	2701
9	"9-out18201"	.65988	227	117	344
9	"9-out18202"	.40625	195	285	480
9	"9-out18203"	.30952	104	232	336
9	"9-out18204"	.32822	557	1140	1697
9	"9-out18205"	.37749	567	935	1502
9	"9-out18206"	.12121	32	232	264
9	"9-out18207"	.23509	205	667	872
9	"9-out18208"	.26038	163	463	626
9	"9-out18209"	.18763	170	736	906
9	"9-out18210"	.44742	451	557	1008
9	"9-out18211"	.35135	52	96	148
9	"9-out18212"	.98976	290	3	293
9	"9-out18213"	.18075	77	349	426
9	"9-out18214"	.79024	162	43	205
9	"9-out18215"	.46692	120	137	257
9	"9-out18216"	.30645	152	344	496
9	"9-out18217"	.35433	180	328	508
9	"9-out18218"	.69214	335	149	484
9	"9-out18219"	.99581	238	1	239
9	"9-out18220"	.28017	65	167	232
9	"9-out18221"	.27793	97	252	349
9	"9-out18222"	.54014	148	126	274
9	"9-out18223"	.29356	187	450	637
9	"9-out18224"	.91441	203	19	222
9	"9-out18225"	.34469	91	173	264
9	"9-out18226"	.92660	202	16	218
9	"9-out18227"	.98735	937	12	949
9	"9-out18228"	.28903	174	428	602
9	"9-out18229"	.32641	236	487	723
9	"9-out18230"	.16993	26	127	153
9	"9-out18231"	.30129	116	269	385
9	"9-out18232"	.35699	176	317	493
9	"9-out18233"	.99694	326	1	327
9	"9-out18234"	.34666	104	196	300
9	"9-out18235"	.26851	116	316	432
9	"9-out18236"	.47846	100	109	209
9	"9-out18237"	.61818	204	126	330
9	"9-out18238"	.23130	167	555	722
9	"9-out18239"	.55487	91	73	164
9	"9-out18240"	.17672	82	382	464
9	"9-out18241"	.27363	165	438	603
9	"9-out18242"	.26245	158	444	602
9	"9-out18243"	.29604	172	409	581
9	"9-out18244"	.33333	213	426	639
9	"9-out18245"	.35891	159	284	443
9	"9-out18246"	.39966	239	359	598
9	"9-out18247"	.38805	52	82	134
9	"9-out18248"	.78287	256	71	327
9	"9-out18249"	.44295	66	83	149
9	"9-out18250"	.27894	53	137	190
9	"9-out18251"	.09090	17	170	187
9	"9-out18252"	.22979	91	305	396
9	"9-out18253"	.31100	65	144	209
9	"9-out18254"	.99881	840	1	841
9	"9-out18255"	.46188	206	240	446
9	"9-out18256"	.87017	248	37	285
9	"9-out18257"	.41288	500	711	1211
9	"9-out18258"	.23713	212	682	894
9	"9-out18259"	.40112	142	212	354
9	"9-out18260"	.95738	966	43	1009
9	"9-out18261"	.29930	173	405	578
9	"9-out18262"	.27848	154	399	553
9	"9-out18263"	.41768	137	191	328
9	"9-out18264"	.98130	105	2	107
9	"9-out18265"	.32803	413	846	1259
9	"9-out18266"	.46376	192	222	414
9	"9-out18267"	.20522	566	2192	2758
9	"9-out18268"	.18494	494	2177	2671
9	"9-out18269"	.09375	36	348	384
9	"9-out18270"	.27407	37	98	135
9	"9-out18271"	.72527	594	225	819
9	"9-out18272"	.37469	154	257	411
9	"9-out18273"	.60995	147	94	241
9	"9-out18274"	.30801	146	328	474
9	"9-out18275"	.23868	58	185	243
9	"9-out18276"	.33812	47	92	139
9	"9-out18277"	.92585	924	74	998
9	"9-out18278"	.31081	23	51	74
9	"9-out18279"	.99876	809	1	810
9	"9-out18280"	.39761	233	353	586
9	"9-out18281"	.97297	108	3	111
9	"9-out18282"	.40666	122	178	300
9	"9-out18283"	.43790	67	86	153
9	"9-out18284"	.99447	180	1	181
9	"9-out18285"	.90171	367	40	407
9	"9-out18286"	.29330	469	1130	1599
9	"9-out18287"	.36088	572	1013	1585
9	"9-out18288"	.36405	79	138	217
9	"9-out18289"	.21365	194	714	908
9	"9-out18290"	.22650	200	683	883
9	"9-out18291"	.32040	190	403	593
9	"9-out18292"	.24455	292	902	1194
9	"9-out18293"	.99590	243	1	244
9	"9-out18294"	.44308	218	274	492
9	"9-out18295"	.26760	76	208	284
9	"9-out18296"	.48214	54	58	112
9	"9-out18297"	.25870	52	149	201
9	"9-out18298"	.51250	123	117	240
9	"9-out18299"	.45901	308	363	671
9	"9-out18300"	.24980	652	1958	2610
9	"9-out18301"	.16064	258	1348	1606
9	"9-out18302"	.19720	310	1262	1572
9	"9-out18303"	.99915	1180	1	1181
9	"9-out18304"	.34322	474	907	1381
9	"9-out18305"	.32577	273	565	838
9	"9-out18306"	.44390	91	114	205
9	"9-out18307"	.34923	205	382	587
9	"9-out18308"	.43269	180	236	416
9	"9-out18309"	.34774	378	709	1087
9	"9-out18310"	.33271	179	359	538
9	"9-out18311"	.46052	140	164	304
9	"9-out18312"	.71121	298	121	419
9	"9-out18313"	.32528	202	419	621
9	"9-out18314"	.17277	33	158	191
9	"9-out18315"	.90356	609	65	674
9	"9-out18316"	.64473	441	243	684
9	"9-out18317"	.41274	149	212	361
9	"9-out18318"	.64985	219	118	337
9	"9-out18319"	.70029	236	101	337
9	"9-out18320"	.21445	89	326	415
9	"9-out18321"	.21875	91	325	416
9	"9-out18322"	.22748	96	326	422
9	"9-out18323"	.53012	220	195	415
9	"9-out18324"	.18344	82	365	447
9	"9-out18325"	.23091	118	393	511
9	"9-out18326"	.30548	128	291	419
9	"9-out18327"	.28648	106	264	370
9	"9-out18328"	.25714	99	286	385
9	"9-out18329"	.32983	157	319	476
9	"9-out18330"	.31698	84	181	265
9	"9-out18331"	.22413	52	180	232
9	"9-out18332"	.21028	90	338	428
9	"9-out18333"	.22911	96	323	419
9	"9-out18334"	.23788	54	173	227
9	"9-out18335"	.31481	85	185	270
9	"9-out18336"	.28496	108	271	379
9	"9-out18337"	.25128	98	292	390
9	"9-out18338"	.42127	99	136	235
9	"9-out18339"	.72401	202	77	279
9	"9-out18340"	.35460	150	273	423
9	"9-out18341"	.57142	76	57	133
9	"9-out18342"	.26035	88	250	338
9	"9-out18343"	.14069	65	397	462
9	"9-out18344"	.54761	46	38	84
9	"9-out18345"	.52000	169	156	325
9	"9-out18346"	.35741	94	169	263
9	"9-out18347"	.46240	123	143	266
9	"9-out18348"	.34456	92	175	267
9	"9-out18349"	.16666	28	140	168
9	"9-out18350"	.30020	145	338	483
9	"9-out18351"	.15994	107	562	669
9	"9-out18352"	.99324	147	1	148
9	"9-out18353"	.89516	444	52	496
9	"9-out18354"	.35483	176	320	496
9	"9-out18355"	.95154	216	11	227
9	"9-out18356"	.99551	222	1	223
9	"9-out18357"	.54545	378	315	693
9	"9-out18358"	.51612	48	45	93
9	"9-out18359"	.53846	329	282	611
9	"9-out18360"	.45652	84	100	184
9	"9-out18361"	.24710	64	195	259
9	"9-out18362"	.19920	50	201	251
9	"9-out18363"	.26913	327	888	1215
9	"9-out18364"	.27100	258	694	952
9	"9-out18365"	.34378	296	565	861
9	"9-out18366"	.22650	229	782	1011
9	"9-out18367"	.99649	568	2	570
9	"9-out18368"	.07936	15	174	189
9	"9-out18369"	.24793	60	182	242
9	"9-out18370"	.27031	173	467	640
9	"9-out18371"	.38571	189	301	490
9	"9-out18372"	.28228	188	478	666
9	"9-out18373"	.21042	105	394	499
9	"9-out18374"	.19534	109	449	558
9	"9-out18375"	.46105	148	173	321
9	"9-out18376"	.29812	127	299	426
9	"9-out18377"	.22020	109	386	495
9	"9-out18378"	.29739	171	404	575
9	"9-out18379"	.16232	81	418	499
9	"9-out18380"	.29080	98	239	337
9	"9-out18381"	.31638	168	363	531
9	"9-out18382"	.99839	621	1	622
9	"9-out18383"	.32178	418	881	1299
9	"9-out18384"	.54414	339	284	623
9	"9-out18385"	.17200	43	207	250
9	"9-out18386"	.27963	92	237	329
9	"9-out18387"	.19848	210	848	1058
9	"9-out18388"	.98679	897	12	909
9	"9-out18389"	.99477	571	3	574
9	"9-out18390"	.45245	295	357	652
9	"9-out18391"	.40216	335	498	833
9	"9-out18392"	.23501	98	319	417
9	"9-out18393"	.96363	106	4	110
9	"9-out18394"	.98319	117	2	119
9	"9-out18395"	.99716	352	1	353
9	"9-out18396"	.99705	339	1	340
9	"9-out18397"	1.00000	377	0	377
9	"9-out18398"	1.00000	453	0	453
9	"9-out18399"	.98113	104	2	106
9	"9-out18400"	.27408	128	339	467
9	"9-out18401"	.35143	110	203	313
9	"9-out18402"	.31101	144	319	463
9	"9-out18403"	.30922	171	382	553
9	"9-out18404"	.16842	48	237	285
9	"9-out18405"	.81333	122	28	150
9	"9-out18406"	.98901	90	1	91
9	"9-out18407"	.30898	110	246	356
9	"9-out18408"	.40255	126	187	313
9	"9-out18409"	.10789	56	463	519
9	"9-out18410"	.22053	116	410	526
9	"9-out18411"	.30468	39	89	128
9	"9-out18412"	.14871	87	498	585
9	"9-out18413"	.31503	132	287	419
9	"9-out18414"	.37640	67	111	178
9	"9-out18415"	.98717	77	1	78
9	"9-out18416"	.29452	43	103	146
9	"9-out18417"	.25900	345	987	1332
9	"9-out18418"	.49444	89	91	180
9	"9-out18419"	.30964	61	136	197
9	"9-out18420"	.66831	135	67	202
9	"9-out18421"	.17791	29	134	163
9	"9-out18422"	.40850	221	320	541
9	"9-out18423"	.80650	446	107	553
9	"9-out18424"	.39447	157	241	398
9	"9-out18425"	.30322	47	108	155
9	"9-out18426"	.27513	52	137	189
9	"9-out18427"	.31160	196	433	629
9	"9-out18428"	.89711	218	25	243
9	"9-out18429"	.36116	199	352	551
9	"9-out18430"	.23529	36	117	153
9	"9-out18431"	.80891	127	30	157
9	"9-out18432"	.24726	181	551	732
9	"9-out18433"	.88888	208	26	234
9	"9-out18434"	.38888	105	165	270
9	"9-out18435"	.27967	139	358	497
9	"9-out18436"	.99541	217	1	218
9	"9-out18437"	.34671	311	586	897
9	"9-out18438"	.28947	44	108	152
9	"9-out18439"	.39245	104	161	265
9	"9-out18440"	.32730	199	409	608
9	"9-out18441"	.24014	134	424	558
9	"9-out18442"	.28665	174	433	607
9	"9-out18443"	.23106	122	406	528
9	"9-out18444"	.20761	109	416	525
9	"9-out18445"	.44444	240	300	540
9	"9-out18446"	.21684	417	1506	1923
9	"9-out18447"	.17972	39	178	217
9	"9-out18448"	.30412	59	135	194
9	"9-out18449"	.29245	570	1379	1949
9	"9-out18450"	.90891	948	95	1043
9	"9-out18451"	.35416	153	279	432
9	"9-out18452"	.28804	53	131	184
9	"9-out18453"	.95045	211	11	222
9	"9-out18454"	.95945	213	9	222
9	"9-out18455"	.99590	243	1	244
9	"9-out18456"	.49523	104	106	210
9	"9-out18457"	.35453	418	761	1179
9	"9-out18458"	.53806	516	443	959
9	"9-out18459"	.99583	239	1	240
9	"9-out18460"	.98630	936	13	949
9	"9-out18461"	.30385	189	433	622
9	"9-out18462"	.23194	167	553	720
9	"9-out18463"	.99418	513	3	516
9	"9-out18464"	.41077	785	1126	1911
9	"9-out18465"	.28854	131	323	454
9	"9-out18466"	.97989	585	12	597
9	"9-out18467"	.83211	342	69	411
9	"9-out18468"	.51968	132	122	254
9	"9-out18469"	.44794	185	228	413
9	"9-out18470"	.29218	142	344	486
9	"9-out18471"	.30631	635	1438	2073
9	"9-out18472"	.27354	183	486	669
9	"9-out18473"	.33701	183	360	543
9	"9-out18474"	.35245	172	316	488
9	"9-out18475"	.29442	111	266	377
9	"9-out18476"	.36469	283	493	776
9	"9-out18477"	.32852	638	1304	1942
9	"9-out18478"	.38056	419	682	1101
9	"9-out18479"	.27489	127	335	462
9	"9-out18480"	.33333	44	88	132
9	"9-out18481"	.19160	73	308	381
9	"9-out18482"	.95921	682	29	711
9	"9-out18483"	.59523	50	34	84
9	"9-out18484"	.49333	111	114	225
9	"9-out18485"	.92660	202	16	218
9	"9-out18486"	.33739	166	326	492
9	"9-out18487"	.29916	321	752	1073
9	"9-out18488"	.38755	81	128	209
9	"9-out18489"	.44307	144	181	325
9	"9-out18490"	.27058	69	186	255
9	"9-out18491"	.21643	108	391	499
9	"9-out18492"	.21703	158	570	728
9	"9-out18493"	.19752	239	971	1210
9	"9-out18494"	.34482	170	323	493
9	"9-out18495"	.22615	230	787	1017
9	"9-out18496"	.22566	51	175	226
9	"9-out18497"	.38498	241	385	626
9	"9-out18498"	.32436	193	402	595
9	"9-out18499"	.24226	47	147	194
9	"9-out18500"	.90769	472	48	520
9	"9-out18501"	.20742	95	363	458
9	"9-out18502"	.25763	135	389	524
9	"9-out18503"	.23353	39	128	167
9	"9-out18504"	.33456	181	360	541
9	"9-out18505"	.22037	119	421	540
9	"9-out18506"	.28825	162	400	562
9	"9-out18507"	.21920	105	374	479
9	"9-out18508"	.92837	337	26	363
9	"9-out18509"	.23754	62	199	261
9	"9-out18510"	.30337	270	620	890
9	"9-out18511"	.24407	103	319	422
9	"9-out18512"	.30289	607	1397	2004
9	"9-out18513"	.40969	186	268	454
9	"9-out18514"	.25792	122	351	473
9	"9-out18515"	.24013	73	231	304
9	"9-out18516"	.52796	387	346	733
9	"9-out18517"	.98969	96	1	97
9	"9-out18518"	.99056	105	1	106
9	"9-out18519"	.30618	203	460	663
9	"9-out18520"	.19480	45	186	231
9	"9-out18521"	.19197	67	282	349
9	"9-out18522"	.25749	275	793	1068
9	"9-out18523"	.32400	81	169	250
9	"9-out18524"	.71131	308	125	433
9	"9-out18525"	.23333	84	276	360
9	"9-out18526"	.21788	95	341	436
9	"9-out18527"	.23466	88	287	375
9	"9-out18528"	.23205	97	321	418
9	"9-out18529"	.75288	326	107	433
9	"9-out18530"	.30825	381	855	1236
9	"9-out18531"	.23560	45	146	191
9	"9-out18532"	.18571	39	171	210
9	"9-out18533"	.38422	151	242	393
9	"9-out18534"	.27576	99	260	359
9	"9-out18535"	.71052	81	33	114
9	"9-out18536"	.43886	341	436	777
9	"9-out18537"	.31914	165	352	517
9	"9-out18538"	.84263	166	31	197
9	"9-out18539"	.36196	59	104	163
9	"9-out18540"	.24404	82	254	336
9	"9-out18541"	.12121	16	116	132
9	"9-out18542"	.19571	137	563	700
9	"9-out18543"	.22402	138	478	616
9	"9-out18544"	.99264	135	1	136
9	"9-out18545"	.99718	354	1	355
9	"9-out18546"	.25581	44	128	172
9	"9-out18547"	.23440	124	405	529
9	"9-out18548"	.85849	91	15	106
9	"9-out18549"	.92063	116	10	126
9	"9-out18550"	.72905	261	97	358
9	"9-out18551"	.98265	340	6	346
9	"9-out18552"	.98816	334	4	338
9	"9-out18553"	.97513	353	9	362
9	"9-out18554"	.30801	146	328	474
9	"9-out18555"	.97560	40	1	41
9	"9-out18556"	.95833	23	1	24
9	"9-out18557"	.96296	26	1	27
9	"9-out18558"	.22028	139	492	631
9	"9-out18559"	.47287	340	379	719
9	"9-out18560"	.19338	76	317	393
9	"9-out18561"	.96839	337	11	348
9	"9-out18562"	.20141	57	226	283
9	"9-out18563"	.26349	244	682	926
9	"9-out18564"	.28846	75	185	260
9	"9-out18565"	.28040	83	213	296
9	"9-out18566"	.45426	149	179	328
9	"9-out18567"	.28417	158	398	556
9	"9-out18568"	.37198	154	260	414
9	"9-out18569"	.24242	24	75	99
9	"9-out18570"	.42748	280	375	655
9	"9-out18571"	.13188	158	1040	1198
9	"9-out18572"	.99719	355	1	356
9	"9-out18573"	.68421	39	18	57
9	"9-out18574"	.28571	52	130	182
9	"9-out18575"	.60784	31	20	51
9	"9-out18576"	.98943	1124	12	1136
9	"9-out18577"	.39926	109	164	273
9	"9-out18578"	.37106	118	200	318
9	"9-out18579"	.58056	245	177	422
9	"9-out18580"	.38333	115	185	300
9	"9-out18581"	.99145	116	1	117
9	"9-out18582"	.99145	116	1	117
9	"9-out18583"	.99145	116	1	117
9	"9-out18584"	.31276	218	479	697
9	"9-out18585"	.46448	170	196	366
9	"9-out18586"	.41352	263	373	636
9	"9-out18587"	.92857	377	29	406
9	"9-out18588"	.25059	106	317	423
9	"9-out18589"	.99555	224	1	225
9	"9-out18590"	.99541	217	1	218
9	"9-out18591"	.23352	163	535	698
9	"9-out18592"	1.00000	330	0	330
9	"9-out18593"	1.00000	327	0	327
9	"9-out18594"	.98113	104	2	106
9	"9-out18595"	.36411	343	599	942
9	"9-out18596"	.81712	210	47	257
9	"9-out18597"	.24594	91	279	370
9	"9-out18598"	.28959	64	157	221
9	"9-out18599"	.99585	240	1	241
9	"9-out18600"	.94594	210	12	222
9	"9-out18601"	.99418	171	1	172
9	"9-out18602"	.41083	182	261	443
9	"9-out18603"	.31171	274	605	879
9	"9-out18604"	.22659	167	570	737
9	"9-out18605"	.28461	37	93	130
9	"9-out18606"	.24615	32	98	130
9	"9-out18607"	.23437	30	98	128
9	"9-out18608"	.23255	30	99	129
9	"9-out18609"	.23846	31	99	130
9	"9-out18610"	.99130	114	1	115
9	"9-out18611"	.21774	81	291	372
9	"9-out18612"	.90625	116	12	128
9	"9-out18613"	.56349	71	55	126
9	"9-out18614"	.56349	71	55	126
9	"9-out18615"	.61111	77	49	126
9	"9-out18616"	.57936	73	53	126
9	"9-out18617"	.57936	73	53	126
9	"9-out18618"	.58730	74	52	126
9	"9-out18619"	.61904	78	48	126
9	"9-out18620"	.15441	21	115	136
9	"9-out18621"	.33088	45	91	136
9	"9-out18622"	.22058	30	106	136
9	"9-out18623"	.71034	206	84	290
9	"9-out18624"	.33137	394	795	1189
9	"9-out18625"	.26216	97	273	370
9	"9-out18626"	.66295	238	121	359
9	"9-out18627"	.28260	104	264	368
9	"9-out18628"	.33170	136	274	410
9	"9-out18629"	.99295	141	1	142
9	"9-out18630"	.98591	140	2	142
9	"9-out18631"	.97235	211	6	217
9	"9-out18632"	.32584	145	300	445
9	"9-out18633"	.37716	109	180	289
9	"9-out18634"	.27608	336	881	1217
9	"9-out18635"	.14857	52	298	350
9	"9-out18636"	.32579	72	149	221
9	"9-out18637"	.74522	351	120	471
9	"9-out18638"	.25952	109	311	420
9	"9-out18639"	.21327	135	498	633
9	"9-out18640"	.98623	215	3	218
9	"9-out18641"	.99264	135	1	136
9	"9-out18642"	.38242	148	239	387
9	"9-out18643"	.33932	170	331	501
9	"9-out18644"	.25283	156	461	617
9	"9-out18645"	.34171	163	314	477
9	"9-out18646"	.26201	289	814	1103
9	"9-out18647"	.35000	84	156	240
9	"9-out18648"	.99606	253	1	254
9	"9-out18649"	.78409	345	95	440
9	"9-out18650"	.33333	237	474	711
9	"9-out18651"	.17674	38	177	215
9	"9-out18652"	.22535	48	165	213
9	"9-out18653"	.18721	41	178	219
9	"9-out18654"	.21568	55	200	255
9	"9-out18655"	.98969	96	1	97
9	"9-out18656"	.25255	99	293	392
9	"9-out18657"	.22900	30	101	131
9	"9-out18658"	.25384	33	97	130
9	"9-out18659"	.20000	26	104	130
9	"9-out18660"	.23437	30	98	128
9	"9-out18661"	.13076	17	113	130
9	"9-out18662"	.23076	33	110	143
9	"9-out18663"	.40944	52	75	127
9	"9-out18664"	.90673	175	18	193
9	"9-out18665"	.89024	146	18	164
9	"9-out18666"	.60317	76	50	126
9	"9-out18667"	.58730	74	52	126
9	"9-out18668"	.57142	72	54	126
9	"9-out18669"	.58730	74	52	126
9	"9-out18670"	.55248	400	324	724
9	"9-out18671"	.86771	2473	377	2850
9	"9-out18672"	.96428	27	1	28
9	"9-out18673"	.99290	420	3	423
9	"9-out18674"	.98498	328	5	333
9	"9-out18675"	.99750	400	1	401
9	"9-out18676"	.21875	77	275	352
9	"9-out18677"	.99152	117	1	118
9	"9-out18678"	.46645	146	167	313
9	"9-out18679"	.99145	116	1	117
9	"9-out18680"	.30787	133	299	432
9	"9-out18681"	.49816	136	137	273
9	"9-out18682"	.99130	114	1	115
9	"9-out18683"	.28654	49	122	171
9	"9-out18684"	.99578	236	1	237
9	"9-out18685"	.41772	99	138	237
9	"9-out18686"	.05737	7	115	122
9	"9-out18687"	.93432	441	31	472
9	"9-out18688"	.30628	117	265	382
9	"9-out18689"	.40591	192	281	473
9	"9-out18690"	.27118	32	86	118
9	"9-out18691"	.32937	111	226	337
9	"9-out18692"	.47761	160	175	335
9	"9-out18693"	.30961	161	359	520
9	"9-out18694"	.77409	257	75	332
9	"9-out18695"	.72014	193	75	268
9	"9-out18696"	.10703	35	292	327
9	"9-out18697"	.57295	161	120	281
9	"9-out18698"	.47014	819	923	1742
9	"9-out18699"	.34602	100	189	289
9	"9-out18700"	.47154	116	130	246
9	"9-out18701"	.09486	24	229	253
9	"9-out18702"	.30731	126	284	410
9	"9-out18703"	.38489	107	171	278
9	"9-out18704"	.25714	234	676	910
9	"9-out18705"	.27982	197	507	704
9	"9-out18706"	.39175	114	177	291
9	"9-out18707"	.42196	146	200	346
9	"9-out18708"	.31188	252	556	808
9	"9-out18709"	.51990	209	193	402
9	"9-out18710"	.16981	135	660	795
9	"9-out18711"	.41878	330	458	788
9	"9-out18712"	.17928	135	618	753
9	"9-out18713"	.31781	239	513	752
9	"9-out18714"	.35185	133	245	378
9	"9-out18715"	.53075	371	328	699
9	"9-out18716"	.29883	205	481	686
9	"9-out18717"	.37133	583	987	1570
9	"9-out18718"	.37152	668	1130	1798
9	"9-out18719"	.24598	322	987	1309
9	"9-out18720"	.23637	620	2003	2623
9	"9-out18721"	.31566	131	284	415
9	"9-out18722"	.36752	86	148	234
9	"9-out18723"	.22153	72	253	325
9	"9-out18724"	.37540	116	193	309
9	"9-out18725"	.15269	51	283	334
9	"9-out18726"	.42603	216	291	507
9	"9-out18727"	.12813	46	313	359
9	"9-out18728"	.10863	39	320	359
9	"9-out18729"	.99152	117	1	118
9	"9-out18730"	.99186	122	1	123
9	"9-out18731"	.99200	124	1	125
9	"9-out18732"	.38628	107	170	277
9	"9-out18733"	.29666	151	358	509
9	"9-out18734"	.38461	115	184	299
9	"9-out18735"	.27295	110	293	403
9	"9-out18736"	.29338	71	171	242
9	"9-out18737"	.19417	80	332	412
9	"9-out18738"	.99145	116	1	117
9	"9-out18739"	.25252	75	222	297
9	"9-out18740"	.47619	230	253	483
9	"9-out18741"	.99236	130	1	131
9	"9-out18742"	.35400	177	323	500
9	"9-out18743"	.30963	257	573	830
9	"9-out18744"	.97222	35	1	36
9	"9-out18745"	.16793	66	327	393
9	"9-out18746"	.96086	221	9	230
9	"9-out18747"	.27659	39	102	141
9	"9-out18748"	.99305	143	1	144
9	"9-out18749"	.20231	70	276	346
9	"9-out18750"	.38645	97	154	251
9	"9-out18751"	.24008	351	1111	1462
9	"9-out18752"	.79545	70	18	88
9	"9-out18753"	.38032	259	422	681
9	"9-out18754"	.34205	183	352	535
9	"9-out18755"	.28102	77	197	274
9	"9-out18756"	.51460	1075	1014	2089
9	"9-out18757"	.99470	188	1	189
9	"9-out18758"	.36178	89	157	246
9	"9-out18759"	.41463	102	144	246
9	"9-out18760"	.42733	197	264	461
9	"9-out18761"	.29497	282	674	956
9	"9-out18762"	.16553	73	368	441
9	"9-out18763"	.17317	71	339	410
9	"9-out18764"	.22342	124	431	555
9	"9-out18765"	.40789	31	45	76
9	"9-out18766"	.95833	23	1	24
9	"9-out18767"	.95833	23	1	24
9	"9-out18768"	.60952	320	205	525
9	"9-out18769"	.14880	25	143	168
9	"9-out18770"	.16938	52	255	307
9	"9-out18771"	.65196	547	292	839
9	"9-out18772"	.26829	44	120	164
9	"9-out18773"	.99705	338	1	339
9	"9-out18774"	.33640	73	144	217
9	"9-out18775"	.78888	213	57	270
9	"9-out18776"	.55681	196	156	352
9	"9-out18777"	.21492	72	263	335
9	"9-out18778"	.53354	167	146	313
9	"9-out18779"	.23890	113	360	473
9	"9-out18780"	.99145	116	1	117
9	"9-out18781"	.42278	282	385	667
9	"9-out18782"	.99130	114	1	115
9	"9-out18783"	.47148	124	139	263
9	"9-out18784"	.32647	1428	2946	4374
9	"9-out18785"	.21232	124	460	584
9	"9-out18786"	.99145	116	1	117
9	"9-out18787"	.20838	154	585	739
9	"9-out18788"	.63389	303	175	478
9	"9-out18789"	.36538	95	165	260
9	"9-out18790"	.28906	333	819	1152
9	"9-out18791"	.44649	363	450	813
9	"9-out18792"	.40320	302	447	749
9	"9-out18793"	.62905	407	240	647
9	"9-out18794"	.40750	163	237	400
9	"9-out18795"	.99152	117	1	118
9	"9-out18796"	.22298	97	338	435
9	"9-out18797"	.99152	117	1	118
9	"9-out18798"	.93868	4807	314	5121
9	"9-out18799"	.99145	116	1	117
9	"9-out18800"	.99137	115	1	116
9	"9-out18801"	.23296	106	349	455
9	"9-out18802"	.99159	118	1	119
9	"9-out18803"	.26169	207	584	791
9	"9-out18804"	.99145	116	1	117
9	"9-out18805"	.32031	41	87	128
9	"9-out18806"	.46402	129	149	278
9	"9-out18807"	.40000	64	96	160
9	"9-out18808"	.29306	279	673	952
9	"9-out18809"	.28146	123	314	437
9	"9-out18810"	.50967	79	76	155
9	"9-out18811"	.35156	180	332	512
9	"9-out18812"	.33573	140	277	417
9	"9-out18813"	.68807	225	102	327
9	"9-out18814"	.99519	207	1	208
9	"9-out18815"	.99519	207	1	208
9	"9-out18816"	.99519	207	1	208
9	"9-out18817"	.91115	482	47	529
9	"9-out18818"	.25650	138	400	538
9	"9-out18819"	.26119	140	396	536
9	"9-out18820"	.38857	68	107	175
9	"9-out18821"	.57865	206	150	356
9	"9-out18822"	.18556	54	237	291
9	"9-out18823"	.35382	282	515	797
9	"9-out18824"	.33551	308	610	918
9	"9-out18825"	.33212	92	185	277
9	"9-out18826"	.48000	96	104	200
9	"9-out18827"	.18556	18	79	97
9	"9-out18828"	.25211	179	531	710
9	"9-out18829"	.22184	65	228	293
9	"9-out18830"	.33943	334	650	984
9	"9-out18831"	.35075	302	559	861
9	"9-out18832"	.78466	696	191	887
9	"9-out18833"	.30854	307	688	995
9	"9-out18834"	.83170	341	69	410
9	"9-out18835"	.37359	133	223	356
9	"9-out18836"	.30053	113	263	376
9	"9-out18837"	.89147	115	14	129
9	"9-out18838"	.32584	29	60	89
9	"9-out18839"	.50171	146	145	291
9	"9-out18840"	.55035	153	125	278
9	"9-out18841"	.26923	154	418	572
9	"9-out18842"	.54600	273	227	500
9	"9-out18843"	.40944	156	225	381
9	"9-out18844"	.31615	227	491	718
9	"9-out18845"	.88571	310	40	350
9	"9-out18846"	.35167	262	483	745
9	"9-out18847"	.18650	141	615	756
9	"9-out18848"	.32262	231	485	716
9	"9-out18849"	.27215	172	460	632
9	"9-out18850"	.51781	247	230	477
9	"9-out18851"	.26007	71	202	273
9	"9-out18852"	.35736	114	205	319
9	"9-out18853"	.17955	65	297	362
9	"9-out18854"	.99519	207	1	208
9	"9-out18855"	.21993	64	227	291
9	"9-out18856"	.43313	149	195	344
9	"9-out18857"	.28505	124	311	435
9	"9-out18858"	.36550	178	309	487
9	"9-out18859"	.65254	308	164	472
9	"9-out18860"	.21186	75	279	354
9	"9-out18861"	.29605	90	214	304
9	"9-out18862"	.47903	297	323	620
9	"9-out18863"	.21559	177	644	821
9	"9-out18864"	.16968	122	597	719
9	"9-out18865"	.42738	359	481	840
9	"9-out18866"	.29658	339	804	1143
9	"9-out18867"	.24626	132	404	536
9	"9-out18868"	.58527	302	214	516
9	"9-out18869"	.98113	52	1	53
9	"9-out18870"	.36690	51	88	139
9	"9-out18871"	.96428	27	1	28
9	"9-out18872"	.55084	195	159	354
9	"9-out18873"	.32727	180	370	550
9	"9-out18874"	.33565	241	477	718
9	"9-out18875"	.22780	195	661	856
9	"9-out18876"	.95751	293	13	306
9	"9-out18877"	.26267	57	160	217
9	"9-out18878"	.47272	390	435	825
9	"9-out18879"	.52054	38	35	73
9	"9-out18880"	.95965	333	14	347
9	"9-out18881"	.91625	372	34	406
9	"9-out18882"	.99145	116	1	117
9	"9-out18883"	.99145	116	1	117
9	"9-out18884"	.18235	62	278	340
9	"9-out18885"	.99145	116	1	117
9	"9-out18886"	.44621	112	139	251
9	"9-out18887"	.87500	238	34	272
9	"9-out18888"	.99115	112	1	113
9	"9-out18889"	.11965	14	103	117
9	"9-out18890"	.30991	75	167	242
9	"9-out18891"	.34541	286	542	828
9	"9-out18892"	.52509	136	123	259
9	"9-out18893"	.99145	116	1	117
9	"9-out18894"	.47049	574	646	1220
9	"9-out18895"	.75856	443	141	584
9	"9-out18896"	.33774	204	400	604
9	"9-out18897"	.39373	176	271	447
9	"9-out18898"	.31958	62	132	194
9	"9-out18899"	.99509	203	1	204
9	"9-out18900"	.27786	369	959	1328
9	"9-out18901"	.54661	129	107	236
9	"9-out18902"	.23986	432	1369	1801
9	"9-out18903"	.19444	56	232	288
9	"9-out18904"	.33568	143	283	426
9	"9-out18905"	.32307	168	352	520
9	"9-out18906"	.28421	81	204	285
9	"9-out18907"	.27946	83	214	297
9	"9-out18908"	.99820	557	1	558
9	"9-out18909"	.21084	206	771	977
9	"9-out18910"	.28923	94	231	325
9	"9-out18911"	.42891	178	237	415
9	"9-out18912"	.95833	23	1	24
9	"9-out18913"	.30776	309	695	1004
9	"9-out18914"	.21568	154	560	714
9	"9-out18915"	.25242	26	77	103
9	"9-out18916"	.34400	43	82	125
9	"9-out18917"	.99159	118	1	119
9	"9-out18918"	.99159	118	1	119
9	"9-out18919"	.99137	115	1	116
9	"9-out18920"	.99145	116	1	117
9	"9-out18921"	.26378	110	307	417
9	"9-out18922"	.17251	59	283	342
9	"9-out18923"	.47629	211	232	443
9	"9-out18924"	.26914	232	630	862
9	"9-out18925"	.31075	156	346	502
9	"9-out18926"	.99145	116	1	117
9	"9-out18927"	.99145	116	1	117
9	"9-out18928"	.41457	330	466	796
9	"9-out18929"	.38372	99	159	258
9	"9-out18930"	.20727	57	218	275
9	"9-out18931"	.28413	77	194	271
9	"9-out18932"	.33750	81	159	240
9	"9-out18933"	.46563	630	723	1353
9	"9-out18934"	.99468	187	1	188
9	"9-out18935"	.29511	157	375	532
9	"9-out18936"	.19867	60	242	302
9	"9-out18937"	.81343	109	25	134
9	"9-out18938"	.20283	43	169	212
9	"9-out18939"	.63928	179	101	280
9	"9-out18940"	.99145	116	1	117
9	"9-out18941"	.26115	281	795	1076
9	"9-out18942"	.99145	116	1	117
9	"9-out18943"	.22676	61	208	269
9	"9-out18944"	.99145	116	1	117
9	"9-out18945"	.36007	193	343	536
9	"9-out18946"	.66875	214	106	320
9	"9-out18947"	.13617	32	203	235
9	"9-out18948"	.64615	84	46	130
9	"9-out18949"	.22860	227	766	993
9	"9-out18950"	.59699	517	349	866
9	"9-out18951"	.77208	708	209	917
9	"9-out18952"	.25316	160	472	632
9	"9-out18953"	.45061	73	89	162
9	"9-out18954"	.52836	149	133	282
9	"9-out18955"	.33098	94	190	284
9	"9-out18956"	.28360	173	437	610
9	"9-out18957"	.18592	37	162	199
9	"9-out18958"	.25818	142	408	550
9	"9-out18959"	.47229	179	200	379
9	"9-out18960"	.27433	124	328	452
9	"9-out18961"	.73267	296	108	404
9	"9-out18962"	.36821	95	163	258
9	"9-out18963"	.99305	143	1	144
9	"9-out18964"	.40206	234	348	582
9	"9-out18965"	.28016	490	1259	1749
9	"9-out18966"	.83516	76	15	91
9	"9-out18967"	.57692	60	44	104
9	"9-out18968"	.50000	39	39	78
9	"9-out18969"	.96186	454	18	472
9	"9-out18970"	.33333	25	50	75
9	"9-out18971"	.32081	205	434	639
9	"9-out18972"	.93693	312	21	333
9	"9-out18973"	.92910	498	38	536
9	"9-out18974"	.26859	130	354	484
9	"9-out18975"	.33333	92	184	276
9	"9-out18976"	.97323	400	11	411
9	"9-out18977"	.88306	219	29	248
9	"9-out18978"	.84415	130	24	154
9	"9-out18979"	.39795	195	295	490
9	"9-out18980"	.32365	156	326	482
9	"9-out18981"	.23557	49	159	208
9	"9-out18982"	.44444	92	115	207
9	"9-out18983"	.84102	164	31	195
9	"9-out18984"	.41346	86	122	208
9	"9-out18985"	.43666	262	338	600
9	"9-out18986"	.68452	115	53	168
9	"9-out18987"	.99115	112	1	113
9	"9-out18988"	.95280	323	16	339
9	"9-out18989"	.35920	449	801	1250
9	"9-out18990"	1.00000	107	0	107
9	"9-out18991"	.83177	178	36	214
9	"9-out18992"	.33015	866	1757	2623
9	"9-out18993"	.35987	113	201	314
9	"9-out18994"	.36792	117	201	318
9	"9-out18995"	.99324	147	1	148
9	"9-out18996"	.34609	226	427	653
9	"9-out18997"	.66412	87	44	131
9	"9-out18998"	.47186	260	291	551
9	"9-out18999"	.99555	224	1	225
9	"9-out19000"	.29827	156	367	523
9	"9-out19001"	.48660	109	115	224
9	"9-out19002"	.19303	305	1275	1580
9	"9-out19003"	.61020	263	168	431
9	"9-out19004"	.42397	237	322	559
9	"9-out19005"	.41392	214	303	517
9	"9-out19006"	.99236	130	1	131
9	"9-out19007"	.40163	49	73	122
9	"9-out19008"	.17692	23	107	130
9	"9-out19009"	.43707	448	577	1025
9	"9-out19010"	.32203	152	320	472
9	"9-out19011"	.99200	124	1	125
9	"9-out19012"	.99242	131	1	132
9	"9-out19013"	.99248	132	1	133
9	"9-out19014"	.97354	184	5	189
9	"9-out19015"	.97354	184	5	189
9	"9-out19016"	.98412	186	3	189
9	"9-out19017"	.98936	186	2	188
9	"9-out19018"	.97883	185	4	189
9	"9-out19019"	.33399	169	337	506
9	"9-out19020"	.80303	106	26	132
9	"9-out19021"	.39459	73	112	185
9	"9-out19022"	.37096	69	117	186
9	"9-out19023"	.28604	125	312	437
9	"9-out19024"	.27617	153	401	554
9	"9-out19025"	.33566	144	285	429
9	"9-out19026"	.64350	500	277	777
9	"9-out19027"	.25396	80	235	315
9	"9-out19028"	.99568	461	2	463
9	"9-out19029"	.28424	83	209	292
9	"9-out19030"	.18840	143	616	759
9	"9-out19031"	.99000	99	1	100
9	"9-out19032"	.40194	248	369	617
9	"9-out19033"	.99509	608	3	611
9	"9-out19034"	.30056	211	491	702
9	"9-out19035"	.94470	205	12	217
9	"9-out19036"	.15517	18	98	116
9	"9-out19037"	.30343	159	365	524
9	"9-out19038"	1.00000	428	0	428
9	"9-out19039"	.98113	104	2	106
9	"9-out19040"	.27732	170	443	613
9	"9-out19041"	.98936	93	1	94
9	"9-out19042"	.80055	289	72	361
9	"9-out19043"	.97549	398	10	408
9	"9-out19044"	.20825	111	422	533
9	"9-out19045"	.99145	116	1	117
9	"9-out19046"	.31121	197	436	633
9	"9-out19047"	.80975	166	39	205
9	"9-out19048"	.26923	49	133	182
9	"9-out19049"	.22666	34	116	150
9	"9-out19050"	.52941	90	80	170
9	"9-out19051"	.19419	361	1498	1859
9	"9-out19052"	.97058	66	2	68
9	"9-out19053"	.16067	76	397	473
9	"9-out19054"	.88235	60	8	68
9	"9-out19055"	.21681	98	354	452
9	"9-out19056"	.26451	123	342	465
9	"9-out19057"	.99421	172	1	173
9	"9-out19058"	.21316	149	550	699
9	"9-out19059"	.30690	240	542	782
9	"9-out19060"	.27109	196	527	723
9	"9-out19061"	.25800	129	371	500
9	"9-out19062"	.18471	29	128	157
9	"9-out19063"	.28310	186	471	657
9	"9-out19064"	.55084	130	106	236
9	"9-out19065"	.52238	315	288	603
9	"9-out19066"	.29769	220	519	739
9	"9-out19067"	.64229	896	499	1395
9	"9-out19068"	.26041	125	355	480
9	"9-out19069"	.86553	457	71	528
9	"9-out19070"	.88010	323	44	367
9	"9-out19071"	.25432	147	431	578
9	"9-out19072"	.65441	89	47	136
9	"9-out19073"	.23877	101	322	423
9	"9-out19074"	.17941	61	279	340
9	"9-out19075"	.47826	33	36	69
9	"9-out19076"	.60273	44	29	73
9	"9-out19077"	.28381	128	323	451
9	"9-out19078"	1.00000	17	0	17
9	"9-out19079"	.59517	222	151	373
9	"9-out19080"	.32620	244	504	748
9	"9-out19081"	.21615	182	660	842
9	"9-out19082"	.54388	316	265	581
9	"9-out19083"	.38569	302	481	783
9	"9-out19084"	.39580	585	893	1478
9	"9-out19085"	.99137	115	1	116
9	"9-out19086"	.99145	116	1	117
9	"9-out19087"	.30404	602	1378	1980
9	"9-out19088"	.81105	176	41	217
9	"9-out19089"	.28759	109	270	379
9	"9-out19090"	.34760	138	259	397
9	"9-out19091"	.37402	239	400	639
9	"9-out19092"	.50756	302	293	595
9	"9-out19093"	.29914	35	82	117
9	"9-out19094"	.96524	611	22	633
9	"9-out19095"	.43200	108	142	250
9	"9-out19096"	.20547	90	348	438
9	"9-out19097"	.29375	193	464	657
9	"9-out19098"	.32762	153	314	467
9	"9-out19099"	.13049	89	593	682
9	"9-out19100"	.99121	564	5	569
9	"9-out19101"	.34805	134	251	385
9	"9-out19102"	.65957	124	64	188
9	"9-out19103"	.99137	115	1	116
9	"9-out19104"	.24924	165	497	662
9	"9-out19105"	.79868	365	92	457
9	"9-out19106"	.87774	280	39	319
9	"9-out19107"	.62000	217	133	350
9	"9-out19108"	.26013	186	529	715
9	"9-out19109"	.30000	198	462	660
9	"9-out19110"	.36977	115	196	311
9	"9-out19111"	.99224	256	2	258
9	"9-out19112"	.81896	380	84	464
9	"9-out19113"	.21805	657	2356	3013
9	"9-out19114"	.25409	264	775	1039
9	"9-out19115"	.24964	534	1605	2139
9	"9-out19116"	.54927	719	590	1309
9	"9-out19117"	.99337	1798	12	1810
9	"9-out19118"	.82758	408	85	493
9	"9-out19119"	.21221	132	490	622
9	"9-out19120"	.30379	120	275	395
9	"9-out19121"	.98648	73	1	74
9	"9-out19122"	.99766	428	1	429
9	"9-out19123"	.99849	665	1	666
9	"9-out19124"	.34838	162	303	465
9	"9-out19125"	.33806	262	513	775
9	"9-out19126"	.50320	393	388	781
9	"9-out19127"	.35546	166	301	467
9	"9-out19128"	.31026	139	309	448
9	"9-out19129"	.99687	958	3	961
9	"9-out19130"	.15968	80	421	501
9	"9-out19131"	.99849	665	1	666
9	"9-out19132"	.20522	55	213	268
9	"9-out19133"	.23250	103	340	443
9	"9-out19134"	.51583	228	214	442
9	"9-out19135"	.34047	286	554	840
9	"9-out19136"	.66718	431	215	646
9	"9-out19137"	.38506	196	313	509
9	"9-out19138"	.27872	262	678	940
9	"9-out19139"	.10294	7	61	68
9	"9-out19140"	.77777	91	26	117
9	"9-out19141"	.14259	79	475	554
9	"9-out19142"	.84201	501	94	595
9	"9-out19143"	.20000	88	352	440
9	"9-out19144"	.22943	145	487	632
9	"9-out19145"	.15822	75	399	474
9	"9-out19146"	.23943	17	54	71
9	"9-out19147"	.99537	430	2	432
9	"9-out19148"	.99616	520	2	522
9	"9-out19149"	.99636	548	2	550
9	"9-out19150"	.27124	83	223	306
9	"9-out19151"	.44181	205	259	464
9	"9-out19152"	.49090	297	308	605
9	"9-out19153"	.99806	517	1	518
9	"9-out19154"	.99145	116	1	117
9	"9-out19155"	.40557	189	277	466
9	"9-out19156"	.67426	207	100	307
9	"9-out19157"	.38968	136	213	349
9	"9-out19158"	.41284	270	384	654
9	"9-out19159"	.29059	34	83	117
9	"9-out19160"	.97872	46	1	47
9	"9-out19161"	.99669	904	3	907
9	"9-out19162"	.88311	136	18	154
9	"9-out19163"	.26491	293	813	1106
9	"9-out19164"	.57180	215	161	376
9	"9-out19165"	.24258	188	587	775
9	"9-out19166"	.20408	50	195	245
9	"9-out19167"	.24475	35	108	143
9	"9-out19168"	.30405	135	309	444
9	"9-out19169"	.69874	334	144	478
9	"9-out19170"	.93121	176	13	189
9	"9-out19171"	.45481	156	187	343
9	"9-out19172"	.28693	134	333	467
9	"9-out19173"	.65587	162	85	247
9	"9-out19174"	.31100	130	288	418
9	"9-out19175"	.19341	94	392	486
9	"9-out19176"	.31098	167	370	537
9	"9-out19177"	.98750	79	1	80
9	"9-out19178"	.99280	138	1	139
9	"9-out19179"	.34183	134	258	392
9	"9-out19180"	.25764	118	340	458
9	"9-out19181"	.30666	23	52	75
9	"9-out19182"	.95093	562	29	591
9	"9-out19183"	.36743	176	303	479
9	"9-out19184"	.96394	615	23	638
9	"9-out19185"	.89743	105	12	117
9	"9-out19186"	.53443	194	169	363
9	"9-out19187"	.18699	92	400	492
9	"9-out19188"	.41501	210	296	506
9	"9-out19189"	.29625	269	639	908
9	"9-out19190"	.44479	141	176	317
9	"9-out19191"	.99719	355	1	356
9	"9-out19192"	.27061	105	283	388
9	"9-out19193"	.51108	530	507	1037
9	"9-out19194"	.98991	5008	51	5059
9	"9-out19195"	.20945	186	702	888
9	"9-out19196"	.65000	273	147	420
9	"9-out19197"	.44657	326	404	730
9	"9-out19198"	.37937	206	337	543
9	"9-out19199"	.14383	21	125	146
9	"9-out19200"	.29137	250	608	858
9	"9-out19201"	.20435	75	292	367
9	"9-out19202"	.95355	698	34	732
9	"9-out19203"	.32727	108	222	330
9	"9-out19204"	.47942	233	253	486
9	"9-out19205"	.33483	149	296	445
9	"9-out19206"	.27642	170	445	615
9	"9-out19207"	.99295	141	1	142
9	"9-out19208"	.99743	389	1	390
9	"9-out19209"	.40508	271	398	669
9	"9-out19210"	.80569	311	75	386
9	"9-out19211"	.19588	238	977	1215
9	"9-out19212"	.07739	25	298	323
9	"9-out19213"	.17771	67	310	377
9	"9-out19214"	.11111	7	56	63
9	"9-out19215"	.24495	85	262	347
9	"9-out19216"	.22484	1267	4368	5635
9	"9-out19217"	.47307	246	274	520
9	"9-out19218"	.58928	231	161	392
9	"9-out19219"	.95698	89	4	93
9	"9-out19220"	.31468	90	196	286
9	"9-out19221"	.24365	192	596	788
9	"9-out19222"	.44782	103	127	230
9	"9-out19223"	.94629	740	42	782
9	"9-out19224"	.64640	468	256	724
9	"9-out19225"	.38000	95	155	250
9	"9-out19226"	.40467	225	331	556
9	"9-out19227"	.46778	472	537	1009
9	"9-out19228"	.20476	86	334	420
9	"9-out19229"	.33898	120	234	354
9	"9-out19230"	.80172	279	69	348
9	"9-out19231"	.34313	140	268	408
9	"9-out19232"	.27526	128	337	465
9	"9-out19233"	.95833	23	1	24
9	"9-out19234"	.76666	69	21	90
9	"9-out19235"	.36813	268	460	728
9	"9-out19236"	.30116	181	420	601
9	"9-out19237"	.23141	137	455	592
9	"9-out19238"	.21406	70	257	327
9	"9-out19239"	.28338	87	220	307
9	"9-out19240"	.98272	455	8	463
9	"9-out19241"	.70212	198	84	282
9	"9-out19242"	.52338	235	214	449
9	"9-out19243"	.46788	102	116	218
9	"9-out19244"	.33846	132	258	390
9	"9-out19245"	.85802	139	23	162
9	"9-out19246"	.25000	41	123	164
9	"9-out19247"	.79729	59	15	74
9	"9-out19248"	.40851	96	139	235
9	"9-out19249"	.19382	69	287	356
9	"9-out19250"	.37325	134	225	359
9	"9-out19251"	.36404	162	283	445
9	"9-out19252"	.79477	426	110	536
9	"9-out19253"	.36991	182	310	492
9	"9-out19254"	.13725	7	44	51
9	"9-out19255"	.46153	120	140	260
9	"9-out19256"	.32000	80	170	250
9	"9-out19257"	.99145	116	1	117
9	"9-out19258"	.23007	127	425	552
9	"9-out19259"	.99159	118	1	119
9	"9-out19260"	.33703	91	179	270
9	"9-out19261"	.54573	179	149	328
9	"9-out19262"	.99145	116	1	117
9	"9-out19263"	.42198	119	163	282
9	"9-out19264"	.99130	114	1	115
9	"9-out19265"	.27378	164	435	599
9	"9-out19266"	.42890	181	241	422
9	"9-out19267"	.43238	275	361	636
9	"9-out19268"	.44307	144	181	325
9	"9-out19269"	.17550	96	451	547
9	"9-out19270"	.99275	137	1	138
9	"9-out19271"	.33753	107	210	317
9	"9-out19272"	.22440	114	394	508
9	"9-out19273"	.48348	161	172	333
9	"9-out19274"	.78028	277	78	355
9	"9-out19275"	.24705	126	384	510
9	"9-out19276"	.11805	34	254	288
9	"9-out19277"	.58651	200	141	341
9	"9-out19278"	.37084	201	341	542
9	"9-out19279"	.31388	113	247	360
9	"9-out19280"	.86813	79	12	91
9	"9-out19281"	.25629	173	502	675
9	"9-out19282"	.34693	238	448	686
9	"9-out19283"	.96793	332	11	343
9	"9-out19284"	.34649	158	298	456
9	"9-out19285"	.45925	62	73	135
9	"9-out19286"	.39754	194	294	488
9	"9-out19287"	.40336	144	213	357
9	"9-out19288"	.95833	23	1	24
9	"9-out19289"	.83333	20	4	24
9	"9-out19290"	.95833	23	1	24
9	"9-out19291"	.80808	80	19	99
9	"9-out19292"	.93548	551	38	589
9	"9-out19293"	.82504	514	109	623
9	"9-out19294"	.41304	57	81	138
9	"9-out19295"	.77682	181	52	233
9	"9-out19296"	.64792	219	119	338
9	"9-out19297"	.99145	116	1	117
9	"9-out19298"	.99152	117	1	118
9	"9-out19299"	.28125	63	161	224
9	"9-out19300"	.21428	123	451	574
9	"9-out19301"	.15765	35	187	222
9	"9-out19302"	.36889	204	349	553
9	"9-out19303"	.71726	241	95	336
9	"9-out19304"	.99145	116	1	117
9	"9-out19305"	.41379	144	204	348
9	"9-out19306"	.45574	654	781	1435
9	"9-out19307"	.89099	188	23	211
9	"9-out19308"	.20802	83	316	399
9	"9-out19309"	.32808	271	555	826
9	"9-out19310"	.99295	141	1	142
9	"9-out19311"	.20000	66	264	330
9	"9-out19312"	.99801	503	1	504
9	"9-out19313"	.20000	27	108	135
9	"9-out19314"	.44814	121	149	270
9	"9-out19315"	.53061	52	46	98
9	"9-out19316"	.34576	102	193	295
9	"9-out19317"	.36756	136	234	370
9	"9-out19318"	.38418	136	218	354
9	"9-out19319"	.32089	129	273	402
9	"9-out19320"	.95833	23	1	24
9	"9-out19321"	.79166	19	5	24
9	"9-out19322"	.28424	83	209	292
9	"9-out19323"	.98634	289	4	293
9	"9-out19324"	.98634	289	4	293
9	"9-out19325"	.26265	83	233	316
9	"9-out19326"	.43433	668	870	1538
9	"9-out19327"	.23295	270	889	1159
9	"9-out19328"	.33092	183	370	553
9	"9-out19329"	.17514	62	292	354
9	"9-out19330"	.44857	314	386	700
9	"9-out19331"	.99913	1157	1	1158
9	"9-out19332"	.60000	69	46	115
9	"9-out19333"	.47682	360	395	755
9	"9-out19334"	.26041	25	71	96
9	"9-out19335"	.14503	19	112	131
9	"9-out19336"	.35211	150	276	426
9	"9-out19337"	.23943	68	216	284
9	"9-out19338"	.99159	118	1	119
9	"9-out19339"	.99159	118	1	119
9	"9-out19340"	.40751	141	205	346
9	"9-out19341"	.98275	57	1	58
9	"9-out19342"	.99145	116	1	117
9	"9-out19343"	.99152	117	1	118
9	"9-out19344"	.23056	86	287	373
9	"9-out19345"	.25328	77	227	304
9	"9-out19346"	.85000	85	15	100
9	"9-out19347"	.29639	107	254	361
9	"9-out19348"	.62222	56	34	90
9	"9-out19349"	.23159	129	428	557
9	"9-out19350"	.32797	245	502	747
9	"9-out19351"	.22641	84	287	371
9	"9-out19352"	.82487	325	69	394
9	"9-out19353"	.90751	314	32	346
9	"9-out19354"	.46632	90	103	193
9	"9-out19355"	.30653	61	138	199
9	"9-out19356"	.99551	222	1	223
9	"9-out19357"	.42652	119	160	279
9	"9-out19358"	.99700	333	1	334
9	"9-out19359"	.30800	150	337	487
9	"9-out19360"	.71282	278	112	390
9	"9-out19361"	.69578	446	195	641
9	"9-out19362"	.47425	304	337	641
9	"9-out19363"	.84210	64	12	76
9	"9-out19364"	.37996	201	328	529
9	"9-out19365"	.19461	65	269	334
9	"9-out19366"	.98498	328	5	333
9	"9-out19367"	.98293	288	5	293
9	"9-out19368"	.98634	289	4	293
9	"9-out19369"	.56347	253	196	449
9	"9-out19370"	.38439	133	213	346
9	"9-out19371"	.37473	175	292	467
9	"9-out19372"	.68562	434	199	633
9	"9-out19373"	.99442	357	2	359
9	"9-out19374"	.14659	28	163	191
9	"9-out19375"	.38860	75	118	193
9	"9-out19376"	.34887	247	461	708
9	"9-out19377"	.98325	411	7	418
9	"9-out19378"	.27745	96	250	346
9	"9-out19379"	.88304	302	40	342
9	"9-out19380"	.86453	351	55	406
9	"9-out19381"	.32550	194	402	596
9	"9-out19382"	.95833	23	1	24
9	"9-out19383"	.71250	57	23	80
9	"9-out19384"	.23741	66	212	278
9	"9-out19385"	.28571	80	200	280
9	"9-out19386"	.99152	117	1	118
9	"9-out19387"	.99145	116	1	117
9	"9-out19388"	.24705	63	192	255
9	"9-out19389"	.39347	205	316	521
9	"9-out19390"	.21993	203	720	923
9	"9-out19391"	.22857	56	189	245
9	"9-out19392"	.30038	310	722	1032
9	"9-out19393"	.29088	530	1292	1822
9	"9-out19394"	.22022	257	910	1167
9	"9-out19395"	.27784	222	577	799
9	"9-out19396"	.22431	179	619	798
9	"9-out19397"	.33205	345	694	1039
9	"9-out19398"	.32702	432	889	1321
9	"9-out19399"	.27868	51	132	183
9	"9-out19400"	.32388	320	668	988
9	"9-out19401"	.26394	246	686	932
9	"9-out19402"	.27323	147	391	538
9	"9-out19403"	.34389	76	145	221
9	"9-out19404"	.40515	173	254	427
9	"9-out19405"	.48091	189	204	393
9	"9-out19406"	.28440	155	390	545
9	"9-out19407"	.22832	108	365	473
9	"9-out19408"	.29244	794	1921	2715
9	"9-out19409"	.41987	2062	2849	4911
9	"9-out19410"	.28733	1591	3946	5537
9	"9-out19411"	.87336	400	58	458
9	"9-out19412"	.29230	361	874	1235
9	"9-out19413"	.22619	152	520	672
9	"9-out19414"	.21981	162	575	737
9	"9-out19415"	.22857	88	297	385
9	"9-out19416"	.82109	436	95	531
9	"9-out19417"	.99375	159	1	160
9	"9-out19418"	.32116	44	93	137
9	"9-out19419"	.75308	61	20	81
9	"9-out19420"	.71428	60	24	84
9	"9-out19421"	.84126	53	10	63
9	"9-out19422"	.91134	257	25	282
9	"9-out19423"	.85098	217	38	255
9	"9-out19424"	.88687	196	25	221
9	"9-out19425"	.96923	189	6	195
9	"9-out19426"	.90547	182	19	201
9	"9-out19427"	.98019	198	4	202
9	"9-out19428"	.97435	152	4	156
9	"9-out19429"	.89411	228	27	255
9	"9-out19430"	.90960	161	16	177
9	"9-out19431"	.70833	68	28	96
9	"9-out19432"	.81250	91	21	112
9	"9-out19433"	.95348	164	8	172
9	"9-out19434"	.93877	92	6	98
9	"9-out19435"	.94897	93	5	98
9	"9-out19436"	.90441	123	13	136
9	"9-out19437"	.81538	159	36	195
9	"9-out19438"	.87951	146	20	166
9	"9-out19439"	.92265	167	14	181
9	"9-out19440"	.92195	189	16	205
9	"9-out19441"	.94761	199	11	210
9	"9-out19442"	.94594	175	10	185
9	"9-out19443"	.92857	195	15	210
9	"9-out19444"	.88489	246	32	278
9	"9-out19445"	.96624	229	8	237
9	"9-out19446"	.91472	118	11	129
9	"9-out19447"	.96969	160	5	165
9	"9-out19448"	.96791	181	6	187
9	"9-out19449"	.99408	168	1	169
9	"9-out19450"	.84507	60	11	71
9	"9-out19451"	.77419	48	14	62
9	"9-out19452"	.84466	87	16	103
9	"9-out19453"	.72800	182	68	250
9	"9-out19454"	.96551	168	6	174
9	"9-out19455"	.92452	147	12	159
9	"9-out19456"	.96753	149	5	154
9	"9-out19457"	.92500	148	12	160
9	"9-out19458"	.91715	155	14	169
9	"9-out19459"	.98742	157	2	159
9	"9-out19460"	.24312	115	358	473
9	"9-out19461"	.42427	437	593	1030
9	"9-out19462"	.39843	51	77	128
9	"9-out19463"	.90643	155	16	171
9	"9-out19464"	.62197	283	172	455
9	"9-out19465"	.91091	409	40	449
9	"9-out19466"	.86403	394	62	456
9	"9-out19467"	.79513	392	101	493
9	"9-out19468"	.20327	149	584	733
9	"9-out19469"	.96533	891	32	923
9	"9-out19470"	.31263	297	653	950
9	"9-out19471"	.21369	103	379	482
9	"9-out19472"	.23264	248	818	1066
9	"9-out19473"	.52195	214	196	410
9	"9-out19474"	.87376	353	51	404
9	"9-out19475"	.45588	62	74	136
9	"9-out19476"	.98113	52	1	53
9	"9-out19477"	.99236	130	1	131
9	"9-out19478"	.99407	1007	6	1013
9	"9-out19479"	.82051	64	14	78
9	"9-out19480"	.90308	205	22	227
9	"9-out19481"	.22153	249	875	1124
9	"9-out19482"	.98433	377	6	383
9	"9-out19483"	.25840	123	353	476
9	"9-out19484"	.53773	285	245	530
9	"9-out19485"	.62393	292	176	468
9	"9-out19486"	.99402	832	5	837
9	"9-out19487"	.45010	221	270	491
9	"9-out19488"	.25978	418	1191	1609
9	"9-out19489"	.34923	615	1146	1761
9	"9-out19490"	.21626	258	935	1193
9	"9-out19491"	.34095	537	1038	1575
9	"9-out19492"	.57857	243	177	420
9	"9-out19493"	.78233	248	69	317
9	"9-out19494"	.88283	648	86	734
9	"9-out19495"	.25398	287	843	1130
9	"9-out19496"	.49236	129	133	262
9	"9-out19497"	.96323	393	15	408
9	"9-out19498"	.41176	287	410	697
9	"9-out19499"	.28975	297	728	1025
9	"9-out19500"	.40596	531	777	1308
9	"9-out19501"	.22453	108	373	481
9	"9-out19502"	.88135	104	14	118
9	"9-out19503"	.87288	103	15	118
9	"9-out19504"	.41721	63	88	151
9	"9-out19505"	.24302	209	651	860
9	"9-out19506"	.47292	131	146	277
9	"9-out19507"	.20258	47	185	232
9	"9-out19508"	.45514	208	249	457
9	"9-out19509"	.26002	201	572	773
9	"9-out19510"	.20903	37	140	177
9	"9-out19511"	.26180	194	547	741
9	"9-out19512"	.26800	789	2155	2944
9	"9-out19513"	.26571	224	619	843
9	"9-out19514"	.24462	182	562	744
9	"9-out19515"	.31678	185	399	584
9	"9-out19516"	.23267	47	155	202
9	"9-out19517"	.26384	243	678	921
9	"9-out19518"	.40203	277	412	689
9	"9-out19519"	.28082	41	105	146
9	"9-out19520"	.29885	26	61	87
9	"9-out19521"	.53963	177	151	328
9	"9-out19522"	.28719	83	206	289
9	"9-out19523"	.97872	92	2	94
9	"9-out19524"	.64285	1116	620	1736
9	"9-out19525"	.37043	446	758	1204
9	"9-out19526"	.64319	137	76	213
9	"9-out19527"	.33456	544	1082	1626
9	"9-out19528"	.08421	16	174	190
9	"9-out19529"	.34170	68	131	199
9	"9-out19530"	.29743	58	137	195
9	"9-out19531"	.69849	139	60	199
9	"9-out19532"	.76339	171	53	224
9	"9-out19533"	.17098	33	160	193
9	"9-out19534"	.28282	56	142	198
9	"9-out19535"	.33608	163	322	485
9	"9-out19536"	.21100	69	258	327
9	"9-out19537"	.34969	57	106	163
9	"9-out19538"	.53142	93	82	175
9	"9-out19539"	.22689	27	92	119
9	"9-out19540"	.41296	223	317	540
9	"9-out19541"	.34947	599	1115	1714
9	"9-out19542"	.36663	334	577	911
9	"9-out19543"	.72777	532	199	731
9	"9-out19544"	.66163	219	112	331
9	"9-out19545"	.42000	210	290	500
9	"9-out19546"	.39759	198	300	498
9	"9-out19547"	.23809	90	288	378
9	"9-out19548"	.26777	113	309	422
9	"9-out19549"	.25661	97	281	378
9	"9-out19550"	.20322	63	247	310
9	"9-out19551"	.99392	327	2	329
9	"9-out19552"	.18386	98	435	533
9	"9-out19553"	.35689	202	364	566
9	"9-out19554"	.32765	327	671	998
9	"9-out19555"	.83734	870	169	1039
9	"9-out19556"	.41206	164	234	398
9	"9-out19557"	.24675	76	232	308
9	"9-out19558"	.43888	79	101	180
9	"9-out19559"	.99047	104	1	105
9	"9-out19560"	.99694	326	1	327
9	"9-out19561"	.23776	34	109	143
9	"9-out19562"	.24903	129	389	518
9	"9-out19563"	.27659	91	238	329
9	"9-out19564"	.98015	247	5	252
9	"9-out19565"	.24367	77	239	316
9	"9-out19566"	.15968	80	421	501
9	"9-out19567"	.26792	71	194	265
9	"9-out19568"	.19304	111	464	575
9	"9-out19569"	.26449	146	406	552
9	"9-out19570"	.27777	130	338	468
9	"9-out19571"	.24423	53	164	217
9	"9-out19572"	.38953	67	105	172
9	"9-out19573"	.42038	330	455	785
9	"9-out19574"	.61825	149	92	241
9	"9-out19575"	.33962	108	210	318
9	"9-out19576"	.27648	107	280	387
9	"9-out19577"	.25448	71	208	279
9	"9-out19578"	.21267	104	385	489
9	"9-out19579"	.18095	95	430	525
9	"9-out19580"	.29301	545	1315	1860
9	"9-out19581"	.67400	153	74	227
9	"9-out19582"	.40938	637	919	1556
9	"9-out19583"	.18723	135	586	721
9	"9-out19584"	.91630	427	39	466
9	"9-out19585"	.92944	382	29	411
9	"9-out19586"	.19772	139	564	703
9	"9-out19587"	.49077	133	138	271
9	"9-out19588"	.24861	45	136	181
9	"9-out19589"	.23791	123	394	517
9	"9-out19590"	.40866	792	1146	1938
9	"9-out19591"	.48743	194	204	398
9	"9-out19592"	.24235	111	347	458
9	"9-out19593"	.99173	120	1	121
9	"9-out19594"	.98461	128	2	130
9	"9-out19595"	.23830	107	342	449
9	"9-out19596"	.53035	166	147	313
9	"9-out19597"	.84162	186	35	221
9	"9-out19598"	.49238	97	100	197
9	"9-out19599"	.55440	107	86	193
9	"9-out19600"	.42857	42	56	98
9	"9-out19601"	.99540	433	2	435
9	"9-out19602"	.20537	344	1331	1675
9	"9-out19603"	.15914	261	1379	1640
9	"9-out19604"	.43344	254	332	586
9	"9-out19605"	.86639	214	33	247
9	"9-out19606"	.75494	191	62	253
9	"9-out19607"	.34770	500	938	1438
9	"9-out19608"	.24680	135	412	547
9	"9-out19609"	.70247	85	36	121
9	"9-out19610"	.51219	105	100	205
9	"9-out19611"	.66071	148	76	224
9	"9-out19612"	.25174	72	214	286
9	"9-out19613"	.35224	298	548	846
9	"9-out19614"	.28122	412	1053	1465
9	"9-out19615"	.26588	113	312	425
9	"9-out19616"	.18926	67	287	354
9	"9-out19617"	.26605	87	240	327
9	"9-out19618"	.26470	90	250	340
9	"9-out19619"	.99390	163	1	164
9	"9-out19620"	.99692	324	1	325
9	"9-out19621"	.99528	211	1	212
9	"9-out19622"	.45179	239	290	529
9	"9-out19623"	.36842	119	204	323
9	"9-out19624"	.48106	216	233	449
9	"9-out19625"	.40839	107	155	262
9	"9-out19626"	.26227	219	616	835
9	"9-out19627"	.39714	1616	2453	4069
9	"9-out19628"	.42142	59	81	140
9	"9-out19629"	.98795	82	1	83
9	"9-out19630"	.96296	52	2	54
9	"9-out19631"	.99324	147	1	148
9	"9-out19632"	.47500	76	84	160
9	"9-out19633"	.29588	266	633	899
9	"9-out19634"	.33532	112	222	334
9	"9-out19635"	.89320	276	33	309
9	"9-out19636"	.24800	217	658	875
9	"9-out19637"	.54879	388	319	707
9	"9-out19638"	.36155	269	475	744
9	"9-out19639"	.36470	186	324	510
9	"9-out19640"	.52173	48	44	92
9	"9-out19641"	.14830	70	402	472
9	"9-out19642"	.37777	136	224	360
9	"9-out19643"	.19351	197	821	1018
9	"9-out19644"	.36636	403	697	1100
9	"9-out19645"	.22915	305	1026	1331
9	"9-out19646"	.98936	93	1	94
9	"9-out19647"	.44382	79	99	178
9	"9-out19648"	.41356	433	614	1047
9	"9-out19649"	.69281	106	47	153
9	"9-out19650"	.29893	84	197	281
9	"9-out19651"	.46368	83	96	179
9	"9-out19652"	.22404	41	142	183
9	"9-out19653"	.46583	75	86	161
9	"9-out19654"	.28000	49	126	175
9	"9-out19655"	.99173	120	1	121
9	"9-out19656"	.28415	416	1048	1464
9	"9-out19657"	.28984	431	1056	1487
9	"9-out19658"	.74924	1246	417	1663
9	"9-out19659"	.31336	523	1146	1669
9	"9-out19660"	.26869	460	1252	1712
9	"9-out19661"	.27952	471	1214	1685
9	"9-out19662"	.99770	1740	4	1744
9	"9-out19663"	.99770	1740	4	1744
9	"9-out19664"	.25283	379	1120	1499
9	"9-out19665"	.18579	191	837	1028
9	"9-out19666"	.17958	183	836	1019
9	"9-out19667"	.22978	520	1743	2263
9	"9-out19668"	.35331	330	604	934
9	"9-out19669"	.45519	320	383	703
9	"9-out19670"	.29103	172	419	591
9	"9-out19671"	.32017	219	465	684
9	"9-out19672"	.42933	240	319	559
9	"9-out19673"	.22641	24	82	106
9	"9-out19674"	.70270	52	22	74
9	"9-out19675"	.64800	81	44	125
9	"9-out19676"	.29870	69	162	231
9	"9-out19677"	.29852	203	477	680
9	"9-out19678"	.32945	595	1211	1806
9	"9-out19679"	.44726	564	697	1261
9	"9-out19680"	.32777	452	927	1379
9	"9-out19681"	.30585	256	581	837
9	"9-out19682"	.25839	500	1435	1935
9	"9-out19683"	.31467	832	1812	2644
9	"9-out19684"	.21849	241	862	1103
9	"9-out19685"	.26000	247	703	950
9	"9-out19686"	.30684	336	759	1095
9	"9-out19687"	.33802	408	799	1207
9	"9-out19688"	.23789	113	362	475
9	"9-out19689"	.99255	1067	8	1075
9	"9-out19690"	.29729	44	104	148
9	"9-out19691"	.38348	130	209	339
9	"9-out19692"	.47338	169	188	357
9	"9-out19693"	.84863	342	61	403
9	"9-out19694"	.83430	287	57	344
9	"9-out19695"	.27913	855	2208	3063
9	"9-out19696"	.33454	184	366	550
9	"9-out19697"	.28451	204	513	717
9	"9-out19698"	.25410	232	681	913
9	"9-out19699"	.18554	95	417	512
9	"9-out19700"	.16751	99	492	591
9	"9-out19701"	.21217	122	453	575
9	"9-out19702"	.79518	132	34	166
9	"9-out19703"	.44041	85	108	193
9	"9-out19704"	.43373	72	94	166
9	"9-out19705"	.30979	430	958	1388
9	"9-out19706"	.24080	203	640	843
9	"9-out19707"	.21875	98	350	448
9	"9-out19708"	.99782	459	1	460
9	"9-out19709"	.22292	175	610	785
9	"9-out19710"	.18387	130	577	707
9	"9-out19711"	.16143	108	561	669
9	"9-out19712"	.59459	132	90	222
9	"9-out19713"	.61386	62	39	101
9	"9-out19714"	.23608	106	343	449
9	"9-out19715"	.38502	504	805	1309
9	"9-out19716"	.46953	131	148	279
9	"9-out19717"	.22046	265	937	1202
9	"9-out19718"	.34155	263	507	770
9	"9-out19719"	.23791	128	410	538
9	"9-out19720"	.99145	116	1	117
9	"9-out19721"	.36000	45	80	125
9	"9-out19722"	.81147	99	23	122
9	"9-out19723"	.48765	158	166	324
9	"9-out19724"	.13539	57	364	421
9	"9-out19725"	.40596	177	259	436
9	"9-out19726"	.18229	105	471	576
9	"9-out19727"	.62167	631	384	1015
9	"9-out19728"	.24032	360	1138	1498
9	"9-out19729"	.26627	135	372	507
9	"9-out19730"	.35651	446	805	1251
9	"9-out19731"	.36959	299	510	809
9	"9-out19732"	.45833	66	78	144
9	"9-out19733"	.21250	34	126	160
9	"9-out19734"	.69784	97	42	139
9	"9-out19735"	.40729	134	195	329
9	"9-out19736"	.39537	376	575	951
9	"9-out19737"	.35096	272	503	775
9	"9-out19738"	.18148	98	442	540
9	"9-out19739"	.37848	285	468	753
9	"9-out19740"	.35714	60	108	168
9	"9-out19741"	.39010	71	111	182
9	"9-out19742"	.39928	111	167	278
9	"9-out19743"	.41517	301	424	725
9	"9-out19744"	.94565	1218	70	1288
9	"9-out19745"	.25486	262	766	1028
9	"9-out19746"	.94409	1216	72	1288
9	"9-out19747"	.37003	484	824	1308
9	"9-out19748"	.25267	330	976	1306
9	"9-out19749"	.38623	898	1427	2325
9	"9-out19750"	.46496	73	84	157
9	"9-out19751"	.26647	364	1002	1366
9	"9-out19752"	.27285	400	1066	1466
9	"9-out19753"	.80201	239	59	298
9	"9-out19754"	.98214	55	1	56
9	"9-out19755"	.47058	96	108	204
9	"9-out19756"	.22695	128	436	564
9	"9-out19757"	.56603	90	69	159
9	"9-out19758"	.35903	284	507	791
9	"9-out19759"	.38324	732	1178	1910
9	"9-out19760"	.31874	386	825	1211
9	"9-out19761"	.53571	1335	1157	2492
9	"9-out19762"	.22688	211	719	930
9	"9-out19763"	.29924	477	1117	1594
9	"9-out19764"	.99779	453	1	454
9	"9-out19765"	.29681	363	860	1223
9	"9-out19766"	.23774	291	933	1224
9	"9-out19767"	.26577	257	710	967
9	"9-out19768"	.29753	205	484	689
9	"9-out19769"	.30184	246	569	815
9	"9-out19770"	.98750	79	1	80
9	"9-out19771"	.49859	177	178	355
9	"9-out19772"	.82825	299	62	361
9	"9-out19773"	.28802	89	220	309
9	"9-out19774"	.36219	456	803	1259
9	"9-out19775"	.24297	199	620	819
9	"9-out19776"	.29832	196	461	657
9	"9-out19777"	.29110	216	526	742
9	"9-out19778"	.16233	25	129	154
9	"9-out19779"	.61983	75	46	121
9	"9-out19780"	.32307	147	308	455
9	"9-out19781"	.49107	55	57	112
9	"9-out19782"	.18454	43	190	233
9	"9-out19783"	.62352	53	32	85
9	"9-out19784"	.41000	82	118	200
9	"9-out19785"	.57923	106	77	183
9	"9-out19786"	.29292	58	140	198
9	"9-out19787"	.41089	83	119	202
9	"9-out19788"	.41237	80	114	194
9	"9-out19789"	.97305	325	9	334
9	"9-out19790"	.21664	164	593	757
9	"9-out19791"	.23247	63	208	271
9	"9-out19792"	.29572	367	874	1241
9	"9-out19793"	.32711	403	829	1232
9	"9-out19794"	.28687	282	701	983
9	"9-out19795"	.60689	88	57	145
9	"9-out19796"	.29640	99	235	334
9	"9-out19797"	.38390	124	199	323
9	"9-out19798"	.20795	136	518	654
9	"9-out19799"	.94626	317	18	335
9	"9-out19800"	.25408	311	913	1224
9	"9-out19801"	.45591	181	216	397
9	"9-out19802"	.42382	153	208	361
9	"9-out19803"	.18518	70	308	378
9	"9-out19804"	.22085	72	254	326
9	"9-out19805"	.19354	72	300	372
9	"9-out19806"	.41142	72	103	175
9	"9-out19807"	.20865	82	311	393
9	"9-out19808"	.29941	103	241	344
9	"9-out19809"	.18848	72	310	382
9	"9-out19810"	.52631	200	180	380
9	"9-out19811"	.34770	129	242	371
9	"9-out19812"	.78336	358	99	457
9	"9-out19813"	.42222	38	52	90
9	"9-out19814"	.22818	102	345	447
9	"9-out19815"	.66086	228	117	345
9	"9-out19816"	.34628	392	740	1132
9	"9-out19817"	.25021	297	890	1187
9	"9-out19818"	.56991	1504	1135	2639
9	"9-out19819"	.99743	778	2	780
9	"9-out19820"	.37195	183	309	492
9	"9-out19821"	.32921	213	434	647
9	"9-out19822"	.75609	186	60	246
9	"9-out19823"	.43307	110	144	254
9	"9-out19824"	.26160	124	350	474
9	"9-out19825"	.27012	104	281	385
9	"9-out19826"	.32771	486	997	1483
9	"9-out19827"	.49606	63	64	127
9	"9-out19828"	.44511	965	1203	2168
9	"9-out19829"	.20800	26	99	125
9	"9-out19830"	.30563	217	493	710
9	"9-out19831"	.31355	148	324	472
9	"9-out19832"	.35977	313	557	870
9	"9-out19833"	.24143	141	443	584
9	"9-out19834"	.40212	189	281	470
9	"9-out19835"	.39122	214	333	547
9	"9-out19836"	.41445	390	551	941
9	"9-out19837"	.69572	1221	534	1755
9	"9-out19838"	.44273	201	253	454
9	"9-out19839"	.23654	167	539	706
9	"9-out19840"	.95000	95	5	100
9	"9-out19841"	.36624	549	950	1499
9	"9-out19842"	.22159	316	1110	1426
9	"9-out19843"	.33819	116	227	343
9	"9-out19844"	.60060	1576	1048	2624
9	"9-out19845"	.33389	198	395	593
9	"9-out19846"	.55029	93	76	169
9	"9-out19847"	.45878	128	151	279
9	"9-out19848"	.40269	209	310	519
9	"9-out19849"	.25470	149	436	585
9	"9-out19850"	.19161	128	540	668
9	"9-out19851"	.80000	120	30	150
9	"9-out19852"	.76000	57	18	75
9	"9-out19853"	.85000	68	12	80
9	"9-out19854"	.94339	100	6	106
9	"9-out19855"	.57971	40	29	69
9	"9-out19856"	.91200	114	11	125
9	"9-out19857"	.68468	76	35	111
9	"9-out19858"	.64166	77	43	120
9	"9-out19859"	.98198	109	2	111
9	"9-out19860"	.27111	122	328	450
9	"9-out19861"	.31729	211	454	665
9	"9-out19862"	.55180	229	186	415
9	"9-out19863"	.28064	190	487	677
9	"9-out19864"	.99152	351	3	354
9	"9-out19865"	.97989	390	8	398
9	"9-out19866"	.56637	128	98	226
9	"9-out19867"	.29694	68	161	229
9	"9-out19868"	.23033	82	274	356
9	"9-out19869"	.36461	136	237	373
9	"9-out19870"	.92698	292	23	315
9	"9-out19871"	.66250	106	54	160
9	"9-out19872"	.27607	45	118	163
9	"9-out19873"	.71559	234	93	327
9	"9-out19874"	.11764	22	165	187
9	"9-out19875"	.99543	218	1	219
9	"9-out19876"	.66806	159	79	238
9	"9-out19877"	.27351	157	417	574
9	"9-out19878"	.25422	301	883	1184
9	"9-out19879"	.36320	77	135	212
9	"9-out19880"	.41604	166	233	399
9	"9-out19881"	.18262	124	555	679
9	"9-out19882"	.15094	16	90	106
9	"9-out19883"	.31077	225	499	724
9	"9-out19884"	.16260	120	618	738
9	"9-out19885"	.34106	147	284	431
9	"9-out19886"	.98958	95	1	96
9	"9-out19887"	.25317	339	1000	1339
9	"9-out19888"	.29547	424	1011	1435
9	"9-out19889"	.16225	184	950	1134
9	"9-out19890"	.32540	383	794	1177
9	"9-out19891"	.43789	208	267	475
9	"9-out19892"	.14534	175	1029	1204
9	"9-out19893"	.33389	394	786	1180
9	"9-out19894"	.41598	510	716	1226
9	"9-out19895"	.28010	335	861	1196
9	"9-out19896"	.20836	259	984	1243
9	"9-out19897"	.86021	240	39	279
9	"9-out19898"	.54929	78	64	142
9	"9-out19899"	.32288	278	583	861
9	"9-out19900"	.26315	25	70	95
9	"9-out19901"	.28444	128	322	450
9	"9-out19902"	.31958	372	792	1164
9	"9-out19903"	.50709	143	139	282
9	"9-out19904"	.17520	65	306	371
9	"9-out19905"	.29253	196	474	670
9	"9-out19906"	.27149	281	754	1035
9	"9-out19907"	.15120	44	247	291
9	"9-out19908"	.34934	80	149	229
9	"9-out19909"	.82666	186	39	225
9	"9-out19910"	.40789	403	585	988
9	"9-out19911"	.87378	90	13	103
9	"9-out19912"	.37763	287	473	760
9	"9-out19913"	.22236	179	626	805
9	"9-out19914"	.34728	83	156	239
9	"9-out19915"	.24122	55	173	228
9	"9-out19916"	.24017	55	174	229
9	"9-out19917"	.99065	212	2	214
9	"9-out19918"	.22529	57	196	253
9	"9-out19919"	.99557	225	1	226
9	"9-out19920"	.26652	129	355	484
9	"9-out19921"	.17463	84	397	481
9	"9-out19922"	.42758	124	166	290
9	"9-out19923"	.42786	86	115	201
9	"9-out19924"	.42178	151	207	358
9	"9-out19925"	.32242	138	290	428
9	"9-out19926"	.30111	162	376	538
9	"9-out19927"	.21298	223	824	1047
9	"9-out19928"	.98529	67	1	68
9	"9-out19929"	.34482	80	152	232
9	"9-out19930"	.40179	538	801	1339
9	"9-out19931"	.35260	122	224	346
9	"9-out19932"	.36077	149	264	413
9	"9-out19933"	.33047	154	312	466
9	"9-out19934"	.99319	146	1	147
9	"9-out19935"	.31174	77	170	247
9	"9-out19936"	.94638	353	20	373
9	"9-out19937"	.24745	414	1259	1673
9	"9-out19938"	.38323	64	103	167
9	"9-out19939"	.30000	93	217	310
9	"9-out19940"	.99047	104	1	105
9	"9-out19941"	.07407	6	75	81
9	"9-out19942"	.08433	7	76	83
9	"9-out19943"	.46823	656	745	1401
9	"9-out19944"	.37270	426	717	1143
9	"9-out19945"	.29917	181	424	605
9	"9-out19946"	.28750	207	513	720
9	"9-out19947"	.40328	417	617	1034
9	"9-out19948"	.27027	150	405	555
9	"9-out19949"	.14478	43	254	297
9	"9-out19950"	.78738	437	118	555
9	"9-out19951"	.23989	570	1806	2376
9	"9-out19952"	.32173	185	390	575
9	"9-out19953"	.29802	166	391	557
9	"9-out19954"	.85964	245	40	285
9	"9-out19955"	.40410	118	174	292
9	"9-out19956"	.27090	81	218	299
9	"9-out19957"	.42926	176	234	410
9	"9-out19958"	.56451	140	108	248
9	"9-out19959"	.42528	37	50	87
9	"9-out19960"	.38414	63	101	164
9	"9-out19961"	.23939	79	251	330
9	"9-out19962"	.39413	121	186	307
9	"9-out19963"	.36827	137	235	372
9	"9-out19964"	.27000	54	146	200
9	"9-out19965"	.44626	627	778	1405
9	"9-out19966"	.28173	293	747	1040
9	"9-out19967"	.21832	224	802	1026
9	"9-out19968"	.30447	313	715	1028
9	"9-out19969"	.12716	176	1208	1384
9	"9-out19970"	.26135	236	667	903
9	"9-out19971"	.21941	165	587	752
9	"9-out19972"	.38622	645	1025	1670
9	"9-out19973"	.32426	548	1142	1690
9	"9-out19974"	.33293	563	1128	1691
9	"9-out19975"	.25027	460	1378	1838
9	"9-out19976"	.40286	703	1042	1745
9	"9-out19977"	.28699	481	1195	1676
9	"9-out19978"	.18885	600	2577	3177
9	"9-out19979"	.29024	759	1856	2615
9	"9-out19980"	.99206	250	2	252
9	"9-out19981"	.14593	61	357	418
9	"9-out19982"	.40712	217	316	533
9	"9-out19983"	.41108	178	255	433
9	"9-out19984"	.75000	165	55	220
9	"9-out19985"	.99393	164	1	165
9	"9-out19986"	.28741	169	419	588
9	"9-out19987"	.39661	117	178	295
9	"9-out19988"	.43005	83	110	193
9	"9-out19989"	.25675	133	385	518
9	"9-out19990"	.15094	48	270	318
9	"9-out19991"	.75170	221	73	294
9	"9-out19992"	.67875	131	62	193
9	"9-out19993"	.46623	145	166	311
9	"9-out19994"	.33823	69	135	204
9	"9-out19995"	.25742	52	150	202
9	"9-out19996"	.28879	67	165	232
9	"9-out19997"	.28684	181	450	631
9	"9-out19998"	.22857	104	351	455
9	"9-out19999"	.43103	150	198	348
9	"9-out20000"	.36281	320	562	882
9	"9-out20001"	.27720	107	279	386
9	"9-out20002"	.12735	54	370	424
9	"9-out20003"	.29345	130	313	443
9	"9-out20004"	.32954	116	236	352
9	"9-out20005"	.35265	146	268	414
9	"9-out20006"	.39963	221	332	553
9	"9-out20007"	.46753	36	41	77
9	"9-out20008"	.43085	162	214	376
9	"9-out20009"	.69565	48	21	69
9	"9-out20010"	.31696	342	737	1079
9	"9-out20011"	.99473	189	1	190
9	"9-out20012"	.35564	85	154	239
9	"9-out20013"	.52475	53	48	101
9	"9-out20014"	.40394	82	121	203
9	"9-out20015"	.75925	82	26	108
9	"9-out20016"	.32283	41	86	127
9	"9-out20017"	.47071	868	976	1844
9	"9-out20018"	.59077	205	142	347
9	"9-out20019"	.95769	1245	55	1300
9	"9-out20020"	.32046	382	810	1192
9	"9-out20021"	.40791	567	823	1390
9	"9-out20022"	.91049	590	58	648
9	"9-out20023"	.32239	167	351	518
9	"9-out20024"	.29554	146	348	494
9	"9-out20025"	.83571	117	23	140
9	"9-out20026"	.23834	46	147	193
9	"9-out20027"	.28970	602	1476	2078
9	"9-out20028"	.39053	66	103	169
9	"9-out20029"	.99206	125	1	126
9	"9-out20030"	.97540	119	3	122
9	"9-out20031"	.22646	190	649	839
9	"9-out20032"	.52813	488	436	924
9	"9-out20033"	.22641	24	82	106
9	"9-out20034"	.42524	256	346	602
9	"9-out20035"	.18728	330	1432	1762
9	"9-out20036"	.69716	663	288	951
9	"9-out20037"	.44927	186	228	414
9	"9-out20038"	.99212	126	1	127
9	"9-out20039"	.61414	382	240	622
9	"9-out20040"	.48979	120	125	245
9	"9-out20041"	.51908	68	63	131
9	"9-out20042"	.21686	36	130	166
9	"9-out20043"	.28988	129	316	445
9	"9-out20044"	.99397	165	1	166
9	"9-out20045"	.99628	268	1	269
9	"9-out20046"	.81690	58	13	71
9	"9-out20047"	.99369	315	2	317
9	"9-out20048"	.21379	31	114	145
9	"9-out20049"	.21684	121	437	558
9	"9-out20050"	.28130	164	419	583
9	"9-out20051"	.34935	189	352	541
9	"9-out20052"	.98924	92	1	93
9	"9-out20053"	.58151	692	498	1190
9	"9-out20054"	.34463	122	232	354
9	"9-out20055"	.32767	309	634	943
9	"9-out20056"	.98981	680	7	687
9	"9-out20057"	.35330	289	529	818
9	"9-out20058"	.20375	152	594	746
9	"9-out20059"	.19677	171	698	869
9	"9-out20060"	.25877	59	169	228
9	"9-out20061"	.31147	76	168	244
9	"9-out20062"	.13793	36	225	261
9	"9-out20063"	.32701	69	142	211
9	"9-out20064"	.31304	72	158	230
9	"9-out20065"	.34090	75	145	220
9	"9-out20066"	.85000	187	33	220
9	"9-out20067"	.19111	43	182	225
9	"9-out20068"	.16167	27	140	167
9	"9-out20069"	.73858	178	63	241
9	"9-out20070"	.39406	93	143	236
9	"9-out20071"	.59659	420	284	704
9	"9-out20072"	.43887	280	358	638
9	"9-out20073"	.56185	109	85	194
9	"9-out20074"	.30120	100	232	332
9	"9-out20075"	.44235	165	208	373
9	"9-out20076"	.24133	362	1138	1500
9	"9-out20077"	.86618	479	74	553
9	"9-out20078"	.38388	243	390	633
9	"9-out20079"	.27433	62	164	226
9	"9-out20080"	.99703	336	1	337
9	"9-out20081"	.39669	48	73	121
9	"9-out20082"	.22253	318	1111	1429
9	"9-out20083"	.15767	190	1015	1205
9	"9-out20084"	.22918	256	861	1117
9	"9-out20085"	.88612	1494	192	1686
9	"9-out20086"	.37345	332	557	889
9	"9-out20087"	.32515	464	963	1427
9	"9-out20088"	.21867	267	954	1221
9	"9-out20089"	.43031	565	748	1313
9	"9-out20090"	.33632	300	592	892
9	"9-out20091"	.23170	95	315	410
9	"9-out20092"	.51381	186	176	362
9	"9-out20093"	.22993	149	499	648
9	"9-out20094"	.23809	35	112	147
9	"9-out20095"	.33333	171	342	513
9	"9-out20096"	.24161	144	452	596
9	"9-out20097"	.46511	280	322	602
9	"9-out20098"	.27394	492	1304	1796
9	"9-out20099"	.98170	322	6	328
9	"9-out20100"	.24324	81	252	333
9	"9-out20101"	.97050	329	10	339
9	"9-out20102"	.97859	320	7	327
9	"9-out20103"	.36462	369	643	1012
9	"9-out20104"	.30510	263	599	862
9	"9-out20105"	.50765	199	193	392
9	"9-out20106"	.21224	208	772	980
9	"9-out20107"	.23441	173	565	738
9	"9-out20108"	.33695	279	549	828
9	"9-out20109"	.34207	287	552	839
9	"9-out20110"	.39480	304	466	770
9	"9-out20111"	.36764	225	387	612
9	"9-out20112"	.32294	518	1086	1604
9	"9-out20113"	.29859	447	1050	1497
9	"9-out20114"	.30444	534	1220	1754
9	"9-out20115"	.90104	519	57	576
9	"9-out20116"	.28196	322	820	1142
9	"9-out20117"	.38006	488	796	1284
9	"9-out20118"	.18411	51	226	277
9	"9-out20119"	.24354	66	205	271
9	"9-out20120"	.30721	294	663	957
9	"9-out20121"	.99193	123	1	124
9	"9-out20122"	.32584	87	180	267
9	"9-out20123"	.39000	39	61	100
9	"9-out20124"	.63184	254	148	402
9	"9-out20125"	.22849	85	287	372
9	"9-out20126"	.36197	139	245	384
9	"9-out20127"	.37655	151	250	401
9	"9-out20128"	.35012	139	258	397
9	"9-out20129"	.26379	239	667	906
9	"9-out20130"	.28646	273	680	953
9	"9-out20131"	.18554	77	338	415
9	"9-out20132"	.33855	173	338	511
9	"9-out20133"	.23529	48	156	204
9	"9-out20134"	.21967	192	682	874
9	"9-out20135"	.84730	738	133	871
9	"9-out20136"	.31578	132	286	418
9	"9-out20137"	.20618	80	308	388
9	"9-out20138"	.34346	113	216	329
9	"9-out20139"	.99456	183	1	184
9	"9-out20140"	.77368	147	43	190
9	"9-out20141"	.38120	146	237	383
9	"9-out20142"	.30508	54	123	177
9	"9-out20143"	.44285	93	117	210
9	"9-out20144"	.25000	184	552	736
9	"9-out20145"	.26278	221	620	841
9	"9-out20146"	.22364	70	243	313
9	"9-out20147"	.38753	143	226	369
9	"9-out20148"	.51190	86	82	168
9	"9-out20149"	.96629	86	3	89
9	"9-out20150"	.34123	72	139	211
9	"9-out20151"	.17431	57	270	327
9	"9-out20152"	.97674	42	1	43
9	"9-out20153"	.99082	108	1	109
9	"9-out20154"	.99082	108	1	109
9	"9-out20155"	.97435	38	1	39
9	"9-out20156"	.97674	42	1	43
9	"9-out20157"	.91943	194	17	211
9	"9-out20158"	.24230	63	197	260
9	"9-out20159"	.82273	427	92	519
9	"9-out20160"	.27023	197	532	729
9	"9-out20161"	.36580	199	345	544
9	"9-out20162"	.33333	109	218	327
9	"9-out20163"	.25170	111	330	441
9	"9-out20164"	.88720	409	52	461
9	"9-out20165"	.44015	342	435	777
9	"9-out20166"	.21875	105	375	480
9	"9-out20167"	.49270	135	139	274
9	"9-out20168"	.74329	194	67	261
9	"9-out20169"	.85492	165	28	193
9	"9-out20170"	.27707	174	454	628
9	"9-out20171"	.53333	56	49	105
9	"9-out20172"	.25818	213	612	825
9	"9-out20173"	.47133	148	166	314
9	"9-out20174"	.43127	91	120	211
9	"9-out20175"	.35466	399	726	1125
9	"9-out20176"	.50591	214	209	423
9	"9-out20177"	.41787	173	241	414
9	"9-out20178"	.45747	156	185	341
9	"9-out20179"	.23058	95	317	412
9	"9-out20180"	.34763	81	152	233
9	"9-out20181"	.35983	86	153	239
9	"9-out20182"	.39790	1214	1837	3051
9	"9-out20183"	.93469	229	16	245
9	"9-out20184"	.31660	82	177	259
9	"9-out20185"	.27111	122	328	450
9	"9-out20186"	.98375	424	7	431
9	"9-out20187"	.43128	204	269	473
9	"9-out20188"	.74774	83	28	111
9	"9-out20189"	.90476	57	6	63
9	"9-out20190"	.77777	56	16	72
9	"9-out20191"	.83962	89	17	106
9	"9-out20192"	.53164	42	37	79
9	"9-out20193"	.80468	103	25	128
9	"9-out20194"	.74015	282	99	381
9	"9-out20195"	.29848	177	416	593
9	"9-out20196"	.18039	322	1463	1785
9	"9-out20197"	.23179	191	633	824
9	"9-out20198"	.99595	492	2	494
9	"9-out20199"	.96527	139	5	144
9	"9-out20200"	.36124	151	267	418
9	"9-out20201"	.40686	937	1366	2303
9	"9-out20202"	.16161	16	83	99
9	"9-out20203"	.39961	207	311	518
9	"9-out20204"	.34545	38	72	110
9	"9-out20205"	.27322	50	133	183
9	"9-out20206"	.28000	28	72	100
9	"9-out20207"	.29740	149	352	501
9	"9-out20208"	.99145	348	3	351
9	"9-out20209"	.08040	16	183	199
9	"9-out20210"	.26813	207	565	772
9	"9-out20211"	.38131	151	245	396
9	"9-out20212"	.61832	81	50	131
9	"9-out20213"	.99397	330	2	332
9	"9-out20214"	.33055	198	401	599
9	"9-out20215"	.28985	120	294	414
9	"9-out20216"	.35167	147	271	418
9	"9-out20217"	.37102	420	712	1132
9	"9-out20218"	.19019	194	826	1020
9	"9-out20219"	.26141	269	760	1029
9	"9-out20220"	.35057	427	791	1218
9	"9-out20221"	.64026	194	109	303
9	"9-out20222"	.31652	113	244	357
9	"9-out20223"	.23934	292	928	1220
9	"9-out20224"	.21379	62	228	290
9	"9-out20225"	.21998	273	968	1241
9	"9-out20226"	.24700	227	692	919
9	"9-out20227"	.65000	65	35	100
9	"9-out20228"	.28682	74	184	258
9	"9-out20229"	.37121	441	747	1188
9	"9-out20230"	.79652	963	246	1209
9	"9-out20231"	.99500	199	1	200
9	"9-out20232"	.33407	300	598	898
9	"9-out20233"	.61290	57	36	93
9	"9-out20234"	.16556	25	126	151
9	"9-out20235"	.38116	85	138	223
9	"9-out20236"	.48717	114	120	234
9	"9-out20237"	.42187	54	74	128
9	"9-out20238"	.99074	107	1	108
9	"9-out20239"	.36666	55	95	150
9	"9-out20240"	.29764	139	328	467
9	"9-out20241"	.41666	55	77	132
9	"9-out20242"	.99319	146	1	147
9	"9-out20243"	.99539	216	1	217
9	"9-out20244"	.33933	113	220	333
9	"9-out20245"	.42622	52	70	122
9	"9-out20246"	.40000	58	87	145
9	"9-out20247"	.36363	100	175	275
9	"9-out20248"	.22764	28	95	123
9	"9-out20249"	.13559	32	204	236
9	"9-out20250"	.43809	138	177	315
9	"9-out20251"	.40068	117	175	292
9	"9-out20252"	.53913	62	53	115
9	"9-out20253"	.44871	35	43	78
9	"9-out20254"	.30797	583	1310	1893
9	"9-out20255"	.86363	437	69	506
9	"9-out20256"	.99707	681	2	683
9	"9-out20257"	.27608	561	1471	2032
9	"9-out20258"	.21998	372	1319	1691
9	"9-out20259"	.26970	284	769	1053
9	"9-out20260"	.36126	388	686	1074
9	"9-out20261"	.99775	445	1	446
9	"9-out20262"	.99775	445	1	446
9	"9-out20263"	.99264	135	1	136
9	"9-out20264"	.99750	399	1	400
9	"9-out20265"	.29752	385	909	1294
9	"9-out20266"	.37238	1138	1918	3056
9	"9-out20267"	.20307	66	259	325
9	"9-out20268"	.37356	65	109	174
9	"9-out20269"	.31413	60	131	191
9	"9-out20270"	.31818	21	45	66
9	"9-out20271"	.49342	75	77	152
9	"9-out20272"	.53582	172	149	321
9	"9-out20273"	.33616	198	391	589
9	"9-out20274"	.56937	119	90	209
9	"9-out20275"	.34817	86	161	247
9	"9-out20276"	.26695	244	670	914
9	"9-out20277"	.29674	73	173	246
9	"9-out20278"	.96946	254	8	262
9	"9-out20279"	.64919	161	87	248
9	"9-out20280"	.90196	46	5	51
9	"9-out20281"	.99378	160	1	161
9	"9-out20282"	.31397	173	378	551
9	"9-out20283"	.95652	66	3	69
9	"9-out20284"	.95050	653	34	687
9	"9-out20285"	.88888	96	12	108
9	"9-out20286"	.31137	52	115	167
9	"9-out20287"	.18485	166	732	898
9	"9-out20288"	.43720	94	121	215
9	"9-out20289"	.32367	67	140	207
9	"9-out20290"	.23934	73	232	305
9	"9-out20291"	.22767	51	173	224
9	"9-out20292"	.29017	65	159	224
9	"9-out20293"	.31963	70	149	219
9	"9-out20294"	.84090	185	35	220
9	"9-out20295"	.21575	63	229	292
9	"9-out20296"	.87727	193	27	220
9	"9-out20297"	.37320	78	131	209
9	"9-out20298"	.22935	50	168	218
9	"9-out20299"	.57819	122	89	211
9	"9-out20300"	.53456	116	101	217
9	"9-out20301"	.44098	269	341	610
9	"9-out20302"	.21707	89	321	410
9	"9-out20303"	.30497	319	727	1046
9	"9-out20304"	.30921	218	487	705
9	"9-out20305"	.71543	357	142	499
9	"9-out20306"	.67558	202	97	299
9	"9-out20307"	.30239	303	699	1002
9	"9-out20308"	.71004	311	127	438
9	"9-out20309"	.48553	151	160	311
9	"9-out20310"	.24498	281	866	1147
9	"9-out20311"	.28409	75	189	264
9	"9-out20312"	.21923	57	203	260
9	"9-out20313"	.24705	42	128	170
9	"9-out20314"	.79187	156	41	197
9	"9-out20315"	.99767	430	1	431
9	"9-out20316"	.43243	80	105	185
9	"9-out20317"	.28723	108	268	376
9	"9-out20318"	.26767	106	290	396
9	"9-out20319"	.99245	263	2	265
9	"9-out20320"	.99371	158	1	159
9	"9-out20321"	.99507	202	1	203
9	"9-out20322"	.75064	289	96	385
9	"9-out20323"	.23880	48	153	201
9	"9-out20324"	.23741	99	318	417
9	"9-out20325"	.22477	98	338	436
9	"9-out20326"	.20705	88	337	425
9	"9-out20327"	.56782	473	360	833
9	"9-out20328"	.66435	192	97	289
9	"9-out20329"	.44397	424	531	955
9	"9-out20330"	.99300	142	1	143
9	"9-out20331"	.40878	121	175	296
9	"9-out20332"	.99746	394	1	395
9	"9-out20333"	.99292	702	5	707
9	"9-out20334"	.99746	394	1	395
9	"9-out20335"	.31046	86	191	277
9	"9-out20336"	.37478	431	719	1150
9	"9-out20337"	.34693	34	64	98
9	"9-out20338"	.24702	228	695	923
9	"9-out20339"	.50239	315	312	627
9	"9-out20340"	.69005	472	212	684
9	"9-out20341"	.26642	150	413	563
9	"9-out20342"	.35294	108	198	306
9	"9-out20343"	.34343	34	65	99
9	"9-out20344"	.34603	227	429	656
9	"9-out20345"	.41414	41	58	99
9	"9-out20346"	.60273	176	116	292
9	"9-out20347"	.26097	107	303	410
9	"9-out20348"	.33460	176	350	526
9	"9-out20349"	.24507	87	268	355
9	"9-out20350"	.63788	229	130	359
9	"9-out20351"	.45391	325	391	716
9	"9-out20352"	.96052	73	3	76
9	"9-out20353"	.83344	1196	239	1435
9	"9-out20354"	.61061	414	264	678
9	"9-out20355"	.57070	226	170	396
9	"9-out20356"	.57142	72	54	126
9	"9-out20357"	.99200	124	1	125
9	"9-out20358"	.37651	747	1237	1984
9	"9-out20359"	.42268	246	336	582
9	"9-out20360"	.25445	200	586	786
9	"9-out20361"	.99521	208	1	209
9	"9-out20362"	.23178	35	116	151
9	"9-out20363"	.40318	177	262	439
9	"9-out20364"	.57476	123	91	214
9	"9-out20365"	.32867	235	480	715
9	"9-out20366"	.99572	233	1	234
9	"9-out20367"	.99502	200	1	201
9	"9-out20368"	.84337	420	78	498
9	"9-out20369"	.99746	394	1	395
9	"9-out20370"	.93959	420	27	447
9	"9-out20371"	.97841	272	6	278
9	"9-out20372"	.66535	169	85	254
9	"9-out20373"	.97826	90	2	92
9	"9-out20374"	.99905	1062	1	1063
9	"9-out20375"	.41735	101	141	242
9	"9-out20376"	.61702	145	90	235
9	"9-out20377"	.99735	377	1	378
9	"9-out20378"	.49555	279	284	563
9	"9-out20379"	.99009	100	1	101
9	"9-out20380"	.63957	181	102	283
9	"9-out20381"	.31173	356	786	1142
9	"9-out20382"	.42089	141	194	335
9	"9-out20383"	.63829	60	34	94
9	"9-out20384"	.95652	88	4	92
9	"9-out20385"	.44297	167	210	377
9	"9-out20386"	.46402	387	447	834
9	"9-out20387"	.44186	152	192	344
9	"9-out20388"	.38161	137	222	359
9	"9-out20389"	.34397	97	185	282
9	"9-out20390"	.48148	143	154	297
9	"9-out20391"	.34801	158	296	454
9	"9-out20392"	.40422	306	451	757
9	"9-out20393"	.42507	139	188	327
9	"9-out20394"	.35311	119	218	337
9	"9-out20395"	.35522	119	216	335
9	"9-out20396"	.87775	438	61	499
9	"9-out20397"	.36842	119	204	323
9	"9-out20398"	.98823	84	1	85
9	"9-out20399"	.71169	353	143	496
9	"9-out20400"	.98336	532	9	541
9	"9-out20401"	.27378	282	748	1030
9	"9-out20402"	.39080	34	53	87
9	"9-out20403"	.29230	38	92	130
9	"9-out20404"	.48754	137	144	281
9	"9-out20405"	.32371	157	328	485
9	"9-out20406"	.96394	909	34	943
9	"9-out20407"	.43239	355	466	821
9	"9-out20408"	.47916	138	150	288
9	"9-out20409"	.50282	89	88	177
9	"9-out20410"	.31395	54	118	172
9	"9-out20411"	.89571	481	56	537
9	"9-out20412"	.33265	164	329	493
10	"10-out1"	.97176	413	12	425
10	"10-out2"	.99537	646	3	649
10	"10-out3"	.32369	112	234	346
10	"10-out4"	.39265	139	215	354
10	"10-out5"	.38888	105	165	270
10	"10-out6"	.34615	117	221	338
10	"10-out7"	.78051	601	169	770
10	"10-out8"	.32539	205	425	630
10	"10-out9"	.37433	140	234	374
10	"10-out10"	.34066	666	1289	1955
10	"10-out11"	.98002	785	16	801
10	"10-out12"	.28471	939	2359	3298
10	"10-out13"	.25194	292	867	1159
10	"10-out14"	.29162	331	804	1135
10	"10-out15"	.87865	811	112	923
10	"10-out16"	.87621	814	115	929
10	"10-out17"	.27110	273	734	1007
10	"10-out18"	.22987	217	727	944
10	"10-out19"	.84640	788	143	931
10	"10-out20"	.87231	813	119	932
10	"10-out21"	.30418	473	1082	1555
10	"10-out22"	.38372	132	212	344
10	"10-out23"	.18000	45	205	250
10	"10-out24"	.40120	199	297	496
10	"10-out25"	.51974	408	377	785
10	"10-out26"	.74230	193	67	260
10	"10-out27"	.81589	616	139	755
10	"10-out28"	.31269	303	666	969
10	"10-out29"	.31707	117	252	369
10	"10-out30"	.22468	457	1577	2034
10	"10-out31"	.36689	430	742	1172
10	"10-out32"	.31284	112	246	358
10	"10-out33"	.99652	287	1	288
10	"10-out34"	.99709	343	1	344
10	"10-out35"	.70175	320	136	456
10	"10-out36"	.65349	579	307	886
10	"10-out37"	.70491	602	252	854
10	"10-out38"	.38344	329	529	858
10	"10-out39"	.26099	89	252	341
10	"10-out40"	.42431	185	251	436
10	"10-out41"	.15384	56	308	364
10	"10-out42"	.35467	144	262	406
10	"10-out43"	.71402	397	159	556
10	"10-out44"	.37417	171	286	457
10	"10-out45"	.75379	248	81	329
10	"10-out46"	.89874	790	89	879
10	"10-out47"	.17504	94	443	537
10	"10-out48"	.64720	510	278	788
10	"10-out49"	.25939	69	197	266
10	"10-out50"	.68264	299	139	438
10	"10-out51"	.73243	271	99	370
10	"10-out52"	.99682	314	1	315
10	"10-out53"	.32520	200	415	615
10	"10-out54"	.23475	154	502	656
10	"10-out55"	.34008	252	489	741
10	"10-out56"	.55817	355	281	636
10	"10-out57"	.34137	283	546	829
10	"10-out58"	.53319	257	225	482
10	"10-out59"	.42750	345	462	807
10	"10-out60"	.33734	252	495	747
10	"10-out61"	.43493	127	165	292
10	"10-out62"	.34583	166	314	480
10	"10-out63"	.29988	266	621	887
10	"10-out64"	.32032	796	1689	2485
10	"10-out65"	.26705	317	870	1187
10	"10-out66"	.19833	167	675	842
10	"10-out67"	.36557	325	564	889
10	"10-out68"	.26896	117	318	435
10	"10-out69"	.45972	371	436	807
10	"10-out70"	.27383	448	1188	1636
10	"10-out71"	.82891	344	71	415
10	"10-out72"	.22015	201	712	913
10	"10-out73"	.54411	185	155	340
10	"10-out74"	.53906	69	59	128
10	"10-out75"	.28571	170	425	595
10	"10-out76"	.87533	660	94	754
10	"10-out77"	.48965	497	518	1015
10	"10-out78"	.26433	212	590	802
10	"10-out79"	.26890	537	1460	1997
10	"10-out80"	.41271	539	767	1306
10	"10-out81"	.25380	484	1423	1907
10	"10-out82"	.55964	624	491	1115
10	"10-out83"	.17768	258	1194	1452
10	"10-out84"	.99509	609	3	612
10	"10-out85"	.31460	28	61	89
10	"10-out86"	.32918	476	970	1446
10	"10-out87"	.39848	369	557	926
10	"10-out88"	.32352	44	92	136
10	"10-out89"	.19064	53	225	278
10	"10-out90"	.23809	135	432	567
10	"10-out91"	.99527	421	2	423
10	"10-out92"	.99888	896	1	897
10	"10-out93"	.49311	215	221	436
10	"10-out94"	.61111	110	70	180
10	"10-out95"	.99705	338	1	339
10	"10-out96"	.48565	220	233	453
10	"10-out97"	.34023	115	223	338
10	"10-out98"	.51838	874	812	1686
10	"10-out99"	.90491	276	29	305
10	"10-out100"	.36516	195	339	534
10	"10-out101"	.37683	205	339	544
10	"10-out102"	.30534	120	273	393
10	"10-out103"	.36672	205	354	559
10	"10-out104"	.97493	350	9	359
10	"10-out105"	.31746	60	129	189
10	"10-out106"	.23946	284	902	1186
10	"10-out107"	.49529	158	161	319
10	"10-out108"	.75982	174	55	229
10	"10-out109"	.99567	230	1	231
10	"10-out110"	.29773	223	526	749
10	"10-out111"	.38632	209	332	541
10	"10-out112"	.45774	65	77	142
10	"10-out113"	.28571	48	120	168
10	"10-out114"	.93939	155	10	165
10	"10-out115"	.94324	349	21	370
10	"10-out116"	.19207	344	1447	1791
10	"10-out117"	.29153	179	435	614
10	"10-out118"	.99897	975	1	976
10	"10-out119"	.38764	207	327	534
10	"10-out120"	.25210	60	178	238
10	"10-out121"	.99804	1023	2	1025
10	"10-out122"	.21582	90	327	417
10	"10-out123"	.40196	82	122	204
10	"10-out124"	.55844	215	170	385
10	"10-out125"	.28612	99	247	346
10	"10-out126"	.35308	149	273	422
10	"10-out127"	.26774	83	227	310
10	"10-out128"	.33385	430	858	1288
10	"10-out129"	.84871	791	141	932
10	"10-out130"	.22820	123	416	539
10	"10-out131"	.14989	140	794	934
10	"10-out132"	.88396	838	110	948
10	"10-out133"	.50747	543	527	1070
10	"10-out134"	.87432	814	117	931
10	"10-out135"	.37472	172	287	459
10	"10-out136"	.87339	814	118	932
10	"10-out137"	.87894	835	115	950
10	"10-out138"	.88631	842	108	950
10	"10-out139"	.32818	85	174	259
10	"10-out140"	.94571	331	19	350
10	"10-out141"	.70370	304	128	432
10	"10-out142"	.30182	1552	3590	5142
10	"10-out143"	.71264	186	75	261
10	"10-out144"	.53225	33	29	62
10	"10-out145"	.16035	72	377	449
10	"10-out146"	.99065	106	1	107
10	"10-out147"	.25752	479	1381	1860
10	"10-out148"	.52316	192	175	367
10	"10-out149"	.24604	576	1765	2341
10	"10-out150"	.33161	129	260	389
10	"10-out151"	.48584	103	109	212
10	"10-out152"	.28112	219	560	779
10	"10-out153"	.62680	304	181	485
10	"10-out154"	.31875	226	483	709
10	"10-out155"	.33581	316	625	941
10	"10-out156"	.32865	375	766	1141
10	"10-out157"	.40663	196	286	482
10	"10-out158"	.14888	67	383	450
10	"10-out159"	.29821	804	1892	2696
10	"10-out160"	.32378	113	236	349
10	"10-out161"	.50285	176	174	350
10	"10-out162"	.98780	243	3	246
10	"10-out163"	.40312	129	191	320
10	"10-out164"	.98684	75	1	76
10	"10-out165"	.31187	281	620	901
10	"10-out166"	.22022	98	347	445
10	"10-out167"	.41872	237	329	566
10	"10-out168"	.35382	236	431	667
10	"10-out169"	.71739	528	208	736
10	"10-out170"	.86274	88	14	102
10	"10-out171"	.66666	188	94	282
10	"10-out172"	.38842	369	581	950
10	"10-out173"	.33214	186	374	560
10	"10-out174"	.26336	133	372	505
10	"10-out175"	.43043	198	262	460
10	"10-out176"	.35035	343	636	979
10	"10-out177"	.31260	367	807	1174
10	"10-out178"	.18045	48	218	266
10	"10-out179"	.16025	50	262	312
10	"10-out180"	.97297	36	1	37
10	"10-out181"	.47624	441	485	926
10	"10-out182"	.33274	188	377	565
10	"10-out183"	.26388	95	265	360
10	"10-out184"	.41146	244	349	593
10	"10-out185"	.23000	23	77	100
10	"10-out186"	.98657	147	2	149
10	"10-out187"	.70560	151	63	214
10	"10-out188"	.34131	114	220	334
10	"10-out189"	.28980	91	223	314
10	"10-out190"	.27932	100	258	358
10	"10-out191"	.26920	389	1056	1445
10	"10-out192"	.27524	368	969	1337
10	"10-out193"	.78417	1566	431	1997
10	"10-out194"	.34246	225	432	657
10	"10-out195"	.30133	587	1361	1948
10	"10-out196"	.41406	53	75	128
10	"10-out197"	.52923	172	153	325
10	"10-out198"	.24305	70	218	288
10	"10-out199"	.33866	784	1531	2315
10	"10-out200"	.31058	91	202	293
10	"10-out201"	.58620	85	60	145
10	"10-out202"	.27675	75	196	271
10	"10-out203"	.22117	94	331	425
10	"10-out204"	.43467	173	225	398
10	"10-out205"	.95511	1064	50	1114
10	"10-out206"	.99065	212	2	214
10	"10-out207"	.36516	130	226	356
10	"10-out208"	.43465	153	199	352
10	"10-out209"	.22881	81	273	354
10	"10-out210"	.56041	218	171	389
10	"10-out211"	.99766	427	1	428
10	"10-out212"	.99806	1033	2	1035
10	"10-out213"	.31474	158	344	502
10	"10-out214"	.30021	142	331	473
10	"10-out215"	.38938	396	621	1017
10	"10-out216"	.99641	278	1	279
10	"10-out217"	.99641	278	1	279
10	"10-out218"	.95544	193	9	202
10	"10-out219"	.99285	139	1	140
10	"10-out220"	.98523	267	4	271
10	"10-out221"	.18312	115	513	628
10	"10-out222"	.40476	187	275	462
10	"10-out223"	.93939	465	30	495
10	"10-out224"	.41176	98	140	238
10	"10-out225"	.45977	280	329	609
10	"10-out226"	.73066	274	101	375
10	"10-out227"	.91286	220	21	241
10	"10-out228"	.28046	168	431	599
10	"10-out229"	.18192	149	670	819
10	"10-out230"	.32581	592	1225	1817
10	"10-out231"	.96261	309	12	321
10	"10-out232"	.54603	172	143	315
10	"10-out233"	.93288	278	20	298
10	"10-out234"	.86792	276	42	318
10	"10-out235"	.94920	299	16	315
10	"10-out236"	.93610	293	20	313
10	"10-out237"	.98083	307	6	313
10	"10-out238"	.28703	93	231	324
10	"10-out239"	.91925	296	26	322
10	"10-out240"	.54545	174	145	319
10	"10-out241"	.94788	291	16	307
10	"10-out242"	.62459	193	116	309
10	"10-out243"	.85760	265	44	309
10	"10-out244"	.94630	282	16	298
10	"10-out245"	.97560	320	8	328
10	"10-out246"	.38263	119	192	311
10	"10-out247"	.48417	153	163	316
10	"10-out248"	.41612	129	181	310
10	"10-out249"	.41358	134	190	324
10	"10-out250"	.43370	157	205	362
10	"10-out251"	.96451	299	11	310
10	"10-out252"	.97444	305	8	313
10	"10-out253"	.96794	302	10	312
10	"10-out254"	.98717	308	4	312
10	"10-out255"	.98076	306	6	312
10	"10-out256"	.94871	296	16	312
10	"10-out257"	.97435	304	8	312
10	"10-out258"	.98397	307	5	312
10	"10-out259"	.95280	323	16	339
10	"10-out260"	.96381	293	11	304
10	"10-out261"	.39379	241	371	612
10	"10-out262"	.40711	103	150	253
10	"10-out263"	.31200	78	172	250
10	"10-out264"	.99450	362	2	364
10	"10-out265"	.99450	362	2	364
10	"10-out266"	.27299	92	245	337
10	"10-out267"	.26714	187	513	700
10	"10-out268"	.74683	531	180	711
10	"10-out269"	.58490	403	286	689
10	"10-out270"	.49822	140	141	281
10	"10-out271"	.34523	87	165	252
10	"10-out272"	.98511	397	6	403
10	"10-out273"	.31232	109	240	349
10	"10-out274"	.62804	206	122	328
10	"10-out275"	.83206	109	22	131
10	"10-out276"	.94639	565	32	597
10	"10-out277"	.66894	588	291	879
10	"10-out278"	.36529	240	417	657
10	"10-out279"	.48771	377	396	773
10	"10-out280"	.45721	171	203	374
10	"10-out281"	.97327	1311	36	1347
10	"10-out282"	.99552	1334	6	1340
10	"10-out283"	.32788	341	699	1040
10	"10-out284"	.25929	307	877	1184
10	"10-out285"	.45657	184	219	403
10	"10-out286"	.24883	107	323	430
10	"10-out287"	.39972	291	437	728
10	"10-out288"	.33449	384	764	1148
10	"10-out289"	.87836	816	113	929
10	"10-out290"	.87432	807	116	923
10	"10-out291"	.87741	816	114	930
10	"10-out292"	.20041	193	770	963
10	"10-out293"	.64316	602	334	936
10	"10-out294"	.27566	341	896	1237
10	"10-out295"	.86659	812	125	937
10	"10-out296"	.83894	797	153	950
10	"10-out297"	.28512	69	173	242
10	"10-out298"	.29099	181	441	622
10	"10-out299"	.55124	199	162	361
10	"10-out300"	.99438	177	1	178
10	"10-out301"	.22058	30	106	136
10	"10-out302"	.24089	119	375	494
10	"10-out303"	.32600	89	184	273
10	"10-out304"	.46835	185	210	395
10	"10-out305"	.23454	110	359	469
10	"10-out306"	.29903	279	654	933
10	"10-out307"	.92800	116	9	125
10	"10-out308"	.99476	190	1	191
10	"10-out309"	.25746	138	398	536
10	"10-out310"	.70124	169	72	241
10	"10-out311"	.46067	328	384	712
10	"10-out312"	.36711	297	512	809
10	"10-out313"	.39568	440	672	1112
10	"10-out314"	.36188	300	529	829
10	"10-out315"	.33446	296	589	885
10	"10-out316"	.21621	80	290	370
10	"10-out317"	.18666	28	122	150
10	"10-out318"	.35071	74	137	211
10	"10-out319"	.38004	160	261	421
10	"10-out320"	.96237	486	19	505
10	"10-out321"	.35684	86	155	241
10	"10-out322"	.21130	86	321	407
10	"10-out323"	.30606	101	229	330
10	"10-out324"	.47147	281	315	596
10	"10-out325"	.97474	386	10	396
10	"10-out326"	.22839	37	125	162
10	"10-out327"	.21794	68	244	312
10	"10-out328"	.36614	93	161	254
10	"10-out329"	.97680	379	9	388
10	"10-out330"	.31126	221	489	710
10	"10-out331"	.28608	111	277	388
10	"10-out332"	.38056	325	529	854
10	"10-out333"	.74814	101	34	135
10	"10-out334"	.50752	371	360	731
10	"10-out335"	.30902	89	199	288
10	"10-out336"	.19137	71	300	371
10	"10-out337"	.98616	784	11	795
10	"10-out338"	.97355	773	21	794
10	"10-out339"	.97861	778	17	795
10	"10-out340"	.87700	820	115	935
10	"10-out341"	.98002	932	19	951
10	"10-out342"	.98773	725	9	734
10	"10-out343"	.29218	852	2064	2916
10	"10-out344"	.87117	825	122	947
10	"10-out345"	.87052	827	123	950
10	"10-out346"	.87768	818	114	932
10	"10-out347"	.87820	822	114	936
10	"10-out348"	.39518	164	251	415
10	"10-out349"	.35838	248	444	692
10	"10-out350"	.26860	574	1563	2137
10	"10-out351"	.27722	140	365	505
10	"10-out352"	.22758	66	224	290
10	"10-out353"	.34540	124	235	359
10	"10-out354"	.57834	502	366	868
10	"10-out355"	.14121	86	523	609
10	"10-out356"	.33457	179	356	535
10	"10-out357"	.33041	151	306	457
10	"10-out358"	.99581	238	1	239
10	"10-out359"	.31250	230	506	736
10	"10-out360"	.36457	319	556	875
10	"10-out361"	.36860	317	543	860
10	"10-out362"	.21575	126	458	584
10	"10-out363"	.22637	115	393	508
10	"10-out364"	.36931	130	222	352
10	"10-out365"	.22045	97	343	440
10	"10-out366"	.40476	34	50	84
10	"10-out367"	.28544	151	378	529
10	"10-out368"	.21804	29	104	133
10	"10-out369"	.66784	189	94	283
10	"10-out370"	.99786	468	1	469
10	"10-out371"	.86428	121	19	140
10	"10-out372"	.29024	824	2015	2839
10	"10-out373"	.99884	865	1	866
10	"10-out374"	.51635	742	695	1437
10	"10-out375"	.56828	362	275	637
10	"10-out376"	.29692	628	1487	2115
10	"10-out377"	.84188	197	37	234
10	"10-out378"	.65882	168	87	255
10	"10-out379"	.53256	139	122	261
10	"10-out380"	.75153	245	81	326
10	"10-out381"	.41104	134	192	326
10	"10-out382"	.52894	201	179	380
10	"10-out383"	.43579	112	145	257
10	"10-out384"	.29846	117	275	392
10	"10-out385"	.21404	64	235	299
10	"10-out386"	.29390	82	197	279
10	"10-out387"	.32283	82	172	254
10	"10-out388"	.20769	27	103	130
10	"10-out389"	.44252	154	194	348
10	"10-out390"	.40652	137	200	337
10	"10-out391"	.94520	69	4	73
10	"10-out392"	.39506	32	49	81
10	"10-out393"	.29532	101	241	342
10	"10-out394"	.48756	196	206	402
10	"10-out395"	.99450	362	2	364
10	"10-out396"	.50094	266	265	531
10	"10-out397"	.33521	178	353	531
10	"10-out398"	.31159	172	380	552
10	"10-out399"	.26952	390	1057	1447
10	"10-out400"	.98863	87	1	88
10	"10-out401"	.39067	134	209	343
10	"10-out402"	.27570	118	310	428
10	"10-out403"	.43174	136	179	315
10	"10-out404"	.32129	258	545	803
10	"10-out405"	.26440	289	804	1093
10	"10-out406"	.28511	205	514	719
10	"10-out407"	.29090	112	273	385
10	"10-out408"	.65263	62	33	95
10	"10-out409"	.36166	234	413	647
10	"10-out410"	.43715	706	909	1615
10	"10-out411"	.58241	53	38	91
10	"10-out412"	.54639	53	44	97
10	"10-out413"	.33766	78	153	231
10	"10-out414"	.99107	111	1	112
10	"10-out415"	.99145	116	1	117
10	"10-out416"	.38056	693	1128	1821
10	"10-out417"	.52348	312	284	596
10	"10-out418"	.28260	91	231	322
10	"10-out419"	.79729	118	30	148
10	"10-out420"	.32947	399	812	1211
10	"10-out421"	.43701	170	219	389
10	"10-out422"	.99280	138	1	139
10	"10-out423"	.22093	38	134	172
10	"10-out424"	.52679	344	309	653
10	"10-out425"	.58769	191	134	325
10	"10-out426"	.61930	231	142	373
10	"10-out427"	.69278	221	98	319
10	"10-out428"	.83286	294	59	353
10	"10-out429"	.25882	66	189	255
10	"10-out430"	.31784	1122	2408	3530
10	"10-out431"	.60598	1175	764	1939
10	"10-out432"	.71325	1383	556	1939
10	"10-out433"	.40841	660	956	1616
10	"10-out434"	.27815	373	968	1341
10	"10-out435"	.30533	778	1770	2548
10	"10-out436"	.31168	48	106	154
10	"10-out437"	.99935	1561	1	1562
10	"10-out438"	.24137	175	550	725
10	"10-out439"	.55029	93	76	169
10	"10-out440"	.41258	118	168	286
10	"10-out441"	.27954	369	951	1320
10	"10-out442"	.82179	807	175	982
10	"10-out443"	.21671	153	553	706
10	"10-out444"	.99686	636	2	638
10	"10-out445"	.99762	420	1	421
10	"10-out446"	.99768	863	2	865
10	"10-out447"	.99552	667	3	670
10	"10-out448"	.33079	174	352	526
10	"10-out449"	.21399	156	573	729
10	"10-out450"	.14032	95	582	677
10	"10-out451"	.39946	2664	4005	6669
10	"10-out452"	.39814	43	65	108
10	"10-out453"	.29925	240	562	802
10	"10-out454"	.99922	1287	1	1288
10	"10-out455"	.36815	148	254	402
10	"10-out456"	.44864	166	204	370
10	"10-out457"	.10919	38	310	348
10	"10-out458"	.21987	73	259	332
10	"10-out459"	.72756	227	85	312
10	"10-out460"	.98397	307	5	312
10	"10-out461"	.92993	292	22	314
10	"10-out462"	.95356	308	15	323
10	"10-out463"	.97667	335	8	343
10	"10-out464"	.66346	207	105	312
10	"10-out465"	.92948	290	22	312
10	"10-out466"	.36666	132	228	360
10	"10-out467"	.81350	253	58	311
10	"10-out468"	.79538	276	71	347
10	"10-out469"	.41157	128	183	311
10	"10-out470"	.50000	165	165	330
10	"10-out471"	.89308	284	34	318
10	"10-out472"	.71704	223	88	311
10	"10-out473"	.53781	192	165	357
10	"10-out474"	.91666	286	26	312
10	"10-out475"	.44164	140	177	317
10	"10-out476"	.93269	291	21	312
10	"10-out477"	.38125	122	198	320
10	"10-out478"	.94805	292	16	308
10	"10-out479"	.41212	136	194	330
10	"10-out480"	.97160	308	9	317
10	"10-out481"	.38187	118	191	309
10	"10-out482"	.75632	239	77	316
10	"10-out483"	.94936	300	16	316
10	"10-out484"	.82371	257	55	312
10	"10-out485"	.49275	170	175	345
10	"10-out486"	.88461	276	36	312
10	"10-out487"	.88461	276	36	312
10	"10-out488"	.94871	296	16	312
10	"10-out489"	.91642	318	29	347
10	"10-out490"	.36977	115	196	311
10	"10-out491"	.89423	279	33	312
10	"10-out492"	.61442	196	123	319
10	"10-out493"	.40108	148	221	369
10	"10-out494"	.87931	306	42	348
10	"10-out495"	.46103	142	166	308
10	"10-out496"	.89935	277	31	308
10	"10-out497"	.99062	317	3	320
10	"10-out498"	.93396	297	21	318
10	"10-out499"	.97126	338	10	348
10	"10-out500"	.95986	287	12	299
10	"10-out501"	.66225	200	102	302
10	"10-out502"	.93865	306	20	326
10	"10-out503"	.54516	169	141	310
10	"10-out504"	.93203	288	21	309
10	"10-out505"	.57741	179	131	310
10	"10-out506"	.85668	269	45	314
10	"10-out507"	.62420	196	118	314
10	"10-out508"	.55448	173	139	312
10	"10-out509"	.96496	303	11	314
10	"10-out510"	.89367	311	37	348
10	"10-out511"	.88141	275	37	312
10	"10-out512"	.98083	307	6	313
10	"10-out513"	.93987	297	19	316
10	"10-out514"	.72077	222	86	308
10	"10-out515"	.93569	291	20	311
10	"10-out516"	.36507	115	200	315
10	"10-out517"	.96178	302	12	314
10	"10-out518"	.51592	162	152	314
10	"10-out519"	.50955	160	154	314
10	"10-out520"	.77316	242	71	313
10	"10-out521"	.93949	295	19	314
10	"10-out522"	.71656	225	89	314
10	"10-out523"	.50000	157	157	314
10	"10-out524"	.71028	228	93	321
10	"10-out525"	.68224	219	102	321
10	"10-out526"	.82410	253	54	307
10	"10-out527"	.79099	246	65	311
10	"10-out528"	.55081	168	137	305
10	"10-out529"	.56591	176	135	311
10	"10-out530"	.39814	129	195	324
10	"10-out531"	.87116	284	42	326
10	"10-out532"	.95882	326	14	340
10	"10-out533"	.34726	108	203	311
10	"10-out534"	.86858	271	41	312
10	"10-out535"	.97756	305	7	312
10	"10-out536"	.97087	300	9	309
10	"10-out537"	.97694	339	8	347
10	"10-out538"	.51359	170	161	331
10	"10-out539"	.41025	128	184	312
10	"10-out540"	.39747	126	191	317
10	"10-out541"	.32051	100	212	312
10	"10-out542"	.75862	242	77	319
10	"10-out543"	.84789	262	47	309
10	"10-out544"	.91025	284	28	312
10	"10-out545"	.96463	300	11	311
10	"10-out546"	.94230	294	18	312
10	"10-out547"	.93225	289	21	310
10	"10-out548"	.94855	295	16	311
10	"10-out549"	.80063	253	63	316
10	"10-out550"	.44776	150	185	335
10	"10-out551"	.46451	144	166	310
10	"10-out552"	.72929	229	85	314
10	"10-out553"	.44745	132	163	295
10	"10-out554"	.76216	282	88	370
10	"10-out555"	.16429	127	646	773
10	"10-out556"	.30309	137	315	452
10	"10-out557"	.21683	85	307	392
10	"10-out558"	.36163	230	406	636
10	"10-out559"	.30494	265	604	869
10	"10-out560"	.30795	275	618	893
10	"10-out561"	.38793	180	284	464
10	"10-out562"	.99074	107	1	108
10	"10-out563"	.40635	755	1103	1858
10	"10-out564"	.25515	99	289	388
10	"10-out565"	.30201	434	1003	1437
10	"10-out566"	.97868	2296	50	2346
10	"10-out567"	.35869	66	118	184
10	"10-out568"	.19047	136	578	714
10	"10-out569"	.31317	347	761	1108
10	"10-out570"	.40205	743	1105	1848
10	"10-out571"	.63282	1315	763	2078
10	"10-out572"	.43209	105	138	243
10	"10-out573"	.40303	239	354	593
10	"10-out574"	.16256	33	170	203
10	"10-out575"	.37846	246	404	650
10	"10-out576"	.67012	258	127	385
10	"10-out577"	.47696	176	193	369
10	"10-out578"	.23969	93	295	388
10	"10-out579"	.92148	223	19	242
10	"10-out580"	.99450	362	2	364
10	"10-out581"	.52686	304	273	577
10	"10-out582"	.63754	197	112	309
10	"10-out583"	.74110	229	80	309
10	"10-out584"	.96784	301	10	311
10	"10-out585"	.95548	322	15	337
10	"10-out586"	.53993	169	144	313
10	"10-out587"	.44788	159	196	355
10	"10-out588"	.59627	192	130	322
10	"10-out589"	.44408	139	174	313
10	"10-out590"	.47468	150	166	316
10	"10-out591"	.46278	143	166	309
10	"10-out592"	.95483	296	14	310
10	"10-out593"	.95161	295	15	310
10	"10-out594"	.41025	128	184	312
10	"10-out595"	.90705	283	29	312
10	"10-out596"	.32500	104	216	320
10	"10-out597"	.38853	122	192	314
10	"10-out598"	.36624	115	199	314
10	"10-out599"	.64126	202	113	315
10	"10-out600"	.79127	254	67	321
10	"10-out601"	.77170	240	71	311
10	"10-out602"	.91475	279	26	305
10	"10-out603"	.91447	278	26	304
10	"10-out604"	.96485	302	11	313
10	"10-out605"	.90384	282	30	312
10	"10-out606"	.51803	158	147	305
10	"10-out607"	.49504	150	153	303
10	"10-out608"	.40432	131	193	324
10	"10-out609"	.98058	303	6	309
10	"10-out610"	.93630	294	20	314
10	"10-out611"	.45307	140	169	309
10	"10-out612"	.30000	96	224	320
10	"10-out613"	.43630	137	177	314
10	"10-out614"	.92378	303	25	328
10	"10-out615"	.95253	301	15	316
10	"10-out616"	.39252	126	195	321
10	"10-out617"	.41935	130	180	310
10	"10-out618"	.43119	141	186	327
10	"10-out619"	.87915	291	40	331
10	"10-out620"	.96784	301	10	311
10	"10-out621"	.41233	127	181	308
10	"10-out622"	.52478	180	163	343
10	"10-out623"	.52076	163	150	313
10	"10-out624"	.38368	127	204	331
10	"10-out625"	.46645	146	167	313
10	"10-out626"	.73040	233	86	319
10	"10-out627"	.92948	290	22	312
10	"10-out628"	.92012	288	25	313
10	"10-out629"	.42071	130	179	309
10	"10-out630"	.61414	191	120	311
10	"10-out631"	.50649	156	152	308
10	"10-out632"	.51125	159	152	311
10	"10-out633"	.91746	289	26	315
10	"10-out634"	.45512	142	170	312
10	"10-out635"	.32590	117	242	359
10	"10-out636"	.67637	209	100	309
10	"10-out637"	.81877	253	56	309
10	"10-out638"	.63057	198	116	314
10	"10-out639"	.46177	151	176	327
10	"10-out640"	.71803	219	86	305
10	"10-out641"	.51592	162	152	314
10	"10-out642"	.38582	98	156	254
10	"10-out643"	.29616	255	606	861
10	"10-out644"	.58139	175	126	301
10	"10-out645"	.99019	101	1	102
10	"10-out646"	.19780	108	438	546
10	"10-out647"	.36643	262	453	715
10	"10-out648"	.39879	264	398	662
10	"10-out649"	.43227	150	197	347
10	"10-out650"	.30300	363	835	1198
10	"10-out651"	.27840	196	508	704
10	"10-out652"	.42805	235	314	549
10	"10-out653"	.41827	325	452	777
10	"10-out654"	.30606	217	492	709
10	"10-out655"	.25905	93	266	359
10	"10-out656"	.26147	131	370	501
10	"10-out657"	.99567	230	1	231
10	"10-out658"	.89426	905	107	1012
10	"10-out659"	.30648	274	620	894
10	"10-out660"	.34571	121	229	350
10	"10-out661"	.36468	380	662	1042
10	"10-out662"	.36947	276	471	747
10	"10-out663"	.32992	419	851	1270
10	"10-out664"	.61596	162	101	263
10	"10-out665"	.30693	310	700	1010
10	"10-out666"	.68265	370	172	542
10	"10-out667"	.46381	314	363	677
10	"10-out668"	.89266	4890	588	5478
10	"10-out669"	.36914	189	323	512
10	"10-out670"	.48115	217	234	451
10	"10-out671"	.97987	14215	292	14507
10	"10-out672"	.84464	3795	698	4493
10	"10-out673"	.29102	188	458	646
10	"10-out674"	.99964	8381	3	8384
10	"10-out675"	.80717	1013	242	1255
10	"10-out676"	.77738	440	126	566
10	"10-out677"	.99943	1772	1	1773
10	"10-out678"	.71635	3710	1469	5179
10	"10-out679"	.98801	2143	26	2169
10	"10-out680"	.98885	5591	63	5654
10	"10-out681"	.70291	265	112	377
10	"10-out682"	.65134	170	91	261
10	"10-out683"	.38888	35	55	90
10	"10-out684"	.47195	244	273	517
10	"10-out685"	.17431	95	450	545
10	"10-out686"	.23412	59	193	252
10	"10-out687"	.52182	263	241	504
10	"10-out688"	.80566	398	96	494
10	"10-out689"	.32911	52	106	158
10	"10-out690"	.74860	134	45	179
10	"10-out691"	.36170	51	90	141
10	"10-out692"	.39420	136	209	345
10	"10-out693"	.98969	96	1	97
10	"10-out694"	.26356	272	760	1032
10	"10-out695"	.30346	254	583	837
10	"10-out696"	.97058	528	16	544
10	"10-out697"	.27745	96	250	346
10	"10-out698"	.79896	461	116	577
10	"10-out699"	.79189	567	149	716
10	"10-out700"	.68106	205	96	301
10	"10-out701"	.65129	226	121	347
10	"10-out702"	.88364	281	37	318
10	"10-out703"	.82594	261	55	316
10	"10-out704"	.63525	209	120	329
10	"10-out705"	.97427	303	8	311
10	"10-out706"	.43042	133	176	309
10	"10-out707"	.23026	35	117	152
10	"10-out708"	.28896	241	593	834
10	"10-out709"	.99369	315	2	317
10	"10-out710"	.32621	107	221	328
10	"10-out711"	.51566	362	340	702
10	"10-out712"	.38541	74	118	192
10	"10-out713"	.95081	58	3	61
10	"10-out714"	.52752	115	103	218
10	"10-out715"	.42448	104	141	245
10	"10-out716"	.36363	96	168	264
10	"10-out717"	.35413	647	1180	1827
10	"10-out718"	.37721	341	563	904
10	"10-out719"	.54954	183	150	333
10	"10-out720"	.44818	346	426	772
10	"10-out721"	.39731	296	449	745
10	"10-out722"	.27433	31	82	113
10	"10-out723"	.50638	119	116	235
10	"10-out724"	.51393	996	942	1938
10	"10-out725"	.39260	764	1182	1946
10	"10-out726"	.25947	534	1524	2058
10	"10-out727"	.27899	575	1486	2061
10	"10-out728"	.35356	332	607	939
10	"10-out729"	.20059	67	267	334
10	"10-out730"	.99401	166	1	167
10	"10-out731"	.24791	89	270	359
10	"10-out732"	.93750	15	1	16
10	"10-out733"	.27397	40	106	146
10	"10-out734"	.55448	860	691	1551
10	"10-out735"	.99653	288	1	289
10	"10-out736"	.25889	400	1145	1545
10	"10-out737"	.97515	314	8	322
10	"10-out738"	.97204	313	9	322
10	"10-out739"	.20250	81	319	400
10	"10-out740"	.42767	136	182	318
10	"10-out741"	.44267	139	175	314
10	"10-out742"	.60063	188	125	313
10	"10-out743"	.35493	115	209	324
10	"10-out744"	.92971	291	22	313
10	"10-out745"	.97575	322	8	330
10	"10-out746"	.55095	173	141	314
10	"10-out747"	.88000	286	39	325
10	"10-out748"	.98153	319	6	325
10	"10-out749"	.94193	292	18	310
10	"10-out750"	.40255	126	187	313
10	"10-out751"	.47284	148	165	313
10	"10-out752"	.97476	309	8	317
10	"10-out753"	.36277	115	202	317
10	"10-out754"	.89240	282	34	316
10	"10-out755"	.87500	273	39	312
10	"10-out756"	.90064	281	31	312
10	"10-out757"	.88102	274	37	311
10	"10-out758"	.94551	295	17	312
10	"10-out759"	.89102	278	34	312
10	"10-out760"	.95370	309	15	324
10	"10-out761"	.96226	306	12	318
10	"10-out762"	.91428	288	27	315
10	"10-out763"	.93269	291	21	312
10	"10-out764"	.82857	261	54	315
10	"10-out765"	.76190	240	75	315
10	"10-out766"	.39228	122	189	311
10	"10-out767"	.94392	303	18	321
10	"10-out768"	.97142	306	9	315
10	"10-out769"	.96825	305	10	315
10	"10-out770"	.70550	218	91	309
10	"10-out771"	.87702	271	38	309
10	"10-out772"	.95792	296	13	309
10	"10-out773"	.52215	165	151	316
10	"10-out774"	.61612	191	119	310
10	"10-out775"	.66775	205	102	307
10	"10-out776"	.32704	104	214	318
10	"10-out777"	.88102	274	37	311
10	"10-out778"	.93968	296	19	315
10	"10-out779"	.33226	104	209	313
10	"10-out780"	.95192	297	15	312
10	"10-out781"	.91475	279	26	305
10	"10-out782"	.42122	131	180	311
10	"10-out783"	.92698	292	23	315
10	"10-out784"	.44891	145	178	323
10	"10-out785"	.35806	111	199	310
10	"10-out786"	.43809	138	177	315
10	"10-out787"	.91205	280	27	307
10	"10-out788"	.91856	282	25	307
10	"10-out789"	.94888	297	16	313
10	"10-out790"	.60517	187	122	309
10	"10-out791"	.84394	265	49	314
10	"10-out792"	.95846	300	13	313
10	"10-out793"	.97230	316	9	325
10	"10-out794"	.93831	289	19	308
10	"10-out795"	.48717	152	160	312
10	"10-out796"	.91883	283	25	308
10	"10-out797"	.86173	268	43	311
10	"10-out798"	.90996	283	28	311
10	"10-out799"	.87936	277	38	315
10	"10-out800"	.51612	160	150	310
10	"10-out801"	.91111	287	28	315
10	"10-out802"	.53726	173	149	322
10	"10-out803"	.64623	232	127	359
10	"10-out804"	.97756	305	7	312
10	"10-out805"	.97452	306	8	314
10	"10-out806"	.21604	70	254	324
10	"10-out807"	.46687	148	169	317
10	"10-out808"	.45110	143	174	317
10	"10-out809"	.26315	85	238	323
10	"10-out810"	.37538	122	203	325
10	"10-out811"	.92258	286	24	310
10	"10-out812"	.87378	270	39	309
10	"10-out813"	.75312	241	79	320
10	"10-out814"	.94444	306	18	324
10	"10-out815"	.58895	192	134	326
10	"10-out816"	.90415	283	30	313
10	"10-out817"	.67096	208	102	310
10	"10-out818"	.50636	159	155	314
10	"10-out819"	.95375	330	16	346
10	"10-out820"	.83922	261	50	311
10	"10-out821"	.94551	295	17	312
10	"10-out822"	.95192	297	15	312
10	"10-out823"	.92903	288	22	310
10	"10-out824"	.80952	255	60	315
10	"10-out825"	.37304	119	200	319
10	"10-out826"	.37785	116	191	307
10	"10-out827"	.68965	220	99	319
10	"10-out828"	.98859	260	3	263
10	"10-out829"	.68709	213	97	310
10	"10-out830"	.70819	216	89	305
10	"10-out831"	.13725	21	132	153
10	"10-out832"	.30718	47	106	153
10	"10-out833"	.42524	128	173	301
10	"10-out834"	.37130	88	149	237
10	"10-out835"	.99534	214	1	215
10	"10-out836"	.28873	123	303	426
10	"10-out837"	.35489	203	369	572
10	"10-out838"	.33393	184	367	551
10	"10-out839"	.23178	140	464	604
10	"10-out840"	.64686	196	107	303
10	"10-out841"	.26324	159	445	604
10	"10-out842"	.88571	310	40	350
10	"10-out843"	.36811	187	321	508
10	"10-out844"	.31476	582	1267	1849
10	"10-out845"	.27866	333	862	1195
10	"10-out846"	.29862	195	458	653
10	"10-out847"	.32850	204	417	621
10	"10-out848"	.31969	211	449	660
10	"10-out849"	.51101	232	222	454
10	"10-out850"	.26217	183	515	698
10	"10-out851"	.38954	164	257	421
10	"10-out852"	.16494	64	324	388
10	"10-out853"	.39663	543	826	1369
10	"10-out854"	.15617	67	362	429
10	"10-out855"	.88841	414	52	466
10	"10-out856"	.44541	408	508	916
10	"10-out857"	.99294	704	5	709
10	"10-out858"	.34010	67	130	197
10	"10-out859"	.99969	3322	1	3323
10	"10-out860"	.99919	1236	1	1237
10	"10-out861"	.73481	4234	1528	5762
10	"10-out862"	.48298	1178	1261	2439
10	"10-out863"	.19034	67	285	352
10	"10-out864"	.34558	94	178	272
10	"10-out865"	.40030	261	391	652
10	"10-out866"	.33333	91	182	273
10	"10-out867"	.44083	231	293	524
10	"10-out868"	.35104	337	623	960
10	"10-out869"	.32635	156	322	478
10	"10-out870"	.38831	226	356	582
10	"10-out871"	.81538	265	60	325
10	"10-out872"	.17050	37	180	217
10	"10-out873"	.37012	114	194	308
10	"10-out874"	.98989	98	1	99
10	"10-out875"	.48156	405	436	841
10	"10-out876"	.45676	280	333	613
10	"10-out877"	.25688	28	81	109
10	"10-out878"	.27131	140	376	516
10	"10-out879"	.82500	330	70	400
10	"10-out880"	.41772	132	184	316
10	"10-out881"	.96308	287	11	298
10	"10-out882"	.88888	280	35	315
10	"10-out883"	.97101	268	8	276
10	"10-out884"	.66134	207	106	313
10	"10-out885"	.32037	173	367	540
10	"10-out886"	.48562	152	161	313
10	"10-out887"	.97239	317	9	326
10	"10-out888"	.45054	533	650	1183
10	"10-out889"	.51470	105	99	204
10	"10-out890"	.65714	276	144	420
10	"10-out891"	.42782	163	218	381
10	"10-out892"	.31592	127	275	402
10	"10-out893"	.22167	90	316	406
10	"10-out894"	.24901	127	383	510
10	"10-out895"	.76383	207	64	271
10	"10-out896"	.60681	196	127	323
10	"10-out897"	.31466	236	514	750
10	"10-out898"	.42992	181	240	421
10	"10-out899"	.30681	135	305	440
10	"10-out900"	.30061	49	114	163
10	"10-out901"	.99082	108	1	109
10	"10-out902"	.54362	81	68	149
10	"10-out903"	.99186	122	1	123
10	"10-out904"	.99481	192	1	193
10	"10-out905"	.20903	74	280	354
10	"10-out906"	.31720	118	254	372
10	"10-out907"	.20789	79	301	380
10	"10-out908"	.38793	135	213	348
10	"10-out909"	.72493	282	107	389
10	"10-out910"	.51653	984	921	1905
10	"10-out911"	.22781	95	322	417
10	"10-out912"	.30139	195	452	647
10	"10-out913"	.30718	47	106	153
10	"10-out914"	.37719	215	355	570
10	"10-out915"	.28212	191	486	677
10	"10-out916"	.41065	239	343	582
10	"10-out917"	.32145	523	1104	1627
10	"10-out918"	.34618	458	865	1323
10	"10-out919"	.38095	48	78	126
10	"10-out920"	.40816	40	58	98
10	"10-out921"	.30263	69	159	228
10	"10-out922"	.98882	354	4	358
10	"10-out923"	.39864	118	178	296
10	"10-out924"	.42292	834	1138	1972
10	"10-out925"	.99453	1091	6	1097
10	"10-out926"	.64053	1242	697	1939
10	"10-out927"	.39429	235	361	596
10	"10-out928"	.29820	631	1485	2116
10	"10-out929"	.26884	453	1232	1685
10	"10-out930"	.38602	210	334	544
10	"10-out931"	.39508	241	369	610
10	"10-out932"	.31967	593	1262	1855
10	"10-out933"	.30100	90	209	299
10	"10-out934"	.38257	101	163	264
10	"10-out935"	.23611	119	385	504
10	"10-out936"	.90737	529	54	583
10	"10-out937"	.55639	222	177	399
10	"10-out938"	.99530	212	1	213
10	"10-out939"	.34739	140	263	403
10	"10-out940"	.99663	296	1	297
10	"10-out941"	.20370	44	172	216
10	"10-out942"	.79545	70	18	88
10	"10-out943"	.25471	54	158	212
10	"10-out944"	.14814	32	184	216
10	"10-out945"	.21402	58	213	271
10	"10-out946"	.31171	149	329	478
10	"10-out947"	.86768	341	52	393
10	"10-out948"	.18012	29	132	161
10	"10-out949"	.88118	267	36	303
10	"10-out950"	.96794	302	10	312
10	"10-out951"	.97749	304	7	311
10	"10-out952"	.48437	155	165	320
10	"10-out953"	.71474	223	89	312
10	"10-out954"	.48242	151	162	313
10	"10-out955"	.97239	317	9	326
10	"10-out956"	.66395	571	289	860
10	"10-out957"	.27684	116	303	419
10	"10-out958"	.71387	247	99	346
10	"10-out959"	.83200	104	21	125
10	"10-out960"	.35018	97	180	277
10	"10-out961"	.36931	65	111	176
10	"10-out962"	.21276	50	185	235
10	"10-out963"	.14534	25	147	172
10	"10-out964"	.29750	119	281	400
10	"10-out965"	.25490	377	1102	1479
10	"10-out966"	.30029	103	240	343
10	"10-out967"	.88509	285	37	322
10	"10-out968"	.89393	295	35	330
10	"10-out969"	.98461	192	3	195
10	"10-out970"	.23381	65	213	278
10	"10-out971"	.39957	374	562	936
10	"10-out972"	.34117	464	896	1360
10	"10-out973"	.98214	55	1	56
10	"10-out974"	.61764	126	78	204
10	"10-out975"	.34782	256	480	736
10	"10-out976"	.32133	241	509	750
10	"10-out977"	.20750	83	317	400
10	"10-out978"	.32424	666	1388	2054
10	"10-out979"	.34389	76	145	221
10	"10-out980"	.22730	333	1132	1465
10	"10-out981"	.80373	172	42	214
10	"10-out982"	.98780	81	1	82
10	"10-out983"	.39574	93	142	235
10	"10-out984"	.41562	133	187	320
10	"10-out985"	.31818	77	165	242
10	"10-out986"	.31476	113	246	359
10	"10-out987"	.42718	440	590	1030
10	"10-out988"	.23411	70	229	299
10	"10-out989"	.34503	226	429	655
10	"10-out990"	.98370	483	8	491
10	"10-out991"	.19892	37	149	186
10	"10-out992"	.26654	149	410	559
10	"10-out993"	.29325	100	241	341
10	"10-out994"	.60714	306	198	504
10	"10-out995"	.25238	159	471	630
10	"10-out996"	.60423	371	243	614
10	"10-out997"	.46491	53	61	114
10	"10-out998"	.45038	59	72	131
10	"10-out999"	.98881	707	8	715
10	"10-out1000"	.68164	182	85	267
10	"10-out1001"	.97959	48	1	49
10	"10-out1002"	.99630	270	1	271
10	"10-out1003"	.95081	58	3	61
10	"10-out1004"	.55172	288	234	522
10	"10-out1005"	.99082	108	1	109
10	"10-out1006"	.24299	26	81	107
10	"10-out1007"	.22051	86	304	390
10	"10-out1008"	.48044	86	93	179
10	"10-out1009"	.24686	177	540	717
10	"10-out1010"	.50847	60	58	118
10	"10-out1011"	.33701	122	240	362
10	"10-out1012"	.29983	185	432	617
10	"10-out1013"	.32980	249	506	755
10	"10-out1014"	.19083	25	106	131
10	"10-out1015"	.26602	83	229	312
10	"10-out1016"	.41714	146	204	350
10	"10-out1017"	.49216	157	162	319
10	"10-out1018"	.35942	124	221	345
10	"10-out1019"	.27397	100	265	365
10	"10-out1020"	.37125	124	210	334
10	"10-out1021"	.25430	266	780	1046
10	"10-out1022"	.99494	394	2	396
10	"10-out1023"	.93809	788	52	840
10	"10-out1024"	.29955	68	159	227
10	"10-out1025"	.21111	133	497	630
10	"10-out1026"	.32209	86	181	267
10	"10-out1027"	.36184	55	97	152
10	"10-out1028"	.33659	447	881	1328
10	"10-out1029"	.23913	275	875	1150
10	"10-out1030"	.28169	100	255	355
10	"10-out1031"	.38831	113	178	291
10	"10-out1032"	.83428	146	29	175
10	"10-out1033"	.61585	101	63	164
10	"10-out1034"	.98648	73	1	74
10	"10-out1035"	.44174	364	460	824
10	"10-out1036"	.23126	108	359	467
10	"10-out1037"	.30163	333	771	1104
10	"10-out1038"	.83529	71	14	85
10	"10-out1039"	.32982	814	1654	2468
10	"10-out1040"	.28242	270	686	956
10	"10-out1041"	.95348	82	4	86
10	"10-out1042"	.28888	143	352	495
10	"10-out1043"	.32992	419	851	1270
10	"10-out1044"	.35643	108	195	303
10	"10-out1045"	.27167	141	378	519
10	"10-out1046"	.30467	241	550	791
10	"10-out1047"	.34382	153	292	445
10	"10-out1048"	.18354	87	387	474
10	"10-out1049"	.21590	38	138	176
10	"10-out1050"	.72297	107	41	148
10	"10-out1051"	.57711	116	85	201
10	"10-out1052"	.46586	116	133	249
10	"10-out1053"	.99782	459	1	460
10	"10-out1054"	.29602	201	478	679
10	"10-out1055"	.34332	126	241	367
10	"10-out1056"	.99711	346	1	347
10	"10-out1057"	.32197	189	398	587
10	"10-out1058"	.39950	326	490	816
10	"10-out1059"	.40257	219	325	544
10	"10-out1060"	.27719	158	412	570
10	"10-out1061"	.29659	218	517	735
10	"10-out1062"	.24764	105	319	424
10	"10-out1063"	.29086	121	295	416
10	"10-out1064"	.37869	192	315	507
10	"10-out1065"	.96969	32	1	33
10	"10-out1066"	.99551	222	1	223
10	"10-out1067"	.41809	416	579	995
10	"10-out1068"	.30113	106	246	352
10	"10-out1069"	.52447	75	68	143
10	"10-out1070"	.99130	114	1	115
10	"10-out1071"	.36657	136	235	371
10	"10-out1072"	.32545	179	371	550
10	"10-out1073"	.47085	105	118	223
10	"10-out1074"	.47560	819	903	1722
10	"10-out1075"	.44537	106	132	238
10	"10-out1076"	.33707	210	413	623
10	"10-out1077"	.57000	285	215	500
10	"10-out1078"	.38493	92	147	239
10	"10-out1079"	.32726	503	1034	1537
10	"10-out1080"	.58488	503	357	860
10	"10-out1081"	.29844	154	362	516
10	"10-out1082"	.45864	61	72	133
10	"10-out1083"	.38650	126	200	326
10	"10-out1084"	.60377	224	147	371
10	"10-out1085"	.99186	122	1	123
10	"10-out1086"	.99145	116	1	117
10	"10-out1087"	.99145	116	1	117
10	"10-out1088"	.20542	144	557	701
10	"10-out1089"	.38165	258	418	676
10	"10-out1090"	.73333	308	112	420
10	"10-out1091"	.89864	133	15	148
10	"10-out1092"	.36276	415	729	1144
10	"10-out1093"	.74829	110	37	147
10	"10-out1094"	.48359	501	535	1036
10	"10-out1095"	.25363	157	462	619
10	"10-out1096"	.77641	316	91	407
10	"10-out1097"	.99363	312	2	314
10	"10-out1098"	.73103	106	39	145
10	"10-out1099"	.41939	307	425	732
10	"10-out1100"	.89772	158	18	176
10	"10-out1101"	.73561	473	170	643
10	"10-out1102"	.36219	343	604	947
10	"10-out1103"	.30333	91	209	300
10	"10-out1104"	.58187	764	549	1313
10	"10-out1105"	.23148	50	166	216
10	"10-out1106"	.56739	543	414	957
10	"10-out1107"	.32507	223	463	686
10	"10-out1108"	.41989	325	449	774
10	"10-out1109"	.25806	128	368	496
10	"10-out1110"	.25000	135	405	540
10	"10-out1111"	.27016	67	181	248
10	"10-out1112"	.99624	265	1	266
10	"10-out1113"	.34050	95	184	279
10	"10-out1114"	.95348	82	4	86
10	"10-out1115"	.25681	292	845	1137
10	"10-out1116"	.49423	257	263	520
10	"10-out1117"	.48750	234	246	480
10	"10-out1118"	.26829	143	390	533
10	"10-out1119"	.34117	116	224	340
10	"10-out1120"	.50485	52	51	103
10	"10-out1121"	.42479	305	413	718
10	"10-out1122"	.35129	163	301	464
10	"10-out1123"	.35000	126	234	360
10	"10-out1124"	.29589	108	257	365
10	"10-out1125"	.33888	122	238	360
10	"10-out1126"	.58585	290	205	495
10	"10-out1127"	.96685	350	12	362
10	"10-out1128"	.38074	431	701	1132
10	"10-out1129"	.32359	277	579	856
10	"10-out1130"	.77237	1208	356	1564
10	"10-out1131"	.29563	515	1227	1742
10	"10-out1132"	.73611	212	76	288
10	"10-out1133"	.20516	127	492	619
10	"10-out1134"	.89763	114	13	127
10	"10-out1135"	.98562	617	9	626
10	"10-out1136"	.95717	380	17	397
10	"10-out1137"	.19409	46	191	237
10	"10-out1138"	.64758	362	197	559
10	"10-out1139"	.39000	195	305	500
10	"10-out1140"	.22511	147	506	653
10	"10-out1141"	.37101	768	1302	2070
10	"10-out1142"	.40076	210	314	524
10	"10-out1143"	.95076	309	16	325
10	"10-out1144"	.34069	108	209	317
10	"10-out1145"	.29827	173	407	580
10	"10-out1146"	.91290	283	27	310
10	"10-out1147"	.40785	135	196	331
10	"10-out1148"	.62576	204	122	326
10	"10-out1149"	.68686	272	124	396
10	"10-out1150"	.62318	215	130	345
10	"10-out1151"	.97239	317	9	326
10	"10-out1152"	.52469	170	154	324
10	"10-out1153"	.62214	191	116	307
10	"10-out1154"	.61224	330	209	539
10	"10-out1155"	.29862	152	357	509
10	"10-out1156"	.64265	223	124	347
10	"10-out1157"	.87106	277	41	318
10	"10-out1158"	.37179	116	196	312
10	"10-out1159"	.52750	163	146	309
10	"10-out1160"	.83826	368	71	439
10	"10-out1161"	.35969	623	1109	1732
10	"10-out1162"	.33313	570	1141	1711
10	"10-out1163"	.42056	90	124	214
10	"10-out1164"	.97362	886	24	910
10	"10-out1165"	.82815	1359	282	1641
10	"10-out1166"	.38716	513	812	1325
10	"10-out1167"	.33922	461	898	1359
10	"10-out1168"	.31441	72	157	229
10	"10-out1169"	.35981	77	137	214
10	"10-out1170"	.72151	114	44	158
10	"10-out1171"	.41406	106	150	256
10	"10-out1172"	.67441	377	182	559
10	"10-out1173"	.78545	216	59	275
10	"10-out1174"	.34196	66	127	193
10	"10-out1175"	.41159	142	203	345
10	"10-out1176"	.34300	390	747	1137
10	"10-out1177"	.33924	153	298	451
10	"10-out1178"	.37398	46	77	123
10	"10-out1179"	.70858	5646	2322	7968
10	"10-out1180"	.40084	760	1136	1896
10	"10-out1181"	.36687	175	302	477
10	"10-out1182"	.47560	39	43	82
10	"10-out1183"	.99824	569	1	570
10	"10-out1184"	.95161	59	3	62
10	"10-out1185"	.69868	160	69	229
10	"10-out1186"	.38095	24	39	63
10	"10-out1187"	.28030	74	190	264
10	"10-out1188"	.60294	41	27	68
10	"10-out1189"	.88962	403	50	453
10	"10-out1190"	.26108	106	300	406
10	"10-out1191"	.99363	312	2	314
10	"10-out1192"	.84466	261	48	309
10	"10-out1193"	.41626	87	122	209
10	"10-out1194"	.84063	960	182	1142
10	"10-out1195"	.26086	48	136	184
10	"10-out1196"	.39021	343	536	879
10	"10-out1197"	.41566	138	194	332
10	"10-out1198"	.69501	474	208	682
10	"10-out1199"	.27085	237	638	875
10	"10-out1200"	.15238	48	267	315
10	"10-out1201"	.99776	446	1	447
10	"10-out1202"	.39658	186	283	469
10	"10-out1203"	.99636	274	1	275
10	"10-out1204"	.99576	235	1	236
10	"10-out1205"	.99212	126	1	127
10	"10-out1206"	.27237	70	187	257
10	"10-out1207"	.69523	146	64	210
10	"10-out1208"	.48076	150	162	312
10	"10-out1209"	.17937	40	183	223
10	"10-out1210"	.25795	73	210	283
10	"10-out1211"	.99088	870	8	878
10	"10-out1212"	.99088	870	8	878
10	"10-out1213"	.99007	798	8	806
10	"10-out1214"	.99088	870	8	878
10	"10-out1215"	.98941	748	8	756
10	"10-out1216"	.98785	732	9	741
10	"10-out1217"	.26901	145	394	539
10	"10-out1218"	.34716	184	346	530
10	"10-out1219"	.57894	110	80	190
10	"10-out1220"	.33014	138	280	418
10	"10-out1221"	.40975	168	242	410
10	"10-out1222"	.42732	147	197	344
10	"10-out1223"	.34798	277	519	796
10	"10-out1224"	.26034	214	608	822
10	"10-out1225"	.27771	233	606	839
10	"10-out1226"	.32540	301	624	925
10	"10-out1227"	.34688	401	755	1156
10	"10-out1228"	.40406	596	879	1475
10	"10-out1229"	.40546	564	827	1391
10	"10-out1230"	.25905	372	1064	1436
10	"10-out1231"	.28359	496	1253	1749
10	"10-out1232"	.99685	317	1	318
10	"10-out1233"	.23757	478	1534	2012
10	"10-out1234"	.25358	530	1560	2090
10	"10-out1235"	.98571	69	1	70
10	"10-out1236"	.47572	294	324	618
10	"10-out1237"	.31715	196	422	618
10	"10-out1238"	.99543	218	1	219
10	"10-out1239"	.63736	232	132	364
10	"10-out1240"	.25995	111	316	427
10	"10-out1241"	.64086	298	167	465
10	"10-out1242"	.34458	245	466	711
10	"10-out1243"	.99704	337	1	338
10	"10-out1244"	.14176	37	224	261
10	"10-out1245"	.69115	555	248	803
10	"10-out1246"	.35609	73	132	205
10	"10-out1247"	.30564	92	209	301
10	"10-out1248"	.53445	605	527	1132
10	"10-out1249"	.28428	85	214	299
10	"10-out1250"	.99706	340	1	341
10	"10-out1251"	.35891	304	543	847
10	"10-out1252"	.99919	1248	1	1249
10	"10-out1253"	.99190	735	6	741
10	"10-out1254"	.34742	304	571	875
10	"10-out1255"	.24866	140	423	563
10	"10-out1256"	.45989	86	101	187
10	"10-out1257"	.43027	398	527	925
10	"10-out1258"	.28529	97	243	340
10	"10-out1259"	.43796	1246	1599	2845
10	"10-out1260"	.37735	260	429	689
10	"10-out1261"	.50252	299	296	595
10	"10-out1262"	.27351	346	919	1265
10	"10-out1263"	.20278	102	401	503
10	"10-out1264"	.55714	312	248	560
10	"10-out1265"	.18821	99	427	526
10	"10-out1266"	.23902	49	156	205
10	"10-out1267"	.68103	158	74	232
10	"10-out1268"	.90612	222	23	245
10	"10-out1269"	.20316	77	302	379
10	"10-out1270"	.92649	668	53	721
10	"10-out1271"	.95904	281	12	293
10	"10-out1272"	.94398	455	27	482
10	"10-out1273"	.97319	472	13	485
10	"10-out1274"	.22719	127	432	559
10	"10-out1275"	.78947	135	36	171
10	"10-out1276"	.80813	139	33	172
10	"10-out1277"	.52482	222	201	423
10	"10-out1278"	.35000	308	572	880
10	"10-out1279"	.31702	175	377	552
10	"10-out1280"	.65705	410	214	624
10	"10-out1281"	.87473	405	58	463
10	"10-out1282"	.42483	130	176	306
10	"10-out1283"	.45631	94	112	206
10	"10-out1284"	.98360	60	1	61
10	"10-out1285"	.92567	137	11	148
10	"10-out1286"	.33333	80	160	240
10	"10-out1287"	.21719	48	173	221
10	"10-out1288"	.40597	136	199	335
10	"10-out1289"	.26876	333	906	1239
10	"10-out1290"	.68341	136	63	199
10	"10-out1291"	.60857	227	146	373
10	"10-out1292"	.41159	142	203	345
10	"10-out1293"	.78082	171	48	219
10	"10-out1294"	.38441	148	237	385
10	"10-out1295"	.28871	261	643	904
10	"10-out1296"	.40857	143	207	350
10	"10-out1297"	.54191	181	153	334
10	"10-out1298"	.31878	168	359	527
10	"10-out1299"	.25488	261	763	1024
10	"10-out1300"	.31907	470	1003	1473
10	"10-out1301"	.30501	316	720	1036
10	"10-out1302"	.35648	195	352	547
10	"10-out1303"	.26410	103	287	390
10	"10-out1304"	.46280	56	65	121
10	"10-out1305"	.27982	312	803	1115
10	"10-out1306"	.64525	673	370	1043
10	"10-out1307"	.77932	392	111	503
10	"10-out1308"	.21721	318	1146	1464
10	"10-out1309"	.22237	330	1154	1484
10	"10-out1310"	.44931	554	679	1233
10	"10-out1311"	.56661	757	579	1336
10	"10-out1312"	.44776	420	518	938
10	"10-out1313"	.68674	57	26	83
10	"10-out1314"	.37785	116	191	307
10	"10-out1315"	.77419	216	63	279
10	"10-out1316"	.32247	99	208	307
10	"10-out1317"	.38095	96	156	252
10	"10-out1318"	.31438	94	205	299
10	"10-out1319"	.19607	30	123	153
10	"10-out1320"	.39506	32	49	81
10	"10-out1321"	.39769	138	209	347
10	"10-out1322"	.49263	368	379	747
10	"10-out1323"	.86458	249	39	288
10	"10-out1324"	.99500	199	1	200
10	"10-out1325"	.34071	585	1132	1717
10	"10-out1326"	.20370	44	172	216
10	"10-out1327"	.69782	321	139	460
10	"10-out1328"	.24386	159	493	652
10	"10-out1329"	.25024	251	752	1003
10	"10-out1330"	.32244	612	1286	1898
10	"10-out1331"	.56078	286	224	510
10	"10-out1332"	.63057	198	116	314
10	"10-out1333"	.97106	302	9	311
10	"10-out1334"	.33403	158	315	473
10	"10-out1335"	.87974	278	38	316
10	"10-out1336"	.58839	213	149	362
10	"10-out1337"	.69278	221	98	319
10	"10-out1338"	.45954	142	167	309
10	"10-out1339"	.35081	107	198	305
10	"10-out1340"	.92424	305	25	330
10	"10-out1341"	.94267	296	18	314
10	"10-out1342"	.89967	278	31	309
10	"10-out1343"	.94731	971	54	1025
10	"10-out1344"	.52812	169	151	320
10	"10-out1345"	.99787	470	1	471
10	"10-out1346"	.37073	76	129	205
10	"10-out1347"	.97734	302	7	309
10	"10-out1348"	.91772	290	26	316
10	"10-out1349"	.91428	288	27	315
10	"10-out1350"	.74418	256	88	344
10	"10-out1351"	.41987	131	181	312
10	"10-out1352"	.33653	105	207	312
10	"10-out1353"	.41358	134	190	324
10	"10-out1354"	.34687	111	209	320
10	"10-out1355"	.36760	118	203	321
10	"10-out1356"	.24172	73	229	302
10	"10-out1357"	.46202	146	170	316
10	"10-out1358"	.17460	55	260	315
10	"10-out1359"	.41009	130	187	317
10	"10-out1360"	.48286	155	166	321
10	"10-out1361"	.40705	127	185	312
10	"10-out1362"	.41795	135	188	323
10	"10-out1363"	.32484	102	212	314
10	"10-out1364"	.34925	117	218	335
10	"10-out1365"	.70347	223	94	317
10	"10-out1366"	.98765	320	4	324
10	"10-out1367"	.98857	346	4	350
10	"10-out1368"	.68810	214	97	311
10	"10-out1369"	.96815	304	10	314
10	"10-out1370"	.96815	304	10	314
10	"10-out1371"	.99088	326	3	329
10	"10-out1372"	.98432	314	5	319
10	"10-out1373"	.97160	308	9	317
10	"10-out1374"	.34062	109	211	320
10	"10-out1375"	.52024	167	154	321
10	"10-out1376"	.69753	226	98	324
10	"10-out1377"	.16822	54	267	321
10	"10-out1378"	.99792	482	1	483
10	"10-out1379"	.59162	339	234	573
10	"10-out1380"	.43827	671	860	1531
10	"10-out1381"	.41107	141	202	343
10	"10-out1382"	.46491	106	122	228
10	"10-out1383"	.99470	188	1	189
10	"10-out1384"	.77824	551	157	708
10	"10-out1385"	.33047	77	156	233
10	"10-out1386"	.39430	429	659	1088
10	"10-out1387"	.83109	433	88	521
10	"10-out1388"	.24356	142	441	583
10	"10-out1389"	.72460	321	122	443
10	"10-out1390"	.29670	54	128	182
10	"10-out1391"	.99411	169	1	170
10	"10-out1392"	.99411	169	1	170
10	"10-out1393"	.41532	103	145	248
10	"10-out1394"	.11304	52	408	460
10	"10-out1395"	.50825	154	149	303
10	"10-out1396"	.77049	47	14	61
10	"10-out1397"	.95081	58	3	61
10	"10-out1398"	.95081	58	3	61
10	"10-out1399"	.95081	58	3	61
10	"10-out1400"	.95081	58	3	61
10	"10-out1401"	.88524	54	7	61
10	"10-out1402"	.93442	57	4	61
10	"10-out1403"	.55844	86	68	154
10	"10-out1404"	.35723	269	484	753
10	"10-out1405"	.69257	196	87	283
10	"10-out1406"	.46214	177	206	383
10	"10-out1407"	.38102	245	398	643
10	"10-out1408"	.35655	215	388	603
10	"10-out1409"	.45578	201	240	441
10	"10-out1410"	.75810	304	97	401
10	"10-out1411"	.66051	179	92	271
10	"10-out1412"	.24074	52	164	216
10	"10-out1413"	.40572	170	249	419
10	"10-out1414"	.24291	60	187	247
10	"10-out1415"	.21666	52	188	240
10	"10-out1416"	.99264	135	1	136
10	"10-out1417"	.30097	155	360	515
10	"10-out1418"	.51910	163	151	314
10	"10-out1419"	.80200	320	79	399
10	"10-out1420"	.28885	184	453	637
10	"10-out1421"	.61875	99	61	160
10	"10-out1422"	.28841	122	301	423
10	"10-out1423"	.47151	149	167	316
10	"10-out1424"	.84276	268	50	318
10	"10-out1425"	.33956	109	212	321
10	"10-out1426"	.99270	136	1	137
10	"10-out1427"	.45092	147	179	326
10	"10-out1428"	.13265	39	255	294
10	"10-out1429"	.28242	307	780	1087
10	"10-out1430"	.49122	196	203	399
10	"10-out1431"	.34285	132	253	385
10	"10-out1432"	.37593	250	415	665
10	"10-out1433"	.28353	186	470	656
10	"10-out1434"	.42570	318	429	747
10	"10-out1435"	.38834	160	252	412
10	"10-out1436"	.26506	44	122	166
10	"10-out1437"	.65042	1215	653	1868
10	"10-out1438"	.82335	275	59	334
10	"10-out1439"	.31306	798	1751	2549
10	"10-out1440"	.98354	538	9	547
10	"10-out1441"	.34722	200	376	576
10	"10-out1442"	.31578	78	169	247
10	"10-out1443"	.28404	146	368	514
10	"10-out1444"	.26588	406	1121	1527
10	"10-out1445"	.30914	409	914	1323
10	"10-out1446"	.47659	112	123	235
10	"10-out1447"	.30630	457	1035	1492
10	"10-out1448"	.99159	118	1	119
10	"10-out1449"	.19583	47	193	240
10	"10-out1450"	.38008	355	579	934
10	"10-out1451"	.33977	123	239	362
10	"10-out1452"	.22183	128	449	577
10	"10-out1453"	.57337	168	125	293
10	"10-out1454"	.40287	56	83	139
10	"10-out1455"	.46009	98	115	213
10	"10-out1456"	.33204	172	346	518
10	"10-out1457"	.27659	65	170	235
10	"10-out1458"	.26382	62	173	235
10	"10-out1459"	.62068	72	44	116
10	"10-out1460"	.39814	86	130	216
10	"10-out1461"	.76237	77	24	101
10	"10-out1462"	.36548	72	125	197
10	"10-out1463"	.36860	317	543	860
10	"10-out1464"	.26967	257	696	953
10	"10-out1465"	.45816	115	136	251
10	"10-out1466"	.76950	434	130	564
10	"10-out1467"	.28235	216	549	765
10	"10-out1468"	.45896	151	178	329
10	"10-out1469"	.41592	47	66	113
10	"10-out1470"	.45218	331	401	732
10	"10-out1471"	.49699	661	669	1330
10	"10-out1472"	.36932	236	403	639
10	"10-out1473"	.56427	338	261	599
10	"10-out1474"	.61538	152	95	247
10	"10-out1475"	.62348	154	93	247
10	"10-out1476"	.43851	189	242	431
10	"10-out1477"	.28102	77	197	274
10	"10-out1478"	.38473	242	387	629
10	"10-out1479"	.34603	218	412	630
10	"10-out1480"	.32670	115	237	352
10	"10-out1481"	.30625	49	111	160
10	"10-out1482"	.20032	123	491	614
10	"10-out1483"	.31161	177	391	568
10	"10-out1484"	.69761	293	127	420
10	"10-out1485"	.26002	240	683	923
10	"10-out1486"	.45495	303	363	666
10	"10-out1487"	.32388	80	167	247
10	"10-out1488"	.83823	171	33	204
10	"10-out1489"	.30263	92	212	304
10	"10-out1490"	.75134	559	185	744
10	"10-out1491"	.50147	509	506	1015
10	"10-out1492"	.59047	248	172	420
10	"10-out1493"	.99918	1221	1	1222
10	"10-out1494"	.47875	383	417	800
10	"10-out1495"	.43217	223	293	516
10	"10-out1496"	.57772	249	182	431
10	"10-out1497"	.45935	243	286	529
10	"10-out1498"	.41580	200	281	481
10	"10-out1499"	.24202	91	285	376
10	"10-out1500"	.26937	73	198	271
10	"10-out1501"	.38042	762	1241	2003
10	"10-out1502"	.98721	386	5	391
10	"10-out1503"	.72972	216	80	296
10	"10-out1504"	.32661	162	334	496
10	"10-out1505"	.81600	306	69	375
10	"10-out1506"	.51170	590	563	1153
10	"10-out1507"	.99472	1132	6	1138
10	"10-out1508"	.54966	83	68	151
10	"10-out1509"	.25743	329	949	1278
10	"10-out1510"	.30350	156	358	514
10	"10-out1511"	.99056	105	1	106
10	"10-out1512"	.76430	227	70	297
10	"10-out1513"	.98979	291	3	294
10	"10-out1514"	.99428	1044	6	1050
10	"10-out1515"	.99472	1132	6	1138
10	"10-out1516"	.99470	1127	6	1133
10	"10-out1517"	.98588	419	6	425
10	"10-out1518"	.99758	413	1	414
10	"10-out1519"	.98611	426	6	432
10	"10-out1520"	.99766	428	1	429
10	"10-out1521"	.27194	127	340	467
10	"10-out1522"	.26889	153	416	569
10	"10-out1523"	.29761	125	295	420
10	"10-out1524"	.67415	60	29	89
10	"10-out1525"	.99655	289	1	290
10	"10-out1526"	.38750	186	294	480
10	"10-out1527"	.51361	132	125	257
10	"10-out1528"	.35217	162	298	460
10	"10-out1529"	.31674	191	412	603
10	"10-out1530"	.21923	98	349	447
10	"10-out1531"	.48536	199	211	410
10	"10-out1532"	.71782	290	114	404
10	"10-out1533"	.98606	283	4	287
10	"10-out1534"	.37346	487	817	1304
10	"10-out1535"	.44128	124	157	281
10	"10-out1536"	.62944	124	73	197
10	"10-out1537"	.38790	109	172	281
10	"10-out1538"	.47058	160	180	340
10	"10-out1539"	.99425	173	1	174
10	"10-out1540"	.28895	191	470	661
10	"10-out1541"	.91160	165	16	181
10	"10-out1542"	.93292	153	11	164
10	"10-out1543"	.99342	151	1	152
10	"10-out1544"	.68013	202	95	297
10	"10-out1545"	.31707	104	224	328
10	"10-out1546"	.40948	190	274	464
10	"10-out1547"	.99494	197	1	198
10	"10-out1548"	.43157	574	756	1330
10	"10-out1549"	.42273	807	1102	1909
10	"10-out1550"	.25000	111	333	444
10	"10-out1551"	.32488	141	293	434
10	"10-out1552"	.30086	139	323	462
10	"10-out1553"	.54948	1560	1279	2839
10	"10-out1554"	.32450	196	408	604
10	"10-out1555"	.64888	584	316	900
10	"10-out1556"	.89855	186	21	207
10	"10-out1557"	.30963	135	301	436
10	"10-out1558"	.43170	177	233	410
10	"10-out1559"	.13380	19	123	142
10	"10-out1560"	.96969	224	7	231
10	"10-out1561"	.47236	188	210	398
10	"10-out1562"	.39793	193	292	485
10	"10-out1563"	.70731	319	132	451
10	"10-out1564"	.98387	305	5	310
10	"10-out1565"	.71159	264	107	371
10	"10-out1566"	.31135	85	188	273
10	"10-out1567"	.55853	229	181	410
10	"10-out1568"	.62520	377	226	603
10	"10-out1569"	.41049	133	191	324
10	"10-out1570"	.78431	640	176	816
10	"10-out1571"	.42724	276	370	646
10	"10-out1572"	.20662	131	503	634
10	"10-out1573"	.36758	93	160	253
10	"10-out1574"	.51056	145	139	284
10	"10-out1575"	.45849	232	274	506
10	"10-out1576"	.41355	244	346	590
10	"10-out1577"	.53296	97	85	182
10	"10-out1578"	.57103	410	308	718
10	"10-out1579"	.44207	145	183	328
10	"10-out1580"	.37071	119	202	321
10	"10-out1581"	.83200	104	21	125
10	"10-out1582"	.85265	434	75	509
10	"10-out1583"	.31174	361	797	1158
10	"10-out1584"	.48717	95	100	195
10	"10-out1585"	.42562	186	251	437
10	"10-out1586"	.30384	158	362	520
10	"10-out1587"	.38317	164	264	428
10	"10-out1588"	.74838	232	78	310
10	"10-out1589"	.31707	65	140	205
10	"10-out1590"	.93051	308	23	331
10	"10-out1591"	.31847	50	107	157
10	"10-out1592"	.80246	195	48	243
10	"10-out1593"	.94786	600	33	633
10	"10-out1594"	.99686	636	2	638
10	"10-out1595"	.99889	901	1	902
10	"10-out1596"	.42982	49	65	114
10	"10-out1597"	.62903	78	46	124
10	"10-out1598"	.74074	60	21	81
10	"10-out1599"	.47528	125	138	263
10	"10-out1600"	.99590	243	1	244
10	"10-out1601"	.99761	418	1	419
10	"10-out1602"	.26802	171	467	638
10	"10-out1603"	.26358	257	718	975
10	"10-out1604"	.40930	264	381	645
10	"10-out1605"	.43513	426	553	979
10	"10-out1606"	.33028	325	659	984
10	"10-out1607"	.32372	348	727	1075
10	"10-out1608"	.99380	481	3	484
10	"10-out1609"	.35448	162	295	457
10	"10-out1610"	.46650	975	1115	2090
10	"10-out1611"	.59782	165	111	276
10	"10-out1612"	.37198	77	130	207
10	"10-out1613"	.98958	95	1	96
10	"10-out1614"	.61538	136	85	221
10	"10-out1615"	.23865	121	386	507
10	"10-out1616"	.19383	88	366	454
10	"10-out1617"	.33722	289	568	857
10	"10-out1618"	.85564	409	69	478
10	"10-out1619"	.34469	91	173	264
10	"10-out1620"	.98666	74	1	75
10	"10-out1621"	.26059	209	593	802
10	"10-out1622"	.50395	255	251	506
10	"10-out1623"	.99774	442	1	443
10	"10-out1624"	.22542	172	591	763
10	"10-out1625"	.40838	555	804	1359
10	"10-out1626"	.18309	104	464	568
10	"10-out1627"	.30000	129	301	430
10	"10-out1628"	.33948	92	179	271
10	"10-out1629"	.20394	124	484	608
10	"10-out1630"	.31898	815	1740	2555
10	"10-out1631"	.99714	349	1	350
10	"10-out1632"	.98373	363	6	369
10	"10-out1633"	.99714	349	1	350
10	"10-out1634"	.99728	368	1	369
10	"10-out1635"	.99728	368	1	369
10	"10-out1636"	.60280	129	85	214
10	"10-out1637"	.99000	495	5	500
10	"10-out1638"	.38775	76	120	196
10	"10-out1639"	.99393	164	1	165
10	"10-out1640"	.17953	107	489	596
10	"10-out1641"	.36213	176	310	486
10	"10-out1642"	.16359	71	363	434
10	"10-out1643"	.44713	203	251	454
10	"10-out1644"	.71308	169	68	237
10	"10-out1645"	.16901	24	118	142
10	"10-out1646"	.39896	77	116	193
10	"10-out1647"	.99891	920	1	921
10	"10-out1648"	.34602	418	790	1208
10	"10-out1649"	.38726	146	231	377
10	"10-out1650"	.25819	378	1086	1464
10	"10-out1651"	.36528	141	245	386
10	"10-out1652"	.36992	930	1584	2514
10	"10-out1653"	.30366	58	133	191
10	"10-out1654"	.94680	178	10	188
10	"10-out1655"	.60459	263	172	435
10	"10-out1656"	.98780	243	3	246
10	"10-out1657"	.89887	400	45	445
10	"10-out1658"	.59337	197	135	332
10	"10-out1659"	.36859	223	382	605
10	"10-out1660"	.33333	139	278	417
10	"10-out1661"	.26515	140	388	528
10	"10-out1662"	.32255	489	1027	1516
10	"10-out1663"	.31842	121	259	380
10	"10-out1664"	.36607	123	213	336
10	"10-out1665"	.22927	177	595	772
10	"10-out1666"	.30823	217	487	704
10	"10-out1667"	.34533	163	309	472
10	"10-out1668"	.98368	784	13	797
10	"10-out1669"	.34375	132	252	384
10	"10-out1670"	.79812	170	43	213
10	"10-out1671"	.20288	253	994	1247
10	"10-out1672"	.99346	152	1	153
10	"10-out1673"	.31749	147	316	463
10	"10-out1674"	.61262	427	270	697
10	"10-out1675"	.31400	65	142	207
10	"10-out1676"	.28440	124	312	436
10	"10-out1677"	.99918	1221	1	1222
10	"10-out1678"	.99714	349	1	350
10	"10-out1679"	.45505	81	97	178
10	"10-out1680"	.25526	97	283	380
10	"10-out1681"	.24874	99	299	398
10	"10-out1682"	.23622	90	291	381
10	"10-out1683"	.37500	162	270	432
10	"10-out1684"	.35579	132	239	371
10	"10-out1685"	.41406	159	225	384
10	"10-out1686"	.33766	78	153	231
10	"10-out1687"	.98529	67	1	68
10	"10-out1688"	.99082	108	1	109
10	"10-out1689"	.33593	905	1789	2694
10	"10-out1690"	.46632	180	206	386
10	"10-out1691"	.35061	284	526	810
10	"10-out1692"	.99598	248	1	249
10	"10-out1693"	.26190	55	155	210
10	"10-out1694"	.21538	84	306	390
10	"10-out1695"	.28468	197	495	692
10	"10-out1696"	.52292	479	437	916
10	"10-out1697"	.79133	201	53	254
10	"10-out1698"	.38026	343	559	902
10	"10-out1699"	.22013	164	581	745
10	"10-out1700"	.90725	450	46	496
10	"10-out1701"	.28491	102	256	358
10	"10-out1702"	.35009	578	1073	1651
10	"10-out1703"	.33582	1573	3111	4684
10	"10-out1704"	.73428	257	93	350
10	"10-out1705"	.58921	142	99	241
10	"10-out1706"	.40517	94	138	232
10	"10-out1707"	.28195	150	382	532
10	"10-out1708"	.98666	74	1	75
10	"10-out1709"	.25174	361	1073	1434
10	"10-out1710"	.99782	459	1	460
10	"10-out1711"	.99692	324	1	325
10	"10-out1712"	.24901	127	383	510
10	"10-out1713"	.99065	106	1	107
10	"10-out1714"	.48299	71	76	147
10	"10-out1715"	.81660	472	106	578
10	"10-out1716"	.80817	257	61	318
10	"10-out1717"	.27394	143	379	522
10	"10-out1718"	.30645	437	989	1426
10	"10-out1719"	.99823	564	1	565
10	"10-out1720"	.49062	157	163	320
10	"10-out1721"	.30579	211	479	690
10	"10-out1722"	.33029	145	294	439
10	"10-out1723"	.55733	209	166	375
10	"10-out1724"	.24494	109	336	445
10	"10-out1725"	.28865	28	69	97
10	"10-out1726"	.32854	206	421	627
10	"10-out1727"	.50638	238	232	470
10	"10-out1728"	.23475	127	414	541
10	"10-out1729"	.30742	178	401	579
10	"10-out1730"	.19424	27	112	139
10	"10-out1731"	.99762	839	2	841
10	"10-out1732"	.42729	288	386	674
10	"10-out1733"	.30845	62	139	201
10	"10-out1734"	.27532	685	1803	2488
10	"10-out1735"	.32620	778	1607	2385
10	"10-out1736"	.40579	112	164	276
10	"10-out1737"	.21078	86	322	408
10	"10-out1738"	.14341	37	221	258
10	"10-out1739"	.92671	569	45	614
10	"10-out1740"	.54424	1144	958	2102
10	"10-out1741"	.17156	140	676	816
10	"10-out1742"	.40641	76	111	187
10	"10-out1743"	.29640	198	470	668
10	"10-out1744"	.34592	348	658	1006
10	"10-out1745"	.80291	110	27	137
10	"10-out1746"	.13975	58	357	415
10	"10-out1747"	.97260	213	6	219
10	"10-out1748"	.32266	121	254	375
10	"10-out1749"	.36931	130	222	352
10	"10-out1750"	.20312	26	102	128
10	"10-out1751"	.32478	114	237	351
10	"10-out1752"	.98159	800	15	815
10	"10-out1753"	.42687	359	482	841
10	"10-out1754"	.26666	72	198	270
10	"10-out1755"	.62730	170	101	271
10	"10-out1756"	.94663	816	46	862
10	"10-out1757"	.14953	64	364	428
10	"10-out1758"	.21015	149	560	709
10	"10-out1759"	.37982	128	209	337
10	"10-out1760"	.72222	130	50	180
10	"10-out1761"	.98958	95	1	96
10	"10-out1762"	.75099	377	125	502
10	"10-out1763"	.32513	489	1015	1504
10	"10-out1764"	.17619	148	692	840
10	"10-out1765"	.62146	527	321	848
10	"10-out1766"	.28029	192	493	685
10	"10-out1767"	.94259	706	43	749
10	"10-out1768"	.43839	306	392	698
10	"10-out1769"	.25628	163	473	636
10	"10-out1770"	.37103	187	317	504
10	"10-out1771"	.98666	74	1	75
10	"10-out1772"	.51271	1190	1131	2321
10	"10-out1773"	.71217	193	78	271
10	"10-out1774"	.29474	275	658	933
10	"10-out1775"	.28923	94	231	325
10	"10-out1776"	.58309	200	143	343
10	"10-out1777"	.99483	1155	6	1161
10	"10-out1778"	.33739	166	326	492
10	"10-out1779"	.23255	70	231	301
10	"10-out1780"	.31265	388	853	1241
10	"10-out1781"	.99748	396	1	397
10	"10-out1782"	.45427	154	185	339
10	"10-out1783"	.99637	275	1	276
10	"10-out1784"	.40156	1183	1763	2946
10	"10-out1785"	.48780	180	189	369
10	"10-out1786"	.34795	230	431	661
10	"10-out1787"	.31123	169	374	543
10	"10-out1788"	.27777	55	143	198
10	"10-out1789"	.81521	150	34	184
10	"10-out1790"	.18333	77	343	420
10	"10-out1791"	.49367	117	120	237
10	"10-out1792"	.53308	145	127	272
10	"10-out1793"	.30379	120	275	395
10	"10-out1794"	.14622	31	181	212
10	"10-out1795"	.99333	149	1	150
10	"10-out1796"	.28669	125	311	436
10	"10-out1797"	.38064	177	288	465
10	"10-out1798"	.26923	56	152	208
10	"10-out1799"	.32394	69	144	213
10	"10-out1800"	.45964	336	395	731
10	"10-out1801"	.75921	886	281	1167
10	"10-out1802"	.46969	279	315	594
10	"10-out1803"	.24000	132	418	550
10	"10-out1804"	.24935	96	289	385
10	"10-out1805"	.26936	466	1264	1730
10	"10-out1806"	.28070	32	82	114
10	"10-out1807"	.17558	105	493	598
10	"10-out1808"	.48722	305	321	626
10	"10-out1809"	.32754	377	774	1151
10	"10-out1810"	.28951	337	827	1164
10	"10-out1811"	.29843	191	449	640
10	"10-out1812"	.37764	321	529	850
10	"10-out1813"	.40839	107	155	262
10	"10-out1814"	.25652	59	171	230
10	"10-out1815"	.31367	117	256	373
10	"10-out1816"	.34278	145	278	423
10	"10-out1817"	.44917	738	905	1643
10	"10-out1818"	.30701	70	158	228
10	"10-out1819"	.34326	219	419	638
10	"10-out1820"	.99921	1266	1	1267
10	"10-out1821"	.61089	157	100	257
10	"10-out1822"	.46802	322	366	688
10	"10-out1823"	.71673	501	198	699
10	"10-out1824"	.17291	60	287	347
10	"10-out1825"	.35431	152	277	429
10	"10-out1826"	.25930	209	597	806
10	"10-out1827"	.82812	53	11	64
10	"10-out1828"	.19614	61	250	311
10	"10-out1829"	.43079	498	658	1156
10	"10-out1830"	.28276	233	591	824
10	"10-out1831"	.36454	218	380	598
10	"10-out1832"	.29940	150	351	501
10	"10-out1833"	.25233	135	400	535
10	"10-out1834"	.07017	12	159	171
10	"10-out1835"	.22442	147	508	655
10	"10-out1836"	.55844	215	170	385
10	"10-out1837"	.33542	107	212	319
10	"10-out1838"	.99408	168	1	169
10	"10-out1839"	.36020	210	373	583
10	"10-out1840"	.91111	164	16	180
10	"10-out1841"	.79878	131	33	164
10	"10-out1842"	.98461	192	3	195
10	"10-out1843"	.65399	172	91	263
10	"10-out1844"	.33640	219	432	651
10	"10-out1845"	.36222	117	206	323
10	"10-out1846"	.20967	52	196	248
10	"10-out1847"	.18604	56	245	301
10	"10-out1848"	.99725	1453	4	1457
10	"10-out1849"	.97979	97	2	99
10	"10-out1850"	.31117	117	259	376
10	"10-out1851"	.19354	126	525	651
10	"10-out1852"	.37450	191	319	510
10	"10-out1853"	.37063	1020	1732	2752
10	"10-out1854"	.32746	186	382	568
10	"10-out1855"	.17142	12	58	70
10	"10-out1856"	.27368	208	552	760
10	"10-out1857"	.98765	80	1	81
10	"10-out1858"	.99137	115	1	116
10	"10-out1859"	.98979	97	1	98
10	"10-out1860"	.32341	163	341	504
10	"10-out1861"	.41712	458	640	1098
10	"10-out1862"	.26836	95	259	354
10	"10-out1863"	.69702	375	163	538
10	"10-out1864"	.27988	377	970	1347
10	"10-out1865"	.34710	210	395	605
10	"10-out1866"	.94524	656	38	694
10	"10-out1867"	.31728	112	241	353
10	"10-out1868"	.58119	136	98	234
10	"10-out1869"	.48501	178	189	367
10	"10-out1870"	.72452	192	73	265
10	"10-out1871"	.36363	60	105	165
10	"10-out1872"	.27377	167	443	610
10	"10-out1873"	.38405	265	425	690
10	"10-out1874"	.51262	203	193	396
10	"10-out1875"	.44072	145	184	329
10	"10-out1876"	.60000	216	144	360
10	"10-out1877"	.63276	224	130	354
10	"10-out1878"	.34063	171	331	502
10	"10-out1879"	.76838	627	189	816
10	"10-out1880"	.53556	128	111	239
10	"10-out1881"	.38028	108	176	284
10	"10-out1882"	.32517	93	193	286
10	"10-out1883"	.43402	421	549	970
10	"10-out1884"	.99702	335	1	336
10	"10-out1885"	.78571	143	39	182
10	"10-out1886"	.19078	29	123	152
10	"10-out1887"	.96601	398	14	412
10	"10-out1888"	.84283	606	113	719
10	"10-out1889"	.35455	245	446	691
10	"10-out1890"	.38461	270	432	702
10	"10-out1891"	.73745	1014	361	1375
10	"10-out1892"	.56947	750	567	1317
10	"10-out1893"	.54347	425	357	782
10	"10-out1894"	.96008	457	19	476
10	"10-out1895"	.98958	285	3	288
10	"10-out1896"	.98666	74	1	75
10	"10-out1897"	.14285	58	348	406
10	"10-out1898"	.57627	170	125	295
10	"10-out1899"	.46953	316	357	673
10	"10-out1900"	.18579	34	149	183
10	"10-out1901"	.65432	106	56	162
10	"10-out1902"	.99682	314	1	315
10	"10-out1903"	.58807	217	152	369
10	"10-out1904"	.98601	423	6	429
10	"10-out1905"	.42919	391	520	911
10	"10-out1906"	.26133	121	342	463
10	"10-out1907"	.38285	67	108	175
10	"10-out1908"	.63238	332	193	525
10	"10-out1909"	.11581	41	313	354
10	"10-out1910"	.17230	56	269	325
10	"10-out1911"	.78787	130	35	165
10	"10-out1912"	.18726	197	855	1052
10	"10-out1913"	.14655	85	495	580
10	"10-out1914"	.31448	178	388	566
10	"10-out1915"	.43820	78	100	178
10	"10-out1916"	.25166	151	449	600
10	"10-out1917"	.99678	310	1	311
10	"10-out1918"	.57777	156	114	270
10	"10-out1919"	.43902	108	138	246
10	"10-out1920"	.35316	184	337	521
10	"10-out1921"	.28360	308	778	1086
10	"10-out1922"	.35211	275	506	781
10	"10-out1923"	.39176	409	635	1044
10	"10-out1924"	.26826	268	731	999
10	"10-out1925"	.42458	76	103	179
10	"10-out1926"	.46849	461	523	984
10	"10-out1927"	.59310	258	177	435
10	"10-out1928"	.31261	176	387	563
10	"10-out1929"	.42021	79	109	188
10	"10-out1930"	.82857	116	24	140
10	"10-out1931"	.37391	43	72	115
10	"10-out1932"	.26508	145	402	547
10	"10-out1933"	.24946	116	349	465
10	"10-out1934"	.37167	433	732	1165
10	"10-out1935"	.35897	28	50	78
10	"10-out1936"	.31559	172	373	545
10	"10-out1937"	.38632	226	359	585
10	"10-out1938"	.42691	406	545	951
10	"10-out1939"	.38037	345	562	907
10	"10-out1940"	.99779	452	1	453
10	"10-out1941"	.33410	290	578	868
10	"10-out1942"	.46290	468	543	1011
10	"10-out1943"	.98960	476	5	481
10	"10-out1944"	.35173	172	317	489
10	"10-out1945"	.58424	853	607	1460
10	"10-out1946"	.99858	706	1	707
10	"10-out1947"	.99224	128	1	129
10	"10-out1948"	.49019	825	858	1683
10	"10-out1949"	.35892	201	359	560
10	"10-out1950"	.99921	1274	1	1275
10	"10-out1951"	.47735	274	300	574
10	"10-out1952"	.16939	31	152	183
10	"10-out1953"	.32924	295	601	896
10	"10-out1954"	.17320	106	506	612
10	"10-out1955"	.41317	207	294	501
10	"10-out1956"	.99750	399	1	400
10	"10-out1957"	.36313	199	349	548
10	"10-out1958"	.63243	234	136	370
10	"10-out1959"	.41700	103	144	247
10	"10-out1960"	.39000	78	122	200
10	"10-out1961"	.45018	244	298	542
10	"10-out1962"	.34638	230	434	664
10	"10-out1963"	.35395	246	449	695
10	"10-out1964"	.53738	230	198	428
10	"10-out1965"	.36318	146	256	402
10	"10-out1966"	.26896	39	106	145
10	"10-out1967"	.42047	230	317	547
10	"10-out1968"	.61177	1185	752	1937
10	"10-out1969"	.41624	82	115	197
10	"10-out1970"	.46571	360	413	773
10	"10-out1971"	.28286	241	611	852
10	"10-out1972"	.22921	204	686	890
10	"10-out1973"	.23854	203	648	851
10	"10-out1974"	.23036	132	441	573
10	"10-out1975"	.18991	128	546	674
10	"10-out1976"	.26910	162	440	602
10	"10-out1977"	.99683	944	3	947
10	"10-out1978"	.54075	272	231	503
10	"10-out1979"	.28875	231	569	800
10	"10-out1980"	.40822	129	187	316
10	"10-out1981"	.55462	132	106	238
10	"10-out1982"	.93989	344	22	366
10	"10-out1983"	.32854	183	374	557
10	"10-out1984"	.21763	79	284	363
10	"10-out1985"	.25862	105	301	406
10	"10-out1986"	.44360	177	222	399
10	"10-out1987"	.30434	63	144	207
10	"10-out1988"	.30325	205	471	676
10	"10-out1989"	.31613	239	517	756
10	"10-out1990"	.26098	95	269	364
10	"10-out1991"	.32278	622	1305	1927
10	"10-out1992"	.12535	44	307	351
10	"10-out1993"	.44054	226	287	513
10	"10-out1994"	.48734	154	162	316
10	"10-out1995"	.31044	208	462	670
10	"10-out1996"	.22727	45	153	198
10	"10-out1997"	.19531	125	515	640
10	"10-out1998"	.99919	1246	1	1247
10	"10-out1999"	.30422	871	1992	2863
10	"10-out2000"	.26923	203	551	754
10	"10-out2001"	.30800	77	173	250
10	"10-out2002"	.44339	423	531	954
10	"10-out2003"	.13056	132	879	1011
10	"10-out2004"	.33924	287	559	846
10	"10-out2005"	.99808	522	1	523
10	"10-out2006"	.36807	113	194	307
10	"10-out2007"	.31656	472	1019	1491
10	"10-out2008"	.37197	430	726	1156
10	"10-out2009"	.31636	230	497	727
10	"10-out2010"	.68786	119	54	173
10	"10-out2011"	.32683	151	311	462
10	"10-out2012"	.38316	1074	1729	2803
10	"10-out2013"	.35596	173	313	486
10	"10-out2014"	.24375	39	121	160
10	"10-out2015"	.55462	66	53	119
10	"10-out2016"	.99887	891	1	892
10	"10-out2017"	.69223	686	305	991
10	"10-out2018"	.25025	244	731	975
10	"10-out2019"	.19337	105	438	543
10	"10-out2020"	.23185	115	381	496
10	"10-out2021"	.19277	96	402	498
10	"10-out2022"	.28638	122	304	426
10	"10-out2023"	.31292	455	999	1454
10	"10-out2024"	.42650	177	238	415
10	"10-out2025"	.46551	81	93	174
10	"10-out2026"	.54187	427	361	788
10	"10-out2027"	.40364	354	523	877
10	"10-out2028"	.17803	47	217	264
10	"10-out2029"	.20626	204	785	989
10	"10-out2030"	.36641	48	83	131
10	"10-out2031"	.74157	132	46	178
10	"10-out2032"	.40772	95	138	233
10	"10-out2033"	.31232	114	251	365
10	"10-out2034"	.31712	150	323	473
10	"10-out2035"	.20789	237	903	1140
10	"10-out2036"	.47176	284	318	602
10	"10-out2037"	.99822	562	1	563
10	"10-out2038"	.52141	207	190	397
10	"10-out2039"	.97313	326	9	335
10	"10-out2040"	.40856	210	304	514
10	"10-out2041"	.45945	119	140	259
10	"10-out2042"	.99744	391	1	392
10	"10-out2043"	.40476	119	175	294
10	"10-out2044"	.42412	109	148	257
10	"10-out2045"	.51044	171	164	335
10	"10-out2046"	.32909	233	475	708
10	"10-out2047"	.34189	253	487	740
10	"10-out2048"	.45000	162	198	360
10	"10-out2049"	.48579	171	181	352
10	"10-out2050"	.46786	182	207	389
10	"10-out2051"	.99259	134	1	135
10	"10-out2052"	.40707	46	67	113
10	"10-out2053"	.17547	289	1358	1647
10	"10-out2054"	.98427	313	5	318
10	"10-out2055"	.29967	92	215	307
10	"10-out2056"	.53314	185	162	347
10	"10-out2057"	.35506	305	554	859
10	"10-out2058"	.58600	201	142	343
10	"10-out2059"	.99681	313	1	314
10	"10-out2060"	.83596	265	52	317
10	"10-out2061"	.82258	102	22	124
10	"10-out2062"	.45578	201	240	441
10	"10-out2063"	.49700	166	168	334
10	"10-out2064"	.32679	50	103	153
10	"10-out2065"	.36470	124	216	340
10	"10-out2066"	.34840	208	389	597
10	"10-out2067"	.32511	501	1040	1541
10	"10-out2068"	.28414	362	912	1274
10	"10-out2069"	.46666	245	280	525
10	"10-out2070"	.51865	139	129	268
10	"10-out2071"	.97058	66	2	68
10	"10-out2072"	.27986	164	422	586
10	"10-out2073"	.24479	94	290	384
10	"10-out2074"	.41569	143	201	344
10	"10-out2075"	.99576	235	1	236
10	"10-out2076"	.96491	110	4	114
10	"10-out2077"	.84745	100	18	118
10	"10-out2078"	.25757	51	147	198
10	"10-out2079"	.51630	95	89	184
10	"10-out2080"	.99386	162	1	163
10	"10-out2081"	.41714	73	102	175
10	"10-out2082"	.99431	175	1	176
10	"10-out2083"	.33056	199	403	602
10	"10-out2084"	.35000	28	52	80
10	"10-out2085"	.21897	90	321	411
10	"10-out2086"	.14745	55	318	373
10	"10-out2087"	.59337	197	135	332
10	"10-out2088"	.79640	266	68	334
10	"10-out2089"	.87048	289	43	332
10	"10-out2090"	.98630	144	2	146
10	"10-out2091"	.45824	225	266	491
10	"10-out2092"	.21257	142	526	668
10	"10-out2093"	.57519	218	161	379
10	"10-out2094"	.16267	68	350	418
10	"10-out2095"	.92349	338	28	366
10	"10-out2096"	.42962	116	154	270
10	"10-out2097"	.39130	72	112	184
10	"10-out2098"	.41363	91	129	220
10	"10-out2099"	.43208	474	623	1097
10	"10-out2100"	.37637	446	739	1185
10	"10-out2101"	.76271	225	70	295
10	"10-out2102"	.40380	361	533	894
10	"10-out2103"	.48470	206	219	425
10	"10-out2104"	.31914	45	96	141
10	"10-out2105"	.30097	62	144	206
10	"10-out2106"	.44329	645	810	1455
10	"10-out2107"	.41208	75	107	182
10	"10-out2108"	.92156	141	12	153
10	"10-out2109"	.30568	129	293	422
10	"10-out2110"	.73972	108	38	146
10	"10-out2111"	.35724	259	466	725
10	"10-out2112"	.29613	207	492	699
10	"10-out2113"	.48684	222	234	456
10	"10-out2114"	.97788	398	9	407
10	"10-out2115"	.33096	186	376	562
10	"10-out2116"	.30701	140	316	456
10	"10-out2117"	.48997	220	229	449
10	"10-out2118"	.46911	243	275	518
10	"10-out2119"	.34028	261	506	767
10	"10-out2120"	.41504	171	241	412
10	"10-out2121"	.27333	123	327	450
10	"10-out2122"	.95804	411	18	429
10	"10-out2123"	.86003	2163	352	2515
10	"10-out2124"	.99058	526	5	531
10	"10-out2125"	.31641	106	229	335
10	"10-out2126"	.33832	158	309	467
10	"10-out2127"	.33098	47	95	142
10	"10-out2128"	.82704	526	110	636
10	"10-out2129"	.47133	222	249	471
10	"10-out2130"	.99799	498	1	499
10	"10-out2131"	.24882	106	320	426
10	"10-out2132"	.97460	307	8	315
10	"10-out2133"	.40064	125	187	312
10	"10-out2134"	.97427	303	8	311
10	"10-out2135"	.31452	184	401	585
10	"10-out2136"	.28348	127	321	448
10	"10-out2137"	.46496	146	168	314
10	"10-out2138"	.31736	106	228	334
10	"10-out2139"	.35365	116	212	328
10	"10-out2140"	.89308	284	34	318
10	"10-out2141"	.88000	462	63	525
10	"10-out2142"	.28020	698	1793	2491
10	"10-out2143"	.50318	158	156	314
10	"10-out2144"	.31528	99	215	314
10	"10-out2145"	.95129	293	15	308
10	"10-out2146"	.93979	640	41	681
10	"10-out2147"	.99657	291	1	292
10	"10-out2148"	.99827	579	1	580
10	"10-out2149"	.30491	93	212	305
10	"10-out2150"	.99636	274	1	275
10	"10-out2151"	.20520	134	519	653
10	"10-out2152"	.35135	91	168	259
10	"10-out2153"	.39420	136	209	345
10	"10-out2154"	.19459	72	298	370
10	"10-out2155"	.81349	205	47	252
10	"10-out2156"	.99280	138	1	139
10	"10-out2157"	.39753	258	391	649
10	"10-out2158"	.33108	98	198	296
10	"10-out2159"	.30886	101	226	327
10	"10-out2160"	.98989	196	2	198
10	"10-out2161"	.26215	178	501	679
10	"10-out2162"	.25625	205	595	800
10	"10-out2163"	.79310	299	78	377
10	"10-out2164"	.25878	162	464	626
10	"10-out2165"	.33333	112	224	336
10	"10-out2166"	.58204	188	135	323
10	"10-out2167"	.33770	464	910	1374
10	"10-out2168"	.43399	263	343	606
10	"10-out2169"	.26897	163	443	606
10	"10-out2170"	.99750	400	1	401
10	"10-out2171"	.28955	97	238	335
10	"10-out2172"	.84756	139	25	164
10	"10-out2173"	.37582	398	661	1059
10	"10-out2174"	.14026	85	521	606
10	"10-out2175"	.40158	304	453	757
10	"10-out2176"	.37688	150	248	398
10	"10-out2177"	.34042	144	279	423
10	"10-out2178"	.46721	171	195	366
10	"10-out2179"	.30576	122	277	399
10	"10-out2180"	.30497	190	433	623
10	"10-out2181"	.49053	311	323	634
10	"10-out2182"	.46481	251	289	540
10	"10-out2183"	.27123	99	266	365
10	"10-out2184"	.28395	161	406	567
10	"10-out2185"	.28405	196	494	690
10	"10-out2186"	.58000	145	105	250
10	"10-out2187"	.36459	723	1260	1983
10	"10-out2188"	.50000	377	377	754
10	"10-out2189"	.84294	263	49	312
10	"10-out2190"	.28552	215	538	753
10	"10-out2191"	.99242	131	1	132
10	"10-out2192"	.43041	600	794	1394
10	"10-out2193"	.50144	174	173	347
10	"10-out2194"	.26086	48	136	184
10	"10-out2195"	.54178	188	159	347
10	"10-out2196"	.48432	139	148	287
10	"10-out2197"	.40962	281	405	686
10	"10-out2198"	.27777	85	221	306
10	"10-out2199"	.29579	331	788	1119
10	"10-out2200"	.50678	523	509	1032
10	"10-out2201"	.28382	86	217	303
10	"10-out2202"	.99319	146	1	147
10	"10-out2203"	.34684	77	145	222
10	"10-out2204"	.62557	137	82	219
10	"10-out2205"	.99264	135	1	136
10	"10-out2206"	.78389	185	51	236
10	"10-out2207"	.68028	483	227	710
10	"10-out2208"	.60884	702	451	1153
10	"10-out2209"	.43696	1019	1313	2332
10	"10-out2210"	.32957	964	1961	2925
10	"10-out2211"	.43605	208	269	477
10	"10-out2212"	.29359	165	397	562
10	"10-out2213"	.21235	306	1135	1441
10	"10-out2214"	.33451	282	561	843
10	"10-out2215"	.40780	230	334	564
10	"10-out2216"	.75259	362	119	481
10	"10-out2217"	.37653	215	356	571
10	"10-out2218"	.22522	100	344	444
10	"10-out2219"	.99915	1184	1	1185
10	"10-out2220"	.24827	108	327	435
10	"10-out2221"	.15972	23	121	144
10	"10-out2222"	.60402	90	59	149
10	"10-out2223"	.45517	66	79	145
10	"10-out2224"	.32954	58	118	176
10	"10-out2225"	.81914	154	34	188
10	"10-out2226"	.30375	202	463	665
10	"10-out2227"	.40422	268	395	663
10	"10-out2228"	.20512	96	372	468
10	"10-out2229"	.31256	301	662	963
10	"10-out2230"	.23059	205	684	889
10	"10-out2231"	.34723	308	579	887
10	"10-out2232"	.26622	361	995	1356
10	"10-out2233"	.27652	86	225	311
10	"10-out2234"	.39042	212	331	543
10	"10-out2235"	.87071	330	49	379
10	"10-out2236"	.30494	111	253	364
10	"10-out2237"	.24471	81	250	331
10	"10-out2238"	.31404	152	332	484
10	"10-out2239"	.99601	250	1	251
10	"10-out2240"	.72058	49	19	68
10	"10-out2241"	.51123	182	174	356
10	"10-out2242"	.98619	786	11	797
10	"10-out2243"	.98120	783	15	798
10	"10-out2244"	.87325	813	118	931
10	"10-out2245"	.96060	756	31	787
10	"10-out2246"	.16589	72	362	434
10	"10-out2247"	.31618	338	731	1069
10	"10-out2248"	.87629	843	119	962
10	"10-out2249"	.88830	843	106	949
10	"10-out2250"	.27872	228	590	818
10	"10-out2251"	.68796	549	249	798
10	"10-out2252"	.33984	87	169	256
10	"10-out2253"	.34285	120	230	350
10	"10-out2254"	.37500	141	235	376
10	"10-out2255"	.32209	191	402	593
10	"10-out2256"	.21739	75	270	345
10	"10-out2257"	.99728	367	1	368
10	"10-out2258"	.90285	474	51	525
10	"10-out2259"	.39534	255	390	645
10	"10-out2260"	.35838	186	333	519
10	"10-out2261"	.31143	128	283	411
10	"10-out2262"	.61555	823	514	1337
10	"10-out2263"	.37802	547	900	1447
10	"10-out2264"	.61310	290	183	473
10	"10-out2265"	.34358	134	256	390
10	"10-out2266"	.42290	96	131	227
10	"10-out2267"	.99751	401	1	402
10	"10-out2268"	.99864	737	1	738
10	"10-out2269"	.42768	346	463	809
10	"10-out2270"	.84121	498	94	592
10	"10-out2271"	.43818	280	359	639
10	"10-out2272"	.28473	166	417	583
10	"10-out2273"	.42656	456	613	1069
10	"10-out2274"	.45966	245	288	533
10	"10-out2275"	.29441	174	417	591
10	"10-out2276"	.26307	317	888	1205
10	"10-out2277"	.28220	241	613	854
10	"10-out2278"	.20234	69	272	341
10	"10-out2279"	.44268	896	1128	2024
10	"10-out2280"	.26093	167	473	640
10	"10-out2281"	.52380	187	170	357
10	"10-out2282"	.40947	1366	1970	3336
10	"10-out2283"	.28006	489	1257	1746
10	"10-out2284"	.42622	442	595	1037
10	"10-out2285"	.18660	78	340	418
10	"10-out2286"	.64124	454	254	708
10	"10-out2287"	.61538	112	70	182
10	"10-out2288"	.32013	97	206	303
10	"10-out2289"	.33076	43	87	130
10	"10-out2290"	.24415	94	291	385
10	"10-out2291"	.20138	87	345	432
10	"10-out2292"	.29127	217	528	745
10	"10-out2293"	.33721	405	796	1201
10	"10-out2294"	.35294	240	440	680
10	"10-out2295"	.30769	60	135	195
10	"10-out2296"	.99864	736	1	737
10	"10-out2297"	.39375	126	194	320
10	"10-out2298"	.79133	201	53	254
10	"10-out2299"	.46564	244	280	524
10	"10-out2300"	.59808	125	84	209
10	"10-out2301"	.94164	355	22	377
10	"10-out2302"	.29304	80	193	273
10	"10-out2303"	.19393	64	266	330
10	"10-out2304"	.24933	94	283	377
10	"10-out2305"	.70370	133	56	189
10	"10-out2306"	.84512	1457	267	1724
10	"10-out2307"	.11764	46	345	391
10	"10-out2308"	.25111	113	337	450
10	"10-out2309"	.63013	230	135	365
10	"10-out2310"	.98113	780	15	795
10	"10-out2311"	.96847	768	25	793
10	"10-out2312"	.30711	164	370	534
10	"10-out2313"	.98750	790	10	800
10	"10-out2314"	.98117	782	15	797
10	"10-out2315"	.44485	242	302	544
10	"10-out2316"	.87810	814	113	927
10	"10-out2317"	.97293	755	21	776
10	"10-out2318"	.88842	844	106	950
10	"10-out2319"	.87553	816	116	932
10	"10-out2320"	.87339	814	118	932
10	"10-out2321"	.57261	481	359	840
10	"10-out2322"	.89373	841	100	941
10	"10-out2323"	.33811	165	323	488
10	"10-out2324"	.64569	667	366	1033
10	"10-out2325"	.46453	596	687	1283
10	"10-out2326"	.40259	62	92	154
10	"10-out2327"	.99492	196	1	197
10	"10-out2328"	.38992	147	230	377
10	"10-out2329"	.27724	173	451	624
10	"10-out2330"	.36868	664	1137	1801
10	"10-out2331"	.36725	249	429	678
10	"10-out2332"	.19689	76	310	386
10	"10-out2333"	.44214	256	323	579
10	"10-out2334"	.24000	102	323	425
10	"10-out2335"	.30271	145	334	479
10	"10-out2336"	.60882	207	133	340
10	"10-out2337"	.34931	590	1099	1689
10	"10-out2338"	.36633	185	320	505
10	"10-out2339"	.97994	782	16	798
10	"10-out2340"	.60930	262	168	430
10	"10-out2341"	.88631	842	108	950
10	"10-out2342"	.22174	208	730	938
10	"10-out2343"	.84245	893	167	1060
10	"10-out2344"	.87660	817	115	932
10	"10-out2345"	.37092	148	251	399
10	"10-out2346"	.19034	134	570	704
10	"10-out2347"	.88818	842	106	948
10	"10-out2348"	.96984	772	24	796
10	"10-out2349"	.40165	243	362	605
10	"10-out2350"	.98507	396	6	402
10	"10-out2351"	.19553	70	288	358
10	"10-out2352"	.97326	182	5	187
10	"10-out2353"	.78521	223	61	284
10	"10-out2354"	.38505	268	428	696
10	"10-out2355"	.23938	62	197	259
10	"10-out2356"	.33386	209	417	626
10	"10-out2357"	.66233	102	52	154
10	"10-out2358"	.38673	379	601	980
10	"10-out2359"	.39009	126	197	323
10	"10-out2360"	.98507	132	2	134
10	"10-out2361"	.19358	151	629	780
10	"10-out2362"	.98412	186	3	189
10	"10-out2363"	.73356	2365	859	3224
10	"10-out2364"	.44793	413	509	922
10	"10-out2365"	.33333	65	130	195
10	"10-out2366"	.22284	80	279	359
10	"10-out2367"	.30102	59	137	196
10	"10-out2368"	.44794	284	350	634
10	"10-out2369"	.66750	267	133	400
10	"10-out2370"	.60723	235	152	387
10	"10-out2371"	.71886	762	298	1060
10	"10-out2372"	.28861	71	175	246
10	"10-out2373"	.38322	658	1059	1717
10	"10-out2374"	.99503	1202	6	1208
10	"10-out2375"	.36528	362	629	991
10	"10-out2376"	.99236	130	1	131
10	"10-out2377"	.23642	74	239	313
10	"10-out2378"	.30225	94	217	311
10	"10-out2379"	.85582	279	47	326
10	"10-out2380"	.96000	96	4	100
10	"10-out2381"	.27751	116	302	418
10	"10-out2382"	.36704	98	169	267
10	"10-out2383"	.97680	379	9	388
10	"10-out2384"	.37807	200	329	529
10	"10-out2385"	.29118	426	1037	1463
10	"10-out2386"	.29445	154	369	523
10	"10-out2387"	.29954	526	1230	1756
10	"10-out2388"	.27927	155	400	555
10	"10-out2389"	.83811	497	96	593
10	"10-out2390"	.83213	347	70	417
10	"10-out2391"	.17088	189	917	1106
10	"10-out2392"	.13397	28	181	209
10	"10-out2393"	.24826	143	433	576
10	"10-out2394"	.37388	209	350	559
10	"10-out2395"	.35754	251	451	702
10	"10-out2396"	.23469	92	300	392
10	"10-out2397"	.29521	111	265	376
10	"10-out2398"	.37037	210	357	567
10	"10-out2399"	.30327	380	873	1253
10	"10-out2400"	.97680	379	9	388
10	"10-out2401"	.56060	148	116	264
10	"10-out2402"	.93442	114	8	122
10	"10-out2403"	.37377	114	191	305
10	"10-out2404"	.37533	140	233	373
10	"10-out2405"	.28150	105	268	373
10	"10-out2406"	.40202	357	531	888
10	"10-out2407"	.27758	161	419	580
10	"10-out2408"	.97808	982	22	1004
10	"10-out2409"	.23517	238	774	1012
10	"10-out2410"	.86746	432	66	498
10	"10-out2411"	.26108	106	300	406
10	"10-out2412"	.26462	95	264	359
10	"10-out2413"	.22948	179	601	780
10	"10-out2414"	.43581	258	334	592
10	"10-out2415"	.20502	106	411	517
10	"10-out2416"	.56797	188	143	331
10	"10-out2417"	.47241	274	306	580
10	"10-out2418"	.45017	253	309	562
10	"10-out2419"	.97794	266	6	272
10	"10-out2420"	.36212	109	192	301
10	"10-out2421"	.64781	710	386	1096
10	"10-out2422"	.39038	796	1243	2039
10	"10-out2423"	.34462	346	658	1004
10	"10-out2424"	.27034	103	278	381
10	"10-out2425"	.36583	484	839	1323
10	"10-out2426"	.99773	441	1	442
10	"10-out2427"	.56211	181	141	322
10	"10-out2428"	.34064	404	782	1186
10	"10-out2429"	.31818	77	165	242
10	"10-out2430"	.28453	276	694	970
10	"10-out2431"	.30319	114	262	376
10	"10-out2432"	.24823	282	854	1136
10	"10-out2433"	.39357	196	302	498
10	"10-out2434"	.99367	157	1	158
10	"10-out2435"	.60544	356	232	588
10	"10-out2436"	.36337	254	445	699
10	"10-out2437"	.99430	349	2	351
10	"10-out2438"	.99650	855	3	858
10	"10-out2439"	.99947	3841	2	3843
10	"10-out2440"	.21463	220	805	1025
10	"10-out2441"	.26925	388	1053	1441
10	"10-out2442"	.37227	239	403	642
10	"10-out2443"	.32747	149	306	455
10	"10-out2444"	.32653	128	264	392
10	"10-out2445"	.51620	223	209	432
10	"10-out2446"	.36826	123	211	334
10	"10-out2447"	.95454	105	5	110
10	"10-out2448"	.85393	76	13	89
10	"10-out2449"	.97826	90	2	92
10	"10-out2450"	.37846	123	202	325
10	"10-out2451"	.37551	273	454	727
10	"10-out2452"	.43072	143	189	332
10	"10-out2453"	.34714	176	331	507
10	"10-out2454"	.24309	44	137	181
10	"10-out2455"	.76589	566	173	739
10	"10-out2456"	.61290	38	24	62
10	"10-out2457"	.99730	370	1	371
10	"10-out2458"	.23216	166	549	715
10	"10-out2459"	.36871	198	339	537
10	"10-out2460"	.33084	133	269	402
10	"10-out2461"	.37438	152	254	406
10	"10-out2462"	.38582	49	78	127
10	"10-out2463"	.28455	70	176	246
10	"10-out2464"	.34255	260	499	759
10	"10-out2465"	.42043	502	692	1194
10	"10-out2466"	.56060	148	116	264
10	"10-out2467"	.25149	42	125	167
10	"10-out2468"	.20862	121	459	580
10	"10-out2469"	.40864	208	301	509
10	"10-out2470"	.55251	121	98	219
10	"10-out2471"	.46205	274	319	593
10	"10-out2472"	.64615	210	115	325
10	"10-out2473"	.21700	74	267	341
10	"10-out2474"	.34068	170	329	499
10	"10-out2475"	.96114	470	19	489
10	"10-out2476"	.92132	445	38	483
10	"10-out2477"	.99832	597	1	598
10	"10-out2478"	.22315	106	369	475
10	"10-out2479"	.78728	681	184	865
10	"10-out2480"	.42696	76	102	178
10	"10-out2481"	.81339	170	39	209
10	"10-out2482"	.33379	243	485	728
10	"10-out2483"	.46546	310	356	666
10	"10-out2484"	.92877	326	25	351
10	"10-out2485"	.21794	85	305	390
10	"10-out2486"	.28967	115	282	397
10	"10-out2487"	.53400	212	185	397
10	"10-out2488"	.26724	31	85	116
10	"10-out2489"	.56521	260	200	460
10	"10-out2490"	.51030	198	190	388
10	"10-out2491"	.36793	241	414	655
10	"10-out2492"	.20000	141	564	705
10	"10-out2493"	.46460	105	121	226
10	"10-out2494"	.48969	95	99	194
10	"10-out2495"	.35977	127	226	353
10	"10-out2496"	.41930	278	385	663
10	"10-out2497"	.53488	184	160	344
10	"10-out2498"	.68731	455	207	662
10	"10-out2499"	.51145	67	64	131
10	"10-out2500"	.66968	148	73	221
10	"10-out2501"	.99404	167	1	168
10	"10-out2502"	.19614	61	250	311
10	"10-out2503"	.21067	75	281	356
10	"10-out2504"	.32456	74	154	228
10	"10-out2505"	.76054	956	301	1257
10	"10-out2506"	.31970	344	732	1076
10	"10-out2507"	.27272	123	328	451
10	"10-out2508"	.40000	186	279	465
10	"10-out2509"	.46680	218	249	467
10	"10-out2510"	.77560	318	92	410
10	"10-out2511"	.99776	447	1	448
10	"10-out2512"	.23602	38	123	161
10	"10-out2513"	.50445	170	167	337
10	"10-out2514"	.18085	51	231	282
10	"10-out2515"	.59523	25	17	42
10	"10-out2516"	.44897	220	270	490
10	"10-out2517"	.26946	405	1098	1503
10	"10-out2518"	.32460	124	258	382
10	"10-out2519"	.32423	190	396	586
10	"10-out2520"	.19761	166	674	840
10	"10-out2521"	.22946	95	319	414
10	"10-out2522"	.47338	249	277	526
10	"10-out2523"	.27272	45	120	165
10	"10-out2524"	.99180	121	1	122
10	"10-out2525"	.38218	133	215	348
10	"10-out2526"	.35294	180	330	510
10	"10-out2527"	.13366	27	175	202
10	"10-out2528"	.18870	117	503	620
10	"10-out2529"	.48479	287	305	592
10	"10-out2530"	.41397	154	218	372
10	"10-out2531"	.53761	343	295	638
10	"10-out2532"	.29534	355	847	1202
10	"10-out2533"	.28426	56	141	197
10	"10-out2534"	.52238	245	224	469
10	"10-out2535"	.99491	587	3	590
10	"10-out2536"	.45414	624	750	1374
10	"10-out2537"	.19382	69	287	356
10	"10-out2538"	.64444	1247	688	1935
10	"10-out2539"	.44864	166	204	370
10	"10-out2540"	.26356	204	570	774
10	"10-out2541"	.29198	153	371	524
10	"10-out2542"	.56677	174	133	307
10	"10-out2543"	.46511	160	184	344
10	"10-out2544"	.41544	113	159	272
10	"10-out2545"	.26256	209	587	796
10	"10-out2546"	.23478	54	176	230
10	"10-out2547"	.21140	63	235	298
10	"10-out2548"	.31106	163	361	524
10	"10-out2549"	.25301	147	434	581
10	"10-out2550"	.17110	122	591	713
10	"10-out2551"	.40713	1850	2694	4544
10	"10-out2552"	.28813	170	420	590
10	"10-out2553"	.99019	101	1	102
10	"10-out2554"	.36216	134	236	370
10	"10-out2555"	.29725	195	461	656
10	"10-out2556"	.45283	264	319	583
10	"10-out2557"	.36147	471	832	1303
10	"10-out2558"	.46335	411	476	887
10	"10-out2559"	.99333	149	1	150
10	"10-out2560"	.42638	753	1013	1766
10	"10-out2561"	.14460	71	420	491
10	"10-out2562"	.99371	158	1	159
10	"10-out2563"	.33439	105	209	314
10	"10-out2564"	.99581	238	1	239
10	"10-out2565"	.24034	168	531	699
10	"10-out2566"	.19979	193	773	966
10	"10-out2567"	.33598	211	417	628
10	"10-out2568"	.26273	98	275	373
10	"10-out2569"	.47689	227	249	476
10	"10-out2570"	.47727	84	92	176
10	"10-out2571"	.62790	189	112	301
10	"10-out2572"	.25247	204	604	808
10	"10-out2573"	.34900	193	360	553
10	"10-out2574"	.29432	254	609	863
10	"10-out2575"	.19891	146	588	734
10	"10-out2576"	.26923	91	247	338
10	"10-out2577"	.54272	578	487	1065
10	"10-out2578"	.59646	1113	753	1866
10	"10-out2579"	.44364	248	311	559
10	"10-out2580"	.30995	221	492	713
10	"10-out2581"	.34848	299	559	858
10	"10-out2582"	.99479	191	1	192
10	"10-out2583"	.30714	172	388	560
10	"10-out2584"	.33379	243	485	728
10	"10-out2585"	.76595	108	33	141
10	"10-out2586"	.61994	230	141	371
10	"10-out2587"	.99145	116	1	117
10	"10-out2588"	.99186	122	1	123
10	"10-out2589"	.99193	123	1	124
10	"10-out2590"	.99180	121	1	122
10	"10-out2591"	.99186	122	1	123
10	"10-out2592"	.37387	83	139	222
10	"10-out2593"	.38308	77	124	201
10	"10-out2594"	.44020	173	220	393
10	"10-out2595"	.61860	133	82	215
10	"10-out2596"	.30484	264	602	866
10	"10-out2597"	.45789	87	103	190
10	"10-out2598"	.33439	105	209	314
10	"10-out2599"	.99242	131	1	132
10	"10-out2600"	.61538	96	60	156
10	"10-out2601"	.27370	228	605	833
10	"10-out2602"	.36463	299	521	820
10	"10-out2603"	.51437	519	490	1009
10	"10-out2604"	.47398	164	182	346
10	"10-out2605"	.61849	214	132	346
10	"10-out2606"	.99135	344	3	347
10	"10-out2607"	.58950	191	133	324
10	"10-out2608"	.30907	497	1111	1608
10	"10-out2609"	.99681	313	1	314
10	"10-out2610"	.41260	347	494	841
10	"10-out2611"	.53196	466	410	876
10	"10-out2612"	.65765	219	114	333
10	"10-out2613"	.29658	382	906	1288
10	"10-out2614"	.28571	178	445	623
10	"10-out2615"	.99953	2155	1	2156
10	"10-out2616"	.33655	383	755	1138
10	"10-out2617"	.47107	114	128	242
10	"10-out2618"	.27240	152	406	558
10	"10-out2619"	.54923	251	206	457
10	"10-out2620"	.23106	61	203	264
10	"10-out2621"	.25703	137	396	533
10	"10-out2622"	.42983	389	516	905
10	"10-out2623"	.34455	133	253	386
10	"10-out2624"	.49009	272	283	555
10	"10-out2625"	.75200	94	31	125
10	"10-out2626"	.16559	103	519	622
10	"10-out2627"	.81936	694	153	847
10	"10-out2628"	.25696	83	240	323
10	"10-out2629"	.26546	103	285	388
10	"10-out2630"	.87931	153	21	174
10	"10-out2631"	.13114	8	53	61
10	"10-out2632"	.44800	112	138	250
10	"10-out2633"	.39730	236	358	594
10	"10-out2634"	.71824	311	122	433
10	"10-out2635"	.33195	321	646	967
10	"10-out2636"	.63983	151	85	236
10	"10-out2637"	.41789	313	436	749
10	"10-out2638"	.45064	105	128	233
10	"10-out2639"	.23287	204	672	876
10	"10-out2640"	.35497	82	149	231
10	"10-out2641"	.26381	105	293	398
10	"10-out2642"	.98861	434	5	439
10	"10-out2643"	.57216	111	83	194
10	"10-out2644"	.95721	604	27	631
10	"10-out2645"	.32762	153	314	467
10	"10-out2646"	.49795	976	984	1960
10	"10-out2647"	.32742	314	645	959
10	"10-out2648"	.45641	89	106	195
10	"10-out2649"	.97687	169	4	173
10	"10-out2650"	.69230	144	64	208
10	"10-out2651"	.85430	129	22	151
10	"10-out2652"	.69186	119	53	172
10	"10-out2653"	.38339	291	468	759
10	"10-out2654"	.22060	456	1611	2067
10	"10-out2655"	.37634	140	232	372
10	"10-out2656"	.31519	139	302	441
10	"10-out2657"	.68596	557	255	812
10	"10-out2658"	.23770	116	372	488
10	"10-out2659"	.35202	113	208	321
10	"10-out2660"	.39622	210	320	530
10	"10-out2661"	.38751	298	471	769
10	"10-out2662"	.45063	283	345	628
10	"10-out2663"	.35905	228	407	635
10	"10-out2664"	.25647	99	287	386
10	"10-out2665"	.16613	52	261	313
10	"10-out2666"	.73491	341	123	464
10	"10-out2667"	.41318	257	365	622
10	"10-out2668"	.31680	1457	3142	4599
10	"10-out2669"	.25276	435	1286	1721
10	"10-out2670"	.99193	123	1	124
10	"10-out2671"	.99130	114	1	115
10	"10-out2672"	.99107	111	1	112
10	"10-out2673"	.33472	80	159	239
10	"10-out2674"	.99186	122	1	123
10	"10-out2675"	.31460	84	183	267
10	"10-out2676"	.31336	136	298	434
10	"10-out2677"	.17200	86	414	500
10	"10-out2678"	.47721	178	195	373
10	"10-out2679"	.81563	407	92	499
10	"10-out2680"	.97658	292	7	299
10	"10-out2681"	.92461	601	49	650
10	"10-out2682"	.40589	248	363	611
10	"10-out2683"	.42564	332	448	780
10	"10-out2684"	.19653	34	139	173
10	"10-out2685"	.99873	787	1	788
10	"10-out2686"	.34354	213	407	620
10	"10-out2687"	.32333	194	406	600
10	"10-out2688"	.42313	289	394	683
10	"10-out2689"	.99371	158	1	159
10	"10-out2690"	.32319	255	534	789
10	"10-out2691"	.16811	58	287	345
10	"10-out2692"	.44183	338	427	765
10	"10-out2693"	.45756	248	294	542
10	"10-out2694"	.18699	23	100	123
10	"10-out2695"	.27507	181	477	658
10	"10-out2696"	.99130	114	1	115
10	"10-out2697"	.99130	114	1	115
10	"10-out2698"	.21654	89	322	411
10	"10-out2699"	.34862	114	213	327
10	"10-out2700"	.33557	350	693	1043
10	"10-out2701"	.32936	360	733	1093
10	"10-out2702"	.28250	491	1247	1738
10	"10-out2703"	.99811	1060	2	1062
10	"10-out2704"	.99835	1212	2	1214
10	"10-out2705"	.23492	74	241	315
10	"10-out2706"	.26655	632	1739	2371
10	"10-out2707"	.93203	192	14	206
10	"10-out2708"	.44031	332	422	754
10	"10-out2709"	.25000	161	483	644
10	"10-out2710"	.35602	136	246	382
10	"10-out2711"	.30049	122	284	406
10	"10-out2712"	.16864	71	350	421
10	"10-out2713"	.99324	588	4	592
10	"10-out2714"	.42907	121	161	282
10	"10-out2715"	.28343	178	450	628
10	"10-out2716"	.96217	407	16	423
10	"10-out2717"	.67088	106	52	158
10	"10-out2718"	.17820	103	475	578
10	"10-out2719"	.50537	94	92	186
10	"10-out2720"	.91472	118	11	129
10	"10-out2721"	.97183	69	2	71
10	"10-out2722"	.24915	220	663	883
10	"10-out2723"	.32031	41	87	128
10	"10-out2724"	.46341	152	176	328
10	"10-out2725"	.43421	33	43	76
10	"10-out2726"	.45378	54	65	119
10	"10-out2727"	.39727	524	795	1319
10	"10-out2728"	.40828	414	600	1014
10	"10-out2729"	.84800	106	19	125
10	"10-out2730"	.25377	84	247	331
10	"10-out2731"	.24056	51	161	212
10	"10-out2732"	.24731	46	140	186
10	"10-out2733"	.31578	48	104	152
10	"10-out2734"	.67763	103	49	152
10	"10-out2735"	.31006	453	1008	1461
10	"10-out2736"	.29614	223	530	753
10	"10-out2737"	.50096	259	258	517
10	"10-out2738"	.35098	179	331	510
10	"10-out2739"	.24353	113	351	464
10	"10-out2740"	.19536	59	243	302
10	"10-out2741"	.29322	173	417	590
10	"10-out2742"	.32733	291	598	889
10	"10-out2743"	.50740	137	133	270
10	"10-out2744"	.39895	229	345	574
10	"10-out2745"	.24910	279	841	1120
10	"10-out2746"	.17402	130	617	747
10	"10-out2747"	.85357	752	129	881
10	"10-out2748"	.99441	178	1	179
10	"10-out2749"	.19502	47	194	241
10	"10-out2750"	.27424	82	217	299
10	"10-out2751"	.39234	574	889	1463
10	"10-out2752"	.27600	138	362	500
10	"10-out2753"	.32145	442	933	1375
10	"10-out2754"	.31698	252	543	795
10	"10-out2755"	.35883	333	595	928
10	"10-out2756"	.36461	272	474	746
10	"10-out2757"	.88053	457	62	519
10	"10-out2758"	.32441	473	985	1458
10	"10-out2759"	.32440	230	479	709
10	"10-out2760"	.32894	50	102	152
10	"10-out2761"	.22604	92	315	407
10	"10-out2762"	.99115	112	1	113
10	"10-out2763"	.40307	210	311	521
10	"10-out2764"	.30243	62	143	205
10	"10-out2765"	.25573	78	227	305
10	"10-out2766"	.31931	281	599	880
10	"10-out2767"	.35311	119	218	337
10	"10-out2768"	.17406	98	465	563
10	"10-out2769"	.40679	443	646	1089
10	"10-out2770"	.44444	44	55	99
10	"10-out2771"	.58333	49	35	84
10	"10-out2772"	.85192	420	73	493
10	"10-out2773"	.99827	578	1	579
10	"10-out2774"	.34862	304	568	872
10	"10-out2775"	.52906	91	81	172
10	"10-out2776"	.70588	108	45	153
10	"10-out2777"	.95857	162	7	169
10	"10-out2778"	.93396	99	7	106
10	"10-out2779"	.42845	539	719	1258
10	"10-out2780"	.72300	154	59	213
10	"10-out2781"	.35294	84	154	238
10	"10-out2782"	.25404	330	969	1299
10	"10-out2783"	.51329	251	238	489
10	"10-out2784"	.34357	313	598	911
10	"10-out2785"	.25714	81	234	315
10	"10-out2786"	.21126	150	560	710
10	"10-out2787"	.23592	88	285	373
10	"10-out2788"	.41221	162	231	393
10	"10-out2789"	.99658	292	1	293
10	"10-out2790"	.17543	80	376	456
10	"10-out2791"	.29394	102	245	347
10	"10-out2792"	.40650	50	73	123
10	"10-out2793"	.65217	75	40	115
10	"10-out2794"	.43600	218	282	500
10	"10-out2795"	.78222	1972	549	2521
10	"10-out2796"	.68013	202	95	297
10	"10-out2797"	.27873	274	709	983
10	"10-out2798"	.43501	405	526	931
10	"10-out2799"	.35338	47	86	133
10	"10-out2800"	.40972	59	85	144
10	"10-out2801"	.22522	125	430	555
10	"10-out2802"	.19047	20	85	105
10	"10-out2803"	.38759	100	158	258
10	"10-out2804"	.26455	50	139	189
10	"10-out2805"	.32413	94	196	290
10	"10-out2806"	.55555	175	140	315
10	"10-out2807"	.38785	83	131	214
10	"10-out2808"	.98148	53	1	54
10	"10-out2809"	.34090	135	261	396
10	"10-out2810"	.35968	182	324	506
10	"10-out2811"	.38979	214	335	549
10	"10-out2812"	.27397	40	106	146
10	"10-out2813"	.38030	251	409	660
10	"10-out2814"	.41295	389	553	942
10	"10-out2815"	.32400	243	507	750
10	"10-out2816"	.25984	132	376	508
10	"10-out2817"	.52888	357	318	675
10	"10-out2818"	.43181	114	150	264
10	"10-out2819"	.42307	33	45	78
10	"10-out2820"	.27089	94	253	347
10	"10-out2821"	.53239	304	267	571
10	"10-out2822"	.29503	475	1135	1610
10	"10-out2823"	.63090	147	86	233
10	"10-out2824"	.51651	172	161	333
10	"10-out2825"	.98333	236	4	240
10	"10-out2826"	.93670	148	10	158
10	"10-out2827"	.49315	144	148	292
10	"10-out2828"	.41293	166	236	402
10	"10-out2829"	.36382	171	299	470
10	"10-out2830"	.32763	479	983	1462
10	"10-out2831"	.98783	406	5	411
10	"10-out2832"	.26086	252	714	966
10	"10-out2833"	.39226	71	110	181
10	"10-out2834"	.33691	282	555	837
10	"10-out2835"	.35427	468	853	1321
10	"10-out2836"	.37391	129	216	345
10	"10-out2837"	.56563	237	182	419
10	"10-out2838"	.27656	432	1130	1562
10	"10-out2839"	.75000	96	32	128
10	"10-out2840"	.33333	218	436	654
10	"10-out2841"	.83235	854	172	1026
10	"10-out2842"	.20039	102	407	509
10	"10-out2843"	.27392	312	827	1139
10	"10-out2844"	.39072	59	92	151
10	"10-out2845"	.41588	89	125	214
10	"10-out2846"	.75945	221	70	291
10	"10-out2847"	.45197	80	97	177
10	"10-out2848"	.31680	230	496	726
10	"10-out2849"	.98969	96	1	97
10	"10-out2850"	.45623	172	205	377
10	"10-out2851"	.41606	575	807	1382
10	"10-out2852"	.20489	67	260	327
10	"10-out2853"	.62454	173	104	277
10	"10-out2854"	.23076	48	160	208
10	"10-out2855"	.76144	316	99	415
10	"10-out2856"	.38339	194	312	506
10	"10-out2857"	.42994	359	476	835
10	"10-out2858"	.43956	160	204	364
10	"10-out2859"	.32618	152	314	466
10	"10-out2860"	.54817	165	136	301
10	"10-out2861"	.37910	1063	1741	2804
10	"10-out2862"	.43820	78	100	178
10	"10-out2863"	.34642	397	749	1146
10	"10-out2864"	.16945	81	397	478
10	"10-out2865"	.23275	189	623	812
10	"10-out2866"	.96178	453	18	471
10	"10-out2867"	.44858	506	622	1128
10	"10-out2868"	.99559	226	1	227
10	"10-out2869"	.99744	390	1	391
10	"10-out2870"	.99726	365	1	366
10	"10-out2871"	.13483	48	308	356
10	"10-out2872"	.36082	490	868	1358
10	"10-out2873"	.24519	102	314	416
10	"10-out2874"	.23668	40	129	169
10	"10-out2875"	.25925	140	400	540
10	"10-out2876"	.27914	182	470	652
10	"10-out2877"	.23015	58	194	252
10	"10-out2878"	.30727	114	257	371
10	"10-out2879"	.99270	136	1	137
10	"10-out2880"	.18934	167	715	882
10	"10-out2881"	.34936	305	568	873
10	"10-out2882"	.26842	102	278	380
10	"10-out2883"	.70348	121	51	172
10	"10-out2884"	.73454	202	73	275
10	"10-out2885"	.45762	324	384	708
10	"10-out2886"	.67491	791	381	1172
10	"10-out2887"	.36860	209	358	567
10	"10-out2888"	.36206	210	370	580
10	"10-out2889"	.45033	730	891	1621
10	"10-out2890"	.30486	282	643	925
10	"10-out2891"	.21686	90	325	415
10	"10-out2892"	.29855	289	679	968
10	"10-out2893"	.98947	94	1	95
10	"10-out2894"	.29593	815	1939	2754
10	"10-out2895"	.18684	71	309	380
10	"10-out2896"	.99668	301	1	302
10	"10-out2897"	.33121	364	735	1099
10	"10-out2898"	.32181	149	314	463
10	"10-out2899"	.67041	417	205	622
10	"10-out2900"	.98854	259	3	262
10	"10-out2901"	.83096	467	95	562
10	"10-out2902"	.42131	166	228	394
10	"10-out2903"	.29146	181	440	621
10	"10-out2904"	.40951	310	447	757
10	"10-out2905"	.45241	290	351	641
10	"10-out2906"	.44765	248	306	554
10	"10-out2907"	.33165	198	399	597
10	"10-out2908"	.29044	237	579	816
10	"10-out2909"	.71339	229	92	321
10	"10-out2910"	.92519	235	19	254
10	"10-out2911"	.48884	526	550	1076
10	"10-out2912"	.23322	73	240	313
10	"10-out2913"	.37539	354	589	943
10	"10-out2914"	.38914	86	135	221
10	"10-out2915"	.47808	240	262	502
10	"10-out2916"	.23859	68	217	285
10	"10-out2917"	.99618	261	1	262
10	"10-out2918"	.56379	327	253	580
10	"10-out2919"	.30254	190	438	628
10	"10-out2920"	.40000	68	102	170
10	"10-out2921"	.34030	521	1010	1531
10	"10-out2922"	.65065	298	160	458
10	"10-out2923"	.50167	598	594	1192
10	"10-out2924"	.32142	162	342	504
10	"10-out2925"	.26072	79	224	303
10	"10-out2926"	.64243	1193	664	1857
10	"10-out2927"	.51219	42	40	82
10	"10-out2928"	.39917	386	581	967
10	"10-out2929"	.55555	140	112	252
10	"10-out2930"	.31392	151	330	481
10	"10-out2931"	.56692	72	55	127
10	"10-out2932"	.84858	269	48	317
10	"10-out2933"	.50479	158	155	313
10	"10-out2934"	.99035	308	3	311
10	"10-out2935"	.99698	331	1	332
10	"10-out2936"	.51940	174	161	335
10	"10-out2937"	.36825	116	199	315
10	"10-out2938"	.49305	284	292	576
10	"10-out2939"	.44409	143	179	322
10	"10-out2940"	.45141	144	175	319
10	"10-out2941"	.33653	105	207	312
10	"10-out2942"	.64826	317	172	489
10	"10-out2943"	.85873	231	38	269
10	"10-out2944"	.52580	163	147	310
10	"10-out2945"	.89677	278	32	310
10	"10-out2946"	.74683	236	80	316
10	"10-out2947"	.39329	129	199	328
10	"10-out2948"	.49850	167	168	335
10	"10-out2949"	.75000	240	80	320
10	"10-out2950"	.95192	297	15	312
10	"10-out2951"	.93750	300	20	320
10	"10-out2952"	.90220	286	31	317
10	"10-out2953"	.95937	307	13	320
10	"10-out2954"	.96226	306	12	318
10	"10-out2955"	.95356	308	15	323
10	"10-out2956"	.95792	296	13	309
10	"10-out2957"	.48709	151	159	310
10	"10-out2958"	.49843	159	160	319
10	"10-out2959"	.46783	160	182	342
10	"10-out2960"	.37579	118	196	314
10	"10-out2961"	.38699	125	198	323
10	"10-out2962"	.27217	89	238	327
10	"10-out2963"	.44025	140	178	318
10	"10-out2964"	.97727	301	7	308
10	"10-out2965"	.76615	249	76	325
10	"10-out2966"	.71339	229	92	321
10	"10-out2967"	.44688	122	151	273
10	"10-out2968"	.29346	211	508	719
10	"10-out2969"	.99725	1452	4	1456
10	"10-out2970"	.37580	292	485	777
10	"10-out2971"	.27098	184	495	679
10	"10-out2972"	.23476	181	590	771
10	"10-out2973"	.24320	197	613	810
10	"10-out2974"	.60846	115	74	189
10	"10-out2975"	.30517	112	255	367
10	"10-out2976"	.36893	190	325	515
10	"10-out2977"	.27245	549	1466	2015
10	"10-out2978"	.39572	1000	1527	2527
10	"10-out2979"	.35018	97	180	277
10	"10-out2980"	.27969	146	376	522
10	"10-out2981"	.79207	640	168	808
10	"10-out2982"	.32881	534	1090	1624
10	"10-out2983"	.16272	55	283	338
10	"10-out2984"	.99115	112	1	113
10	"10-out2985"	.49894	237	238	475
10	"10-out2986"	.41853	280	389	669
10	"10-out2987"	.36375	550	962	1512
10	"10-out2988"	.99193	123	1	124
10	"10-out2989"	.46093	118	138	256
10	"10-out2990"	.57254	367	274	641
10	"10-out2991"	.32115	334	706	1040
10	"10-out2992"	.32428	203	423	626
10	"10-out2993"	.42460	3137	4251	7388
10	"10-out2994"	.19444	77	319	396
10	"10-out2995"	.67539	258	124	382
10	"10-out2996"	.37532	292	486	778
10	"10-out2997"	.47904	160	174	334
10	"10-out2998"	.32969	272	553	825
10	"10-out2999"	.34894	231	431	662
10	"10-out3000"	.91549	975	90	1065
10	"10-out3001"	.41801	232	323	555
10	"10-out3002"	.31358	217	475	692
10	"10-out3003"	.29172	208	505	713
10	"10-out3004"	.23282	200	659	859
10	"10-out3005"	.19822	67	271	338
10	"10-out3006"	.36308	179	314	493
10	"10-out3007"	.21648	155	561	716
10	"10-out3008"	.99931	1452	1	1453
10	"10-out3009"	.24704	1150	3505	4655
10	"10-out3010"	.24784	144	437	581
10	"10-out3011"	.99487	194	1	195
10	"10-out3012"	.36883	284	486	770
10	"10-out3013"	.32388	617	1288	1905
10	"10-out3014"	.22442	362	1251	1613
10	"10-out3015"	.42361	366	498	864
10	"10-out3016"	.21944	79	281	360
10	"10-out3017"	.20437	28	109	137
10	"10-out3018"	.36000	45	80	125
10	"10-out3019"	.98989	98	1	99
10	"10-out3020"	.99180	121	1	122
10	"10-out3021"	.99166	119	1	120
10	"10-out3022"	.32075	170	360	530
10	"10-out3023"	.36700	1395	2406	3801
10	"10-out3024"	.99690	322	1	323
10	"10-out3025"	.71774	178	70	248
10	"10-out3026"	.94385	1429	85	1514
10	"10-out3027"	.34272	292	560	852
10	"10-out3028"	.37090	102	173	275
10	"10-out3029"	.98295	173	3	176
10	"10-out3030"	.35240	234	430	664
10	"10-out3031"	.35433	360	656	1016
10	"10-out3032"	.49898	739	742	1481
10	"10-out3033"	.21113	91	340	431
10	"10-out3034"	.16870	179	882	1061
10	"10-out3035"	.99568	231	1	232
10	"10-out3036"	.94148	177	11	188
10	"10-out3037"	.99672	304	1	305
10	"10-out3038"	.99743	389	1	390
10	"10-out3039"	.68493	400	184	584
10	"10-out3040"	.32352	33	69	102
10	"10-out3041"	.48421	92	98	190
10	"10-out3042"	.98076	153	3	156
10	"10-out3043"	.35040	855	1585	2440
10	"10-out3044"	.99867	753	1	754
10	"10-out3045"	.41098	374	536	910
10	"10-out3046"	.74380	360	124	484
10	"10-out3047"	.39340	155	239	394
10	"10-out3048"	.29973	229	535	764
10	"10-out3049"	.74137	43	15	58
10	"10-out3050"	.70949	127	52	179
10	"10-out3051"	.36893	76	130	206
10	"10-out3052"	.89497	784	92	876
10	"10-out3053"	.99869	1528	2	1530
10	"10-out3054"	.24843	159	481	640
10	"10-out3055"	.30819	609	1367	1976
10	"10-out3056"	.38574	184	293	477
10	"10-out3057"	.33483	149	296	445
10	"10-out3058"	.32927	379	772	1151
10	"10-out3059"	.26029	297	844	1141
10	"10-out3060"	.50429	235	231	466
10	"10-out3061"	.45977	880	1034	1914
10	"10-out3062"	.25045	275	823	1098
10	"10-out3063"	.32270	81	170	251
10	"10-out3064"	.34857	183	342	525
10	"10-out3065"	.75115	649	215	864
10	"10-out3066"	.74446	437	150	587
10	"10-out3067"	.84679	304	55	359
10	"10-out3068"	.20408	20	78	98
10	"10-out3069"	.37592	965	1602	2567
10	"10-out3070"	.44500	267	333	600
10	"10-out3071"	.26518	572	1585	2157
10	"10-out3072"	.29320	285	687	972
10	"10-out3073"	.91627	197	18	215
10	"10-out3074"	.42839	341	455	796
10	"10-out3075"	.35740	99	178	277
10	"10-out3076"	.78923	352	94	446
10	"10-out3077"	.43181	76	100	176
10	"10-out3078"	.37419	232	388	620
10	"10-out3079"	.35578	206	373	579
10	"10-out3080"	.41538	189	266	455
10	"10-out3081"	.33590	174	344	518
10	"10-out3082"	.70547	103	43	146
10	"10-out3083"	.60645	282	183	465
10	"10-out3084"	.32617	987	2039	3026
10	"10-out3085"	.31400	65	142	207
10	"10-out3086"	.28602	133	332	465
10	"10-out3087"	.98979	97	1	98
10	"10-out3088"	.99782	458	1	459
10	"10-out3089"	.32692	51	105	156
10	"10-out3090"	.51760	485	452	937
10	"10-out3091"	.20833	55	209	264
10	"10-out3092"	.30292	269	619	888
10	"10-out3093"	.16666	41	205	246
10	"10-out3094"	.41987	131	181	312
10	"10-out3095"	.99649	284	1	285
10	"10-out3096"	.24929	88	265	353
10	"10-out3097"	.54420	911	763	1674
10	"10-out3098"	.34321	544	1041	1585
10	"10-out3099"	.72610	957	361	1318
10	"10-out3100"	.99860	718	1	719
10	"10-out3101"	.24913	358	1079	1437
10	"10-out3102"	.52361	787	716	1503
10	"10-out3103"	.86610	207	32	239
10	"10-out3104"	.42964	400	531	931
10	"10-out3105"	.36393	329	575	904
10	"10-out3106"	.96420	431	16	447
10	"10-out3107"	.36500	73	127	200
10	"10-out3108"	.22571	158	542	700
10	"10-out3109"	.36691	732	1263	1995
10	"10-out3110"	.43548	108	140	248
10	"10-out3111"	.43711	358	461	819
10	"10-out3112"	.28125	63	161	224
10	"10-out3113"	.28316	301	762	1063
10	"10-out3114"	.23595	42	136	178
10	"10-out3115"	.38490	306	489	795
10	"10-out3116"	.49595	245	249	494
10	"10-out3117"	.41081	304	436	740
10	"10-out3118"	.72580	180	68	248
10	"10-out3119"	.92951	211	16	227
10	"10-out3120"	.28019	58	149	207
10	"10-out3121"	.99729	1108	3	1111
10	"10-out3122"	.27115	157	422	579
10	"10-out3123"	.34819	328	614	942
10	"10-out3124"	.34943	651	1212	1863
10	"10-out3125"	.47530	308	340	648
10	"10-out3126"	.37632	283	469	752
10	"10-out3127"	.86407	89	14	103
10	"10-out3128"	.61275	269	170	439
10	"10-out3129"	.31213	54	119	173
10	"10-out3130"	.25131	238	709	947
10	"10-out3131"	.45686	143	170	313
10	"10-out3132"	.53917	1046	894	1940
10	"10-out3133"	.34807	299	560	859
10	"10-out3134"	.33719	378	743	1121
10	"10-out3135"	.99367	157	1	158
10	"10-out3136"	.46961	170	192	362
10	"10-out3137"	.36951	320	546	866
10	"10-out3138"	.22960	121	406	527
10	"10-out3139"	.35013	132	245	377
10	"10-out3140"	.99654	866	3	869
10	"10-out3141"	.25822	204	586	790
10	"10-out3142"	.30969	441	983	1424
10	"10-out3143"	.27506	310	817	1127
10	"10-out3144"	.31313	646	1417	2063
10	"10-out3145"	.32921	213	434	647
10	"10-out3146"	.98290	115	2	117
10	"10-out3147"	.98290	115	2	117
10	"10-out3148"	.45152	489	594	1083
10	"10-out3149"	.31835	170	364	534
10	"10-out3150"	.33476	234	465	699
10	"10-out3151"	.32316	233	488	721
10	"10-out3152"	.25311	183	540	723
10	"10-out3153"	.31983	308	655	963
10	"10-out3154"	.17391	28	133	161
10	"10-out3155"	.85714	78	13	91
10	"10-out3156"	.99159	118	1	119
10	"10-out3157"	.99145	116	1	117
10	"10-out3158"	.33561	49	97	146
10	"10-out3159"	.65934	240	124	364
10	"10-out3160"	.99186	2805	23	2828
10	"10-out3161"	.99509	203	1	204
10	"10-out3162"	.14956	156	887	1043
10	"10-out3163"	.39729	880	1335	2215
10	"10-out3164"	.32275	61	128	189
10	"10-out3165"	.94686	695	39	734
10	"10-out3166"	.40847	723	1047	1770
10	"10-out3167"	.22365	225	781	1006
10	"10-out3168"	.26326	268	750	1018
10	"10-out3169"	.20064	186	741	927
10	"10-out3170"	.83778	408	79	487
10	"10-out3171"	.98604	212	3	215
10	"10-out3172"	.66666	614	307	921
10	"10-out3173"	.47023	158	178	336
10	"10-out3174"	.44796	198	244	442
10	"10-out3175"	.36302	375	658	1033
10	"10-out3176"	.30270	224	516	740
10	"10-out3177"	.31891	317	677	994
10	"10-out3178"	.25666	308	892	1200
10	"10-out3179"	.36416	63	110	173
10	"10-out3180"	.99672	304	1	305
10	"10-out3181"	.99656	290	1	291
10	"10-out3182"	.87563	690	98	788
10	"10-out3183"	.99961	5205	2	5207
10	"10-out3184"	.46405	71	82	153
10	"10-out3185"	.35741	1672	3006	4678
10	"10-out3186"	.26759	251	687	938
10	"10-out3187"	.62029	1204	737	1941
10	"10-out3188"	.39103	506	788	1294
10	"10-out3189"	.45454	60	72	132
10	"10-out3190"	.71603	817	324	1141
10	"10-out3191"	.23390	298	976	1274
10	"10-out3192"	.34651	447	843	1290
10	"10-out3193"	.48309	400	428	828
10	"10-out3194"	.98809	83	1	84
10	"10-out3195"	.39150	682	1060	1742
10	"10-out3196"	.17732	183	849	1032
10	"10-out3197"	.36286	86	151	237
10	"10-out3198"	.29257	67	162	229
10	"10-out3199"	.39285	352	544	896
10	"10-out3200"	.35662	347	626	973
10	"10-out3201"	.99755	408	1	409
10	"10-out3202"	.30813	106	238	344
10	"10-out3203"	.99897	979	1	980
10	"10-out3204"	.23091	242	806	1048
10	"10-out3205"	.79109	231	61	292
10	"10-out3206"	.20289	28	110	138
10	"10-out3207"	.38377	175	281	456
10	"10-out3208"	.99671	303	1	304
10	"10-out3209"	.34523	648	1229	1877
10	"10-out3210"	.36119	121	214	335
10	"10-out3211"	.43715	80	103	183
10	"10-out3212"	.32394	161	336	497
10	"10-out3213"	.56962	45	34	79
10	"10-out3214"	.99489	195	1	196
10	"10-out3215"	.76190	240	75	315
10	"10-out3216"	.36000	243	432	675
10	"10-out3217"	.59548	290	197	487
10	"10-out3218"	.40594	205	300	505
10	"10-out3219"	.72466	379	144	523
10	"10-out3220"	.68553	218	100	318
10	"10-out3221"	.88741	134	17	151
10	"10-out3222"	.84591	269	49	318
10	"10-out3223"	.34853	107	200	307
10	"10-out3224"	.40584	125	183	308
10	"10-out3225"	.43016	77	102	179
10	"10-out3226"	.96784	301	10	311
10	"10-out3227"	.31627	68	147	215
10	"10-out3228"	.82677	105	22	127
10	"10-out3229"	.99367	157	1	158
10	"10-out3230"	.72903	226	84	310
10	"10-out3231"	.35913	116	207	323
10	"10-out3232"	.70886	224	92	316
10	"10-out3233"	.72865	239	89	328
10	"10-out3234"	.96784	301	10	311
10	"10-out3235"	.96116	297	12	309
10	"10-out3236"	.44871	140	172	312
10	"10-out3237"	.91475	279	26	305
10	"10-out3238"	.95192	297	15	312
10	"10-out3239"	.95846	300	13	313
10	"10-out3240"	.93929	294	19	313
10	"10-out3241"	.55128	172	140	312
10	"10-out3242"	.92307	288	24	312
10	"10-out3243"	.33438	106	211	317
10	"10-out3244"	.44904	141	173	314
10	"10-out3245"	.42307	132	180	312
10	"10-out3246"	.42944	140	186	326
10	"10-out3247"	.47039	143	161	304
10	"10-out3248"	.48101	152	164	316
10	"10-out3249"	.54166	169	143	312
10	"10-out3250"	.92660	303	24	327
10	"10-out3251"	.76677	240	73	313
10	"10-out3252"	.64375	206	114	320
10	"10-out3253"	.95192	198	10	208
10	"10-out3254"	.23711	115	370	485
10	"10-out3255"	.33818	93	182	275
10	"10-out3256"	.25288	263	777	1040
10	"10-out3257"	.33104	818	1653	2471
10	"10-out3258"	.32100	729	1542	2271
10	"10-out3259"	.52717	194	174	368
10	"10-out3260"	.45339	647	780	1427
10	"10-out3261"	.32132	107	226	333
10	"10-out3262"	.36325	437	766	1203
10	"10-out3263"	.59661	176	119	295
10	"10-out3264"	.22986	214	717	931
10	"10-out3265"	.31226	494	1088	1582
10	"10-out3266"	.12658	10	69	79
10	"10-out3267"	.93548	522	36	558
10	"10-out3268"	.27326	373	992	1365
10	"10-out3269"	.20977	73	275	348
10	"10-out3270"	.99386	162	1	163
10	"10-out3271"	.32183	28	59	87
10	"10-out3272"	.93902	154	10	164
10	"10-out3273"	.55955	202	159	361
10	"10-out3274"	.16860	29	143	172
10	"10-out3275"	.37215	131	221	352
10	"10-out3276"	.35251	245	450	695
10	"10-out3277"	.29746	94	222	316
10	"10-out3278"	.99504	201	1	202
10	"10-out3279"	.41401	195	276	471
10	"10-out3280"	.19587	76	312	388
10	"10-out3281"	.31283	117	257	374
10	"10-out3282"	.41520	142	200	342
10	"10-out3283"	.44067	156	198	354
10	"10-out3284"	.10187	38	335	373
10	"10-out3285"	.36885	533	912	1445
10	"10-out3286"	.38043	280	456	736
10	"10-out3287"	.41666	295	413	708
10	"10-out3288"	.41983	309	427	736
10	"10-out3289"	.30798	81	182	263
10	"10-out3290"	.99580	475	2	477
10	"10-out3291"	.46760	397	452	849
10	"10-out3292"	.99868	760	1	761
10	"10-out3293"	.46055	181	212	393
10	"10-out3294"	.26617	181	499	680
10	"10-out3295"	.22116	140	493	633
10	"10-out3296"	.27348	198	526	724
10	"10-out3297"	.31868	232	496	728
10	"10-out3298"	.27702	41	107	148
10	"10-out3299"	.99746	393	1	394
10	"10-out3300"	.20289	28	110	138
10	"10-out3301"	.45918	180	212	392
10	"10-out3302"	.85895	542	89	631
10	"10-out3303"	.51086	329	315	644
10	"10-out3304"	.46335	177	205	382
10	"10-out3305"	.40970	304	438	742
10	"10-out3306"	.39064	259	404	663
10	"10-out3307"	.25102	122	364	486
10	"10-out3308"	.31626	210	454	664
10	"10-out3309"	.34797	103	193	296
10	"10-out3310"	.40322	100	148	248
10	"10-out3311"	.98414	683	11	694
10	"10-out3312"	.99811	530	1	531
10	"10-out3313"	.55855	62	49	111
10	"10-out3314"	.21683	85	307	392
10	"10-out3315"	.32653	144	297	441
10	"10-out3316"	.63698	93	53	146
10	"10-out3317"	.99099	110	1	111
10	"10-out3318"	.35398	40	73	113
10	"10-out3319"	.73684	70	25	95
10	"10-out3320"	.92899	314	24	338
10	"10-out3321"	.26016	32	91	123
10	"10-out3322"	.98956	474	5	479
10	"10-out3323"	.29357	160	385	545
10	"10-out3324"	.58015	304	220	524
10	"10-out3325"	.73265	433	158	591
10	"10-out3326"	.96951	159	5	164
10	"10-out3327"	.96951	159	5	164
10	"10-out3328"	.98170	161	3	164
10	"10-out3329"	.34738	412	774	1186
10	"10-out3330"	.43456	601	782	1383
10	"10-out3331"	.36147	137	242	379
10	"10-out3332"	.31007	120	267	387
10	"10-out3333"	.42140	252	346	598
10	"10-out3334"	.28175	173	441	614
10	"10-out3335"	.84000	168	32	200
10	"10-out3336"	.35378	248	453	701
10	"10-out3337"	.31677	102	220	322
10	"10-out3338"	.57600	216	159	375
10	"10-out3339"	.73372	744	270	1014
10	"10-out3340"	.56395	194	150	344
10	"10-out3341"	.39294	156	241	397
10	"10-out3342"	.26783	184	503	687
10	"10-out3343"	.20698	77	295	372
10	"10-out3344"	.27688	103	269	372
10	"10-out3345"	.99570	232	1	233
10	"10-out3346"	.43184	396	521	917
10	"10-out3347"	.34827	435	814	1249
10	"10-out3348"	.20299	95	373	468
10	"10-out3349"	.52727	116	104	220
10	"10-out3350"	.96078	49	2	51
10	"10-out3351"	.29263	139	336	475
10	"10-out3352"	.86294	913	145	1058
10	"10-out3353"	.48088	327	353	680
10	"10-out3354"	.33797	97	190	287
10	"10-out3355"	.99687	319	1	320
10	"10-out3356"	.98360	60	1	61
10	"10-out3357"	.15079	19	107	126
10	"10-out3358"	.26858	354	964	1318
10	"10-out3359"	.57031	365	275	640
10	"10-out3360"	.42958	302	401	703
10	"10-out3361"	.98275	57	1	58
10	"10-out3362"	.38363	272	437	709
10	"10-out3363"	.99431	175	1	176
10	"10-out3364"	.30788	121	272	393
10	"10-out3365"	.29661	35	83	118
10	"10-out3366"	.50299	168	166	334
10	"10-out3367"	.99593	245	1	246
10	"10-out3368"	.73728	87	31	118
10	"10-out3369"	.26666	44	121	165
10	"10-out3370"	.56302	134	104	238
10	"10-out3371"	.21243	41	152	193
10	"10-out3372"	.45893	95	112	207
10	"10-out3373"	.29090	48	117	165
10	"10-out3374"	.28330	302	764	1066
10	"10-out3375"	.99619	262	1	263
10	"10-out3376"	.99065	106	1	107
10	"10-out3377"	.99408	168	1	169
10	"10-out3378"	.48387	45	48	93
10	"10-out3379"	.57425	58	43	101
10	"10-out3380"	.40934	447	645	1092
10	"10-out3381"	.77419	264	77	341
10	"10-out3382"	.32639	909	1876	2785
10	"10-out3383"	.46774	58	66	124
10	"10-out3384"	.99832	596	1	597
10	"10-out3385"	.45350	317	382	699
10	"10-out3386"	.29039	124	303	427
10	"10-out3387"	.99173	120	1	121
10	"10-out3388"	.99462	185	1	186
10	"10-out3389"	.53448	124	108	232
10	"10-out3390"	.30041	292	680	972
10	"10-out3391"	.18012	29	132	161
10	"10-out3392"	.79268	130	34	164
10	"10-out3393"	.41349	435	617	1052
10	"10-out3394"	.36734	54	93	147
10	"10-out3395"	.25702	183	529	712
10	"10-out3396"	.41585	467	656	1123
10	"10-out3397"	.33503	328	651	979
10	"10-out3398"	.99720	357	1	358
10	"10-out3399"	.31268	106	233	339
10	"10-out3400"	.52914	118	105	223
10	"10-out3401"	.34467	152	289	441
10	"10-out3402"	.24274	159	496	655
10	"10-out3403"	.99635	273	1	274
10	"10-out3404"	.99621	526	2	528
10	"10-out3405"	.26282	82	230	312
10	"10-out3406"	.99056	525	5	530
10	"10-out3407"	.69706	214	93	307
10	"10-out3408"	.54225	77	65	142
10	"10-out3409"	.27717	431	1124	1555
10	"10-out3410"	.38319	561	903	1464
10	"10-out3411"	.73316	588	214	802
10	"10-out3412"	.48113	153	165	318
10	"10-out3413"	.42837	308	411	719
10	"10-out3414"	.98301	521	9	530
10	"10-out3415"	.49250	263	271	534
10	"10-out3416"	.99590	243	1	244
10	"10-out3417"	.99593	245	1	246
10	"10-out3418"	.51639	126	118	244
10	"10-out3419"	.99700	333	1	334
10	"10-out3420"	.96341	237	9	246
10	"10-out3421"	.34459	357	679	1036
10	"10-out3422"	.33474	158	314	472
10	"10-out3423"	.23750	114	366	480
10	"10-out3424"	.35230	780	1434	2214
10	"10-out3425"	.38990	425	665	1090
10	"10-out3426"	.27648	261	683	944
10	"10-out3427"	.31041	289	642	931
10	"10-out3428"	.38949	178	279	457
10	"10-out3429"	.44626	710	881	1591
10	"10-out3430"	.49420	128	131	259
10	"10-out3431"	.35154	296	546	842
10	"10-out3432"	.21720	207	746	953
10	"10-out3433"	.28425	749	1886	2635
10	"10-out3434"	.25659	836	2422	3258
10	"10-out3435"	.35185	285	525	810
10	"10-out3436"	.96820	609	20	629
10	"10-out3437"	.36174	1095	1932	3027
10	"10-out3438"	.35491	148	269	417
10	"10-out3439"	.43589	187	242	429
10	"10-out3440"	.45848	254	300	554
10	"10-out3441"	.73819	344	122	466
10	"10-out3442"	.21808	41	147	188
10	"10-out3443"	.45454	75	90	165
10	"10-out3444"	.28750	46	114	160
10	"10-out3445"	.31446	50	109	159
10	"10-out3446"	.28498	167	419	586
10	"10-out3447"	.37714	307	507	814
10	"10-out3448"	.32478	38	79	117
10	"10-out3449"	.89949	707	79	786
10	"10-out3450"	.34716	92	173	265
10	"10-out3451"	.31418	93	203	296
10	"10-out3452"	.68393	515	238	753
10	"10-out3453"	.34120	130	251	381
10	"10-out3454"	.99890	913	1	914
10	"10-out3455"	.32563	409	847	1256
10	"10-out3456"	.99841	631	1	632
10	"10-out3457"	.47940	291	316	607
10	"10-out3458"	.29238	438	1060	1498
10	"10-out3459"	.29769	142	335	477
10	"10-out3460"	.40902	299	432	731
10	"10-out3461"	.88588	295	38	333
10	"10-out3462"	.25631	132	383	515
10	"10-out3463"	.17391	76	361	437
10	"10-out3464"	.38961	60	94	154
10	"10-out3465"	.35180	127	234	361
10	"10-out3466"	.32589	263	544	807
10	"10-out3467"	.31439	321	700	1021
10	"10-out3468"	.46519	274	315	589
10	"10-out3469"	.58685	250	176	426
10	"10-out3470"	.96805	394	13	407
10	"10-out3471"	.36018	76	135	211
10	"10-out3472"	.86067	383	62	445
10	"10-out3473"	.30930	103	230	333
10	"10-out3474"	.22097	59	208	267
10	"10-out3475"	.35233	136	250	386
10	"10-out3476"	.68921	428	193	621
10	"10-out3477"	.99267	542	4	546
10	"10-out3478"	.29181	82	199	281
10	"10-out3479"	.52506	199	180	379
10	"10-out3480"	.50113	221	220	441
10	"10-out3481"	.28971	383	939	1322
10	"10-out3482"	.53307	137	120	257
10	"10-out3483"	.99856	698	1	699
10	"10-out3484"	.32233	127	267	394
10	"10-out3485"	.38074	348	566	914
10	"10-out3486"	.56872	331	251	582
10	"10-out3487"	.40801	224	325	549
10	"10-out3488"	.27586	40	105	145
10	"10-out3489"	.25259	73	216	289
10	"10-out3490"	.23934	73	232	305
10	"10-out3491"	.70121	230	98	328
10	"10-out3492"	.65750	263	137	400
10	"10-out3493"	.99855	692	1	693
10	"10-out3494"	.99855	692	1	693
10	"10-out3495"	.99834	602	1	603
10	"10-out3496"	.99664	595	2	597
10	"10-out3497"	.99767	429	1	430
10	"10-out3498"	.36898	376	643	1019
10	"10-out3499"	.39072	177	276	453
10	"10-out3500"	.40000	198	297	495
10	"10-out3501"	.20652	19	73	92
10	"10-out3502"	.33000	33	67	100
10	"10-out3503"	.35930	166	296	462
10	"10-out3504"	.31472	124	270	394
10	"10-out3505"	.28863	127	313	440
10	"10-out3506"	.29203	132	320	452
10	"10-out3507"	.99851	674	1	675
10	"10-out3508"	.52000	130	120	250
10	"10-out3509"	.63207	134	78	212
10	"10-out3510"	.99242	131	1	132
10	"10-out3511"	.34169	109	210	319
10	"10-out3512"	.98123	366	7	373
10	"10-out3513"	.45619	151	180	331
10	"10-out3514"	.42933	404	537	941
10	"10-out3515"	.24583	236	724	960
10	"10-out3516"	.55414	174	140	314
10	"10-out3517"	.45200	226	274	500
10	"10-out3518"	.28723	81	201	282
10	"10-out3519"	.87184	449	66	515
10	"10-out3520"	.15555	56	304	360
10	"10-out3521"	.67409	242	117	359
10	"10-out3522"	.32545	124	257	381
10	"10-out3523"	.39787	150	227	377
10	"10-out3524"	.32676	116	239	355
10	"10-out3525"	.52673	197	177	374
10	"10-out3526"	.96739	178	6	184
10	"10-out3527"	.53309	298	261	559
10	"10-out3528"	.65207	283	151	434
10	"10-out3529"	.36405	158	276	434
10	"10-out3530"	.53456	232	202	434
10	"10-out3531"	.73816	265	94	359
10	"10-out3532"	.24576	87	267	354
10	"10-out3533"	.36323	247	433	680
10	"10-out3534"	.99855	692	1	693
10	"10-out3535"	.28273	244	619	863
10	"10-out3536"	.29707	183	433	616
10	"10-out3537"	.43247	301	395	696
10	"10-out3538"	.30165	146	338	484
10	"10-out3539"	.33849	153	299	452
10	"10-out3540"	.25322	98	289	387
10	"10-out3541"	.80101	475	118	593
10	"10-out3542"	.68457	293	135	428
10	"10-out3543"	.31941	130	277	407
10	"10-out3544"	.38709	108	171	279
10	"10-out3545"	.49027	353	367	720
10	"10-out3546"	.99683	315	1	316
10	"10-out3547"	.27173	75	201	276
10	"10-out3548"	.99767	429	1	430
10	"10-out3549"	.36228	317	558	875
10	"10-out3550"	.87924	881	121	1002
10	"10-out3551"	.44977	1003	1227	2230
10	"10-out3552"	.99173	120	1	121
10	"10-out3553"	.36515	153	266	419
10	"10-out3554"	.99750	400	1	401
10	"10-out3555"	.99498	397	2	399
10	"10-out3556"	.45637	136	162	298
10	"10-out3557"	.70297	71	30	101
10	"10-out3558"	.25000	209	627	836
10	"10-out3559"	.20447	201	782	983
10	"10-out3560"	.34586	46	87	133
10	"10-out3561"	.35160	417	769	1186
10	"10-out3562"	.17159	29	140	169
10	"10-out3563"	.23845	320	1022	1342
10	"10-out3564"	.25809	247	710	957
10	"10-out3565"	.36800	460	790	1250
10	"10-out3566"	.39507	273	418	691
10	"10-out3567"	.68079	241	113	354
10	"10-out3568"	.48306	214	229	443
10	"10-out3569"	.54487	85	71	156
10	"10-out3570"	.50588	774	756	1530
10	"10-out3571"	.62307	81	49	130
10	"10-out3572"	.40874	271	392	663
10	"10-out3573"	.99264	135	1	136
10	"10-out3574"	.88095	592	80	672
10	"10-out3575"	.46438	163	188	351
10	"10-out3576"	.35024	352	653	1005
10	"10-out3577"	.25171	183	544	727
10	"10-out3578"	.25581	363	1056	1419
10	"10-out3579"	.22264	118	412	530
10	"10-out3580"	.31144	147	325	472
10	"10-out3581"	.33333	179	358	537
10	"10-out3582"	.61797	55	34	89
10	"10-out3583"	.70476	148	62	210
10	"10-out3584"	.34294	1380	2644	4024
10	"10-out3585"	.99137	115	1	116
10	"10-out3586"	.57062	101	76	177
10	"10-out3587"	.27398	1225	3246	4471
10	"10-out3588"	.46025	110	129	239
10	"10-out3589"	.43632	233	301	534
10	"10-out3590"	.28545	155	388	543
10	"10-out3591"	.99890	912	1	913
10	"10-out3592"	.97478	348	9	357
10	"10-out3593"	.18269	38	170	208
10	"10-out3594"	.19015	112	477	589
10	"10-out3595"	.44035	251	319	570
10	"10-out3596"	.99828	583	1	584
10	"10-out3597"	.60526	46	30	76
10	"10-out3598"	.99476	190	1	191
10	"10-out3599"	.99792	481	1	482
10	"10-out3600"	.99464	557	3	560
10	"10-out3601"	.99856	698	1	699
10	"10-out3602"	.99856	697	1	698
10	"10-out3603"	.99489	585	3	588
10	"10-out3604"	.99848	660	1	661
10	"10-out3605"	.98775	242	3	245
10	"10-out3606"	.50191	131	130	261
10	"10-out3607"	.26836	95	259	354
10	"10-out3608"	.41760	185	258	443
10	"10-out3609"	.99591	244	1	245
10	"10-out3610"	.41845	254	353	607
10	"10-out3611"	.20338	60	235	295
10	"10-out3612"	.38636	136	216	352
10	"10-out3613"	.21525	79	288	367
10	"10-out3614"	.16052	61	319	380
10	"10-out3615"	.99267	542	4	546
10	"10-out3616"	.22222	60	210	270
10	"10-out3617"	.36716	293	505	798
10	"10-out3618"	.30712	168	379	547
10	"10-out3619"	.97457	115	3	118
10	"10-out3620"	.36177	106	187	293
10	"10-out3621"	.99382	2252	14	2266
10	"10-out3622"	.34669	147	277	424
10	"10-out3623"	.33734	28	55	83
10	"10-out3624"	.19172	51	215	266
10	"10-out3625"	.34716	92	173	265
10	"10-out3626"	.96941	317	10	327
10	"10-out3627"	.28447	557	1401	1958
10	"10-out3628"	.36641	96	166	262
10	"10-out3629"	.24068	239	754	993
10	"10-out3630"	.38271	403	650	1053
10	"10-out3631"	.11464	18	139	157
10	"10-out3632"	.40079	101	151	252
10	"10-out3633"	.67512	399	192	591
10	"10-out3634"	.75776	366	117	483
10	"10-out3635"	.99668	301	1	302
10	"10-out3636"	.99668	301	1	302
10	"10-out3637"	.11507	58	446	504
10	"10-out3638"	.22439	92	318	410
10	"10-out3639"	.98859	520	6	526
10	"10-out3640"	.25806	96	276	372
10	"10-out3641"	.31588	181	392	573
10	"10-out3642"	.36226	192	338	530
10	"10-out3643"	.76056	108	34	142
10	"10-out3644"	.26760	38	104	142
10	"10-out3645"	.32061	311	659	970
10	"10-out3646"	.99367	157	1	158
10	"10-out3647"	.30000	126	294	420
10	"10-out3648"	.11304	39	306	345
10	"10-out3649"	.23563	82	266	348
10	"10-out3650"	.25263	216	639	855
10	"10-out3651"	.88405	427	56	483
10	"10-out3652"	.84696	559	101	660
10	"10-out3653"	.93804	2483	164	2647
10	"10-out3654"	.22012	70	248	318
10	"10-out3655"	.40136	118	176	294
10	"10-out3656"	.40740	231	336	567
10	"10-out3657"	.19519	65	268	333
10	"10-out3658"	.99820	557	1	558
10	"10-out3659"	.19796	312	1264	1576
10	"10-out3660"	.83622	1062	208	1270
10	"10-out3661"	.88390	335	44	379
10	"10-out3662"	.16449	63	320	383
10	"10-out3663"	.73062	1763	650	2413
10	"10-out3664"	.35588	142	257	399
10	"10-out3665"	.36172	327	577	904
10	"10-out3666"	.96551	112	4	116
10	"10-out3667"	.38113	194	315	509
10	"10-out3668"	.47058	264	297	561
10	"10-out3669"	.39087	197	307	504
10	"10-out3670"	.44736	153	189	342
10	"10-out3671"	.39782	146	221	367
10	"10-out3672"	.57348	398	296	694
10	"10-out3673"	.16330	81	415	496
10	"10-out3674"	.27184	28	75	103
10	"10-out3675"	.21194	149	554	703
10	"10-out3676"	.97878	323	7	330
10	"10-out3677"	.55404	610	491	1101
10	"10-out3678"	.42162	503	690	1193
10	"10-out3679"	.22382	233	808	1041
10	"10-out3680"	.33878	145	283	428
10	"10-out3681"	.42558	183	247	430
10	"10-out3682"	.59810	189	127	316
10	"10-out3683"	.33699	92	181	273
10	"10-out3684"	.28917	203	499	702
10	"10-out3685"	.41899	150	208	358
10	"10-out3686"	.30416	73	167	240
10	"10-out3687"	.31558	83	180	263
10	"10-out3688"	.54451	367	307	674
10	"10-out3689"	.85309	482	83	565
10	"10-out3690"	.33934	1411	2747	4158
10	"10-out3691"	.57627	102	75	177
10	"10-out3692"	.41494	1283	1809	3092
10	"10-out3693"	.37430	134	224	358
10	"10-out3694"	.35323	71	130	201
10	"10-out3695"	.48982	746	777	1523
10	"10-out3696"	.38121	207	336	543
10	"10-out3697"	.31515	52	113	165
10	"10-out3698"	.40312	129	191	320
10	"10-out3699"	.15655	191	1029	1220
10	"10-out3700"	.36276	152	267	419
10	"10-out3701"	.38606	205	326	531
10	"10-out3702"	.43130	135	178	313
10	"10-out3703"	.47919	380	413	793
10	"10-out3704"	.28988	149	365	514
10	"10-out3705"	.45959	91	107	198
10	"10-out3706"	.36538	38	66	104
10	"10-out3707"	.40794	195	283	478
10	"10-out3708"	.32958	322	655	977
10	"10-out3709"	.25000	24	72	96
10	"10-out3710"	.25894	181	518	699
10	"10-out3711"	.99292	421	3	424
10	"10-out3712"	.98477	194	3	197
10	"10-out3713"	.90071	626	69	695
10	"10-out3714"	.29347	216	520	736
10	"10-out3715"	.33333	68	136	204
10	"10-out3716"	.35890	496	886	1382
10	"10-out3717"	.15410	90	494	584
10	"10-out3718"	.23602	38	123	161
10	"10-out3719"	.99576	235	1	236
10	"10-out3720"	.65596	143	75	218
10	"10-out3721"	.11699	42	317	359
10	"10-out3722"	.24724	202	615	817
10	"10-out3723"	.69026	312	140	452
10	"10-out3724"	.26033	315	895	1210
10	"10-out3725"	.38601	254	404	658
10	"10-out3726"	.32981	406	825	1231
10	"10-out3727"	.53097	60	53	113
10	"10-out3728"	.82446	465	99	564
10	"10-out3729"	.41592	188	264	452
10	"10-out3730"	.37458	112	187	299
10	"10-out3731"	.22085	180	635	815
10	"10-out3732"	.34598	310	586	896
10	"10-out3733"	.31081	612	1357	1969
10	"10-out3734"	.50574	132	129	261
10	"10-out3735"	.48948	652	680	1332
10	"10-out3736"	.36924	305	521	826
10	"10-out3737"	.35531	361	655	1016
10	"10-out3738"	.38772	297	469	766
10	"10-out3739"	.34238	391	751	1142
10	"10-out3740"	.35537	86	156	242
10	"10-out3741"	.38088	283	460	743
10	"10-out3742"	.40918	205	296	501
10	"10-out3743"	.90571	317	33	350
10	"10-out3744"	.72789	214	80	294
10	"10-out3745"	.26736	77	211	288
10	"10-out3746"	.52802	292	261	553
10	"10-out3747"	.32402	174	363	537
10	"10-out3748"	.23688	131	422	553
10	"10-out3749"	.27504	162	427	589
10	"10-out3750"	.99438	177	1	178
10	"10-out3751"	.45760	313	371	684
10	"10-out3752"	.99386	162	1	163
10	"10-out3753"	.56783	113	86	199
10	"10-out3754"	.83703	226	44	270
10	"10-out3755"	.71666	258	102	360
10	"10-out3756"	.12373	49	347	396
10	"10-out3757"	.33230	108	217	325
10	"10-out3758"	.99521	208	1	209
10	"10-out3759"	.38461	75	120	195
10	"10-out3760"	.36335	117	205	322
10	"10-out3761"	.34221	257	494	751
10	"10-out3762"	.21900	53	189	242
10	"10-out3763"	.34246	50	96	146
10	"10-out3764"	.26568	199	550	749
10	"10-out3765"	.53974	129	110	239
10	"10-out3766"	.71250	171	69	240
10	"10-out3767"	.27102	58	156	214
10	"10-out3768"	.28318	64	162	226
10	"10-out3769"	.57647	147	108	255
10	"10-out3770"	.24390	50	155	205
10	"10-out3771"	.44600	95	118	213
10	"10-out3772"	.55882	133	105	238
10	"10-out3773"	.32894	75	153	228
10	"10-out3774"	.99736	379	1	380
10	"10-out3775"	.28524	87	218	305
10	"10-out3776"	.98734	78	1	79
10	"10-out3777"	.98734	78	1	79
10	"10-out3778"	.99295	141	1	142
10	"10-out3779"	.32193	113	238	351
10	"10-out3780"	.67289	72	35	107
10	"10-out3781"	.61153	159	101	260
10	"10-out3782"	.35410	250	456	706
10	"10-out3783"	.20864	111	421	532
10	"10-out3784"	.43640	175	226	401
10	"10-out3785"	.24375	117	363	480
10	"10-out3786"	.98936	93	1	94
10	"10-out3787"	.35082	956	1769	2725
10	"10-out3788"	.44117	30	38	68
10	"10-out3789"	.35632	279	504	783
10	"10-out3790"	.41486	134	189	323
10	"10-out3791"	.25696	83	240	323
10	"10-out3792"	.28939	292	717	1009
10	"10-out3793"	.28178	359	915	1274
10	"10-out3794"	.58974	345	240	585
10	"10-out3795"	.19115	229	969	1198
10	"10-out3796"	.30278	76	175	251
10	"10-out3797"	.98947	94	1	95
10	"10-out3798"	.19642	33	135	168
10	"10-out3799"	.29673	100	237	337
10	"10-out3800"	.17335	134	639	773
10	"10-out3801"	.19591	144	591	735
10	"10-out3802"	.37000	111	189	300
10	"10-out3803"	.25806	80	230	310
10	"10-out3804"	.99706	340	1	341
10	"10-out3805"	.75510	74	24	98
10	"10-out3806"	.40000	58	87	145
10	"10-out3807"	.61855	60	37	97
10	"10-out3808"	.98507	66	1	67
10	"10-out3809"	.34230	407	782	1189
10	"10-out3810"	.33284	675	1353	2028
10	"10-out3811"	.98630	72	1	73
10	"10-out3812"	.31166	187	413	600
10	"10-out3813"	.52417	206	187	393
10	"10-out3814"	.64144	195	109	304
10	"10-out3815"	.27284	209	557	766
10	"10-out3816"	.18904	69	296	365
10	"10-out3817"	.28554	743	1859	2602
10	"10-out3818"	.55041	939	767	1706
10	"10-out3819"	.31055	150	333	483
10	"10-out3820"	.22144	285	1002	1287
10	"10-out3821"	.35727	189	340	529
10	"10-out3822"	.39148	184	286	470
10	"10-out3823"	.90909	150	15	165
10	"10-out3824"	.64948	126	68	194
10	"10-out3825"	.98437	63	1	64
10	"10-out3826"	.29975	241	563	804
10	"10-out3827"	.98571	69	1	70
10	"10-out3828"	.36734	396	682	1078
10	"10-out3829"	.85119	143	25	168
10	"10-out3830"	.85714	72	12	84
10	"10-out3831"	.43181	171	225	396
10	"10-out3832"	.19597	107	439	546
10	"10-out3833"	.23558	94	305	399
10	"10-out3834"	.17894	204	936	1140
10	"10-out3835"	.18072	165	748	913
10	"10-out3836"	.28437	242	609	851
10	"10-out3837"	.41621	385	540	925
10	"10-out3838"	.86000	86	14	100
10	"10-out3839"	.38273	235	379	614
10	"10-out3840"	.56191	962	750	1712
10	"10-out3841"	.64285	45	25	70
10	"10-out3842"	.45568	365	436	801
10	"10-out3843"	.36853	342	586	928
10	"10-out3844"	.96547	783	28	811
10	"10-out3845"	.41276	97	138	235
10	"10-out3846"	.38122	406	659	1065
10	"10-out3847"	.18105	86	389	475
10	"10-out3848"	.26488	178	494	672
10	"10-out3849"	.39753	161	244	405
10	"10-out3850"	.43710	556	716	1272
10	"10-out3851"	.25775	133	383	516
10	"10-out3852"	.28140	56	143	199
10	"10-out3853"	.34177	189	364	553
10	"10-out3854"	.92307	252	21	273
10	"10-out3855"	.78481	124	34	158
10	"10-out3856"	.25702	311	899	1210
10	"10-out3857"	.98717	77	1	78
10	"10-out3858"	.53742	280	241	521
10	"10-out3859"	.98924	92	1	93
10	"10-out3860"	.48997	171	178	349
10	"10-out3861"	.99718	354	1	355
10	"10-out3862"	.43204	213	280	493
10	"10-out3863"	.37307	388	652	1040
10	"10-out3864"	.99894	949	1	950
10	"10-out3865"	.38805	130	205	335
10	"10-out3866"	.36567	343	595	938
10	"10-out3867"	.32271	152	319	471
10	"10-out3868"	.58620	136	96	232
10	"10-out3869"	.40395	347	512	859
10	"10-out3870"	.41235	247	352	599
10	"10-out3871"	.60666	364	236	600
10	"10-out3872"	.32432	240	500	740
10	"10-out3873"	.98936	93	1	94
10	"10-out3874"	.41680	258	361	619
10	"10-out3875"	.45752	377	447	824
10	"10-out3876"	.37439	386	645	1031
10	"10-out3877"	.28543	147	368	515
10	"10-out3878"	.44938	182	223	405
10	"10-out3879"	.32507	328	681	1009
10	"10-out3880"	.35558	570	1033	1603
10	"10-out3881"	.33490	71	141	212
10	"10-out3882"	.42900	142	189	331
10	"10-out3883"	.68343	231	107	338
10	"10-out3884"	.75961	237	75	312
10	"10-out3885"	.24344	297	923	1220
10	"10-out3886"	.76645	722	220	942
10	"10-out3887"	.60461	445	291	736
10	"10-out3888"	.27456	204	539	743
10	"10-out3889"	.62642	716	427	1143
10	"10-out3890"	.31428	121	264	385
10	"10-out3891"	.41114	118	169	287
10	"10-out3892"	.61484	265	166	431
10	"10-out3893"	.34189	479	922	1401
10	"10-out3894"	.42010	163	225	388
10	"10-out3895"	.31713	248	534	782
10	"10-out3896"	.86184	262	42	304
10	"10-out3897"	.52427	324	294	618
10	"10-out3898"	.44957	214	262	476
10	"10-out3899"	.31887	147	314	461
10	"10-out3900"	.36956	170	290	460
10	"10-out3901"	.14705	25	145	170
10	"10-out3902"	.29508	72	172	244
10	"10-out3903"	.25252	100	296	396
10	"10-out3904"	.29508	126	301	427
10	"10-out3905"	.24598	153	469	622
10	"10-out3906"	.05660	18	300	318
10	"10-out3907"	.64645	501	274	775
10	"10-out3908"	.48848	297	311	608
10	"10-out3909"	.53556	128	111	239
10	"10-out3910"	.73780	242	86	328
10	"10-out3911"	.79051	883	234	1117
10	"10-out3912"	.48214	135	145	280
10	"10-out3913"	.38293	386	622	1008
10	"10-out3914"	.25462	234	685	919
10	"10-out3915"	.32065	371	786	1157
10	"10-out3916"	.79589	620	159	779
10	"10-out3917"	.27723	621	1619	2240
10	"10-out3918"	.33354	519	1037	1556
10	"10-out3919"	.36640	277	479	756
10	"10-out3920"	.28739	98	243	341
10	"10-out3921"	.45428	159	191	350
10	"10-out3922"	.68181	165	77	242
10	"10-out3923"	.30241	300	692	992
10	"10-out3924"	.22513	163	561	724
10	"10-out3925"	.98630	72	1	73
10	"10-out3926"	.42482	308	417	725
10	"10-out3927"	.33542	107	212	319
10	"10-out3928"	.96592	652	23	675
10	"10-out3929"	.74135	536	187	723
10	"10-out3930"	.98611	71	1	72
10	"10-out3931"	.41903	251	348	599
10	"10-out3932"	.51162	396	378	774
10	"10-out3933"	.72138	334	129	463
10	"10-out3934"	.94910	317	17	334
10	"10-out3935"	.49593	244	248	492
10	"10-out3936"	.43598	269	348	617
10	"10-out3937"	.34246	100	192	292
10	"10-out3938"	.44262	108	136	244
10	"10-out3939"	.58947	112	78	190
10	"10-out3940"	.78431	80	22	102
10	"10-out3941"	.30526	87	198	285
10	"10-out3942"	.32565	325	673	998
10	"10-out3943"	.99253	133	1	134
10	"10-out3944"	.79647	587	150	737
10	"10-out3945"	.87314	764	111	875
10	"10-out3946"	.30573	96	218	314
10	"10-out3947"	.20245	66	260	326
10	"10-out3948"	.28141	159	406	565
10	"10-out3949"	.21098	96	359	455
10	"10-out3950"	.26134	334	944	1278
10	"10-out3951"	.19275	149	624	773
10	"10-out3952"	.33954	164	319	483
10	"10-out3953"	.31077	225	499	724
10	"10-out3954"	.74018	490	172	662
10	"10-out3955"	.99896	969	1	970
10	"10-out3956"	.68587	500	229	729
10	"10-out3957"	.98936	93	1	94
10	"10-out3958"	.91769	223	20	243
10	"10-out3959"	.83007	425	87	512
10	"10-out3960"	.99494	197	1	198
10	"10-out3961"	.31350	469	1027	1496
10	"10-out3962"	.39339	751	1158	1909
10	"10-out3963"	.52483	317	287	604
10	"10-out3964"	.23969	93	295	388
10	"10-out3965"	.99545	219	1	220
10	"10-out3966"	.96236	537	21	558
10	"10-out3967"	.23053	77	257	334
10	"10-out3968"	.98461	64	1	65
10	"10-out3969"	.26813	85	232	317
10	"10-out3970"	.21499	152	555	707
10	"10-out3971"	.99719	356	1	357
10	"10-out3972"	.99371	158	1	159
10	"10-out3973"	.32068	338	716	1054
10	"10-out3974"	.37164	97	164	261
10	"10-out3975"	.25368	86	253	339
10	"10-out3976"	.24402	194	601	795
10	"10-out3977"	.43164	461	607	1068
10	"10-out3978"	.99889	906	1	907
10	"10-out3979"	.99290	140	1	141
10	"10-out3980"	.92907	131	10	141
10	"10-out3981"	.35751	271	487	758
10	"10-out3982"	.39153	74	115	189
10	"10-out3983"	.61437	94	59	153
10	"10-out3984"	.58823	60	42	102
10	"10-out3985"	.57317	47	35	82
10	"10-out3986"	.98863	87	1	88
10	"10-out3987"	.46753	36	41	77
10	"10-out3988"	.48535	116	123	239
10	"10-out3989"	.46332	120	139	259
10	"10-out3990"	.51020	175	168	343
10	"10-out3991"	.51816	271	252	523
10	"10-out3992"	.30909	34	76	110
10	"10-out3993"	.84555	219	40	259
10	"10-out3994"	.50210	119	118	237
10	"10-out3995"	.39574	186	284	470
10	"10-out3996"	.43111	388	512	900
10	"10-out3997"	.33192	236	475	711
10	"10-out3998"	.28894	230	566	796
10	"10-out3999"	.26111	141	399	540
10	"10-out4000"	.57957	386	280	666
10	"10-out4001"	.42155	266	365	631
10	"10-out4002"	.32236	284	597	881
10	"10-out4003"	.95074	637	33	670
10	"10-out4004"	.27056	148	399	547
10	"10-out4005"	.62945	265	156	421
10	"10-out4006"	.33898	100	195	295
10	"10-out4007"	.42253	720	984	1704
10	"10-out4008"	.94088	191	12	203
10	"10-out4009"	.70454	93	39	132
10	"10-out4010"	.21686	144	520	664
10	"10-out4011"	.65625	147	77	224
10	"10-out4012"	.49090	81	84	165
10	"10-out4013"	.49671	227	230	457
10	"10-out4014"	.98979	194	2	196
10	"10-out4015"	.99549	221	1	222
10	"10-out4016"	.59009	131	91	222
10	"10-out4017"	.83589	163	32	195
10	"10-out4018"	.22448	44	152	196
10	"10-out4019"	.41966	175	242	417
10	"10-out4020"	.91071	102	10	112
10	"10-out4021"	.36573	222	385	607
10	"10-out4022"	.24503	37	114	151
10	"10-out4023"	.43786	222	285	507
10	"10-out4024"	.42408	405	550	955
10	"10-out4025"	.42506	173	234	407
10	"10-out4026"	.25800	145	417	562
10	"10-out4027"	.55350	150	121	271
10	"10-out4028"	.49226	159	164	323
10	"10-out4029"	.27257	160	427	587
10	"10-out4030"	.34437	156	297	453
10	"10-out4031"	.57296	267	199	466
10	"10-out4032"	.33134	111	224	335
10	"10-out4033"	.38000	152	248	400
10	"10-out4034"	.31007	280	623	903
10	"10-out4035"	.43683	204	263	467
10	"10-out4036"	.43220	102	134	236
10	"10-out4037"	.18333	33	147	180
10	"10-out4038"	.94604	263	15	278
10	"10-out4039"	.85405	158	27	185
10	"10-out4040"	.32124	62	131	193
10	"10-out4041"	.39153	74	115	189
10	"10-out4042"	.33225	513	1031	1544
10	"10-out4043"	.25759	212	611	823
10	"10-out4044"	.16666	30	150	180
10	"10-out4045"	.23012	165	552	717
10	"10-out4046"	.29404	232	557	789
10	"10-out4047"	.58193	277	199	476
10	"10-out4048"	.17302	68	325	393
10	"10-out4049"	.34858	160	299	459
10	"10-out4050"	.28205	132	336	468
10	"10-out4051"	.54455	165	138	303
10	"10-out4052"	.32812	63	129	192
10	"10-out4053"	.33264	162	325	487
10	"10-out4054"	.26036	496	1409	1905
10	"10-out4055"	.35269	255	468	723
10	"10-out4056"	.20573	122	471	593
10	"10-out4057"	.28074	226	579	805
10	"10-out4058"	.60869	56	36	92
10	"10-out4059"	.23060	214	714	928
10	"10-out4060"	.20984	81	305	386
10	"10-out4061"	.43112	169	223	392
10	"10-out4062"	.29360	170	409	579
10	"10-out4063"	.98809	83	1	84
10	"10-out4064"	.53521	76	66	142
10	"10-out4065"	.99559	226	1	227
10	"10-out4066"	.38255	342	552	894
10	"10-out4067"	.62313	792	479	1271
10	"10-out4068"	.98255	169	3	172
10	"10-out4069"	.36286	258	453	711
10	"10-out4070"	.95108	875	45	920
10	"10-out4071"	.48062	62	67	129
10	"10-out4072"	.65789	75	39	114
10	"10-out4073"	.99846	650	1	651
10	"10-out4074"	.22087	91	321	412
10	"10-out4075"	.23437	120	392	512
10	"10-out4076"	.50383	263	259	522
10	"10-out4077"	.89755	587	67	654
10	"10-out4078"	.37430	67	112	179
10	"10-out4079"	.99576	235	1	236
10	"10-out4080"	.99800	499	1	500
10	"10-out4081"	.27920	141	364	505
10	"10-out4082"	.34649	158	298	456
10	"10-out4083"	.27261	214	571	785
10	"10-out4084"	.08500	17	183	200
10	"10-out4085"	.60330	73	48	121
10	"10-out4086"	.30319	57	131	188
10	"10-out4087"	.36879	104	178	282
10	"10-out4088"	.20370	11	43	54
10	"10-out4089"	.24709	170	518	688
10	"10-out4090"	.26686	91	250	341
10	"10-out4091"	.30349	278	638	916
10	"10-out4092"	.43521	262	340	602
10	"10-out4093"	.47417	101	112	213
10	"10-out4094"	.56756	126	96	222
10	"10-out4095"	.39914	93	140	233
10	"10-out4096"	.96491	165	6	171
10	"10-out4097"	.50248	101	100	201
10	"10-out4098"	.37969	172	281	453
10	"10-out4099"	.30049	244	568	812
10	"10-out4100"	.37500	51	85	136
10	"10-out4101"	.17147	107	517	624
10	"10-out4102"	.76555	320	98	418
10	"10-out4103"	.90952	191	19	210
10	"10-out4104"	.41798	79	110	189
10	"10-out4105"	.29729	88	208	296
10	"10-out4106"	.54304	328	276	604
10	"10-out4107"	.43407	293	382	675
10	"10-out4108"	.99047	104	1	105
10	"10-out4109"	.87258	226	33	259
10	"10-out4110"	.85981	92	15	107
10	"10-out4111"	.24173	117	367	484
10	"10-out4112"	.77284	592	174	766
10	"10-out4113"	.36662	301	520	821
10	"10-out4114"	.26997	196	530	726
10	"10-out4115"	.29742	196	463	659
10	"10-out4116"	.63818	351	199	550
10	"10-out4117"	.53801	276	237	513
10	"10-out4118"	.27624	50	131	181
10	"10-out4119"	.99230	129	1	130
10	"10-out4120"	.25518	123	359	482
10	"10-out4121"	.91408	383	36	419
10	"10-out4122"	.62352	159	96	255
10	"10-out4123"	.11904	10	74	84
10	"10-out4124"	.41921	96	133	229
10	"10-out4125"	.76587	193	59	252
10	"10-out4126"	.99315	145	1	146
10	"10-out4127"	.31750	107	230	337
10	"10-out4128"	.37179	203	343	546
10	"10-out4129"	.42140	252	346	598
10	"10-out4130"	.38741	277	438	715
10	"10-out4131"	.99310	144	1	145
10	"10-out4132"	.23728	406	1305	1711
10	"10-out4133"	.25508	213	622	835
10	"10-out4134"	.36116	173	306	479
10	"10-out4135"	.35238	74	136	210
10	"10-out4136"	.37128	75	127	202
10	"10-out4137"	.40092	87	130	217
10	"10-out4138"	.30548	128	291	419
10	"10-out4139"	.23076	57	190	247
10	"10-out4140"	.99616	260	1	261
10	"10-out4141"	.36295	290	509	799
10	"10-out4142"	.54589	452	376	828
10	"10-out4143"	.51685	276	258	534
10	"10-out4144"	.41330	174	247	421
10	"10-out4145"	.42690	73	98	171
10	"10-out4146"	.26522	135	374	509
10	"10-out4147"	.92372	109	9	118
10	"10-out4148"	.99633	272	1	273
10	"10-out4149"	.35784	73	131	204
10	"10-out4150"	.87610	495	70	565
10	"10-out4151"	.15810	40	213	253
10	"10-out4152"	.20073	437	1740	2177
10	"10-out4153"	.17230	168	807	975
10	"10-out4154"	.99797	493	1	494
10	"10-out4155"	.31034	27	60	87
10	"10-out4156"	.96268	387	15	402
10	"10-out4157"	.48425	123	131	254
10	"10-out4158"	.31818	98	210	308
10	"10-out4159"	.41398	219	310	529
10	"10-out4160"	.27639	288	754	1042
10	"10-out4161"	.36108	334	591	925
10	"10-out4162"	.27167	141	378	519
10	"10-out4163"	.26554	491	1358	1849
10	"10-out4164"	.48768	198	208	406
10	"10-out4165"	.27310	266	708	974
10	"10-out4166"	.96741	475	16	491
10	"10-out4167"	.63380	90	52	142
10	"10-out4168"	.37362	170	285	455
10	"10-out4169"	.24528	104	320	424
10	"10-out4170"	.34108	132	255	387
10	"10-out4171"	.21938	86	306	392
10	"10-out4172"	.81390	433	99	532
10	"10-out4173"	.26296	289	810	1099
10	"10-out4174"	.42929	170	226	396
10	"10-out4175"	.12408	17	120	137
10	"10-out4176"	.30120	75	174	249
10	"10-out4177"	.49902	256	257	513
10	"10-out4178"	.38003	1492	2434	3926
10	"10-out4179"	.83829	197	38	235
10	"10-out4180"	.27848	66	171	237
10	"10-out4181"	.23447	253	826	1079
10	"10-out4182"	.39487	77	118	195
10	"10-out4183"	.99183	486	4	490
10	"10-out4184"	.32861	116	237	353
10	"10-out4185"	.99465	186	1	187
10	"10-out4186"	.30327	1473	3384	4857
10	"10-out4187"	.16246	58	299	357
10	"10-out4188"	.96268	387	15	402
10	"10-out4189"	.22627	155	530	685
10	"10-out4190"	.51236	145	138	283
10	"10-out4191"	.45652	84	100	184
10	"10-out4192"	.80499	1032	250	1282
10	"10-out4193"	.52100	62	57	119
10	"10-out4194"	.99137	115	1	116
10	"10-out4195"	.99385	647	4	651
10	"10-out4196"	.30018	163	380	543
10	"10-out4197"	.37732	466	769	1235
10	"10-out4198"	.27906	120	310	430
10	"10-out4199"	.28352	148	374	522
10	"10-out4200"	.48712	1665	1753	3418
10	"10-out4201"	.31862	195	417	612
10	"10-out4202"	.32155	355	749	1104
10	"10-out4203"	.40285	423	627	1050
10	"10-out4204"	.38156	414	671	1085
10	"10-out4205"	.99862	724	1	725
10	"10-out4206"	.88793	103	13	116
10	"10-out4207"	.94666	213	12	225
10	"10-out4208"	.98902	631	7	638
10	"10-out4209"	.45730	166	197	363
10	"10-out4210"	.99797	493	1	494
10	"10-out4211"	.29156	114	277	391
10	"10-out4212"	.83720	144	28	172
10	"10-out4213"	.39590	561	856	1417
10	"10-out4214"	.22441	250	864	1114
10	"10-out4215"	.74054	137	48	185
10	"10-out4216"	.18154	179	807	986
10	"10-out4217"	.36635	233	403	636
10	"10-out4218"	.44292	97	122	219
10	"10-out4219"	.48407	152	162	314
10	"10-out4220"	.42380	89	121	210
10	"10-out4221"	.99719	356	1	357
10	"10-out4222"	.31428	33	72	105
10	"10-out4223"	.93029	694	52	746
10	"10-out4224"	.21484	55	201	256
10	"10-out4225"	.54235	1652	1394	3046
10	"10-out4226"	.98666	74	1	75
10	"10-out4227"	.27863	90	233	323
10	"10-out4228"	.56521	416	320	736
10	"10-out4229"	.47653	599	658	1257
10	"10-out4230"	.85594	511	86	597
10	"10-out4231"	.39444	71	109	180
10	"10-out4232"	.41009	130	187	317
10	"10-out4233"	.27802	62	161	223
10	"10-out4234"	.26153	255	720	975
10	"10-out4235"	.54800	274	226	500
10	"10-out4236"	.54602	261	217	478
10	"10-out4237"	.48876	87	91	178
10	"10-out4238"	.90400	113	12	125
10	"10-out4239"	.32158	511	1078	1589
10	"10-out4240"	.60975	200	128	328
10	"10-out4241"	.25048	128	383	511
10	"10-out4242"	.39508	209	320	529
10	"10-out4243"	.81535	446	101	547
10	"10-out4244"	.31250	50	110	160
10	"10-out4245"	.51538	804	756	1560
10	"10-out4246"	.29563	149	355	504
10	"10-out4247"	.63133	137	80	217
10	"10-out4248"	.31610	159	344	503
10	"10-out4249"	.13592	28	178	206
10	"10-out4250"	.60185	65	43	108
10	"10-out4251"	.30821	90	202	292
10	"10-out4252"	.56416	655	506	1161
10	"10-out4253"	.32142	117	247	364
10	"10-out4254"	.33387	205	409	614
10	"10-out4255"	.32302	94	197	291
10	"10-out4256"	.45196	207	251	458
10	"10-out4257"	.24493	145	447	592
10	"10-out4258"	.99310	144	1	145
10	"10-out4259"	.33583	269	532	801
10	"10-out4260"	.27386	109	289	398
10	"10-out4261"	.16294	124	637	761
10	"10-out4262"	.27429	333	881	1214
10	"10-out4263"	.35572	143	259	402
10	"10-out4264"	.44605	215	267	482
10	"10-out4265"	.41772	66	92	158
10	"10-out4266"	.36298	102	179	281
10	"10-out4267"	.29775	212	500	712
10	"10-out4268"	.99805	512	1	513
10	"10-out4269"	.99310	144	1	145
10	"10-out4270"	.20000	28	112	140
10	"10-out4271"	.51447	462	436	898
10	"10-out4272"	.37673	136	225	361
10	"10-out4273"	.50000	83	83	166
10	"10-out4274"	.26995	186	503	689
10	"10-out4275"	.21061	131	491	622
10	"10-out4276"	.29683	122	289	411
10	"10-out4277"	.70212	66	28	94
10	"10-out4278"	.23272	128	422	550
10	"10-out4279"	.98765	80	1	81
10	"10-out4280"	.32618	76	157	233
10	"10-out4281"	.38510	243	388	631
10	"10-out4282"	.54723	168	139	307
10	"10-out4283"	.67587	269	129	398
10	"10-out4284"	.45201	146	177	323
10	"10-out4285"	.29577	105	250	355
10	"10-out4286"	.45172	262	318	580
10	"10-out4287"	.42780	160	214	374
10	"10-out4288"	.17379	65	309	374
10	"10-out4289"	.20105	76	302	378
10	"10-out4290"	.29444	265	635	900
10	"10-out4291"	.30273	221	509	730
10	"10-out4292"	.99792	481	1	482
10	"10-out4293"	.98616	784	11	795
10	"10-out4294"	.17197	54	260	314
10	"10-out4295"	.85470	100	17	117
10	"10-out4296"	.42339	152	207	359
10	"10-out4297"	.65573	40	21	61
10	"10-out4298"	.34497	79	150	229
10	"10-out4299"	.38489	214	342	556
10	"10-out4300"	.85018	454	80	534
10	"10-out4301"	.55255	184	149	333
10	"10-out4302"	.43225	268	352	620
10	"10-out4303"	.10486	28	239	267
10	"10-out4304"	.29042	88	215	303
10	"10-out4305"	.37145	380	643	1023
10	"10-out4306"	.39618	519	791	1310
10	"10-out4307"	.39577	150	229	379
10	"10-out4308"	.41156	121	173	294
10	"10-out4309"	.55555	70	56	126
10	"10-out4310"	.70588	72	30	102
10	"10-out4311"	.93916	494	32	526
10	"10-out4312"	.57281	1420	1059	2479
10	"10-out4313"	.24733	116	353	469
10	"10-out4314"	.40734	455	662	1117
10	"10-out4315"	.23500	47	153	200
10	"10-out4316"	.24705	105	320	425
10	"10-out4317"	.74349	200	69	269
10	"10-out4318"	.95555	258	12	270
10	"10-out4319"	.33756	133	261	394
10	"10-out4320"	.20320	38	149	187
10	"10-out4321"	.30864	150	336	486
10	"10-out4322"	.44010	169	215	384
10	"10-out4323"	.29333	88	212	300
10	"10-out4324"	.32000	48	102	150
10	"10-out4325"	.91986	551	48	599
10	"10-out4326"	.40512	427	627	1054
10	"10-out4327"	.33689	189	372	561
10	"10-out4328"	.27514	238	627	865
10	"10-out4329"	.66533	501	252	753
10	"10-out4330"	.63059	169	99	268
10	"10-out4331"	.49784	231	233	464
10	"10-out4332"	.41198	110	157	267
10	"10-out4333"	.81208	242	56	298
10	"10-out4334"	.35535	269	488	757
10	"10-out4335"	.49748	297	300	597
10	"10-out4336"	.44311	74	93	167
10	"10-out4337"	.58422	326	232	558
10	"10-out4338"	.99230	129	1	130
10	"10-out4339"	.38857	136	214	350
10	"10-out4340"	.99630	270	1	271
10	"10-out4341"	.99152	117	1	118
10	"10-out4342"	.38957	254	398	652
10	"10-out4343"	.69008	167	75	242
10	"10-out4344"	.96052	73	3	76
10	"10-out4345"	.99462	185	1	186
10	"10-out4346"	.59842	76	51	127
10	"10-out4347"	.30714	43	97	140
10	"10-out4348"	.45253	839	1015	1854
10	"10-out4349"	.99551	222	1	223
10	"10-out4350"	.65955	2102	1085	3187
10	"10-out4351"	.30000	186	434	620
10	"10-out4352"	.34756	57	107	164
10	"10-out4353"	.55852	167	132	299
10	"10-out4354"	.49011	124	129	253
10	"10-out4355"	.37480	488	814	1302
10	"10-out4356"	.62264	99	60	159
10	"10-out4357"	.13054	50	333	383
10	"10-out4358"	.29113	69	168	237
10	"10-out4359"	.59829	210	141	351
10	"10-out4360"	.56802	167	127	294
10	"10-out4361"	.40000	66	99	165
10	"10-out4362"	.31891	59	126	185
10	"10-out4363"	.53235	510	448	958
10	"10-out4364"	.99509	203	1	204
10	"10-out4365"	.33884	82	160	242
10	"10-out4366"	.36363	100	175	275
10	"10-out4367"	.46256	173	201	374
10	"10-out4368"	.51898	492	456	948
10	"10-out4369"	.46956	54	61	115
10	"10-out4370"	.53535	53	46	99
10	"10-out4371"	.52155	121	111	232
10	"10-out4372"	.33630	113	223	336
10	"10-out4373"	.32564	113	234	347
10	"10-out4374"	.99459	184	1	185
10	"10-out4375"	.23984	189	599	788
10	"10-out4376"	.88228	727	97	824
10	"10-out4377"	.21149	92	343	435
10	"10-out4378"	.31223	148	326	474
10	"10-out4379"	.66804	161	80	241
10	"10-out4380"	.42063	106	146	252
10	"10-out4381"	.27005	239	646	885
10	"10-out4382"	.79057	151	40	191
10	"10-out4383"	.16853	75	370	445
10	"10-out4384"	.95774	272	12	284
10	"10-out4385"	.67391	403	195	598
10	"10-out4386"	.29530	88	210	298
10	"10-out4387"	.46590	82	94	176
10	"10-out4388"	.95959	1520	64	1584
10	"10-out4389"	.99716	352	1	353
10	"10-out4390"	.99551	222	1	223
10	"10-out4391"	.26779	79	216	295
10	"10-out4392"	.32519	626	1299	1925
10	"10-out4393"	.57385	540	401	941
10	"10-out4394"	.53230	173	152	325
10	"10-out4395"	.67753	395	188	583
10	"10-out4396"	.42763	65	87	152
10	"10-out4397"	.29682	103	244	347
10	"10-out4398"	.53061	156	138	294
10	"10-out4399"	.53246	82	72	154
10	"10-out4400"	.98395	184	3	187
10	"10-out4401"	.42968	220	292	512
10	"10-out4402"	.28308	154	390	544
10	"10-out4403"	.39000	195	305	500
10	"10-out4404"	.45208	1104	1338	2442
10	"10-out4405"	.94219	489	30	519
10	"10-out4406"	.99705	339	1	340
10	"10-out4407"	.21753	129	464	593
10	"10-out4408"	.37125	62	105	167
10	"10-out4409"	.34210	39	75	114
10	"10-out4410"	.30515	213	485	698
10	"10-out4411"	.97674	84	2	86
10	"10-out4412"	.99447	180	1	181
10	"10-out4413"	.42335	290	395	685
10	"10-out4414"	.98518	133	2	135
10	"10-out4415"	.21238	96	356	452
10	"10-out4416"	.33892	465	907	1372
10	"10-out4417"	.62454	173	104	277
10	"10-out4418"	.25701	119	344	463
10	"10-out4419"	.44213	149	188	337
10	"10-out4420"	.96048	316	13	329
10	"10-out4421"	.99743	389	1	390
10	"10-out4422"	.41888	315	437	752
10	"10-out4423"	.81607	457	103	560
10	"10-out4424"	.95145	392	20	412
10	"10-out4425"	.29545	117	279	396
10	"10-out4426"	.99751	401	1	402
10	"10-out4427"	.99115	112	1	113
10	"10-out4428"	.41780	122	170	292
10	"10-out4429"	.40000	54	81	135
10	"10-out4430"	.26000	65	185	250
10	"10-out4431"	.99386	162	1	163
10	"10-out4432"	.36036	200	355	555
10	"10-out4433"	.40368	197	291	488
10	"10-out4434"	.51540	485	456	941
10	"10-out4435"	.26050	31	88	119
10	"10-out4436"	.39953	173	260	433
10	"10-out4437"	.93898	277	18	295
10	"10-out4438"	.33720	116	228	344
10	"10-out4439"	.43598	126	163	289
10	"10-out4440"	.26972	212	574	786
10	"10-out4441"	.32112	114	241	355
10	"10-out4442"	.99489	779	4	783
10	"10-out4443"	.26877	68	185	253
10	"10-out4444"	.37466	417	696	1113
10	"10-out4445"	.99644	280	1	281
10	"10-out4446"	.36878	215	368	583
10	"10-out4447"	.18584	42	184	226
10	"10-out4448"	.36228	171	301	472
10	"10-out4449"	.29090	64	156	220
10	"10-out4450"	.50455	166	163	329
10	"10-out4451"	.59824	204	137	341
10	"10-out4452"	.29378	104	250	354
10	"10-out4453"	.39071	261	407	668
10	"10-out4454"	.46153	390	455	845
10	"10-out4455"	.47708	177	194	371
10	"10-out4456"	.54339	144	121	265
10	"10-out4457"	.15048	31	175	206
10	"10-out4458"	.27830	59	153	212
10	"10-out4459"	.39880	603	909	1512
10	"10-out4460"	.40099	1043	1558	2601
10	"10-out4461"	.55938	146	115	261
10	"10-out4462"	.36241	54	95	149
10	"10-out4463"	.35969	373	664	1037
10	"10-out4464"	.16379	19	97	116
10	"10-out4465"	.33854	238	465	703
10	"10-out4466"	.25517	148	432	580
10	"10-out4467"	.50153	327	325	652
10	"10-out4468"	.39285	88	136	224
10	"10-out4469"	.19512	40	165	205
10	"10-out4470"	.39849	265	400	665
10	"10-out4471"	.49079	80	83	163
10	"10-out4472"	.39034	566	884	1450
10	"10-out4473"	.97837	181	4	185
10	"10-out4474"	.17937	40	183	223
10	"10-out4475"	.43820	234	300	534
10	"10-out4476"	.48846	127	133	260
10	"10-out4477"	.20618	40	154	194
10	"10-out4478"	.60925	237	152	389
10	"10-out4479"	.39879	132	199	331
10	"10-out4480"	.50000	50	50	100
10	"10-out4481"	.59514	147	100	247
10	"10-out4482"	.71287	144	58	202
10	"10-out4483"	.17222	62	298	360
10	"10-out4484"	.11746	37	278	315
10	"10-out4485"	.24489	24	74	98
10	"10-out4486"	.22960	76	255	331
10	"10-out4487"	.38666	58	92	150
10	"10-out4488"	.42298	184	251	435
10	"10-out4489"	.84946	316	56	372
10	"10-out4490"	.44782	339	418	757
10	"10-out4491"	.52272	184	168	352
10	"10-out4492"	.27410	199	527	726
10	"10-out4493"	.27898	77	199	276
10	"10-out4494"	.24257	49	153	202
10	"10-out4495"	.73901	269	95	364
10	"10-out4496"	.30059	101	235	336
10	"10-out4497"	.48249	248	266	514
10	"10-out4498"	.43520	534	693	1227
10	"10-out4499"	.37692	98	162	260
10	"10-out4500"	.23838	118	377	495
10	"10-out4501"	.43304	152	199	351
10	"10-out4502"	.28196	86	219	305
10	"10-out4503"	.42231	212	290	502
10	"10-out4504"	.57821	207	151	358
10	"10-out4505"	.66666	92	46	138
10	"10-out4506"	.45367	142	171	313
10	"10-out4507"	.38860	75	118	193
10	"10-out4508"	.34053	599	1160	1759
10	"10-out4509"	.22541	94	323	417
10	"10-out4510"	.32624	138	285	423
10	"10-out4511"	.42246	583	797	1380
10	"10-out4512"	.57623	257	189	446
10	"10-out4513"	.27593	250	656	906
10	"10-out4514"	.44500	263	328	591
10	"10-out4515"	.94172	501	31	532
10	"10-out4516"	.40875	112	162	274
10	"10-out4517"	.34640	53	100	153
10	"10-out4518"	.57591	110	81	191
10	"10-out4519"	.25498	64	187	251
10	"10-out4520"	.38509	367	586	953
10	"10-out4521"	.35365	116	212	328
10	"10-out4522"	.34606	317	599	916
10	"10-out4523"	.33333	90	180	270
10	"10-out4524"	.30379	96	220	316
10	"10-out4525"	.45566	185	221	406
10	"10-out4526"	.99624	265	1	266
10	"10-out4527"	.41071	92	132	224
10	"10-out4528"	.34782	168	315	483
10	"10-out4529"	.56462	249	192	441
10	"10-out4530"	.18656	25	109	134
10	"10-out4531"	.99082	108	1	109
10	"10-out4532"	.35416	153	279	432
10	"10-out4533"	.62983	228	134	362
10	"10-out4534"	.49103	685	710	1395
10	"10-out4535"	.46923	244	276	520
10	"10-out4536"	.35714	125	225	350
10	"10-out4537"	.28338	87	220	307
10	"10-out4538"	.64390	132	73	205
10	"10-out4539"	.43596	160	207	367
10	"10-out4540"	.19327	46	192	238
10	"10-out4541"	.26337	64	179	243
10	"10-out4542"	.20329	37	145	182
10	"10-out4543"	.41484	190	268	458
10	"10-out4544"	.17982	41	187	228
10	"10-out4545"	.34328	92	176	268
10	"10-out4546"	.25029	215	644	859
10	"10-out4547"	.23780	39	125	164
10	"10-out4548"	.38888	77	121	198
10	"10-out4549"	.38611	178	283	461
10	"10-out4550"	.14285	24	144	168
10	"10-out4551"	.44990	238	291	529
10	"10-out4552"	.28301	420	1064	1484
10	"10-out4553"	.84813	296	53	349
10	"10-out4554"	.19565	27	111	138
10	"10-out4555"	.43105	347	458	805
10	"10-out4556"	.22440	114	394	508
10	"10-out4557"	.77536	107	31	138
10	"10-out4558"	.26479	774	2149	2923
10	"10-out4559"	.39320	81	125	206
10	"10-out4560"	.76821	116	35	151
10	"10-out4561"	.52315	644	587	1231
10	"10-out4562"	.45549	261	312	573
10	"10-out4563"	.37075	251	426	677
10	"10-out4564"	.99387	487	3	490
10	"10-out4565"	.87811	1232	171	1403
10	"10-out4566"	.42483	65	88	153
10	"10-out4567"	.81690	116	26	142
10	"10-out4568"	.64356	130	72	202
10	"10-out4569"	.38979	168	263	431
10	"10-out4570"	.30351	190	436	626
10	"10-out4571"	.21965	228	810	1038
10	"10-out4572"	.27867	277	717	994
10	"10-out4573"	.49642	139	141	280
10	"10-out4574"	.26059	123	349	472
10	"10-out4575"	.23469	46	150	196
10	"10-out4576"	.65354	166	88	254
10	"10-out4577"	.19117	78	330	408
10	"10-out4578"	.20385	148	578	726
10	"10-out4579"	.41056	101	145	246
10	"10-out4580"	.28555	528	1321	1849
10	"10-out4581"	.72521	256	97	353
10	"10-out4582"	.98809	83	1	84
10	"10-out4583"	.44444	76	95	171
10	"10-out4584"	.90718	303	31	334
10	"10-out4585"	.25951	75	214	289
10	"10-out4586"	.39525	100	153	253
10	"10-out4587"	.99547	220	1	221
10	"10-out4588"	.89256	324	39	363
10	"10-out4589"	.43017	268	355	623
10	"10-out4590"	.43660	427	551	978
10	"10-out4591"	.58007	163	118	281
10	"10-out4592"	.99724	362	1	363
10	"10-out4593"	.34177	27	52	79
10	"10-out4594"	.49382	120	123	243
10	"10-out4595"	.58378	216	154	370
10	"10-out4596"	.40845	58	84	142
10	"10-out4597"	.21538	112	408	520
10	"10-out4598"	.28860	228	562	790
10	"10-out4599"	.29792	230	542	772
10	"10-out4600"	.32891	298	608	906
10	"10-out4601"	.47774	161	176	337
10	"10-out4602"	.20414	187	729	916
10	"10-out4603"	.41564	170	239	409
10	"10-out4604"	.68663	298	136	434
10	"10-out4605"	.38636	187	297	484
10	"10-out4606"	.31023	94	209	303
10	"10-out4607"	.39252	126	195	321
10	"10-out4608"	.46978	171	193	364
10	"10-out4609"	.21821	115	412	527
10	"10-out4610"	.35951	119	212	331
10	"10-out4611"	.98058	404	8	412
10	"10-out4612"	.16049	26	136	162
10	"10-out4613"	.55154	107	87	194
10	"10-out4614"	.42307	88	120	208
10	"10-out4615"	.29616	170	404	574
10	"10-out4616"	.98561	137	2	139
10	"10-out4617"	.78983	233	62	295
10	"10-out4618"	.30044	271	631	902
10	"10-out4619"	.18138	76	343	419
10	"10-out4620"	.33766	338	663	1001
10	"10-out4621"	.19284	97	406	503
10	"10-out4622"	.21604	35	127	162
10	"10-out4623"	.48756	98	103	201
10	"10-out4624"	.40318	152	225	377
10	"10-out4625"	.25496	77	225	302
10	"10-out4626"	.39529	370	566	936
10	"10-out4627"	.99657	291	1	292
10	"10-out4628"	.70930	183	75	258
10	"10-out4629"	.99663	296	1	297
10	"10-out4630"	.61413	339	213	552
10	"10-out4631"	.52018	451	416	867
10	"10-out4632"	.50000	105	105	210
10	"10-out4633"	.51328	367	348	715
10	"10-out4634"	.99736	379	1	380
10	"10-out4635"	.32368	179	374	553
10	"10-out4636"	.67292	251	122	373
10	"10-out4637"	.78906	404	108	512
10	"10-out4638"	.62692	163	97	260
10	"10-out4639"	.75131	429	142	571
10	"10-out4640"	.40625	39	57	96
10	"10-out4641"	.35051	34	63	97
10	"10-out4642"	.35433	45	82	127
10	"10-out4643"	.51943	147	136	283
10	"10-out4644"	.31436	116	253	369
10	"10-out4645"	.98947	94	1	95
10	"10-out4646"	.30303	20	46	66
10	"10-out4647"	.47236	94	105	199
10	"10-out4648"	.81235	355	82	437
10	"10-out4649"	.23449	155	506	661
10	"10-out4650"	.33333	80	160	240
10	"10-out4651"	.21093	27	101	128
10	"10-out4652"	.27586	72	189	261
10	"10-out4653"	.43543	145	188	333
10	"10-out4654"	.61185	454	288	742
10	"10-out4655"	.17543	30	141	171
10	"10-out4656"	.49787	117	118	235
10	"10-out4657"	.26057	117	332	449
10	"10-out4658"	.31825	190	407	597
10	"10-out4659"	.70466	136	57	193
10	"10-out4660"	.47115	98	110	208
10	"10-out4661"	.31548	165	358	523
10	"10-out4662"	.76838	1808	545	2353
10	"10-out4663"	.48582	1080	1143	2223
10	"10-out4664"	.43137	198	261	459
10	"10-out4665"	.29411	95	228	323
10	"10-out4666"	.28735	125	310	435
10	"10-out4667"	.92968	119	9	128
10	"10-out4668"	.37777	119	196	315
10	"10-out4669"	.34117	58	112	170
10	"10-out4670"	.29588	474	1128	1602
10	"10-out4671"	.28593	183	457	640
10	"10-out4672"	.28373	389	982	1371
10	"10-out4673"	.24615	144	441	585
10	"10-out4674"	.34901	89	166	255
10	"10-out4675"	.34446	165	314	479
10	"10-out4676"	.50909	140	135	275
10	"10-out4677"	.28762	86	213	299
10	"10-out4678"	.26808	289	789	1078
10	"10-out4679"	.99541	217	1	218
10	"10-out4680"	.39513	130	199	329
10	"10-out4681"	.94478	154	9	163
10	"10-out4682"	.27207	114	305	419
10	"10-out4683"	.27698	272	710	982
10	"10-out4684"	.24454	56	173	229
10	"10-out4685"	.19963	110	441	551
10	"10-out4686"	.19963	110	441	551
10	"10-out4687"	.23711	23	74	97
10	"10-out4688"	.49097	136	141	277
10	"10-out4689"	.42929	255	339	594
10	"10-out4690"	.56842	839	637	1476
10	"10-out4691"	.99746	394	1	395
10	"10-out4692"	.40449	108	159	267
10	"10-out4693"	.52613	765	689	1454
10	"10-out4694"	.65430	706	373	1079
10	"10-out4695"	.25799	113	325	438
10	"10-out4696"	.41935	39	54	93
10	"10-out4697"	.34701	93	175	268
10	"10-out4698"	.51838	282	262	544
10	"10-out4699"	.38289	206	332	538
10	"10-out4700"	.19552	166	683	849
10	"10-out4701"	.97176	413	12	425
10	"10-out4702"	.98901	90	1	91
10	"10-out4703"	.51724	405	378	783
10	"10-out4704"	.74005	279	98	377
10	"10-out4705"	.35498	235	427	662
10	"10-out4706"	.23762	72	231	303
10	"10-out4707"	.26098	101	286	387
10	"10-out4708"	.83566	239	47	286
10	"10-out4709"	.34707	320	602	922
10	"10-out4710"	.61377	205	129	334
10	"10-out4711"	.41975	68	94	162
10	"10-out4712"	.99074	107	1	108
10	"10-out4713"	.41880	49	68	117
10	"10-out4714"	.21557	191	695	886
10	"10-out4715"	.46093	59	69	128
10	"10-out4716"	.40207	464	690	1154
10	"10-out4717"	.51940	348	322	670
10	"10-out4718"	.24444	44	136	180
10	"10-out4719"	.31647	194	419	613
10	"10-out4720"	.37179	493	833	1326
10	"10-out4721"	.50681	558	543	1101
10	"10-out4722"	.80314	204	50	254
10	"10-out4723"	.64835	177	96	273
10	"10-out4724"	.55692	181	144	325
10	"10-out4725"	.50000	100	100	200
10	"10-out4726"	.30979	193	430	623
10	"10-out4727"	.53191	175	154	329
10	"10-out4728"	.51524	490	461	951
10	"10-out4729"	.98888	89	1	90
10	"10-out4730"	.99305	143	1	144
10	"10-out4731"	.86787	1202	183	1385
10	"10-out4732"	.92391	85	7	92
10	"10-out4733"	.44791	43	53	96
10	"10-out4734"	.41052	78	112	190
10	"10-out4735"	.28011	100	257	357
10	"10-out4736"	.29247	136	329	465
10	"10-out4737"	.33611	121	239	360
10	"10-out4738"	.55555	205	164	369
10	"10-out4739"	.46534	188	216	404
10	"10-out4740"	.97983	243	5	248
10	"10-out4741"	.46779	138	157	295
10	"10-out4742"	.97506	352	9	361
10	"10-out4743"	.42560	615	830	1445
10	"10-out4744"	.21532	59	215	274
10	"10-out4745"	.98924	92	1	93
10	"10-out4746"	.17073	28	136	164
10	"10-out4747"	.50228	110	109	219
10	"10-out4748"	.38918	144	226	370
10	"10-out4749"	.19491	46	190	236
10	"10-out4750"	.73544	278	100	378
10	"10-out4751"	.99447	360	2	362
10	"10-out4752"	.15267	20	111	131
10	"10-out4753"	.57485	96	71	167
10	"10-out4754"	.99218	127	1	128
10	"10-out4755"	.43758	340	437	777
10	"10-out4756"	.35407	700	1277	1977
10	"10-out4757"	.99016	302	3	305
10	"10-out4758"	.55233	438	355	793
10	"10-out4759"	.25303	167	493	660
10	"10-out4760"	.18041	70	318	388
10	"10-out4761"	.23850	83	265	348
10	"10-out4762"	.30243	372	858	1230
10	"10-out4763"	.27431	110	291	401
10	"10-out4764"	.22549	161	553	714
10	"10-out4765"	.26833	172	469	641
10	"10-out4766"	.42920	97	129	226
10	"10-out4767"	.19865	118	476	594
10	"10-out4768"	.27659	91	238	329
10	"10-out4769"	.39348	157	242	399
10	"10-out4770"	.84965	243	43	286
10	"10-out4771"	.72000	108	42	150
10	"10-out4772"	.53435	70	61	131
10	"10-out4773"	.29385	67	161	228
10	"10-out4774"	.56024	93	73	166
10	"10-out4775"	.29411	125	300	425
10	"10-out4776"	.14251	60	361	421
10	"10-out4777"	.26547	283	783	1066
10	"10-out4778"	.35214	156	287	443
10	"10-out4779"	.24235	111	347	458
10	"10-out4780"	.30569	59	134	193
10	"10-out4781"	.20588	77	297	374
10	"10-out4782"	.31203	762	1680	2442
10	"10-out4783"	.31722	151	325	476
10	"10-out4784"	.33849	415	811	1226
10	"10-out4785"	.28481	135	339	474
10	"10-out4786"	.99841	629	1	630
10	"10-out4787"	.99746	394	1	395
10	"10-out4788"	.98529	67	1	68
10	"10-out4789"	.33803	575	1126	1701
10	"10-out4790"	.69744	355	154	509
10	"10-out4791"	.34343	102	195	297
10	"10-out4792"	.80961	404	95	499
10	"10-out4793"	.22291	72	251	323
10	"10-out4794"	.31034	126	280	406
10	"10-out4795"	.46892	249	282	531
10	"10-out4796"	.28438	184	463	647
10	"10-out4797"	.19473	37	153	190
10	"10-out4798"	.39516	98	150	248
10	"10-out4799"	.99565	229	1	230
10	"10-out4800"	.43498	184	239	423
10	"10-out4801"	.62275	208	126	334
10	"10-out4802"	.99741	773	2	775
10	"10-out4803"	.38874	304	478	782
10	"10-out4804"	.16158	53	275	328
10	"10-out4805"	.37133	114	193	307
10	"10-out4806"	.99655	289	1	290
10	"10-out4807"	.33786	199	390	589
10	"10-out4808"	.20055	145	578	723
10	"10-out4809"	.34700	203	382	585
10	"10-out4810"	.44701	135	167	302
10	"10-out4811"	.30456	120	274	394
10	"10-out4812"	.32899	607	1238	1845
10	"10-out4813"	.57224	400	299	699
10	"10-out4814"	.39051	280	437	717
10	"10-out4815"	.26911	264	717	981
10	"10-out4816"	.53448	93	81	174
10	"10-out4817"	.29005	277	678	955
10	"10-out4818"	.39436	56	86	142
10	"10-out4819"	.96969	32	1	33
10	"10-out4820"	.22041	95	336	431
10	"10-out4821"	.29365	37	89	126
10	"10-out4822"	.06557	8	114	122
10	"10-out4823"	.99621	263	1	264
10	"10-out4824"	.97916	282	6	288
10	"10-out4825"	.83946	251	48	299
10	"10-out4826"	.69047	145	65	210
10	"10-out4827"	.51027	621	596	1217
10	"10-out4828"	.57726	325	238	563
10	"10-out4829"	.44328	426	535	961
10	"10-out4830"	.23754	62	199	261
10	"10-out4831"	.27173	75	201	276
10	"10-out4832"	.98841	768	9	777
10	"10-out4833"	.45291	101	122	223
10	"10-out4834"	.90000	306	34	340
10	"10-out4835"	.72602	106	40	146
10	"10-out4836"	.37011	265	451	716
10	"10-out4837"	.13953	36	222	258
10	"10-out4838"	.84691	426	77	503
10	"10-out4839"	.48245	55	59	114
10	"10-out4840"	.47947	292	317	609
10	"10-out4841"	.89663	720	83	803
10	"10-out4842"	.35185	361	665	1026
10	"10-out4843"	.30443	158	361	519
10	"10-out4844"	.98921	2017	22	2039
10	"10-out4845"	.98717	308	4	312
10	"10-out4846"	.40274	176	261	437
10	"10-out4847"	.99514	410	2	412
10	"10-out4848"	.44851	196	241	437
10	"10-out4849"	.83010	386	79	465
10	"10-out4850"	.63775	125	71	196
10	"10-out4851"	.68390	119	55	174
10	"10-out4852"	.30769	56	126	182
10	"10-out4853"	.62376	63	38	101
10	"10-out4854"	.46208	195	227	422
10	"10-out4855"	.79098	386	102	488
10	"10-out4856"	.87407	1763	254	2017
10	"10-out4857"	.31250	95	209	304
10	"10-out4858"	.99651	286	1	287
10	"10-out4859"	.34402	236	450	686
10	"10-out4860"	.22600	113	387	500
10	"10-out4861"	.36767	182	313	495
10	"10-out4862"	.28853	73	180	253
10	"10-out4863"	.45137	181	220	401
10	"10-out4864"	.16184	28	145	173
10	"10-out4865"	.30263	46	106	152
10	"10-out4866"	.33898	40	78	118
10	"10-out4867"	.34188	40	77	117
10	"10-out4868"	.34757	122	229	351
10	"10-out4869"	.21531	45	164	209
10	"10-out4870"	.53488	69	60	129
10	"10-out4871"	.99494	197	1	198
10	"10-out4872"	.55147	75	61	136
10	"10-out4873"	.22718	112	381	493
10	"10-out4874"	.99019	101	1	102
10	"10-out4875"	.74879	623	209	832
10	"10-out4876"	.40780	230	334	564
10	"10-out4877"	.16184	28	145	173
10	"10-out4878"	.25781	66	190	256
10	"10-out4879"	.36281	201	353	554
10	"10-out4880"	.99539	216	1	217
10	"10-out4881"	.46527	67	77	144
10	"10-out4882"	.83375	326	65	391
10	"10-out4883"	.38015	544	887	1431
10	"10-out4884"	.33860	407	795	1202
10	"10-out4885"	.87212	341	50	391
10	"10-out4886"	.50175	143	142	285
10	"10-out4887"	.53971	265	226	491
10	"10-out4888"	.16257	53	273	326
10	"10-out4889"	.81791	283	63	346
10	"10-out4890"	.99397	165	1	166
10	"10-out4891"	.99444	537	3	540
10	"10-out4892"	.31382	59	129	188
10	"10-out4893"	.48958	47	49	96
10	"10-out4894"	.49109	689	714	1403
10	"10-out4895"	.39743	217	329	546
10	"10-out4896"	.42528	333	450	783
10	"10-out4897"	.44319	593	745	1338
10	"10-out4898"	.32147	226	477	703
10	"10-out4899"	.77914	127	36	163
10	"10-out4900"	.99512	204	1	205
10	"10-out4901"	.34210	130	250	380
10	"10-out4902"	.42702	711	954	1665
10	"10-out4903"	.84166	202	38	240
10	"10-out4904"	.30472	71	162	233
10	"10-out4905"	.34653	70	132	202
10	"10-out4906"	.99393	164	1	165
10	"10-out4907"	.63228	141	82	223
10	"10-out4908"	.99009	100	1	101
10	"10-out4909"	.28096	152	389	541
10	"10-out4910"	.37037	150	255	405
10	"10-out4911"	.98913	91	1	92
10	"10-out4912"	.37096	92	156	248
10	"10-out4913"	.40598	95	139	234
10	"10-out4914"	.37219	83	140	223
10	"10-out4915"	.24277	42	131	173
10	"10-out4916"	.45394	69	83	152
10	"10-out4917"	.39039	130	203	333
10	"10-out4918"	.88853	279	35	314
10	"10-out4919"	.65555	59	31	90
10	"10-out4920"	.38596	22	35	57
10	"10-out4921"	.99805	512	1	513
10	"10-out4922"	.24195	233	730	963
10	"10-out4923"	.27755	141	367	508
10	"10-out4924"	.51898	82	76	158
10	"10-out4925"	.95769	498	22	520
10	"10-out4926"	.99798	496	1	497
10	"10-out4927"	.92697	457	36	493
10	"10-out4928"	.21330	109	402	511
10	"10-out4929"	.37139	322	545	867
10	"10-out4930"	.44466	225	281	506
10	"10-out4931"	.61829	311	192	503
10	"10-out4932"	.39445	185	284	469
10	"10-out4933"	.35614	203	367	570
10	"10-out4934"	.47636	131	144	275
10	"10-out4935"	.98571	69	1	70
10	"10-out4936"	.43256	170	223	393
10	"10-out4937"	.54362	81	68	149
10	"10-out4938"	.15865	142	753	895
10	"10-out4939"	.28370	303	765	1068
10	"10-out4940"	.32323	32	67	99
10	"10-out4941"	.79104	53	14	67
10	"10-out4942"	.38947	37	58	95
10	"10-out4943"	.42253	30	41	71
10	"10-out4944"	.67457	199	96	295
10	"10-out4945"	.29746	47	111	158
10	"10-out4946"	.26044	106	301	407
10	"10-out4947"	.30731	189	426	615
10	"10-out4948"	.62833	377	223	600
10	"10-out4949"	.94611	597	34	631
10	"10-out4950"	.29516	165	394	559
10	"10-out4951"	.35540	161	292	453
10	"10-out4952"	.42477	144	195	339
10	"10-out4953"	.64794	300	163	463
10	"10-out4954"	.17543	60	282	342
10	"10-out4955"	.51468	368	347	715
10	"10-out4956"	.42193	327	448	775
10	"10-out4957"	.46190	194	226	420
10	"10-out4958"	.20474	69	268	337
10	"10-out4959"	.62283	431	261	692
10	"10-out4960"	.72527	132	50	182
10	"10-out4961"	.09809	36	331	367
10	"10-out4962"	.76359	365	113	478
10	"10-out4963"	.80167	384	95	479
10	"10-out4964"	.20350	58	227	285
10	"10-out4965"	.34319	58	111	169
10	"10-out4966"	.71463	586	234	820
10	"10-out4967"	.23316	45	148	193
10	"10-out4968"	.28280	153	388	541
10	"10-out4969"	.20458	107	416	523
10	"10-out4970"	.31250	50	110	160
10	"10-out4971"	.36764	50	86	136
10	"10-out4972"	.98850	86	1	87
10	"10-out4973"	.27536	19	50	69
10	"10-out4974"	.19736	15	61	76
10	"10-out4975"	.99641	556	2	558
10	"10-out4976"	.24229	110	344	454
10	"10-out4977"	.44444	220	275	495
10	"10-out4978"	.29511	278	664	942
10	"10-out4979"	.21081	156	584	740
10	"10-out4980"	.22993	149	499	648
10	"10-out4981"	.23033	41	137	178
10	"10-out4982"	.27419	51	135	186
10	"10-out4983"	.36087	345	611	956
10	"10-out4984"	.34283	445	853	1298
10	"10-out4985"	.24675	38	116	154
10	"10-out4986"	.98571	69	1	70
10	"10-out4987"	.63934	39	22	61
10	"10-out4988"	.47761	32	35	67
10	"10-out4989"	.29189	108	262	370
10	"10-out4990"	.28774	101	250	351
10	"10-out4991"	.59534	512	348	860
10	"10-out4992"	.88334	1575	208	1783
10	"10-out4993"	.82288	525	113	638
10	"10-out4994"	.29381	171	411	582
10	"10-out4995"	.41846	136	189	325
10	"10-out4996"	.22000	66	234	300
10	"10-out4997"	.99734	375	1	376
10	"10-out4998"	.98461	64	1	65
10	"10-out4999"	.99472	754	4	758
10	"10-out5000"	.43715	80	103	183
10	"10-out5001"	.34216	142	273	415
10	"10-out5002"	.07843	8	94	102
10	"10-out5003"	.48780	60	63	123
10	"10-out5004"	.98484	65	1	66
10	"10-out5005"	.23076	18	60	78
10	"10-out5006"	.99358	155	1	156
10	"10-out5007"	.34234	38	73	111
10	"10-out5008"	.99324	147	1	148
10	"10-out5009"	.45316	179	216	395
10	"10-out5010"	.31801	173	371	544
10	"10-out5011"	.89662	399	46	445
10	"10-out5012"	.53538	174	151	325
10	"10-out5013"	.42881	256	341	597
10	"10-out5014"	.25000	54	162	216
10	"10-out5015"	.39615	206	314	520
10	"10-out5016"	.18614	43	188	231
10	"10-out5017"	.48241	727	780	1507
10	"10-out5018"	.46428	221	255	476
10	"10-out5019"	.24257	351	1096	1447
10	"10-out5020"	.22635	146	499	645
10	"10-out5021"	.17374	45	214	259
10	"10-out5022"	.24371	97	301	398
10	"10-out5023"	.29591	29	69	98
10	"10-out5024"	.34825	389	728	1117
10	"10-out5025"	.55214	90	73	163
10	"10-out5026"	.98347	238	4	242
10	"10-out5027"	.39895	152	229	381
10	"10-out5028"	.39410	214	329	543
10	"10-out5029"	.99761	419	1	420
10	"10-out5030"	.26360	155	433	588
10	"10-out5031"	.58571	164	116	280
10	"10-out5032"	.33628	38	75	113
10	"10-out5033"	.34189	253	487	740
10	"10-out5034"	.99462	740	4	744
10	"10-out5035"	.99588	484	2	486
10	"10-out5036"	.99481	576	3	579
10	"10-out5037"	.91394	616	58	674
10	"10-out5038"	.27209	117	313	430
10	"10-out5039"	.25804	369	1061	1430
10	"10-out5040"	.70353	458	193	651
10	"10-out5041"	.54022	188	160	348
10	"10-out5042"	.29949	118	276	394
10	"10-out5043"	.99487	194	1	195
10	"10-out5044"	.99212	378	3	381
10	"10-out5045"	.45682	164	195	359
10	"10-out5046"	.63116	397	232	629
10	"10-out5047"	.37168	42	71	113
10	"10-out5048"	.99386	162	1	163
10	"10-out5049"	.32077	247	523	770
10	"10-out5050"	.28750	115	285	400
10	"10-out5051"	.43166	439	578	1017
10	"10-out5052"	.81560	115	26	141
10	"10-out5053"	.48798	264	277	541
10	"10-out5054"	.99763	421	1	422
10	"10-out5055"	.31339	262	574	836
10	"10-out5056"	.99883	854	1	855
10	"10-out5057"	.99270	136	1	137
10	"10-out5058"	.36470	248	432	680
10	"10-out5059"	.36211	411	724	1135
10	"10-out5060"	.31941	176	375	551
10	"10-out5061"	.58666	132	93	225
10	"10-out5062"	.56553	233	179	412
10	"10-out5063"	.34961	136	253	389
10	"10-out5064"	.89709	340	39	379
10	"10-out5065"	.24326	271	843	1114
10	"10-out5066"	.43384	141	184	325
10	"10-out5067"	.67749	292	139	431
10	"10-out5068"	.47592	168	185	353
10	"10-out5069"	.35428	62	113	175
10	"10-out5070"	.69856	146	63	209
10	"10-out5071"	.52688	98	88	186
10	"10-out5072"	.36746	61	105	166
10	"10-out5073"	.99275	137	1	138
10	"10-out5074"	.38916	237	372	609
10	"10-out5075"	.45012	370	452	822
10	"10-out5076"	.13944	35	216	251
10	"10-out5077"	.28421	135	340	475
10	"10-out5078"	.41796	484	674	1158
10	"10-out5079"	.37103	269	456	725
10	"10-out5080"	.37690	173	286	459
10	"10-out5081"	.44129	109	138	247
10	"10-out5082"	.87103	439	65	504
10	"10-out5083"	.56796	117	89	206
10	"10-out5084"	.98484	325	5	330
10	"10-out5085"	.57940	467	339	806
10	"10-out5086"	.64935	350	189	539
10	"10-out5087"	.91423	1066	100	1166
10	"10-out5088"	.18993	83	354	437
10	"10-out5089"	.29105	335	816	1151
10	"10-out5090"	.31005	182	405	587
10	"10-out5091"	.60547	221	144	365
10	"10-out5092"	.39153	148	230	378
10	"10-out5093"	.30275	231	532	763
10	"10-out5094"	.97272	321	9	330
10	"10-out5095"	.22980	202	677	879
10	"10-out5096"	.28149	143	365	508
10	"10-out5097"	.35365	174	318	492
10	"10-out5098"	.26538	841	2328	3169
10	"10-out5099"	.54666	451	374	825
10	"10-out5100"	.40000	228	342	570
10	"10-out5101"	.29878	147	345	492
10	"10-out5102"	.09638	48	450	498
10	"10-out5103"	.36792	195	335	530
10	"10-out5104"	.96500	193	7	200
10	"10-out5105"	.34408	64	122	186
10	"10-out5106"	.30267	102	235	337
10	"10-out5107"	.17847	68	313	381
10	"10-out5108"	.99180	121	1	122
10	"10-out5109"	.31237	154	339	493
10	"10-out5110"	.46062	427	500	927
10	"10-out5111"	.63062	659	386	1045
10	"10-out5112"	.26910	169	459	628
10	"10-out5113"	.21237	151	560	711
10	"10-out5114"	.80319	151	37	188
10	"10-out5115"	.37771	139	229	368
10	"10-out5116"	.43043	198	262	460
10	"10-out5117"	.69124	300	134	434
10	"10-out5118"	.38333	115	185	300
10	"10-out5119"	.34848	115	215	330
10	"10-out5120"	.96820	335	11	346
10	"10-out5121"	.42705	161	216	377
10	"10-out5122"	.31265	257	565	822
10	"10-out5123"	.72164	140	54	194
10	"10-out5124"	.37039	523	889	1412
10	"10-out5125"	.67759	124	59	183
10	"10-out5126"	.98507	198	3	201
10	"10-out5127"	.72271	1728	663	2391
10	"10-out5128"	.30841	132	296	428
10	"10-out5129"	.21808	82	294	376
10	"10-out5130"	.26057	191	542	733
10	"10-out5131"	.34980	630	1171	1801
10	"10-out5132"	.57668	188	138	326
10	"10-out5133"	.31343	189	414	603
10	"10-out5134"	.46027	168	197	365
10	"10-out5135"	.99606	506	2	508
10	"10-out5136"	.15885	78	413	491
10	"10-out5137"	.41176	154	220	374
10	"10-out5138"	.28296	824	2088	2912
10	"10-out5139"	.86995	582	87	669
10	"10-out5140"	.33186	301	606	907
10	"10-out5141"	.99826	577	1	578
10	"10-out5142"	.90509	515	54	569
10	"10-out5143"	.76878	133	40	173
10	"10-out5144"	.30415	205	469	674
10	"10-out5145"	.83132	138	28	166
10	"10-out5146"	.64705	209	114	323
10	"10-out5147"	.22799	544	1842	2386
10	"10-out5148"	.49193	244	252	496
10	"10-out5149"	.43835	128	164	292
10	"10-out5150"	.37404	98	164	262
10	"10-out5151"	.59392	724	495	1219
10	"10-out5152"	.96140	548	22	570
10	"10-out5153"	.70982	159	65	224
10	"10-out5154"	.98876	88	1	89
10	"10-out5155"	.24144	127	399	526
10	"10-out5156"	.99557	225	1	226
10	"10-out5157"	.56078	143	112	255
10	"10-out5158"	.96296	234	9	243
10	"10-out5159"	.54059	293	249	542
10	"10-out5160"	.26470	90	250	340
10	"10-out5161"	.34626	1276	2409	3685
10	"10-out5162"	.24538	1010	3106	4116
10	"10-out5163"	.29325	1356	3268	4624
10	"10-out5164"	.23396	1087	3559	4646
10	"10-out5165"	.35930	226	403	629
10	"10-out5166"	.53378	1872	1635	3507
10	"10-out5167"	.19966	120	481	601
10	"10-out5168"	.33846	176	344	520
10	"10-out5169"	.18823	64	276	340
10	"10-out5170"	.62022	276	169	445
10	"10-out5171"	.31512	150	326	476
10	"10-out5172"	.69538	226	99	325
10	"10-out5173"	.99612	257	1	258
10	"10-out5174"	.33194	239	481	720
10	"10-out5175"	.27752	184	479	663
10	"10-out5176"	.84218	539	101	640
10	"10-out5177"	.43324	172	225	397
10	"10-out5178"	.46815	147	167	314
10	"10-out5179"	.28143	94	240	334
10	"10-out5180"	.27889	181	468	649
10	"10-out5181"	.44985	305	373	678
10	"10-out5182"	.25270	187	553	740
10	"10-out5183"	.99606	253	1	254
10	"10-out5184"	.62939	197	116	313
10	"10-out5185"	.39702	187	284	471
10	"10-out5186"	.40225	214	318	532
10	"10-out5187"	.34890	112	209	321
10	"10-out5188"	.22196	95	333	428
10	"10-out5189"	.87145	400	59	459
10	"10-out5190"	.46846	104	118	222
10	"10-out5191"	.37675	457	756	1213
10	"10-out5192"	.52264	900	822	1722
10	"10-out5193"	.30755	334	752	1086
10	"10-out5194"	.20825	111	422	533
10	"10-out5195"	.94570	418	24	442
10	"10-out5196"	.25446	57	167	224
10	"10-out5197"	.49360	502	515	1017
10	"10-out5198"	.79025	795	211	1006
10	"10-out5199"	.76969	381	114	495
10	"10-out5200"	.57101	197	148	345
10	"10-out5201"	.99777	1790	4	1794
10	"10-out5202"	.24258	499	1558	2057
10	"10-out5203"	.28540	530	1327	1857
10	"10-out5204"	.93495	345	24	369
10	"10-out5205"	.35958	105	187	292
10	"10-out5206"	.45833	297	351	648
10	"10-out5207"	.30174	156	361	517
10	"10-out5208"	.99331	297	2	299
10	"10-out5209"	.29273	387	935	1322
10	"10-out5210"	.54069	186	158	344
10	"10-out5211"	.85329	285	49	334
10	"10-out5212"	.29032	117	286	403
10	"10-out5213"	.25819	126	362	488
10	"10-out5214"	.32974	153	311	464
10	"10-out5215"	.37799	268	441	709
10	"10-out5216"	.99651	286	1	287
10	"10-out5217"	.23012	165	552	717
10	"10-out5218"	.35658	138	249	387
10	"10-out5219"	.40810	282	409	691
10	"10-out5220"	.09034	29	292	321
10	"10-out5221"	.31021	255	567	822
10	"10-out5222"	.27488	58	153	211
10	"10-out5223"	.38789	410	647	1057
10	"10-out5224"	.27365	107	284	391
10	"10-out5225"	.14532	59	347	406
10	"10-out5226"	.44206	103	130	233
10	"10-out5227"	.30612	45	102	147
10	"10-out5228"	.51612	96	90	186
10	"10-out5229"	.18122	83	375	458
10	"10-out5230"	.99234	648	5	653
10	"10-out5231"	.43910	137	175	312
10	"10-out5232"	.66071	148	76	224
10	"10-out5233"	.21863	61	218	279
10	"10-out5234"	.30946	268	598	866
10	"10-out5235"	.27291	271	722	993
10	"10-out5236"	.68146	967	452	1419
10	"10-out5237"	.99724	362	1	363
10	"10-out5238"	.39873	252	380	632
10	"10-out5239"	.41322	200	284	484
10	"10-out5240"	.46634	97	111	208
10	"10-out5241"	.57790	204	149	353
10	"10-out5242"	.34986	268	498	766
10	"10-out5243"	.16067	67	350	417
10	"10-out5244"	.83574	173	34	207
10	"10-out5245"	.44769	107	132	239
10	"10-out5246"	.23943	68	216	284
10	"10-out5247"	.23076	48	160	208
10	"10-out5248"	.28014	230	591	821
10	"10-out5249"	.99696	329	1	330
10	"10-out5250"	.41207	471	672	1143
10	"10-out5251"	.34878	158	295	453
10	"10-out5252"	.56979	249	188	437
10	"10-out5253"	.35151	174	321	495
10	"10-out5254"	.19936	253	1016	1269
10	"10-out5255"	.21238	24	89	113
10	"10-out5256"	.21868	103	368	471
10	"10-out5257"	.20123	130	516	646
10	"10-out5258"	.92655	164	13	177
10	"10-out5259"	.99319	146	1	147
10	"10-out5260"	.58158	278	200	478
10	"10-out5261"	.20536	153	592	745
10	"10-out5262"	.37530	304	506	810
10	"10-out5263"	.96832	214	7	221
10	"10-out5264"	.94444	102	6	108
10	"10-out5265"	.62996	206	121	327
10	"10-out5266"	.32321	149	312	461
10	"10-out5267"	.27464	39	103	142
10	"10-out5268"	.30263	161	371	532
10	"10-out5269"	.98876	88	1	89
10	"10-out5270"	.32490	334	694	1028
10	"10-out5271"	.44012	136	173	309
10	"10-out5272"	.87722	443	62	505
10	"10-out5273"	.34857	122	228	350
10	"10-out5274"	.73819	172	61	233
10	"10-out5275"	.86190	181	29	210
10	"10-out5276"	.94272	395	24	419
10	"10-out5277"	.66530	326	164	490
10	"10-out5278"	.91315	347	33	380
10	"10-out5279"	.60588	103	67	170
10	"10-out5280"	.30864	75	168	243
10	"10-out5281"	.44938	657	805	1462
10	"10-out5282"	.55072	114	93	207
10	"10-out5283"	.35648	77	139	216
10	"10-out5284"	.26492	71	197	268
10	"10-out5285"	.29810	347	817	1164
10	"10-out5286"	.60645	94	61	155
10	"10-out5287"	.45971	97	114	211
10	"10-out5288"	.29189	54	131	185
10	"10-out5289"	.23367	136	446	582
10	"10-out5290"	.50000	54	54	108
10	"10-out5291"	.16618	58	291	349
10	"10-out5292"	.19690	89	363	452
10	"10-out5293"	.98876	88	1	89
10	"10-out5294"	.27777	40	104	144
10	"10-out5295"	.95626	481	22	503
10	"10-out5296"	.72941	682	253	935
10	"10-out5297"	.26877	68	185	253
10	"10-out5298"	.31836	78	167	245
10	"10-out5299"	.36713	315	543	858
10	"10-out5300"	.62917	207	122	329
10	"10-out5301"	.34892	97	181	278
10	"10-out5302"	.33564	97	192	289
10	"10-out5303"	.54773	109	90	199
10	"10-out5304"	.04733	8	161	169
10	"10-out5305"	.11538	21	161	182
10	"10-out5306"	.99193	123	1	124
10	"10-out5307"	.61379	89	56	145
10	"10-out5308"	.27741	43	112	155
10	"10-out5309"	.99931	1467	1	1468
10	"10-out5310"	.30882	84	188	272
10	"10-out5311"	.39748	190	288	478
10	"10-out5312"	.36945	75	128	203
10	"10-out5313"	.48762	1222	1284	2506
10	"10-out5314"	.35000	77	143	220
10	"10-out5315"	.35912	840	1499	2339
10	"10-out5316"	.15569	123	667	790
10	"10-out5317"	.44986	166	203	369
10	"10-out5318"	.31050	68	151	219
10	"10-out5319"	.25156	201	598	799
10	"10-out5320"	.42002	344	475	819
10	"10-out5321"	.32747	205	421	626
10	"10-out5322"	.41573	148	208	356
10	"10-out5323"	.22560	74	254	328
10	"10-out5324"	.31920	113	241	354
10	"10-out5325"	.45833	143	169	312
10	"10-out5326"	.24025	74	234	308
10	"10-out5327"	.34254	62	119	181
10	"10-out5328"	.93750	360	24	384
10	"10-out5329"	.36241	54	95	149
10	"10-out5330"	.89684	426	49	475
10	"10-out5331"	.42905	127	169	296
10	"10-out5332"	.29477	158	378	536
10	"10-out5333"	.30375	89	204	293
10	"10-out5334"	.28613	97	242	339
10	"10-out5335"	.97468	77	2	79
10	"10-out5336"	.37811	197	324	521
10	"10-out5337"	.39676	221	336	557
10	"10-out5338"	.34494	99	188	287
10	"10-out5339"	.71771	239	94	333
10	"10-out5340"	.32838	155	317	472
10	"10-out5341"	.38818	184	290	474
10	"10-out5342"	.28368	40	101	141
10	"10-out5343"	.20522	110	426	536
10	"10-out5344"	.49585	239	243	482
10	"10-out5345"	.20715	110	421	531
10	"10-out5346"	.37598	191	317	508
10	"10-out5347"	.48705	301	317	618
10	"10-out5348"	.99513	409	2	411
10	"10-out5349"	.40490	132	194	326
10	"10-out5350"	.26899	131	356	487
10	"10-out5351"	.18994	238	1015	1253
10	"10-out5352"	.35322	148	271	419
10	"10-out5353"	.43939	58	74	132
10	"10-out5354"	.66523	310	156	466
10	"10-out5355"	.65607	351	184	535
10	"10-out5356"	.36507	138	240	378
10	"10-out5357"	.33217	384	772	1156
10	"10-out5358"	.33859	322	629	951
10	"10-out5359"	.54201	129	109	238
10	"10-out5360"	.33128	216	436	652
10	"10-out5361"	.29268	72	174	246
10	"10-out5362"	.21825	55	197	252
10	"10-out5363"	.28952	141	346	487
10	"10-out5364"	.37839	613	1007	1620
10	"10-out5365"	.25840	292	838	1130
10	"10-out5366"	.20164	220	871	1091
10	"10-out5367"	.14851	15	86	101
10	"10-out5368"	.99487	194	1	195
10	"10-out5369"	.99526	210	1	211
10	"10-out5370"	.38452	328	525	853
10	"10-out5371"	.32947	57	116	173
10	"10-out5372"	.27324	241	641	882
10	"10-out5373"	.22719	762	2592	3354
10	"10-out5374"	.41255	184	262	446
10	"10-out5375"	.99657	582	2	584
10	"10-out5376"	.99367	157	1	158
10	"10-out5377"	.30158	38	88	126
10	"10-out5378"	.99365	313	2	315
10	"10-out5379"	.35983	344	612	956
10	"10-out5380"	.58855	329	230	559
10	"10-out5381"	.32233	254	534	788
10	"10-out5382"	.35922	111	198	309
10	"10-out5383"	.53650	169	146	315
10	"10-out5384"	.32061	84	178	262
10	"10-out5385"	.80835	658	156	814
10	"10-out5386"	.19653	68	278	346
10	"10-out5387"	.52060	240	221	461
10	"10-out5388"	.18363	92	409	501
10	"10-out5389"	.99279	1240	9	1249
10	"10-out5390"	.24701	62	189	251
10	"10-out5391"	.98888	89	1	90
10	"10-out5392"	.83140	360	73	433
10	"10-out5393"	.48933	390	407	797
10	"10-out5394"	.84710	205	37	242
10	"10-out5395"	.26442	110	306	416
10	"10-out5396"	.23033	41	137	178
10	"10-out5397"	.75886	535	170	705
10	"10-out5398"	.32839	133	272	405
10	"10-out5399"	.52107	136	125	261
10	"10-out5400"	.31350	137	300	437
10	"10-out5401"	.41269	52	74	126
10	"10-out5402"	.84710	205	37	242
10	"10-out5403"	.38053	344	560	904
10	"10-out5404"	.33600	252	498	750
10	"10-out5405"	.37479	919	1533	2452
10	"10-out5406"	.47311	132	147	279
10	"10-out5407"	.56102	262	205	467
10	"10-out5408"	.62925	499	294	793
10	"10-out5409"	.25882	154	441	595
10	"10-out5410"	.49703	335	339	674
10	"10-out5411"	.97814	179	4	183
10	"10-out5412"	.22733	178	605	783
10	"10-out5413"	.98058	202	4	206
10	"10-out5414"	.26436	46	128	174
10	"10-out5415"	.99658	292	1	293
10	"10-out5416"	.18245	52	233	285
10	"10-out5417"	.42546	254	343	597
10	"10-out5418"	.78827	834	224	1058
10	"10-out5419"	.51239	62	59	121
10	"10-out5420"	.98958	95	1	96
10	"10-out5421"	.99206	125	1	126
10	"10-out5422"	.25327	58	171	229
10	"10-out5423"	.36650	232	401	633
10	"10-out5424"	.27286	179	477	656
10	"10-out5425"	.36650	814	1407	2221
10	"10-out5426"	.31490	262	570	832
10	"10-out5427"	.29219	232	562	794
10	"10-out5428"	.33896	281	548	829
10	"10-out5429"	.32000	224	476	700
10	"10-out5430"	.33918	232	452	684
10	"10-out5431"	.32298	437	916	1353
10	"10-out5432"	.31715	366	788	1154
10	"10-out5433"	.99561	227	1	228
10	"10-out5434"	.84158	340	64	404
10	"10-out5435"	.20329	37	145	182
10	"10-out5436"	.21492	72	263	335
10	"10-out5437"	.38390	291	467	758
10	"10-out5438"	.34310	117	224	341
10	"10-out5439"	.48680	461	486	947
10	"10-out5440"	.92599	488	39	527
10	"10-out5441"	.47826	209	228	437
10	"10-out5442"	.99838	1235	2	1237
10	"10-out5443"	.84281	311	58	369
10	"10-out5444"	.83241	303	61	364
10	"10-out5445"	.28616	91	227	318
10	"10-out5446"	.28779	198	490	688
10	"10-out5447"	.69971	247	106	353
10	"10-out5448"	.18577	47	206	253
10	"10-out5449"	.72995	173	64	237
10	"10-out5450"	.38775	57	90	147
10	"10-out5451"	.46994	86	97	183
10	"10-out5452"	.35483	121	220	341
10	"10-out5453"	.40930	88	127	215
10	"10-out5454"	.32567	85	176	261
10	"10-out5455"	.26869	212	577	789
10	"10-out5456"	.31004	395	879	1274
10	"10-out5457"	.29396	117	281	398
10	"10-out5458"	.29976	125	292	417
10	"10-out5459"	.28867	237	584	821
10	"10-out5460"	.30044	201	468	669
10	"10-out5461"	.28317	367	929	1296
10	"10-out5462"	.47908	481	523	1004
10	"10-out5463"	.13380	171	1107	1278
10	"10-out5464"	.36974	176	300	476
10	"10-out5465"	.24574	260	798	1058
10	"10-out5466"	.84061	654	124	778
10	"10-out5467"	.35016	631	1171	1802
10	"10-out5468"	.99601	250	1	251
10	"10-out5469"	.80618	391	94	485
10	"10-out5470"	.46387	244	282	526
10	"10-out5471"	.99617	521	2	523
10	"10-out5472"	.99658	584	2	586
10	"10-out5473"	.52040	51	47	98
10	"10-out5474"	.99408	168	1	169
10	"10-out5475"	.98979	97	1	98
10	"10-out5476"	.51145	134	128	262
10	"10-out5477"	.99949	1981	1	1982
10	"10-out5478"	.52905	173	154	327
10	"10-out5479"	.59279	214	147	361
10	"10-out5480"	.34020	66	128	194
10	"10-out5481"	.37313	50	84	134
10	"10-out5482"	.99462	185	1	186
10	"10-out5483"	.36782	423	727	1150
10	"10-out5484"	.38909	107	168	275
10	"10-out5485"	.41304	342	486	828
10	"10-out5486"	.21733	173	623	796
10	"10-out5487"	.99719	711	2	713
10	"10-out5488"	.41480	986	1391	2377
10	"10-out5489"	.52620	251	226	477
10	"10-out5490"	.34375	231	441	672
10	"10-out5491"	.27796	169	439	608
10	"10-out5492"	.23860	199	635	834
10	"10-out5493"	.27952	142	366	508
10	"10-out5494"	.16837	115	568	683
10	"10-out5495"	.90540	134	14	148
10	"10-out5496"	.27533	125	329	454
10	"10-out5497"	.28755	67	166	233
10	"10-out5498"	.34687	111	209	320
10	"10-out5499"	.30369	304	697	1001
10	"10-out5500"	.97784	309	7	316
10	"10-out5501"	.45384	118	142	260
10	"10-out5502"	.99929	1426	1	1427
10	"10-out5503"	.97415	490	13	503
10	"10-out5504"	.99290	140	1	141
10	"10-out5505"	.38678	562	891	1453
10	"10-out5506"	.62369	179	108	287
10	"10-out5507"	.97457	115	3	118
10	"10-out5508"	.27403	57	151	208
10	"10-out5509"	.92727	102	8	110
10	"10-out5510"	.33517	243	482	725
10	"10-out5511"	.24832	74	224	298
10	"10-out5512"	.48113	102	110	212
10	"10-out5513"	.30478	153	349	502
10	"10-out5514"	.98837	85	1	86
10	"10-out5515"	.28443	159	400	559
10	"10-out5516"	.42977	153	203	356
10	"10-out5517"	.38189	173	280	453
10	"10-out5518"	.47570	186	205	391
10	"10-out5519"	.60552	307	200	507
10	"10-out5520"	.31077	124	275	399
10	"10-out5521"	.43612	594	768	1362
10	"10-out5522"	.34905	111	207	318
10	"10-out5523"	.36009	148	263	411
10	"10-out5524"	.28381	342	863	1205
10	"10-out5525"	.51984	131	121	252
10	"10-out5526"	.54240	614	518	1132
10	"10-out5527"	.84842	403	72	475
10	"10-out5528"	.98798	329	4	333
10	"10-out5529"	.33877	83	162	245
10	"10-out5530"	.37837	84	138	222
10	"10-out5531"	.38581	272	433	705
10	"10-out5532"	.33793	98	192	290
10	"10-out5533"	.20918	123	465	588
10	"10-out5534"	.36317	215	377	592
10	"10-out5535"	.44612	1035	1285	2320
10	"10-out5536"	.35856	668	1195	1863
10	"10-out5537"	.24934	191	575	766
10	"10-out5538"	.70857	372	153	525
10	"10-out5539"	.99560	453	2	455
10	"10-out5540"	.99656	290	1	291
10	"10-out5541"	.23913	121	385	506
10	"10-out5542"	.20274	59	232	291
10	"10-out5543"	.21354	82	302	384
10	"10-out5544"	.34014	183	355	538
10	"10-out5545"	.98798	329	4	333
10	"10-out5546"	.47986	429	465	894
10	"10-out5547"	.58907	248	173	421
10	"10-out5548"	.38793	270	426	696
10	"10-out5549"	.42923	1010	1343	2353
10	"10-out5550"	.38500	385	615	1000
10	"10-out5551"	.35322	148	271	419
10	"10-out5552"	.26285	92	258	350
10	"10-out5553"	.28671	326	811	1137
10	"10-out5554"	.28140	56	143	199
10	"10-out5555"	.61445	51	32	83
10	"10-out5556"	.32539	41	85	126
10	"10-out5557"	.64750	259	141	400
10	"10-out5558"	.45925	124	146	270
10	"10-out5559"	.99736	379	1	380
10	"10-out5560"	.32127	222	469	691
10	"10-out5561"	.34683	137	258	395
10	"10-out5562"	.31440	155	338	493
10	"10-out5563"	.28102	650	1663	2313
10	"10-out5564"	.34615	288	544	832
10	"10-out5565"	.26696	118	324	442
10	"10-out5566"	.26174	39	110	149
10	"10-out5567"	.36241	54	95	149
10	"10-out5568"	.33243	495	994	1489
10	"10-out5569"	.47926	104	113	217
10	"10-out5570"	.37618	278	461	739
10	"10-out5571"	.38339	194	312	506
10	"10-out5572"	.44228	318	401	719
10	"10-out5573"	.35055	285	528	813
10	"10-out5574"	.40682	286	417	703
10	"10-out5575"	.30579	211	479	690
10	"10-out5576"	.41764	71	99	170
10	"10-out5577"	.34837	247	462	709
10	"10-out5578"	.31854	359	768	1127
10	"10-out5579"	.35379	98	179	277
10	"10-out5580"	.38662	399	633	1032
10	"10-out5581"	.32310	200	419	619
10	"10-out5582"	.82978	234	48	282
10	"10-out5583"	.29036	205	501	706
10	"10-out5584"	.60852	157	101	258
10	"10-out5585"	.36021	134	238	372
10	"10-out5586"	.43317	269	352	621
10	"10-out5587"	.35576	222	402	624
10	"10-out5588"	.14498	39	230	269
10	"10-out5589"	.19753	48	195	243
10	"10-out5590"	.66666	82	41	123
10	"10-out5591"	.55290	162	131	293
10	"10-out5592"	.33673	33	65	98
10	"10-out5593"	.99200	124	1	125
10	"10-out5594"	.57222	103	77	180
10	"10-out5595"	.53097	60	53	113
10	"10-out5596"	.27072	601	1619	2220
10	"10-out5597"	.39891	440	663	1103
10	"10-out5598"	.28719	139	345	484
10	"10-out5599"	.79090	87	23	110
10	"10-out5600"	.23595	189	612	801
10	"10-out5601"	.16305	128	657	785
10	"10-out5602"	.27255	589	1572	2161
10	"10-out5603"	.35670	117	211	328
10	"10-out5604"	.26162	90	254	344
10	"10-out5605"	.31210	98	216	314
10	"10-out5606"	.30769	80	180	260
10	"10-out5607"	.19420	161	668	829
10	"10-out5608"	.51735	164	153	317
10	"10-out5609"	.25127	197	587	784
10	"10-out5610"	.55319	78	63	141
10	"10-out5611"	.27015	506	1367	1873
10	"10-out5612"	.46863	127	144	271
10	"10-out5613"	.21237	127	471	598
10	"10-out5614"	.34183	67	129	196
10	"10-out5615"	.27397	40	106	146
10	"10-out5616"	.84251	107	20	127
10	"10-out5617"	.34842	177	331	508
10	"10-out5618"	.33333	412	824	1236
10	"10-out5619"	.95764	1040	46	1086
10	"10-out5620"	.33047	154	312	466
10	"10-out5621"	.98081	409	8	417
10	"10-out5622"	.43779	183	235	418
10	"10-out5623"	.27688	363	948	1311
10	"10-out5624"	.99137	115	1	116
10	"10-out5625"	.99145	116	1	117
10	"10-out5626"	.99849	665	1	666
10	"10-out5627"	.36769	346	595	941
10	"10-out5628"	.99849	665	1	666
10	"10-out5629"	.43750	70	90	160
10	"10-out5630"	.22641	36	123	159
10	"10-out5631"	.30520	170	387	557
10	"10-out5632"	.99404	167	1	168
10	"10-out5633"	.28005	191	491	682
10	"10-out5634"	.41029	837	1203	2040
10	"10-out5635"	.29019	601	1470	2071
10	"10-out5636"	.45208	217	263	480
10	"10-out5637"	.31004	142	316	458
10	"10-out5638"	.54746	248	205	453
10	"10-out5639"	.41596	198	278	476
10	"10-out5640"	.37083	89	151	240
10	"10-out5641"	.99354	154	1	155
10	"10-out5642"	.54653	458	380	838
10	"10-out5643"	.68695	237	108	345
10	"10-out5644"	.17897	80	367	447
10	"10-out5645"	.33273	186	373	559
10	"10-out5646"	.45918	90	106	196
10	"10-out5647"	.25206	61	181	242
10	"10-out5648"	.36599	127	220	347
10	"10-out5649"	.96581	113	4	117
10	"10-out5650"	.97142	34	1	35
10	"10-out5651"	.39344	96	148	244
10	"10-out5652"	.16747	104	517	621
10	"10-out5653"	.25348	91	268	359
10	"10-out5654"	.26995	115	311	426
10	"10-out5655"	.47136	214	240	454
10	"10-out5656"	.24910	139	419	558
10	"10-out5657"	.25157	80	238	318
10	"10-out5658"	.23671	285	919	1204
10	"10-out5659"	.31678	600	1294	1894
10	"10-out5660"	.38461	90	144	234
10	"10-out5661"	.63679	135	77	212
10	"10-out5662"	.25617	83	241	324
10	"10-out5663"	.80650	446	107	553
10	"10-out5664"	.34736	132	248	380
10	"10-out5665"	.57644	230	169	399
10	"10-out5666"	.62234	234	142	376
10	"10-out5667"	.35735	243	437	680
10	"10-out5668"	.68817	192	87	279
10	"10-out5669"	.21566	223	811	1034
10	"10-out5670"	.98857	173	2	175
10	"10-out5671"	.52471	138	125	263
10	"10-out5672"	.92558	199	16	215
10	"10-out5673"	.42889	564	751	1315
10	"10-out5674"	.31197	112	247	359
10	"10-out5675"	.46289	131	152	283
10	"10-out5676"	.90645	281	29	310
10	"10-out5677"	.20286	241	947	1188
10	"10-out5678"	.99570	232	1	233
10	"10-out5679"	.34366	122	233	355
10	"10-out5680"	.35346	158	289	447
10	"10-out5681"	.38709	60	95	155
10	"10-out5682"	.21985	93	330	423
10	"10-out5683"	.29583	263	626	889
10	"10-out5684"	.46730	343	391	734
10	"10-out5685"	.93939	186	12	198
10	"10-out5686"	.41929	226	313	539
10	"10-out5687"	.45392	133	160	293
10	"10-out5688"	.35643	252	455	707
10	"10-out5689"	.33612	201	397	598
10	"10-out5690"	.33191	78	157	235
10	"10-out5691"	.99428	174	1	175
10	"10-out5692"	.19090	126	534	660
10	"10-out5693"	.16949	110	539	649
10	"10-out5694"	.42745	109	146	255
10	"10-out5695"	.16279	28	144	172
10	"10-out5696"	.33937	206	401	607
10	"10-out5697"	.97634	454	11	465
10	"10-out5698"	.98076	408	8	416
10	"10-out5699"	.44339	235	295	530
10	"10-out5700"	.47857	67	73	140
10	"10-out5701"	.47239	154	172	326
10	"10-out5702"	.99137	115	1	116
10	"10-out5703"	.99090	109	1	110
10	"10-out5704"	.26782	154	421	575
10	"10-out5705"	.36206	42	74	116
10	"10-out5706"	.99850	666	1	667
10	"10-out5707"	.40974	143	206	349
10	"10-out5708"	.60377	192	126	318
10	"10-out5709"	.99425	173	1	174
10	"10-out5710"	.37813	256	421	677
10	"10-out5711"	.56752	374	285	659
10	"10-out5712"	.41880	147	204	351
10	"10-out5713"	.25299	1014	2994	4008
10	"10-out5714"	.96473	465	17	482
10	"10-out5715"	.41085	53	76	129
10	"10-out5716"	.23592	176	570	746
10	"10-out5717"	.52293	57	52	109
10	"10-out5718"	.99798	495	1	496
10	"10-out5719"	.20779	64	244	308
10	"10-out5720"	.99791	478	1	479
10	"10-out5721"	.17105	117	567	684
10	"10-out5722"	.36781	32	55	87
10	"10-out5723"	.99438	177	1	178
10	"10-out5724"	.70526	67	28	95
10	"10-out5725"	.26782	154	421	575
10	"10-out5726"	.39039	187	292	479
10	"10-out5727"	.29589	108	257	365
10	"10-out5728"	.99849	665	1	666
10	"10-out5729"	.97136	441	13	454
10	"10-out5730"	.28709	149	370	519
10	"10-out5731"	.41818	92	128	220
10	"10-out5732"	.41379	216	306	522
10	"10-out5733"	.22988	80	268	348
10	"10-out5734"	.59144	249	172	421
10	"10-out5735"	.98068	660	13	673
10	"10-out5736"	.73062	198	73	271
10	"10-out5737"	.55010	269	220	489
10	"10-out5738"	.98130	105	2	107
10	"10-out5739"	.46930	237	268	505
10	"10-out5740"	.98701	152	2	154
10	"10-out5741"	.86096	322	52	374
10	"10-out5742"	.99707	341	1	342
10	"10-out5743"	.25527	133	388	521
10	"10-out5744"	.32700	224	461	685
10	"10-out5745"	.32182	205	432	637
10	"10-out5746"	.32743	222	456	678
10	"10-out5747"	.25569	146	425	571
10	"10-out5748"	.28632	67	167	234
10	"10-out5749"	.39790	569	861	1430
10	"10-out5750"	.29232	1421	3440	4861
10	"10-out5751"	.67501	3263	1571	4834
10	"10-out5752"	.34398	183	349	532
10	"10-out5753"	.41727	459	641	1100
10	"10-out5754"	.39279	218	337	555
10	"10-out5755"	.29549	354	844	1198
10	"10-out5756"	.21717	134	483	617
10	"10-out5757"	.97142	408	12	420
10	"10-out5758"	.99088	435	4	439
10	"10-out5759"	.59083	387	268	655
10	"10-out5760"	.25349	145	427	572
10	"10-out5761"	.99470	188	1	189
10	"10-out5762"	.43406	316	412	728
10	"10-out5763"	.39170	170	264	434
10	"10-out5764"	.74301	532	184	716
10	"10-out5765"	.98076	408	8	416
10	"10-out5766"	.45363	318	383	701
10	"10-out5767"	.20224	18	71	89
10	"10-out5768"	.37638	408	676	1084
10	"10-out5769"	.33739	166	326	492
10	"10-out5770"	.21544	452	1646	2098
10	"10-out5771"	.42603	144	194	338
10	"10-out5772"	.64471	323	178	501
10	"10-out5773"	.94000	705	45	750
10	"10-out5774"	.58047	220	159	379
10	"10-out5775"	.70495	313	131	444
10	"10-out5776"	.31511	196	426	622
10	"10-out5777"	.73945	298	105	403
10	"10-out5778"	.42678	376	505	881
10	"10-out5779"	.26914	116	315	431
10	"10-out5780"	.99640	277	1	278
10	"10-out5781"	.99645	281	1	282
10	"10-out5782"	.99640	277	1	278
10	"10-out5783"	.92896	170	13	183
10	"10-out5784"	.29405	886	2127	3013
10	"10-out5785"	.30243	659	1520	2179
10	"10-out5786"	.65093	524	281	805
10	"10-out5787"	.33627	267	527	794
10	"10-out5788"	.65700	408	213	621
10	"10-out5789"	.26894	181	492	673
10	"10-out5790"	.42000	126	174	300
10	"10-out5791"	.98081	409	8	417
10	"10-out5792"	.84958	305	54	359
10	"10-out5793"	.99849	665	1	666
10	"10-out5794"	.21951	27	96	123
10	"10-out5795"	.15336	73	403	476
10	"10-out5796"	.28825	292	721	1013
10	"10-out5797"	.28890	427	1051	1478
10	"10-out5798"	.85692	551	92	643
10	"10-out5799"	.99690	322	1	323
10	"10-out5800"	.33951	183	356	539
10	"10-out5801"	.94581	995	57	1052
10	"10-out5802"	.36677	117	202	319
10	"10-out5803"	.17520	106	499	605
10	"10-out5804"	.36964	95	162	257
10	"10-out5805"	.43883	226	289	515
10	"10-out5806"	.30579	211	479	690
10	"10-out5807"	.19111	43	182	225
10	"10-out5808"	.43673	107	138	245
10	"10-out5809"	.73122	185	68	253
10	"10-out5810"	.74418	192	66	258
10	"10-out5811"	.13425	29	187	216
10	"10-out5812"	.35935	511	911	1422
10	"10-out5813"	.80740	218	52	270
10	"10-out5814"	.29776	226	533	759
10	"10-out5815"	.25357	71	209	280
10	"10-out5816"	.67508	401	193	594
10	"10-out5817"	.25657	39	113	152
10	"10-out5818"	.28358	57	144	201
10	"10-out5819"	.32227	68	143	211
10	"10-out5820"	.31728	145	312	457
10	"10-out5821"	.51010	202	194	396
10	"10-out5822"	.32642	189	390	579
10	"10-out5823"	.46822	221	251	472
10	"10-out5824"	.77821	200	57	257
10	"10-out5825"	.21428	123	451	574
10	"10-out5826"	.99687	319	1	320
10	"10-out5827"	.24588	388	1190	1578
10	"10-out5828"	.39495	282	432	714
10	"10-out5829"	.22970	116	389	505
10	"10-out5830"	.29043	246	601	847
10	"10-out5831"	.25581	88	256	344
10	"10-out5832"	.51816	3579	3328	6907
10	"10-out5833"	.40495	98	144	242
10	"10-out5834"	.34006	219	425	644
10	"10-out5835"	.45345	151	182	333
10	"10-out5836"	.99845	646	1	647
10	"10-out5837"	.25401	158	464	622
10	"10-out5838"	.18421	63	279	342
10	"10-out5839"	.54005	209	178	387
10	"10-out5840"	.27722	28	73	101
10	"10-out5841"	.37358	99	166	265
10	"10-out5842"	.55555	100	80	180
10	"10-out5843"	.72571	127	48	175
10	"10-out5844"	.23935	236	750	986
10	"10-out5845"	.27376	144	382	526
10	"10-out5846"	.30555	363	825	1188
10	"10-out5847"	.28019	225	578	803
10	"10-out5848"	.44751	81	100	181
10	"10-out5849"	.41847	77	107	184
10	"10-out5850"	.42643	342	460	802
10	"10-out5851"	.61016	216	138	354
10	"10-out5852"	.89847	177	20	197
10	"10-out5853"	.96610	171	6	177
10	"10-out5854"	.96434	541	20	561
10	"10-out5855"	.46857	589	668	1257
10	"10-out5856"	.33261	155	311	466
10	"10-out5857"	.31932	152	324	476
10	"10-out5858"	.64456	350	193	543
10	"10-out5859"	.43967	215	274	489
10	"10-out5860"	.45454	415	498	913
10	"10-out5861"	.32637	297	613	910
10	"10-out5862"	.20580	156	602	758
10	"10-out5863"	.41996	223	308	531
10	"10-out5864"	.32735	274	563	837
10	"10-out5865"	.18808	60	259	319
10	"10-out5866"	.45862	859	1014	1873
10	"10-out5867"	.39068	109	170	279
10	"10-out5868"	.99948	1943	1	1944
10	"10-out5869"	.35276	121	222	343
10	"10-out5870"	.27150	101	271	372
10	"10-out5871"	.45510	147	176	323
10	"10-out5872"	.96407	161	6	167
10	"10-out5873"	.27624	50	131	181
10	"10-out5874"	.45554	620	741	1361
10	"10-out5875"	.39856	222	335	557
10	"10-out5876"	.39106	70	109	179
10	"10-out5877"	.54838	102	84	186
10	"10-out5878"	.49747	295	298	593
10	"10-out5879"	.55582	229	183	412
10	"10-out5880"	.45884	602	710	1312
10	"10-out5881"	.21195	39	145	184
10	"10-out5882"	.55249	421	341	762
10	"10-out5883"	.44621	365	453	818
10	"10-out5884"	.69503	196	86	282
10	"10-out5885"	.37010	255	434	689
10	"10-out5886"	.39105	341	531	872
10	"10-out5887"	.96688	146	5	151
10	"10-out5888"	.14545	16	94	110
10	"10-out5889"	.33050	661	1339	2000
10	"10-out5890"	.31780	621	1333	1954
10	"10-out5891"	.27476	746	1969	2715
10	"10-out5892"	.36175	1048	1849	2897
10	"10-out5893"	.30639	182	412	594
10	"10-out5894"	.46526	509	585	1094
10	"10-out5895"	.27647	201	526	727
10	"10-out5896"	.53638	199	172	371
10	"10-out5897"	.41884	80	111	191
10	"10-out5898"	.22571	237	813	1050
10	"10-out5899"	.26270	212	595	807
10	"10-out5900"	.35714	30	54	84
10	"10-out5901"	.27554	89	234	323
10	"10-out5902"	.11034	48	387	435
10	"10-out5903"	.26210	157	442	599
10	"10-out5904"	.35732	139	250	389
10	"10-out5905"	.28600	284	709	993
10	"10-out5906"	.22957	118	396	514
10	"10-out5907"	.91213	218	21	239
10	"10-out5908"	.89189	330	40	370
10	"10-out5909"	.27019	97	262	359
10	"10-out5910"	.46182	375	437	812
10	"10-out5911"	.90379	310	33	343
10	"10-out5912"	.23529	80	260	340
10	"10-out5913"	.39677	344	523	867
10	"10-out5914"	.39605	221	337	558
10	"10-out5915"	.57943	62	45	107
10	"10-out5916"	.45351	200	241	441
10	"10-out5917"	.55932	66	52	118
10	"10-out5918"	.41695	713	997	1710
10	"10-out5919"	.26526	795	2202	2997
10	"10-out5920"	.34304	259	496	755
10	"10-out5921"	.33355	1522	3041	4563
10	"10-out5922"	.29323	78	188	266
10	"10-out5923"	.98753	317	4	321
10	"10-out5924"	.19961	104	417	521
10	"10-out5925"	.33701	61	120	181
10	"10-out5926"	.35028	124	230	354
10	"10-out5927"	.56493	174	134	308
10	"10-out5928"	.39407	266	409	675
10	"10-out5929"	.38481	299	478	777
10	"10-out5930"	.31204	474	1045	1519
10	"10-out5931"	.35067	209	387	596
10	"10-out5932"	.25766	378	1089	1467
10	"10-out5933"	.39883	546	823	1369
10	"10-out5934"	.37912	69	113	182
10	"10-out5935"	.37611	841	1395	2236
10	"10-out5936"	.93500	187	13	200
10	"10-out5937"	.98930	185	2	187
10	"10-out5938"	.33409	291	580	871
10	"10-out5939"	.33497	136	270	406
10	"10-out5940"	.29085	372	907	1279
10	"10-out5941"	.79130	546	144	690
10	"10-out5942"	.95053	1518	79	1597
10	"10-out5943"	.62500	570	342	912
10	"10-out5944"	.25777	398	1146	1544
10	"10-out5945"	.27110	228	613	841
10	"10-out5946"	.90807	326	33	359
10	"10-out5947"	.98187	325	6	331
10	"10-out5948"	.24489	48	148	196
10	"10-out5949"	.45098	92	112	204
10	"10-out5950"	.48044	86	93	179
10	"10-out5951"	.71196	351	142	493
10	"10-out5952"	.35353	210	384	594
10	"10-out5953"	.23423	52	170	222
10	"10-out5954"	.97368	259	7	266
10	"10-out5955"	.99723	361	1	362
10	"10-out5956"	.99723	361	1	362
10	"10-out5957"	.34605	136	257	393
10	"10-out5958"	.96986	354	11	365
10	"10-out5959"	.34333	103	197	300
10	"10-out5960"	.34490	298	566	864
10	"10-out5961"	.30837	173	388	561
10	"10-out5962"	.99756	821	2	823
10	"10-out5963"	.30878	109	244	353
10	"10-out5964"	.81497	370	84	454
10	"10-out5965"	.19259	52	218	270
10	"10-out5966"	.16871	55	271	326
10	"10-out5967"	.30785	145	326	471
10	"10-out5968"	.27923	351	906	1257
10	"10-out5969"	.45697	154	183	337
10	"10-out5970"	.46987	234	264	498
10	"10-out5971"	.32871	166	339	505
10	"10-out5972"	.99604	1007	4	1011
10	"10-out5973"	.96385	240	9	249
10	"10-out5974"	.49574	233	237	470
10	"10-out5975"	.70445	348	146	494
10	"10-out5976"	.99242	262	2	264
10	"10-out5977"	.15228	60	334	394
10	"10-out5978"	.19506	182	751	933
10	"10-out5979"	.93069	564	42	606
10	"10-out5980"	.87116	142	21	163
10	"10-out5981"	.33850	109	213	322
10	"10-out5982"	.41855	203	282	485
10	"10-out5983"	.99710	344	1	345
10	"10-out5984"	.35423	113	206	319
10	"10-out5985"	.60190	316	209	525
10	"10-out5986"	.26166	129	364	493
10	"10-out5987"	.36432	239	417	656
10	"10-out5988"	.93157	1593	117	1710
10	"10-out5989"	.24260	238	743	981
10	"10-out5990"	.41486	173	244	417
10	"10-out5991"	.36858	352	603	955
10	"10-out5992"	.27033	113	305	418
10	"10-out5993"	.31153	162	358	520
10	"10-out5994"	.17821	18	83	101
10	"10-out5995"	.40186	172	256	428
10	"10-out5996"	.23655	343	1107	1450
10	"10-out5997"	.99793	483	1	484
10	"10-out5998"	.42020	416	574	990
10	"10-out5999"	.96435	487	18	505
10	"10-out6000"	.30861	129	289	418
10	"10-out6001"	.29166	105	255	360
10	"10-out6002"	.35657	445	803	1248
10	"10-out6003"	.37795	96	158	254
10	"10-out6004"	.18154	179	807	986
10	"10-out6005"	.21893	185	660	845
10	"10-out6006"	.26713	113	310	423
10	"10-out6007"	.29567	123	293	416
10	"10-out6008"	.74093	143	50	193
10	"10-out6009"	.98091	514	10	524
10	"10-out6010"	.99367	157	1	158
10	"10-out6011"	.72289	60	23	83
10	"10-out6012"	.29095	222	541	763
10	"10-out6013"	.66281	287	146	433
10	"10-out6014"	.28571	98	245	343
10	"10-out6015"	.35465	183	333	516
10	"10-out6016"	.99756	821	2	823
10	"10-out6017"	.31570	203	440	643
10	"10-out6018"	.57462	154	114	268
10	"10-out6019"	.41950	185	256	441
10	"10-out6020"	.28221	219	557	776
10	"10-out6021"	.30758	231	520	751
10	"10-out6022"	.32080	111	235	346
10	"10-out6023"	.98573	622	9	631
10	"10-out6024"	.51357	227	215	442
10	"10-out6025"	.26760	38	104	142
10	"10-out6026"	.44569	119	148	267
10	"10-out6027"	.99661	294	1	295
10	"10-out6028"	.78640	162	44	206
10	"10-out6029"	.28527	93	233	326
10	"10-out6030"	.90243	444	48	492
10	"10-out6031"	.30752	282	635	917
10	"10-out6032"	.58796	254	178	432
10	"10-out6033"	.36834	270	463	733
10	"10-out6034"	.40202	238	354	592
10	"10-out6035"	.35701	196	353	549
10	"10-out6036"	.40033	239	358	597
10	"10-out6037"	.33237	231	464	695
10	"10-out6038"	.37249	279	470	749
10	"10-out6039"	.36968	200	341	541
10	"10-out6040"	.24450	89	275	364
10	"10-out6041"	.99145	116	1	117
10	"10-out6042"	.99145	116	1	117
10	"10-out6043"	.08441	13	141	154
10	"10-out6044"	.24623	147	450	597
10	"10-out6045"	.25799	226	650	876
10	"10-out6046"	.25711	235	679	914
10	"10-out6047"	.21645	100	362	462
10	"10-out6048"	.44709	262	324	586
10	"10-out6049"	.34722	25	47	72
10	"10-out6050"	.98550	68	1	69
10	"10-out6051"	.47432	157	174	331
10	"10-out6052"	.28133	431	1101	1532
10	"10-out6053"	.38284	183	295	478
10	"10-out6054"	.25307	103	304	407
10	"10-out6055"	.39285	121	187	308
10	"10-out6056"	.86290	321	51	372
10	"10-out6057"	.41491	178	251	429
10	"10-out6058"	.19780	72	292	364
10	"10-out6059"	.28000	70	180	250
10	"10-out6060"	.28542	143	358	501
10	"10-out6061"	.47032	214	241	455
10	"10-out6062"	.62888	283	167	450
10	"10-out6063"	.23369	172	564	736
10	"10-out6064"	.30107	140	325	465
10	"10-out6065"	.99647	566	2	568
10	"10-out6066"	.99310	144	1	145
10	"10-out6067"	.99310	144	1	145
10	"10-out6068"	.97718	257	6	263
10	"10-out6069"	.99619	262	1	263
10	"10-out6070"	.98859	260	3	263
10	"10-out6071"	.98113	104	2	106
10	"10-out6072"	.98113	104	2	106
10	"10-out6073"	.96568	197	7	204
10	"10-out6074"	.29043	246	601	847
10	"10-out6075"	.96460	109	4	113
10	"10-out6076"	.99047	104	1	105
10	"10-out6077"	.40404	320	472	792
10	"10-out6078"	.43351	163	213	376
10	"10-out6079"	.46373	422	488	910
10	"10-out6080"	.95652	88	4	92
10	"10-out6081"	.25500	51	149	200
10	"10-out6082"	.79185	175	46	221
10	"10-out6083"	.83743	170	33	203
10	"10-out6084"	.43049	96	127	223
10	"10-out6085"	.24186	52	163	215
10	"10-out6086"	.27941	133	343	476
10	"10-out6087"	.42028	87	120	207
10	"10-out6088"	.62688	457	272	729
10	"10-out6089"	.98039	50	1	51
10	"10-out6090"	.97423	416	11	427
10	"10-out6091"	.37764	321	529	850
10	"10-out6092"	.91007	759	75	834
10	"10-out6093"	.65236	152	81	233
10	"10-out6094"	.36193	135	238	373
10	"10-out6095"	.21134	41	153	194
10	"10-out6096"	.75490	539	175	714
10	"10-out6097"	.42533	94	127	221
10	"10-out6098"	.24472	58	179	237
10	"10-out6099"	.41013	89	128	217
10	"10-out6100"	.87793	187	26	213
10	"10-out6101"	.90118	228	25	253
10	"10-out6102"	.25644	209	606	815
10	"10-out6103"	.72268	258	99	357
10	"10-out6104"	.43277	206	270	476
10	"10-out6105"	.19817	87	352	439
10	"10-out6106"	.90839	595	60	655
10	"10-out6107"	.97311	905	25	930
10	"10-out6108"	.46009	98	115	213
10	"10-out6109"	.36245	112	197	309
10	"10-out6110"	.42349	393	535	928
10	"10-out6111"	.14285	29	174	203
10	"10-out6112"	.39453	101	155	256
10	"10-out6113"	.98924	92	1	93
10	"10-out6114"	.36036	120	213	333
10	"10-out6115"	.12962	28	188	216
10	"10-out6116"	.20379	43	168	211
10	"10-out6117"	.33505	65	129	194
10	"10-out6118"	.35159	77	142	219
10	"10-out6119"	.58737	121	85	206
10	"10-out6120"	.21634	45	163	208
10	"10-out6121"	.87007	221	33	254
10	"10-out6122"	.89763	228	26	254
10	"10-out6123"	.88059	177	24	201
10	"10-out6124"	.99497	198	1	199
10	"10-out6125"	.43233	246	323	569
10	"10-out6126"	.39583	76	116	192
10	"10-out6127"	.81299	513	118	631
10	"10-out6128"	.37979	188	307	495
10	"10-out6129"	.40625	533	779	1312
10	"10-out6130"	.26104	195	552	747
10	"10-out6131"	.45070	192	234	426
10	"10-out6132"	.95037	383	20	403
10	"10-out6133"	.33333	102	204	306
10	"10-out6134"	.30272	577	1329	1906
10	"10-out6135"	.34215	194	373	567
10	"10-out6136"	.59708	123	83	206
10	"10-out6137"	.77173	142	42	184
10	"10-out6138"	.22775	64	217	281
10	"10-out6139"	.98630	792	11	803
10	"10-out6140"	.51038	516	495	1011
10	"10-out6141"	.44711	93	115	208
10	"10-out6142"	.35889	117	209	326
10	"10-out6143"	.28660	92	229	321
10	"10-out6144"	.29355	123	296	419
10	"10-out6145"	.30992	331	737	1068
10	"10-out6146"	.29830	335	788	1123
10	"10-out6147"	.37291	179	301	480
10	"10-out6148"	.10377	33	285	318
10	"10-out6149"	.53319	265	232	497
10	"10-out6150"	.99479	191	1	192
10	"10-out6151"	.32329	483	1011	1494
10	"10-out6152"	.38244	353	570	923
10	"10-out6153"	.29534	508	1212	1720
10	"10-out6154"	.35897	238	425	663
10	"10-out6155"	.19696	13	53	66
10	"10-out6156"	.99500	597	3	600
10	"10-out6157"	.38360	117	188	305
10	"10-out6158"	.40773	137	199	336
10	"10-out6159"	.32432	108	225	333
10	"10-out6160"	.33426	119	237	356
10	"10-out6161"	.20000	75	300	375
10	"10-out6162"	.42894	163	217	380
10	"10-out6163"	.66852	240	119	359
10	"10-out6164"	.46231	184	214	398
10	"10-out6165"	.22179	116	407	523
10	"10-out6166"	.27659	78	204	282
10	"10-out6167"	.39506	128	196	324
10	"10-out6168"	.26022	70	199	269
10	"10-out6169"	.36593	116	201	317
10	"10-out6170"	.22562	81	278	359
10	"10-out6171"	.37438	152	254	406
10	"10-out6172"	.48771	258	271	529
10	"10-out6173"	.38133	143	232	375
10	"10-out6174"	.27990	117	301	418
10	"10-out6175"	.17788	148	684	832
10	"10-out6176"	.82378	575	123	698
10	"10-out6177"	.90084	536	59	595
10	"10-out6178"	.99747	395	1	396
10	"10-out6179"	.99756	409	1	410
10	"10-out6180"	.22842	45	152	197
10	"10-out6181"	.98911	545	6	551
10	"10-out6182"	.83940	392	75	467
10	"10-out6183"	.41251	323	460	783
10	"10-out6184"	.89494	230	27	257
10	"10-out6185"	.26813	85	232	317
10	"10-out6186"	.99122	113	1	114
10	"10-out6187"	.30948	212	473	685
10	"10-out6188"	.32131	98	207	305
10	"10-out6189"	.78125	150	42	192
10	"10-out6190"	.23747	199	639	838
10	"10-out6191"	.46448	340	392	732
10	"10-out6192"	.17006	25	122	147
10	"10-out6193"	.35016	104	193	297
10	"10-out6194"	.34946	130	242	372
10	"10-out6195"	.16891	25	123	148
10	"10-out6196"	.98251	281	5	286
10	"10-out6197"	.35501	191	347	538
10	"10-out6198"	.38036	62	101	163
10	"10-out6199"	.26490	311	863	1174
10	"10-out6200"	.99130	114	1	115
10	"10-out6201"	.39370	50	77	127
10	"10-out6202"	.39587	211	322	533
10	"10-out6203"	.38936	271	425	696
10	"10-out6204"	.49874	198	199	397
10	"10-out6205"	.27846	203	526	729
10	"10-out6206"	.94148	177	11	188
10	"10-out6207"	.48972	143	149	292
10	"10-out6208"	.49438	88	90	178
10	"10-out6209"	.26562	34	94	128
10	"10-out6210"	.21882	86	307	393
10	"10-out6211"	.20263	77	303	380
10	"10-out6212"	.51351	152	144	296
10	"10-out6213"	.68292	280	130	410
10	"10-out6214"	.28596	163	407	570
10	"10-out6215"	.32228	214	450	664
10	"10-out6216"	.34285	120	230	350
10	"10-out6217"	.58333	91	65	156
10	"10-out6218"	.44946	209	256	465
10	"10-out6219"	.21705	56	202	258
10	"10-out6220"	.99761	419	1	420
10	"10-out6221"	.89130	164	20	184
10	"10-out6222"	.29365	37	89	126
10	"10-out6223"	.34383	120	229	349
10	"10-out6224"	.36708	116	200	316
10	"10-out6225"	.99494	197	1	198
10	"10-out6226"	.30465	85	194	279
10	"10-out6227"	.30690	120	271	391
10	"10-out6228"	.52551	206	186	392
10	"10-out6229"	.32590	117	242	359
10	"10-out6230"	.41047	243	349	592
10	"10-out6231"	.26720	66	181	247
10	"10-out6232"	.99346	152	1	153
10	"10-out6233"	.44791	86	106	192
10	"10-out6234"	.99841	630	1	631
10	"10-out6235"	.99591	244	1	245
10	"10-out6236"	.75319	177	58	235
10	"10-out6237"	.62068	126	77	203
10	"10-out6238"	.52608	121	109	230
10	"10-out6239"	.33873	230	449	679
10	"10-out6240"	.37974	90	147	237
10	"10-out6241"	.62727	138	82	220
10	"10-out6242"	.44308	253	318	571
10	"10-out6243"	.99342	151	1	152
10	"10-out6244"	.99705	339	1	340
10	"10-out6245"	.37878	100	164	264
10	"10-out6246"	.92125	351	30	381
10	"10-out6247"	.16053	48	251	299
10	"10-out6248"	.83448	363	72	435
10	"10-out6249"	.31018	67	149	216
10	"10-out6250"	.76953	197	59	256
10	"10-out6251"	.30337	162	372	534
10	"10-out6252"	.20431	284	1106	1390
10	"10-out6253"	.30753	461	1038	1499
10	"10-out6254"	.21052	28	105	133
10	"10-out6255"	.37185	518	875	1393
10	"10-out6256"	.32876	240	490	730
10	"10-out6257"	.87352	891	129	1020
10	"10-out6258"	.87356	304	44	348
10	"10-out6259"	.26016	32	91	123
10	"10-out6260"	.83660	256	50	306
10	"10-out6261"	.94174	97	6	103
10	"10-out6262"	.50781	65	63	128
10	"10-out6263"	.23853	78	249	327
10	"10-out6264"	.51456	106	100	206
10	"10-out6265"	.48780	100	105	205
10	"10-out6266"	.50485	104	102	206
10	"10-out6267"	.34840	131	245	376
10	"10-out6268"	.26173	184	519	703
10	"10-out6269"	.37853	268	440	708
10	"10-out6270"	.97704	298	7	305
10	"10-out6271"	.45052	214	261	475
10	"10-out6272"	.38430	387	620	1007
10	"10-out6273"	.38526	136	217	353
10	"10-out6274"	.97757	218	5	223
10	"10-out6275"	.72297	107	41	148
10	"10-out6276"	.36455	253	441	694
10	"10-out6277"	.49090	135	140	275
10	"10-out6278"	.27634	118	309	427
10	"10-out6279"	.93865	153	10	163
10	"10-out6280"	.41284	180	256	436
10	"10-out6281"	.26565	157	434	591
10	"10-out6282"	.43413	580	756	1336
10	"10-out6283"	.87264	185	27	212
10	"10-out6284"	.40837	234	339	573
10	"10-out6285"	.25447	199	583	782
10	"10-out6286"	.38292	278	448	726
10	"10-out6287"	.20666	31	119	150
10	"10-out6288"	.99473	189	1	190
10	"10-out6289"	.32195	66	139	205
10	"10-out6290"	.32567	85	176	261
10	"10-out6291"	.83478	96	19	115
10	"10-out6292"	.38095	56	91	147
10	"10-out6293"	.56551	410	315	725
10	"10-out6294"	.94086	350	22	372
10	"10-out6295"	.94811	201	11	212
10	"10-out6296"	.77586	45	13	58
10	"10-out6297"	.99130	114	1	115
10	"10-out6298"	.62060	247	151	398
10	"10-out6299"	.98360	120	2	122
10	"10-out6300"	.99523	209	1	210
10	"10-out6301"	.40000	82	123	205
10	"10-out6302"	.54262	331	279	610
10	"10-out6303"	.36538	114	198	312
10	"10-out6304"	.38356	84	135	219
10	"10-out6305"	.36405	79	138	217
10	"10-out6306"	.99539	216	1	217
10	"10-out6307"	.99310	144	1	145
10	"10-out6308"	.90510	124	13	137
10	"10-out6309"	1.00000	59	0	59
10	"10-out6310"	.99621	263	1	264
10	"10-out6311"	.99588	242	1	243
10	"10-out6312"	.99489	195	1	196
10	"10-out6313"	.41044	55	79	134
10	"10-out6314"	.28901	250	615	865
10	"10-out6315"	.31130	146	323	469
10	"10-out6316"	.99666	598	2	600
10	"10-out6317"	.81991	560	123	683
10	"10-out6318"	.17033	209	1018	1227
10	"10-out6319"	.92168	153	13	166
10	"10-out6320"	.43621	530	685	1215
10	"10-out6321"	.37303	166	279	445
10	"10-out6322"	.79467	209	54	263
10	"10-out6323"	.89756	184	21	205
10	"10-out6324"	.49565	57	58	115
10	"10-out6325"	.29442	111	266	377
10	"10-out6326"	.26981	160	433	593
10	"10-out6327"	.26815	48	131	179
10	"10-out6328"	.23259	274	904	1178
10	"10-out6329"	.67010	65	32	97
10	"10-out6330"	.99596	494	2	496
10	"10-out6331"	.37500	123	205	328
10	"10-out6332"	.34871	68	127	195
10	"10-out6333"	.28894	230	566	796
10	"10-out6334"	.15325	40	221	261
10	"10-out6335"	.41911	114	158	272
10	"10-out6336"	.26359	446	1246	1692
10	"10-out6337"	.31034	126	280	406
10	"10-out6338"	.77892	303	86	389
10	"10-out6339"	.97674	210	5	215
10	"10-out6340"	.95212	179	9	188
10	"10-out6341"	.99264	135	1	136
10	"10-out6342"	.23791	64	205	269
10	"10-out6343"	.87850	188	26	214
10	"10-out6344"	.98522	200	3	203
10	"10-out6345"	.98461	128	2	130
10	"10-out6346"	.99789	473	1	474
10	"10-out6347"	.99789	473	1	474
10	"10-out6348"	.99789	475	1	476
10	"10-out6349"	.99789	473	1	474
10	"10-out6350"	.48955	328	342	670
10	"10-out6351"	.67684	1020	487	1507
10	"10-out6352"	.99547	220	1	221
10	"10-out6353"	.99547	220	1	221
10	"10-out6354"	.95432	397	19	416
10	"10-out6355"	.97734	302	7	309
10	"10-out6356"	.57122	802	602	1404
10	"10-out6357"	.22596	181	620	801
10	"10-out6358"	.80357	180	44	224
10	"10-out6359"	.99450	181	1	182
10	"10-out6360"	.19128	180	761	941
10	"10-out6361"	.96376	133	5	138
10	"10-out6362"	.43497	291	378	669
10	"10-out6363"	.98117	469	9	478
10	"10-out6364"	.19668	83	339	422
10	"10-out6365"	.32633	342	706	1048
10	"10-out6366"	.40967	127	183	310
10	"10-out6367"	.99431	175	1	176
10	"10-out6368"	.92835	311	24	335
10	"10-out6369"	.96009	409	17	426
10	"10-out6370"	.36408	671	1172	1843
10	"10-out6371"	.65142	228	122	350
10	"10-out6372"	.50378	133	131	264
10	"10-out6373"	.23577	29	94	123
10	"10-out6374"	.51629	396	371	767
10	"10-out6375"	.46438	163	188	351
10	"10-out6376"	.29106	140	341	481
10	"10-out6377"	.29696	147	348	495
10	"10-out6378"	.35154	148	273	421
10	"10-out6379"	.26743	303	830	1133
10	"10-out6380"	.28301	90	228	318
10	"10-out6381"	.99038	103	1	104
10	"10-out6382"	.35831	196	351	547
10	"10-out6383"	.99047	104	1	105
10	"10-out6384"	.35303	233	427	660
10	"10-out6385"	.54320	308	259	567
10	"10-out6386"	.99736	379	1	380
10	"10-out6387"	.35695	403	726	1129
10	"10-out6388"	.26292	117	328	445
10	"10-out6389"	.30258	82	189	271
10	"10-out6390"	.30042	140	326	466
10	"10-out6391"	.34114	262	506	768
10	"10-out6392"	.11282	44	346	390
10	"10-out6393"	.37194	289	488	777
10	"10-out6394"	.46411	97	112	209
10	"10-out6395"	.37855	293	481	774
10	"10-out6396"	.89417	338	40	378
10	"10-out6397"	.59795	293	197	490
10	"10-out6398"	.99690	645	2	647
10	"10-out6399"	.19387	171	711	882
10	"10-out6400"	.22519	59	203	262
10	"10-out6401"	.99715	1753	5	1758
10	"10-out6402"	.32590	190	393	583
10	"10-out6403"	.47798	76	83	159
10	"10-out6404"	.40831	167	242	409
10	"10-out6405"	.52491	158	143	301
10	"10-out6406"	.84084	634	120	754
10	"10-out6407"	.36024	58	103	161
10	"10-out6408"	.19230	10	42	52
10	"10-out6409"	.39248	188	291	479
10	"10-out6410"	.25289	153	452	605
10	"10-out6411"	.33907	256	499	755
10	"10-out6412"	.39867	181	273	454
10	"10-out6413"	.52093	224	206	430
10	"10-out6414"	.36559	136	236	372
10	"10-out6415"	.54862	378	311	689
10	"10-out6416"	.88926	795	99	894
10	"10-out6417"	.99791	478	1	479
10	"10-out6418"	.37340	264	443	707
10	"10-out6419"	.99803	508	1	509
10	"10-out6420"	.34426	357	680	1037
10	"10-out6421"	.99790	477	1	478
10	"10-out6422"	.77272	153	45	198
10	"10-out6423"	.35305	567	1039	1606
10	"10-out6424"	.50264	95	94	189
10	"10-out6425"	.99975	4127	1	4128
10	"10-out6426"	.59512	366	249	615
10	"10-out6427"	.18502	42	185	227
10	"10-out6428"	.64893	61	33	94
10	"10-out6429"	.28166	189	482	671
10	"10-out6430"	.31296	169	371	540
10	"10-out6431"	.24031	31	98	129
10	"10-out6432"	.40780	188	273	461
10	"10-out6433"	.50262	287	284	571
10	"10-out6434"	.33611	121	239	360
10	"10-out6435"	.42662	125	168	293
10	"10-out6436"	.96654	260	9	269
10	"10-out6437"	.97383	335	9	344
10	"10-out6438"	.99719	355	1	356
10	"10-out6439"	.96363	424	16	440
10	"10-out6440"	.26845	80	218	298
10	"10-out6441"	.34177	189	364	553
10	"10-out6442"	.23037	91	304	395
10	"10-out6443"	.99004	597	6	603
10	"10-out6444"	.33195	80	161	241
10	"10-out6445"	.29787	70	165	235
10	"10-out6446"	.25826	297	853	1150
10	"10-out6447"	.36652	346	598	944
10	"10-out6448"	.34649	272	513	785
10	"10-out6449"	.66901	190	94	284
10	"10-out6450"	.50077	325	324	649
10	"10-out6451"	.88306	219	29	248
10	"10-out6452"	.34225	435	836	1271
10	"10-out6453"	.27737	38	99	137
10	"10-out6454"	.22601	172	589	761
10	"10-out6455"	.44549	94	117	211
10	"10-out6456"	.35742	89	160	249
10	"10-out6457"	.34496	336	638	974
10	"10-out6458"	.39719	425	645	1070
10	"10-out6459"	.48467	253	269	522
10	"10-out6460"	.21864	204	729	933
10	"10-out6461"	.52325	90	82	172
10	"10-out6462"	.92783	180	14	194
10	"10-out6463"	.34042	400	775	1175
10	"10-out6464"	.46245	234	272	506
10	"10-out6465"	.25797	97	279	376
10	"10-out6466"	.51219	105	100	205
10	"10-out6467"	.28211	123	313	436
10	"10-out6468"	.55352	212	171	383
10	"10-out6469"	.23809	145	464	609
10	"10-out6470"	1.00000	969	0	969
10	"10-out6471"	1.00000	812	0	812
10	"10-out6472"	1.00000	1459	0	1459
10	"10-out6473"	.24167	167	524	691
10	"10-out6474"	.15804	110	586	696
10	"10-out6475"	.54248	332	280	612
10	"10-out6476"	.29020	249	609	858
10	"10-out6477"	.39473	60	92	152
10	"10-out6478"	.41250	264	376	640
10	"10-out6479"	.83636	92	18	110
10	"10-out6480"	.59176	158	109	267
10	"10-out6481"	.51452	124	117	241
10	"10-out6482"	.99669	302	1	303
10	"10-out6483"	.15158	67	375	442
10	"10-out6484"	.99629	269	1	270
10	"10-out6485"	.41134	116	166	282
10	"10-out6486"	.99715	1753	5	1758
10	"10-out6487"	.44290	128	161	289
10	"10-out6488"	.53559	775	672	1447
10	"10-out6489"	.24570	100	307	407
10	"10-out6490"	.37391	215	360	575
10	"10-out6491"	.53987	176	150	326
10	"10-out6492"	.51486	329	310	639
10	"10-out6493"	.78846	82	22	104
10	"10-out6494"	.44636	129	160	289
10	"10-out6495"	.33992	86	167	253
10	"10-out6496"	.38709	132	209	341
10	"10-out6497"	.99218	127	1	128
10	"10-out6498"	.28417	158	398	556
10	"10-out6499"	.45484	136	163	299
10	"10-out6500"	.28687	282	701	983
10	"10-out6501"	.34266	624	1197	1821
10	"10-out6502"	.35483	143	260	403
10	"10-out6503"	.21495	161	588	749
10	"10-out6504"	.37763	520	857	1377
10	"10-out6505"	.99318	437	3	440
10	"10-out6506"	.99663	296	1	297
10	"10-out6507"	.34442	352	670	1022
10	"10-out6508"	.26166	129	364	493
10	"10-out6509"	.54241	243	205	448
10	"10-out6510"	.22082	123	434	557
10	"10-out6511"	.99749	398	1	399
10	"10-out6512"	.81889	520	115	635
10	"10-out6513"	.99509	203	1	204
10	"10-out6514"	.28328	100	253	353
10	"10-out6515"	.42826	200	267	467
10	"10-out6516"	.70952	149	61	210
10	"10-out6517"	.95683	133	6	139
10	"10-out6518"	.24852	84	254	338
10	"10-out6519"	.33458	89	177	266
10	"10-out6520"	.86495	506	79	585
10	"10-out6521"	.85433	217	37	254
10	"10-out6522"	.25344	276	813	1089
10	"10-out6523"	.31944	138	294	432
10	"10-out6524"	.29285	246	594	840
10	"10-out6525"	.91463	75	7	82
10	"10-out6526"	.17575	58	272	330
10	"10-out6527"	.41688	158	221	379
10	"10-out6528"	.31416	1333	2910	4243
10	"10-out6529"	.95375	495	24	519
10	"10-out6530"	.99232	388	3	391
10	"10-out6531"	.27368	1115	2959	4074
10	"10-out6532"	.92571	162	13	175
10	"10-out6533"	.30379	48	110	158
10	"10-out6534"	.31529	437	949	1386
10	"10-out6535"	.44585	140	174	314
10	"10-out6536"	.49319	435	447	882
10	"10-out6537"	.47222	119	133	252
10	"10-out6538"	.23809	180	576	756
10	"10-out6539"	.38762	119	188	307
10	"10-out6540"	.25742	26	75	101
10	"10-out6541"	.43724	108	139	247
10	"10-out6542"	.40567	200	293	493
10	"10-out6543"	.38174	92	149	241
10	"10-out6544"	.23151	216	717	933
10	"10-out6545"	.47872	225	245	470
10	"10-out6546"	.83419	161	32	193
10	"10-out6547"	.33809	308	603	911
10	"10-out6548"	.35185	1545	2846	4391
10	"10-out6549"	.47667	1206	1324	2530
10	"10-out6550"	.38907	235	369	604
10	"10-out6551"	.50599	211	206	417
10	"10-out6552"	.25066	94	281	375
10	"10-out6553"	.51713	166	155	321
10	"10-out6554"	.39222	111	172	283
10	"10-out6555"	.36243	137	241	378
10	"10-out6556"	.41896	517	717	1234
10	"10-out6557"	.42980	199	264	463
10	"10-out6558"	.55970	300	236	536
10	"10-out6559"	.21621	56	203	259
10	"10-out6560"	.99404	167	1	168
10	"10-out6561"	.99481	192	1	193
10	"10-out6562"	.47560	117	129	246
10	"10-out6563"	.17057	80	389	469
10	"10-out6564"	.33700	153	301	454
10	"10-out6565"	.24561	168	516	684
10	"10-out6566"	.27816	321	833	1154
10	"10-out6567"	.28951	207	508	715
10	"10-out6568"	.10629	27	227	254
10	"10-out6569"	.17696	106	493	599
10	"10-out6570"	.35714	70	126	196
10	"10-out6571"	.59192	132	91	223
10	"10-out6572"	.86923	113	17	130
10	"10-out6573"	.39781	656	993	1649
10	"10-out6574"	.27952	213	549	762
10	"10-out6575"	.73619	120	43	163
10	"10-out6576"	.19823	45	182	227
10	"10-out6577"	.49489	194	198	392
10	"10-out6578"	.38048	1084	1765	2849
10	"10-out6579"	.23267	94	310	404
10	"10-out6580"	.42749	339	454	793
10	"10-out6581"	.41524	267	376	643
10	"10-out6582"	.34980	276	513	789
10	"10-out6583"	.32258	190	399	589
10	"10-out6584"	.33727	257	505	762
10	"10-out6585"	.35444	431	785	1216
10	"10-out6586"	.67207	912	445	1357
10	"10-out6587"	.98920	275	3	278
10	"10-out6588"	.21200	106	394	500
10	"10-out6589"	.98913	91	1	92
10	"10-out6590"	.23666	71	229	300
10	"10-out6591"	.54613	219	182	401
10	"10-out6592"	.37795	48	79	127
10	"10-out6593"	.38082	139	226	365
10	"10-out6594"	.92888	209	16	225
10	"10-out6595"	.18269	19	85	104
10	"10-out6596"	.39171	123	191	314
10	"10-out6597"	.23367	68	223	291
10	"10-out6598"	.99942	1731	1	1732
10	"10-out6599"	.34025	508	985	1493
10	"10-out6600"	.56291	170	132	302
10	"10-out6601"	.34899	52	97	149
10	"10-out6602"	.59459	132	90	222
10	"10-out6603"	.38745	482	762	1244
10	"10-out6604"	.36545	493	856	1349
10	"10-out6605"	.29963	415	970	1385
10	"10-out6606"	.34658	279	526	805
10	"10-out6607"	.47916	299	325	624
10	"10-out6608"	.28748	255	632	887
10	"10-out6609"	.27102	87	234	321
10	"10-out6610"	.28028	155	398	553
10	"10-out6611"	.34868	212	396	608
10	"10-out6612"	.39409	467	718	1185
10	"10-out6613"	.49290	243	250	493
10	"10-out6614"	.75925	615	195	810
10	"10-out6615"	.19920	252	1013	1265
10	"10-out6616"	.41666	590	826	1416
10	"10-out6617"	.92731	1735	136	1871
10	"10-out6618"	.99826	577	1	578
10	"10-out6619"	.64974	256	138	394
10	"10-out6620"	.53474	177	154	331
10	"10-out6621"	.57600	72	53	125
10	"10-out6622"	.36669	447	772	1219
10	"10-out6623"	.29240	231	559	790
10	"10-out6624"	.31764	135	290	425
10	"10-out6625"	.37007	413	703	1116
10	"10-out6626"	.34939	116	216	332
10	"10-out6627"	.99810	1054	2	1056
10	"10-out6628"	.82857	145	30	175
10	"10-out6629"	.32404	279	582	861
10	"10-out6630"	.38095	176	286	462
10	"10-out6631"	.46072	481	563	1044
10	"10-out6632"	.28248	200	508	708
10	"10-out6633"	.91029	3917	386	4303
10	"10-out6634"	.68108	126	59	185
10	"10-out6635"	.34507	49	93	142
10	"10-out6636"	.69336	303	134	437
10	"10-out6637"	.25115	109	325	434
10	"10-out6638"	.30714	692	1561	2253
10	"10-out6639"	.33673	165	325	490
10	"10-out6640"	.45604	166	198	364
10	"10-out6641"	.20620	266	1024	1290
10	"10-out6642"	.29178	494	1199	1693
10	"10-out6643"	.31050	340	755	1095
10	"10-out6644"	.37000	417	710	1127
10	"10-out6645"	.99690	322	1	323
10	"10-out6646"	.16721	51	254	305
10	"10-out6647"	.22971	167	560	727
10	"10-out6648"	.38127	281	456	737
10	"10-out6649"	.25067	185	553	738
10	"10-out6650"	.37078	703	1193	1896
10	"10-out6651"	.99333	149	1	150
10	"10-out6652"	.43111	823	1086	1909
10	"10-out6653"	.33609	527	1041	1568
10	"10-out6654"	.99771	1744	4	1748
10	"10-out6655"	.99814	537	1	538
10	"10-out6656"	.99660	1759	6	1765
10	"10-out6657"	.64161	111	62	173
10	"10-out6658"	.99122	113	1	114
10	"10-out6659"	.16428	69	351	420
10	"10-out6660"	.25487	196	573	769
10	"10-out6661"	.80226	1274	314	1588
10	"10-out6662"	.46902	530	600	1130
10	"10-out6663"	.24120	48	151	199
10	"10-out6664"	.26839	62	169	231
10	"10-out6665"	.18796	278	1201	1479
10	"10-out6666"	.37768	474	781	1255
10	"10-out6667"	.27668	197	515	712
10	"10-out6668"	.99873	789	1	790
10	"10-out6669"	.55178	293	238	531
10	"10-out6670"	.30232	39	90	129
10	"10-out6671"	.45573	139	166	305
10	"10-out6672"	.23979	188	596	784
10	"10-out6673"	.31632	62	134	196
10	"10-out6674"	.29584	121	288	409
10	"10-out6675"	.31738	378	813	1191
10	"10-out6676"	.43408	461	601	1062
10	"10-out6677"	.48453	141	150	291
10	"10-out6678"	.28739	392	972	1364
10	"10-out6679"	.99000	297	3	300
10	"10-out6680"	.66367	517	262	779
10	"10-out6681"	.26315	295	826	1121
10	"10-out6682"	.37931	110	180	290
10	"10-out6683"	.37408	153	256	409
10	"10-out6684"	.37142	182	308	490
10	"10-out6685"	.40769	879	1277	2156
10	"10-out6686"	.38757	131	207	338
10	"10-out6687"	.28876	311	766	1077
10	"10-out6688"	.42600	95	128	223
10	"10-out6689"	.21938	43	153	196
10	"10-out6690"	.35699	342	616	958
10	"10-out6691"	.44339	188	236	424
10	"10-out6692"	.24909	484	1459	1943
10	"10-out6693"	.33742	275	540	815
10	"10-out6694"	.63448	460	265	725
10	"10-out6695"	.95728	493	22	515
10	"10-out6696"	.97872	276	6	282
10	"10-out6697"	.37391	129	216	345
10	"10-out6698"	.51851	140	130	270
10	"10-out6699"	.48372	431	460	891
10	"10-out6700"	.18678	130	566	696
10	"10-out6701"	.13136	111	734	845
10	"10-out6702"	.39611	387	590	977
10	"10-out6703"	.37873	317	520	837
10	"10-out6704"	.16597	159	799	958
10	"10-out6705"	.33417	266	530	796
10	"10-out6706"	.32435	494	1029	1523
10	"10-out6707"	.44812	298	367	665
10	"10-out6708"	.53921	275	235	510
10	"10-out6709"	.28750	138	342	480
10	"10-out6710"	.27845	137	355	492
10	"10-out6711"	.33204	86	173	259
10	"10-out6712"	.49829	146	147	293
10	"10-out6713"	.34338	148	283	431
10	"10-out6714"	.42105	144	198	342
10	"10-out6715"	.49806	129	130	259
10	"10-out6716"	.38105	181	294	475
10	"10-out6717"	.45925	417	491	908
10	"10-out6718"	.30818	384	862	1246
10	"10-out6719"	.95569	151	7	158
10	"10-out6720"	.56165	542	423	965
10	"10-out6721"	.98159	160	3	163
10	"10-out6722"	.44844	374	460	834
10	"10-out6723"	.31203	249	549	798
10	"10-out6724"	.34939	203	378	581
10	"10-out6725"	.55055	648	529	1177
10	"10-out6726"	.37611	126	209	335
10	"10-out6727"	.47289	157	175	332
10	"10-out6728"	.99242	131	1	132
10	"10-out6729"	.44366	252	316	568
10	"10-out6730"	.40619	236	345	581
10	"10-out6731"	.39910	89	134	223
10	"10-out6732"	.48965	284	296	580
10	"10-out6733"	.25000	43	129	172
10	"10-out6734"	.64379	394	218	612
10	"10-out6735"	.98684	225	3	228
10	"10-out6736"	.20760	131	500	631
10	"10-out6737"	.32614	227	469	696
10	"10-out6738"	.99285	278	2	280
10	"10-out6739"	.96969	160	5	165
10	"10-out6740"	.26422	65	181	246
10	"10-out6741"	.57103	205	154	359
10	"10-out6742"	.51807	129	120	249
10	"10-out6743"	.99197	371	3	374
10	"10-out6744"	.48344	146	156	302
10	"10-out6745"	.21010	79	297	376
10	"10-out6746"	.28053	232	595	827
10	"10-out6747"	.73601	513	184	697
10	"10-out6748"	.63719	209	119	328
10	"10-out6749"	.98752	475	6	481
10	"10-out6750"	.42017	329	454	783
10	"10-out6751"	.30021	278	648	926
10	"10-out6752"	.98717	77	1	78
10	"10-out6753"	.29347	27	65	92
10	"10-out6754"	.52747	48	43	91
10	"10-out6755"	.24412	187	579	766
10	"10-out6756"	.87692	114	16	130
10	"10-out6757"	.98947	94	1	95
10	"10-out6758"	.98181	54	1	55
10	"10-out6759"	.34332	229	438	667
10	"10-out6760"	.98305	58	1	59
10	"10-out6761"	.98591	70	1	71
10	"10-out6762"	.99029	102	1	103
10	"10-out6763"	.99242	131	1	132
10	"10-out6764"	.98823	84	1	85
10	"10-out6765"	.98924	92	1	93
10	"10-out6766"	.25670	134	388	522
10	"10-out6767"	.29573	118	281	399
10	"10-out6768"	.33250	133	267	400
10	"10-out6769"	.91666	187	17	204
10	"10-out6770"	.92201	201	17	218
10	"10-out6771"	.95038	249	13	262
10	"10-out6772"	.28373	368	929	1297
10	"10-out6773"	.90954	362	36	398
10	"10-out6774"	.97159	171	5	176
10	"10-out6775"	.31640	592	1279	1871
10	"10-out6776"	.99029	102	1	103
10	"10-out6777"	.37719	172	284	456
10	"10-out6778"	.40332	315	466	781
10	"10-out6779"	.47058	120	135	255
10	"10-out6780"	.99173	120	1	121
10	"10-out6781"	.47330	195	217	412
10	"10-out6782"	.35376	127	232	359
10	"10-out6783"	.36075	114	202	316
10	"10-out6784"	.38164	316	512	828
10	"10-out6785"	.64679	293	160	453
10	"10-out6786"	.81362	406	93	499
10	"10-out6787"	.84881	393	70	463
10	"10-out6788"	.27176	359	962	1321
10	"10-out6789"	.45410	94	113	207
10	"10-out6790"	.44468	205	256	461
10	"10-out6791"	.94594	70	4	74
10	"10-out6792"	.98214	55	1	56
10	"10-out6793"	.22044	69	244	313
10	"10-out6794"	.29411	110	264	374
10	"10-out6795"	.31814	405	868	1273
10	"10-out6796"	.25559	297	865	1162
10	"10-out6797"	.16560	52	262	314
10	"10-out6798"	.45161	140	170	310
10	"10-out6799"	.31830	113	242	355
10	"10-out6800"	.53900	152	130	282
10	"10-out6801"	.86635	564	87	651
10	"10-out6802"	.41624	82	115	197
10	"10-out6803"	.99483	385	2	387
10	"10-out6804"	.50684	185	180	365
10	"10-out6805"	.32830	522	1068	1590
10	"10-out6806"	.24817	102	309	411
10	"10-out6807"	.53233	782	687	1469
10	"10-out6808"	.34412	170	324	494
10	"10-out6809"	.34848	46	86	132
10	"10-out6810"	.87096	135	20	155
10	"10-out6811"	.56435	285	220	505
10	"10-out6812"	.32009	540	1147	1687
10	"10-out6813"	.56453	796	614	1410
10	"10-out6814"	.39409	307	472	779
10	"10-out6815"	.33091	274	554	828
10	"10-out6816"	.80490	722	175	897
10	"10-out6817"	.34152	139	268	407
10	"10-out6818"	.22727	30	102	132
10	"10-out6819"	.43520	450	584	1034
10	"10-out6820"	.42662	250	336	586
10	"10-out6821"	.23922	394	1253	1647
10	"10-out6822"	.32978	93	189	282
10	"10-out6823"	.40555	219	321	540
10	"10-out6824"	.86904	73	11	84
10	"10-out6825"	.41206	82	117	199
10	"10-out6826"	.39316	138	213	351
10	"10-out6827"	.34649	79	149	228
10	"10-out6828"	.31304	72	158	230
10	"10-out6829"	.23918	271	862	1133
10	"10-out6830"	.53125	1275	1125	2400
10	"10-out6831"	.18414	209	926	1135
10	"10-out6832"	.36274	74	130	204
10	"10-out6833"	.15317	53	293	346
10	"10-out6834"	.87323	124	18	142
10	"10-out6835"	.19188	194	817	1011
10	"10-out6836"	.37788	605	996	1601
10	"10-out6837"	.30248	389	897	1286
10	"10-out6838"	.48571	153	162	315
10	"10-out6839"	.39526	217	332	549
10	"10-out6840"	.34669	147	277	424
10	"10-out6841"	.33739	166	326	492
10	"10-out6842"	.99246	395	3	398
10	"10-out6843"	.21258	98	363	461
10	"10-out6844"	.99053	314	3	317
10	"10-out6845"	.56157	228	178	406
10	"10-out6846"	.53206	307	270	577
10	"10-out6847"	.37823	219	360	579
10	"10-out6848"	.35555	176	319	495
10	"10-out6849"	.12000	21	154	175
10	"10-out6850"	.37048	123	209	332
10	"10-out6851"	.21428	24	88	112
10	"10-out6852"	.32608	45	93	138
10	"10-out6853"	.83850	135	26	161
10	"10-out6854"	.26179	172	485	657
10	"10-out6855"	.36197	278	490	768
10	"10-out6856"	.49158	263	272	535
10	"10-out6857"	.30057	104	242	346
10	"10-out6858"	.16607	94	472	566
10	"10-out6859"	.99696	328	1	329
10	"10-out6860"	.89102	556	68	624
10	"10-out6861"	.85021	403	71	474
10	"10-out6862"	.27886	128	331	459
10	"10-out6863"	.44036	96	122	218
10	"10-out6864"	.20000	30	120	150
10	"10-out6865"	.97807	223	5	228
10	"10-out6866"	.87782	194	27	221
10	"10-out6867"	.19331	81	338	419
10	"10-out6868"	.15772	50	267	317
10	"10-out6869"	.34140	282	544	826
10	"10-out6870"	.56211	181	141	322
10	"10-out6871"	.24746	341	1037	1378
10	"10-out6872"	.38832	539	849	1388
10	"10-out6873"	.25642	359	1041	1400
10	"10-out6874"	.91981	195	17	212
10	"10-out6875"	.96581	113	4	117
10	"10-out6876"	.29850	20	47	67
10	"10-out6877"	.68421	286	132	418
10	"10-out6878"	.38957	665	1042	1707
10	"10-out6879"	.35300	694	1272	1966
10	"10-out6880"	.98780	1215	15	1230
10	"10-out6881"	.26970	154	417	571
10	"10-out6882"	.32812	84	172	256
10	"10-out6883"	.56493	87	67	154
10	"10-out6884"	.42711	2224	2983	5207
10	"10-out6885"	.95000	171	9	180
10	"10-out6886"	.50000	156	156	312
10	"10-out6887"	.34986	127	236	363
10	"10-out6888"	.17073	49	238	287
10	"10-out6889"	.71686	238	94	332
10	"10-out6890"	.48221	122	131	253
10	"10-out6891"	.68021	385	181	566
10	"10-out6892"	.13068	23	153	176
10	"10-out6893"	.32748	112	230	342
10	"10-out6894"	.49379	199	204	403
10	"10-out6895"	.32733	273	561	834
10	"10-out6896"	.23899	76	242	318
10	"10-out6897"	.34825	70	131	201
10	"10-out6898"	.97241	423	12	435
10	"10-out6899"	.59464	311	212	523
10	"10-out6900"	.39719	85	129	214
10	"10-out6901"	.99669	302	1	303
10	"10-out6902"	.55629	84	67	151
10	"10-out6903"	.71532	98	39	137
10	"10-out6904"	.33695	124	244	368
10	"10-out6905"	.37628	146	242	388
10	"10-out6906"	.86428	121	19	140
10	"10-out6907"	.47413	55	61	116
10	"10-out6908"	.30232	39	90	129
10	"10-out6909"	.50242	207	205	412
10	"10-out6910"	.29503	113	270	383
10	"10-out6911"	.35335	100	183	283
10	"10-out6912"	.67881	298	141	439
10	"10-out6913"	.58390	254	181	435
10	"10-out6914"	.99583	478	2	480
10	"10-out6915"	.99509	203	1	204
10	"10-out6916"	.44516	207	258	465
10	"10-out6917"	.23938	124	394	518
10	"10-out6918"	.14176	74	448	522
10	"10-out6919"	.21387	74	272	346
10	"10-out6920"	.87764	789	110	899
10	"10-out6921"	.53461	139	121	260
10	"10-out6922"	.43265	106	139	245
10	"10-out6923"	.83728	247	48	295
10	"10-out6924"	.36255	153	269	422
10	"10-out6925"	.54228	218	184	402
10	"10-out6926"	.92544	360	29	389
10	"10-out6927"	.45787	125	148	273
10	"10-out6928"	.82743	187	39	226
10	"10-out6929"	.99122	113	1	114
10	"10-out6930"	.42518	449	607	1056
10	"10-out6931"	.32910	337	687	1024
10	"10-out6932"	.24513	189	582	771
10	"10-out6933"	.71351	132	53	185
10	"10-out6934"	.34633	293	553	846
10	"10-out6935"	.77862	204	58	262
10	"10-out6936"	.50296	339	335	674
10	"10-out6937"	.21808	41	147	188
10	"10-out6938"	.37881	186	305	491
10	"10-out6939"	.98148	53	1	54
10	"10-out6940"	.94512	465	27	492
10	"10-out6941"	.37197	523	883	1406
10	"10-out6942"	.42984	628	833	1461
10	"10-out6943"	.23589	301	975	1276
10	"10-out6944"	.97741	303	7	310
10	"10-out6945"	.31664	683	1474	2157
10	"10-out6946"	.26909	222	603	825
10	"10-out6947"	.19774	123	499	622
10	"10-out6948"	.42753	236	316	552
10	"10-out6949"	.99531	638	3	641
10	"10-out6950"	.35135	208	384	592
10	"10-out6951"	.30000	120	280	400
10	"10-out6952"	.50592	128	125	253
10	"10-out6953"	.49771	109	110	219
10	"10-out6954"	.99733	374	1	375
10	"10-out6955"	.41768	137	191	328
10	"10-out6956"	.98850	86	1	87
10	"10-out6957"	.99041	310	3	313
10	"10-out6958"	.69976	303	130	433
10	"10-out6959"	.97500	273	7	280
10	"10-out6960"	.38983	161	252	413
10	"10-out6961"	.27607	90	236	326
10	"10-out6962"	.45320	184	222	406
10	"10-out6963"	.45189	155	188	343
10	"10-out6964"	.46931	130	147	277
10	"10-out6965"	.45833	231	273	504
10	"10-out6966"	.85352	775	133	908
10	"10-out6967"	.96652	231	8	239
10	"10-out6968"	.34545	190	360	550
10	"10-out6969"	.99099	110	1	111
10	"10-out6970"	.25490	26	76	102
10	"10-out6971"	.54901	84	69	153
10	"10-out6972"	.35216	293	539	832
10	"10-out6973"	.31451	78	170	248
10	"10-out6974"	.96301	651	25	676
10	"10-out6975"	.55468	71	57	128
10	"10-out6976"	.99851	1344	2	1346
10	"10-out6977"	.64253	142	79	221
10	"10-out6978"	.63470	139	80	219
10	"10-out6979"	.47385	145	161	306
10	"10-out6980"	.99090	218	2	220
10	"10-out6981"	.25000	88	264	352
10	"10-out6982"	.62500	160	96	256
10	"10-out6983"	.11363	30	234	264
10	"10-out6984"	.38281	98	158	256
10	"10-out6985"	.94033	394	25	419
10	"10-out6986"	.38071	75	122	197
10	"10-out6987"	.31889	81	173	254
10	"10-out6988"	.34824	109	204	313
10	"10-out6989"	.96389	267	10	277
10	"10-out6990"	.69642	234	102	336
10	"10-out6991"	.36008	166	295	461
10	"10-out6992"	.49821	279	281	560
10	"10-out6993"	.35838	186	333	519
10	"10-out6994"	.99285	139	1	140
10	"10-out6995"	.28657	143	356	499
10	"10-out6996"	.37941	129	211	340
10	"10-out6997"	.98427	313	5	318
10	"10-out6998"	.64417	592	327	919
10	"10-out6999"	.13242	29	190	219
10	"10-out7000"	.77850	355	101	456
10	"10-out7001"	.19945	147	590	737
10	"10-out7002"	.43085	81	107	188
10	"10-out7003"	.45620	125	149	274
10	"10-out7004"	.97972	145	3	148
10	"10-out7005"	.36410	213	372	585
10	"10-out7006"	.54150	137	116	253
10	"10-out7007"	.23684	99	319	418
10	"10-out7008"	.99697	330	1	331
10	"10-out7009"	.25311	61	180	241
10	"10-out7010"	.98913	182	2	184
10	"10-out7011"	.96542	363	13	376
10	"10-out7012"	.25462	55	161	216
10	"10-out7013"	.96009	409	17	426
10	"10-out7014"	.95987	311	13	324
10	"10-out7015"	.40000	252	378	630
10	"10-out7016"	.99790	477	1	478
10	"10-out7017"	.47544	455	502	957
10	"10-out7018"	.99789	473	1	474
10	"10-out7019"	.97206	348	10	358
10	"10-out7020"	.98630	216	3	219
10	"10-out7021"	.28914	229	563	792
10	"10-out7022"	.39901	488	735	1223
10	"10-out7023"	.99425	173	1	174
10	"10-out7024"	.44968	143	175	318
10	"10-out7025"	.34482	100	190	290
10	"10-out7026"	.40666	122	178	300
10	"10-out7027"	.16317	39	200	239
10	"10-out7028"	.20652	57	219	276
10	"10-out7029"	.46386	276	319	595
10	"10-out7030"	.88141	275	37	312
10	"10-out7031"	.99792	482	1	483
10	"10-out7032"	.99791	478	1	479
10	"10-out7033"	.99789	473	1	474
10	"10-out7034"	.99789	475	1	476
10	"10-out7035"	.29581	113	269	382
10	"10-out7036"	.99790	477	1	478
10	"10-out7037"	.99337	150	1	151
10	"10-out7038"	.99547	220	1	221
10	"10-out7039"	.99547	220	1	221
10	"10-out7040"	.99789	474	1	475
10	"10-out7041"	.48648	108	114	222
10	"10-out7042"	.39930	686	1032	1718
10	"10-out7043"	.36162	98	173	271
10	"10-out7044"	.46261	99	115	214
10	"10-out7045"	.39100	400	623	1023
10	"10-out7046"	.35155	328	605	933
10	"10-out7047"	.35268	164	301	465
10	"10-out7048"	.46302	263	305	568
10	"10-out7049"	.54263	70	59	129
10	"10-out7050"	.27962	59	152	211
10	"10-out7051"	.20824	197	749	946
10	"10-out7052"	.32469	188	391	579
10	"10-out7053"	.68253	129	60	189
10	"10-out7054"	.99619	262	1	263
10	"10-out7055"	.79249	359	94	453
10	"10-out7056"	.27817	859	2229	3088
10	"10-out7057"	.50000	55	55	110
10	"10-out7058"	.23728	56	180	236
10	"10-out7059"	.51552	249	234	483
10	"10-out7060"	.32017	73	155	228
10	"10-out7061"	.84912	439	78	517
10	"10-out7062"	.27641	259	678	937
10	"10-out7063"	.17603	166	777	943
10	"10-out7064"	.25239	132	391	523
10	"10-out7065"	.22765	107	363	470
10	"10-out7066"	.21814	113	405	518
10	"10-out7067"	.95341	307	15	322
10	"10-out7068"	.19193	119	501	620
10	"10-out7069"	.96163	376	15	391
10	"10-out7070"	.26229	48	135	183
10	"10-out7071"	.99047	104	1	105
10	"10-out7072"	.99047	104	1	105
10	"10-out7073"	.28836	280	691	971
10	"10-out7074"	.30499	226	515	741
10	"10-out7075"	.32611	241	498	739
10	"10-out7076"	.85098	474	83	557
10	"10-out7077"	.33830	68	133	201
10	"10-out7078"	.26587	67	185	252
10	"10-out7079"	.49019	125	130	255
10	"10-out7080"	.31517	81	176	257
10	"10-out7081"	.20634	39	150	189
10	"10-out7082"	.97156	205	6	211
10	"10-out7083"	.99397	165	1	166
10	"10-out7084"	.99397	165	1	166
10	"10-out7085"	.35091	439	812	1251
10	"10-out7086"	.38115	1193	1937	3130
10	"10-out7087"	.99651	286	1	287
10	"10-out7088"	.67301	389	189	578
10	"10-out7089"	.22865	83	280	363
10	"10-out7090"	.27896	130	336	466
10	"10-out7091"	.91798	291	26	317
10	"10-out7092"	.33605	329	650	979
10	"10-out7093"	.94952	301	16	317
10	"10-out7094"	.42572	278	375	653
10	"10-out7095"	.29860	407	956	1363
10	"10-out7096"	.79906	171	43	214
10	"10-out7097"	.40920	169	244	413
10	"10-out7098"	.49762	523	528	1051
10	"10-out7099"	.59065	215	149	364
10	"10-out7100"	.36764	400	688	1088
10	"10-out7101"	.26923	42	114	156
10	"10-out7102"	.94636	494	28	522
10	"10-out7103"	.37759	91	150	241
10	"10-out7104"	.80195	328	81	409
10	"10-out7105"	.26028	310	881	1191
10	"10-out7106"	.48264	153	164	317
10	"10-out7107"	.99047	104	1	105
10	"10-out7108"	.65671	132	69	201
10	"10-out7109"	.23641	818	2642	3460
10	"10-out7110"	.12824	79	537	616
10	"10-out7111"	.94904	149	8	157
10	"10-out7112"	.41130	262	375	637
10	"10-out7113"	.64814	140	76	216
10	"10-out7114"	.28464	341	857	1198
10	"10-out7115"	.30353	146	335	481
10	"10-out7116"	.32424	761	1586	2347
10	"10-out7117"	.37815	464	763	1227
10	"10-out7118"	.68664	252	115	367
10	"10-out7119"	.30543	73	166	239
10	"10-out7120"	.99593	245	1	246
10	"10-out7121"	.52925	199	177	376
10	"10-out7122"	.31085	106	235	341
10	"10-out7123"	.42464	665	901	1566
10	"10-out7124"	.47175	167	187	354
10	"10-out7125"	.42721	540	724	1264
10	"10-out7126"	.99651	286	1	287
10	"10-out7127"	.35701	201	362	563
10	"10-out7128"	.32179	344	725	1069
10	"10-out7129"	.35534	495	898	1393
10	"10-out7130"	.24683	39	119	158
10	"10-out7131"	.49690	241	244	485
10	"10-out7132"	.39548	210	321	531
10	"10-out7133"	.31129	113	250	363
10	"10-out7134"	.36500	73	127	200
10	"10-out7135"	.90909	110	11	121
10	"10-out7136"	.33235	113	227	340
10	"10-out7137"	.42868	550	733	1283
10	"10-out7138"	.43386	328	428	756
10	"10-out7139"	.33585	266	526	792
10	"10-out7140"	.41481	56	79	135
10	"10-out7141"	.74857	262	88	350
10	"10-out7142"	.69402	93	41	134
10	"10-out7143"	.45945	51	60	111
10	"10-out7144"	.29712	331	783	1114
10	"10-out7145"	.26700	106	291	397
10	"10-out7146"	.40243	462	686	1148
10	"10-out7147"	.28320	145	367	512
10	"10-out7148"	.25034	184	551	735
10	"10-out7149"	.21111	95	355	450
10	"10-out7150"	.29812	127	299	426
10	"10-out7151"	.69788	231	100	331
10	"10-out7152"	.40396	570	841	1411
10	"10-out7153"	.38311	118	190	308
10	"10-out7154"	.18215	49	220	269
10	"10-out7155"	.52362	410	373	783
10	"10-out7156"	.31284	280	615	895
10	"10-out7157"	.31675	312	673	985
10	"10-out7158"	.51282	180	171	351
10	"10-out7159"	.30973	140	312	452
10	"10-out7160"	.99438	177	1	178
10	"10-out7161"	.99526	210	1	211
10	"10-out7162"	.58126	304	219	523
10	"10-out7163"	.96374	319	12	331
10	"10-out7164"	.99647	283	1	284
10	"10-out7165"	.87223	1065	156	1221
10	"10-out7166"	.21428	87	319	406
10	"10-out7167"	.75829	320	102	422
10	"10-out7168"	.22739	176	598	774
10	"10-out7169"	.47440	278	308	586
10	"10-out7170"	.23461	61	199	260
10	"10-out7171"	.29277	77	186	263
10	"10-out7172"	.24343	176	547	723
10	"10-out7173"	.74841	473	159	632
10	"10-out7174"	.37012	228	388	616
10	"10-out7175"	.29519	129	308	437
10	"10-out7176"	.33081	307	621	928
10	"10-out7177"	.31707	65	140	205
10	"10-out7178"	.48618	88	93	181
10	"10-out7179"	.21398	101	371	472
10	"10-out7180"	.37979	188	307	495
10	"10-out7181"	.33888	61	119	180
10	"10-out7182"	.28467	39	98	137
10	"10-out7183"	.26315	90	252	342
10	"10-out7184"	.41451	177	250	427
10	"10-out7185"	.30845	62	139	201
10	"10-out7186"	.99809	525	1	526
10	"10-out7187"	.82592	223	47	270
10	"10-out7188"	.51966	185	171	356
10	"10-out7189"	.20507	97	376	473
10	"10-out7190"	.28650	104	259	363
10	"10-out7191"	.46907	182	206	388
10	"10-out7192"	.31578	48	104	152
10	"10-out7193"	.30331	64	147	211
10	"10-out7194"	.26168	196	553	749
10	"10-out7195"	.38817	210	331	541
10	"10-out7196"	.99065	106	1	107
10	"10-out7197"	.67153	92	45	137
10	"10-out7198"	.99065	212	2	214
10	"10-out7199"	.93234	441	32	473
10	"10-out7200"	.98684	225	3	228
10	"10-out7201"	.98684	225	3	228
10	"10-out7202"	.30941	207	462	669
10	"10-out7203"	.44210	84	106	190
10	"10-out7204"	.24479	235	725	960
10	"10-out7205"	.72423	260	99	359
10	"10-out7206"	.46619	393	450	843
10	"10-out7207"	.38331	386	621	1007
10	"10-out7208"	.73207	388	142	530
10	"10-out7209"	.42639	84	113	197
10	"10-out7210"	.73451	83	30	113
10	"10-out7211"	.99596	494	2	496
10	"10-out7212"	.28295	88	223	311
10	"10-out7213"	.99596	494	2	496
10	"10-out7214"	.99596	494	2	496
10	"10-out7215"	.25949	82	234	316
10	"10-out7216"	.99047	104	1	105
10	"10-out7217"	.97391	112	3	115
10	"10-out7218"	.51485	156	147	303
10	"10-out7219"	.33163	65	131	196
10	"10-out7220"	.22388	30	104	134
10	"10-out7221"	.25388	147	432	579
10	"10-out7222"	.35444	431	785	1216
10	"10-out7223"	.34899	104	194	298
10	"10-out7224"	.46069	586	686	1272
10	"10-out7225"	.48250	262	281	543
10	"10-out7226"	.98850	172	2	174
10	"10-out7227"	.79064	321	85	406
10	"10-out7228"	.21079	125	468	593
10	"10-out7229"	.29661	70	166	236
10	"10-out7230"	.26380	215	600	815
10	"10-out7231"	.99652	287	1	288
10	"10-out7232"	.36495	277	482	759
10	"10-out7233"	.40854	478	692	1170
10	"10-out7234"	.50177	141	140	281
10	"10-out7235"	.30150	281	651	932
10	"10-out7236"	.27882	104	269	373
10	"10-out7237"	.39814	43	65	108
10	"10-out7238"	.99596	494	2	496
10	"10-out7239"	.51963	172	159	331
10	"10-out7240"	.50865	558	539	1097
10	"10-out7241"	.95168	453	23	476
10	"10-out7242"	.24623	49	150	199
10	"10-out7243"	.17777	24	111	135
10	"10-out7244"	.34730	174	327	501
10	"10-out7245"	.46619	331	379	710
10	"10-out7246"	.99393	164	1	165
10	"10-out7247"	.99684	316	1	317
10	"10-out7248"	.31359	143	313	456
10	"10-out7249"	.69791	134	58	192
10	"10-out7250"	.63758	95	54	149
10	"10-out7251"	.99363	156	1	157
10	"10-out7252"	.99596	247	1	248
10	"10-out7253"	.97972	145	3	148
10	"10-out7254"	.99371	158	1	159
10	"10-out7255"	.40000	130	195	325
10	"10-out7256"	.55737	170	135	305
10	"10-out7257"	.42322	113	154	267
10	"10-out7258"	.19310	28	117	145
10	"10-out7259"	.42011	213	294	507
10	"10-out7260"	.71276	134	54	188
10	"10-out7261"	.30198	167	386	553
10	"10-out7262"	.34056	157	304	461
10	"10-out7263"	.32039	421	893	1314
10	"10-out7264"	.32765	154	316	470
10	"10-out7265"	.56607	604	463	1067
10	"10-out7266"	.42682	140	188	328
10	"10-out7267"	.61992	336	206	542
10	"10-out7268"	.99337	150	1	151
10	"10-out7269"	.44514	852	1062	1914
10	"10-out7270"	.20833	45	171	216
10	"10-out7271"	.89272	233	28	261
10	"10-out7272"	.64800	162	88	250
10	"10-out7273"	.27095	139	374	513
10	"10-out7274"	.64810	291	158	449
10	"10-out7275"	.38709	60	95	155
10	"10-out7276"	.38043	35	57	92
10	"10-out7277"	.94615	369	21	390
10	"10-out7278"	.85915	122	20	142
10	"10-out7279"	.27702	41	107	148
10	"10-out7280"	.43086	134	177	311
10	"10-out7281"	.35437	174	317	491
10	"10-out7282"	.19245	102	428	530
10	"10-out7283"	.60355	204	134	338
10	"10-out7284"	.17529	44	207	251
10	"10-out7285"	.76205	237	74	311
10	"10-out7286"	.37223	370	624	994
10	"10-out7287"	.15753	69	369	438
10	"10-out7288"	.92653	227	18	245
10	"10-out7289"	.64705	715	390	1105
10	"10-out7290"	.72727	112	42	154
10	"10-out7291"	.20512	32	124	156
10	"10-out7292"	.40916	527	761	1288
10	"10-out7293"	.28368	120	303	423
10	"10-out7294"	.35964	82	146	228
10	"10-out7295"	.27631	84	220	304
10	"10-out7296"	.42880	268	357	625
10	"10-out7297"	.53284	73	64	137
10	"10-out7298"	.18589	29	127	156
10	"10-out7299"	.40318	152	225	377
10	"10-out7300"	.24229	55	172	227
10	"10-out7301"	.82407	356	76	432
10	"10-out7302"	.61538	96	60	156
10	"10-out7303"	.36098	496	878	1374
10	"10-out7304"	.60338	356	234	590
10	"10-out7305"	.27184	140	375	515
10	"10-out7306"	.26327	114	319	433
10	"10-out7307"	.58955	632	440	1072
10	"10-out7308"	.76315	145	45	190
10	"10-out7309"	.33333	148	296	444
10	"10-out7310"	.39826	552	834	1386
10	"10-out7311"	.99624	265	1	266
10	"10-out7312"	.76500	306	94	400
10	"10-out7313"	.38700	274	434	708
10	"10-out7314"	.44234	257	324	581
10	"10-out7315"	.29778	148	349	497
10	"10-out7316"	.83116	64	13	77
10	"10-out7317"	.27441	59	156	215
10	"10-out7318"	.53846	35	30	65
10	"10-out7319"	.89140	591	72	663
10	"10-out7320"	.98757	159	2	161
10	"10-out7321"	.99598	248	1	249
10	"10-out7322"	.27530	204	537	741
10	"10-out7323"	.36414	197	344	541
10	"10-out7324"	.36004	292	519	811
10	"10-out7325"	.45224	734	889	1623
10	"10-out7326"	.18965	44	188	232
10	"10-out7327"	.14537	33	194	227
10	"10-out7328"	.10655	26	218	244
10	"10-out7329"	.45370	196	236	432
10	"10-out7330"	.68759	471	214	685
10	"10-out7331"	.45773	222	263	485
10	"10-out7332"	.56097	92	72	164
10	"10-out7333"	.25806	104	299	403
10	"10-out7334"	.23888	43	137	180
10	"10-out7335"	.45783	76	90	166
10	"10-out7336"	.82911	131	27	158
10	"10-out7337"	.99319	146	1	147
10	"10-out7338"	.42356	133	181	314
10	"10-out7339"	.23706	55	177	232
10	"10-out7340"	.25467	109	319	428
10	"10-out7341"	.71241	109	44	153
10	"10-out7342"	.38000	152	248	400
10	"10-out7343"	.44212	191	241	432
10	"10-out7344"	.38799	336	530	866
10	"10-out7345"	.40851	259	375	634
10	"10-out7346"	.38397	139	223	362
10	"10-out7347"	.23499	184	599	783
10	"10-out7348"	.38709	48	76	124
10	"10-out7349"	.05194	8	146	154
10	"10-out7350"	.29145	58	141	199
10	"10-out7351"	.25000	55	165	220
10	"10-out7352"	.43656	117	151	268
10	"10-out7353"	.38515	109	174	283
10	"10-out7354"	.61157	222	141	363
10	"10-out7355"	.42948	134	178	312
10	"10-out7356"	.42331	138	188	326
10	"10-out7357"	.32580	476	985	1461
10	"10-out7358"	.57500	69	51	120
10	"10-out7359"	.07339	8	101	109
10	"10-out7360"	.69005	541	243	784
10	"10-out7361"	.16853	225	1110	1335
10	"10-out7362"	.51984	131	121	252
10	"10-out7363"	.62794	346	205	551
10	"10-out7364"	.99596	494	2	496
10	"10-out7365"	.35015	111	206	317
10	"10-out7366"	.99494	197	1	198
10	"10-out7367"	.45238	152	184	336
10	"10-out7368"	.99047	104	1	105
10	"10-out7369"	.36090	96	170	266
10	"10-out7370"	.24378	304	943	1247
10	"10-out7371"	.39095	242	377	619
10	"10-out7372"	.46035	180	211	391
10	"10-out7373"	.70370	76	32	108
10	"10-out7374"	.32352	110	230	340
10	"10-out7375"	.29305	211	509	720
10	"10-out7376"	.26956	31	84	115
10	"10-out7377"	.38787	64	101	165
10	"10-out7378"	.25389	163	479	642
10	"10-out7379"	.89670	408	47	455
10	"10-out7380"	.99811	529	1	530
10	"10-out7381"	.49635	272	276	548
10	"10-out7382"	.30041	73	170	243
10	"10-out7383"	.09729	18	167	185
10	"10-out7384"	.60000	192	128	320
10	"10-out7385"	.37931	198	324	522
10	"10-out7386"	.98931	463	5	468
10	"10-out7387"	.38658	196	311	507
10	"10-out7388"	.25904	265	758	1023
10	"10-out7389"	.13868	38	236	274
10	"10-out7390"	.77854	225	64	289
10	"10-out7391"	.48414	168	179	347
10	"10-out7392"	.29376	99	238	337
10	"10-out7393"	.36217	113	199	312
10	"10-out7394"	.53318	466	408	874
10	"10-out7395"	.30000	42	98	140
10	"10-out7396"	.99839	1247	2	1249
10	"10-out7397"	.99760	832	2	834
10	"10-out7398"	.99837	1227	2	1229
10	"10-out7399"	.85273	249	43	292
10	"10-out7400"	.32094	95	201	296
10	"10-out7401"	.29979	146	341	487
10	"10-out7402"	.28707	542	1346	1888
10	"10-out7403"	.88118	178	24	202
10	"10-out7404"	.35338	141	258	399
10	"10-out7405"	.27707	110	287	397
10	"10-out7406"	.23696	100	322	422
10	"10-out7407"	.45546	271	324	595
10	"10-out7408"	.28647	108	269	377
10	"10-out7409"	.28090	459	1175	1634
10	"10-out7410"	.46646	153	175	328
10	"10-out7411"	.99721	358	1	359
10	"10-out7412"	.43632	209	270	479
10	"10-out7413"	.45945	221	260	481
10	"10-out7414"	.27289	146	389	535
10	"10-out7415"	.21513	108	394	502
10	"10-out7416"	.43937	366	467	833
10	"10-out7417"	.50000	137	137	274
10	"10-out7418"	.95913	798	34	832
10	"10-out7419"	.25786	205	590	795
10	"10-out7420"	.28633	132	329	461
10	"10-out7421"	.42452	270	366	636
10	"10-out7422"	.19392	115	478	593
10	"10-out7423"	.54687	175	145	320
10	"10-out7424"	.42298	346	472	818
10	"10-out7425"	.91295	472	45	517
10	"10-out7426"	.34040	289	560	849
10	"10-out7427"	.57407	93	69	162
10	"10-out7428"	.97560	160	4	164
10	"10-out7429"	.96951	159	5	164
10	"10-out7430"	.96951	159	5	164
10	"10-out7431"	.96951	159	5	164
10	"10-out7432"	.63200	541	315	856
10	"10-out7433"	.50965	343	330	673
10	"10-out7434"	.38475	212	339	551
10	"10-out7435"	.14722	106	614	720
10	"10-out7436"	.24792	298	904	1202
10	"10-out7437"	.97385	298	8	306
10	"10-out7438"	.98717	77	1	78
10	"10-out7439"	.72289	60	23	83
10	"10-out7440"	.98901	90	1	91
10	"10-out7441"	.38383	38	61	99
10	"10-out7442"	.99152	117	1	118
10	"10-out7443"	.98947	94	1	95
10	"10-out7444"	.31343	21	46	67
10	"10-out7445"	.99259	134	1	135
10	"10-out7446"	.99418	171	1	172
10	"10-out7447"	.99342	151	1	152
10	"10-out7448"	.99019	101	1	102
10	"10-out7449"	.98924	92	1	93
10	"10-out7450"	.76146	664	208	872
10	"10-out7451"	.98529	67	1	68
10	"10-out7452"	.41074	428	614	1042
10	"10-out7453"	.34750	139	261	400
10	"10-out7454"	.34168	259	499	758
10	"10-out7455"	.29714	52	123	175
10	"10-out7456"	.52112	148	136	284
10	"10-out7457"	.48453	141	150	291
10	"10-out7458"	.38554	128	204	332
10	"10-out7459"	.99458	735	4	739
10	"10-out7460"	.43567	298	386	684
10	"10-out7461"	.38736	282	446	728
10	"10-out7462"	.92307	924	77	1001
10	"10-out7463"	.24876	202	610	812
10	"10-out7464"	.33147	297	599	896
10	"10-out7465"	.32884	220	449	669
10	"10-out7466"	.37674	243	402	645
10	"10-out7467"	.37430	201	336	537
10	"10-out7468"	.44217	497	627	1124
10	"10-out7469"	.26865	90	245	335
10	"10-out7470"	.28421	81	204	285
10	"10-out7471"	.45674	132	157	289
10	"10-out7472"	.32246	89	187	276
10	"10-out7473"	.23754	62	199	261
10	"10-out7474"	.45557	482	576	1058
10	"10-out7475"	.26553	406	1123	1529
10	"10-out7476"	.38704	478	757	1235
10	"10-out7477"	.89345	805	96	901
10	"10-out7478"	.97750	565	13	578
10	"10-out7479"	.31469	287	625	912
10	"10-out7480"	.14385	123	732	855
10	"10-out7481"	.58847	143	100	243
10	"10-out7482"	.24376	88	273	361
10	"10-out7483"	.33873	209	408	617
10	"10-out7484"	.27093	55	148	203
10	"10-out7485"	.43951	109	139	248
10	"10-out7486"	.26607	120	331	451
10	"10-out7487"	.83333	215	43	258
10	"10-out7488"	.27055	102	275	377
10	"10-out7489"	.99295	141	1	142
10	"10-out7490"	1.00000	2	0	2
10	"10-out7491"	.30726	165	372	537
10	"10-out7492"	.33928	152	296	448
10	"10-out7493"	.98007	492	10	502
10	"10-out7494"	.24836	38	115	153
10	"10-out7495"	.45639	157	187	344
10	"10-out7496"	.43037	68	90	158
10	"10-out7497"	.99453	182	1	183
10	"10-out7498"	.46700	92	105	197
10	"10-out7499"	.26478	103	286	389
10	"10-out7500"	.91891	68	6	74
10	"10-out7501"	.97196	936	27	963
10	"10-out7502"	.70270	260	110	370
10	"10-out7503"	.37368	142	238	380
10	"10-out7504"	.24945	228	686	914
10	"10-out7505"	.37366	979	1641	2620
10	"10-out7506"	.45125	412	501	913
10	"10-out7507"	.33121	312	630	942
10	"10-out7508"	.42751	348	466	814
10	"10-out7509"	.29942	312	730	1042
10	"10-out7510"	.30232	208	480	688
10	"10-out7511"	.35099	616	1139	1755
10	"10-out7512"	.28470	121	304	425
10	"10-out7513"	.39370	200	308	508
10	"10-out7514"	.37627	184	305	489
10	"10-out7515"	.89683	539	62	601
10	"10-out7516"	.29038	151	369	520
10	"10-out7517"	.70656	183	76	259
10	"10-out7518"	.29721	96	227	323
10	"10-out7519"	.22382	62	215	277
10	"10-out7520"	.97103	2481	74	2555
10	"10-out7521"	.16485	76	385	461
10	"10-out7522"	.26600	108	298	406
10	"10-out7523"	.49896	480	482	962
10	"10-out7524"	.15743	108	578	686
10	"10-out7525"	.30360	371	851	1222
10	"10-out7526"	.99519	207	1	208
10	"10-out7527"	.99778	451	1	452
10	"10-out7528"	.99356	309	2	311
10	"10-out7529"	.99834	603	1	604
10	"10-out7530"	.99285	139	1	140
10	"10-out7531"	.99453	182	1	183
10	"10-out7532"	.98924	92	1	93
10	"10-out7533"	.99346	152	1	153
10	"10-out7534"	.99386	162	1	163
10	"10-out7535"	.99551	222	1	223
10	"10-out7536"	.99567	230	1	231
10	"10-out7537"	.98734	78	1	79
10	"10-out7538"	.99728	368	1	369
10	"10-out7539"	.99280	138	1	139
10	"10-out7540"	.29416	373	895	1268
10	"10-out7541"	.26825	180	491	671
10	"10-out7542"	.24062	199	628	827
10	"10-out7543"	.64176	335	187	522
10	"10-out7544"	.99745	392	1	393
10	"10-out7545"	.99549	221	1	222
10	"10-out7546"	.48299	71	76	147
10	"10-out7547"	.75977	136	43	179
10	"10-out7548"	.83542	731	144	875
10	"10-out7549"	.35087	380	703	1083
10	"10-out7550"	.37044	183	311	494
10	"10-out7551"	.25840	146	419	565
10	"10-out7552"	.19008	115	490	605
10	"10-out7553"	.36760	497	855	1352
10	"10-out7554"	.72568	1164	440	1604
10	"10-out7555"	.26462	285	792	1077
10	"10-out7556"	.43909	447	571	1018
10	"10-out7557"	.37963	522	853	1375
10	"10-out7558"	.37777	391	644	1035
10	"10-out7559"	.26895	259	704	963
10	"10-out7560"	.25298	275	812	1087
10	"10-out7561"	.36626	393	680	1073
10	"10-out7562"	.23659	203	655	858
10	"10-out7563"	.24962	165	496	661
10	"10-out7564"	.79647	497	127	624
10	"10-out7565"	.25473	121	354	475
10	"10-out7566"	.14176	37	224	261
10	"10-out7567"	.45230	147	178	325
10	"10-out7568"	.99646	282	1	283
10	"10-out7569"	.34782	48	90	138
10	"10-out7570"	.60486	323	211	534
10	"10-out7571"	.75806	94	30	124
10	"10-out7572"	.42857	69	92	161
10	"10-out7573"	.21498	66	241	307
10	"10-out7574"	.33970	160	311	471
10	"10-out7575"	.34131	57	110	167
10	"10-out7576"	.41183	327	467	794
10	"10-out7577"	.50923	772	744	1516
10	"10-out7578"	.98765	320	4	324
10	"10-out7579"	.33041	189	383	572
10	"10-out7580"	.40201	80	119	199
10	"10-out7581"	.98947	94	1	95
10	"10-out7582"	.20000	20	80	100
10	"10-out7583"	.50354	71	70	141
10	"10-out7584"	.18421	98	434	532
10	"10-out7585"	.99545	219	1	220
10	"10-out7586"	.98550	68	1	69
10	"10-out7587"	.23091	118	393	511
10	"10-out7588"	.14146	29	176	205
10	"10-out7589"	.80212	227	56	283
10	"10-out7590"	.46949	1762	1991	3753
10	"10-out7591"	1.00000	156	0	156
10	"10-out7592"	.32901	203	414	617
10	"10-out7593"	.99610	256	1	257
10	"10-out7594"	.24611	111	340	451
10	"10-out7595"	.34090	75	145	220
10	"10-out7596"	.23529	96	312	408
10	"10-out7597"	.36728	119	205	324
10	"10-out7598"	.30288	63	145	208
10	"10-out7599"	.36160	81	143	224
10	"10-out7600"	.99373	317	2	319
10	"10-out7601"	.48967	166	173	339
10	"10-out7602"	.40740	132	192	324
10	"10-out7603"	.59393	98	67	165
10	"10-out7604"	.17788	37	171	208
10	"10-out7605"	.35172	153	282	435
10	"10-out7606"	.29344	103	248	351
10	"10-out7607"	.26200	60	169	229
10	"10-out7608"	.52713	68	61	129
10	"10-out7609"	.35735	238	428	666
10	"10-out7610"	.47276	243	271	514
10	"10-out7611"	.26470	36	100	136
10	"10-out7612"	.24940	105	316	421
10	"10-out7613"	.38888	63	99	162
10	"10-out7614"	.27192	155	415	570
10	"10-out7615"	.30833	74	166	240
10	"10-out7616"	.42522	236	319	555
10	"10-out7617"	.40000	58	87	145
10	"10-out7618"	.52083	150	138	288
10	"10-out7619"	.92118	187	16	203
10	"10-out7620"	.32625	123	254	377
10	"10-out7621"	.36607	123	213	336
10	"10-out7622"	.48717	76	80	156
10	"10-out7623"	.97570	241	6	247
10	"10-out7624"	.59116	107	74	181
10	"10-out7625"	.59910	538	360	898
10	"10-out7626"	.21516	193	704	897
10	"10-out7627"	.26822	92	251	343
10	"10-out7628"	.40350	115	170	285
10	"10-out7629"	.30708	78	176	254
10	"10-out7630"	.35869	99	177	276
10	"10-out7631"	.22120	242	852	1094
10	"10-out7632"	.36167	302	533	835
10	"10-out7633"	.25649	148	429	577
10	"10-out7634"	.35098	179	331	510
10	"10-out7635"	.45065	274	334	608
10	"10-out7636"	.39904	417	628	1045
10	"10-out7637"	.23676	237	764	1001
10	"10-out7638"	.31720	59	127	186
10	"10-out7639"	.77294	480	141	621
10	"10-out7640"	.52679	403	362	765
10	"10-out7641"	.99285	139	1	140
10	"10-out7642"	.38121	69	112	181
10	"10-out7643"	.31845	628	1344	1972
10	"10-out7644"	.99285	139	1	140
10	"10-out7645"	.40836	586	849	1435
10	"10-out7646"	.30580	137	311	448
10	"10-out7647"	.98659	515	7	522
10	"10-out7648"	.20644	237	911	1148
10	"10-out7649"	.99428	174	1	175
10	"10-out7650"	.74870	289	97	386
10	"10-out7651"	.36162	196	346	542
10	"10-out7652"	.99107	111	1	112
10	"10-out7653"	.99082	108	1	109
10	"10-out7654"	.99107	111	1	112
10	"10-out7655"	.99115	112	1	113
10	"10-out7656"	.99107	111	1	112
10	"10-out7657"	.99122	113	1	114
10	"10-out7658"	.99047	104	1	105
10	"10-out7659"	.98214	110	2	112
10	"10-out7660"	.99082	108	1	109
10	"10-out7661"	.98165	107	2	109
10	"10-out7662"	.99159	118	1	119
10	"10-out7663"	.99115	112	1	113
10	"10-out7664"	.99115	112	1	113
10	"10-out7665"	.99122	113	1	114
10	"10-out7666"	.99115	112	1	113
10	"10-out7667"	.99107	111	1	112
10	"10-out7668"	.99122	113	1	114
10	"10-out7669"	.99130	114	1	115
10	"10-out7670"	.99082	108	1	109
10	"10-out7671"	.99193	123	1	124
10	"10-out7672"	.98260	113	2	115
10	"10-out7673"	.99099	110	1	111
10	"10-out7674"	.99130	114	1	115
10	"10-out7675"	.99122	113	1	114
10	"10-out7676"	.99130	114	1	115
10	"10-out7677"	.99099	110	1	111
10	"10-out7678"	.99122	113	1	114
10	"10-out7679"	.99122	113	1	114
10	"10-out7680"	.99122	113	1	114
10	"10-out7681"	.99122	113	1	114
10	"10-out7682"	.99122	113	1	114
10	"10-out7683"	.58012	181	131	312
10	"10-out7684"	.49659	292	296	588
10	"10-out7685"	.35233	241	443	684
10	"10-out7686"	.75241	234	77	311
10	"10-out7687"	.99319	292	2	294
10	"10-out7688"	.90978	474	47	521
10	"10-out7689"	.60386	125	82	207
10	"10-out7690"	.16952	89	436	525
10	"10-out7691"	.58675	186	131	317
10	"10-out7692"	.26631	302	832	1134
10	"10-out7693"	.33333	146	292	438
10	"10-out7694"	.43529	74	96	170
10	"10-out7695"	.24758	77	234	311
10	"10-out7696"	.23047	121	404	525
10	"10-out7697"	.99746	394	1	395
10	"10-out7698"	.20038	103	411	514
10	"10-out7699"	.99719	356	1	357
10	"10-out7700"	.95608	479	22	501
10	"10-out7701"	.62151	156	95	251
10	"10-out7702"	.30119	253	587	840
10	"10-out7703"	1.00000	156	0	156
10	"10-out7704"	.50000	102	102	204
10	"10-out7705"	.40354	205	303	508
10	"10-out7706"	.77419	120	35	155
10	"10-out7707"	.89915	107	12	119
10	"10-out7708"	.95774	204	9	213
10	"10-out7709"	.54827	159	131	290
10	"10-out7710"	.49291	174	179	353
10	"10-out7711"	.99009	100	1	101
10	"10-out7712"	.37692	196	324	520
10	"10-out7713"	.64220	210	117	327
10	"10-out7714"	.39298	112	173	285
10	"10-out7715"	1.00000	156	0	156
10	"10-out7716"	1.00000	156	0	156
10	"10-out7717"	.56842	162	123	285
10	"10-out7718"	.29574	160	381	541
10	"10-out7719"	.55793	260	206	466
10	"10-out7720"	.40882	213	308	521
10	"10-out7721"	.89371	185	22	207
10	"10-out7722"	.44343	98	123	221
10	"10-out7723"	.36842	168	288	456
10	"10-out7724"	.25248	305	903	1208
10	"10-out7725"	.28275	287	728	1015
10	"10-out7726"	.39300	292	451	743
10	"10-out7727"	.25388	196	576	772
10	"10-out7728"	.80548	617	149	766
10	"10-out7729"	.37081	155	263	418
10	"10-out7730"	.25000	226	678	904
10	"10-out7731"	.27441	59	156	215
10	"10-out7732"	.99122	113	1	114
10	"10-out7733"	.27200	34	91	125
10	"10-out7734"	.24742	48	146	194
10	"10-out7735"	.93333	98	7	105
10	"10-out7736"	.42368	161	219	380
10	"10-out7737"	.51245	144	137	281
10	"10-out7738"	.35877	94	168	262
10	"10-out7739"	.37593	100	166	266
10	"10-out7740"	.81278	178	41	219
10	"10-out7741"	.38505	134	214	348
10	"10-out7742"	.34387	87	166	253
10	"10-out7743"	.48297	156	167	323
10	"10-out7744"	.98984	585	6	591
10	"10-out7745"	.99844	641	1	642
10	"10-out7746"	.30752	139	313	452
10	"10-out7747"	.40546	178	261	439
10	"10-out7748"	.43141	824	1086	1910
10	"10-out7749"	.29457	38	91	129
10	"10-out7750"	.26066	55	156	211
10	"10-out7751"	.22319	254	884	1138
10	"10-out7752"	.41993	257	355	612
10	"10-out7753"	.44000	462	588	1050
10	"10-out7754"	.26398	151	421	572
10	"10-out7755"	.99773	440	1	441
10	"10-out7756"	.33727	114	224	338
10	"10-out7757"	.57894	286	208	494
10	"10-out7758"	.48951	397	414	811
10	"10-out7759"	.55089	433	353	786
10	"10-out7760"	.48852	383	401	784
10	"10-out7761"	.21370	106	390	496
10	"10-out7762"	.39534	51	78	129
10	"10-out7763"	.91962	389	34	423
10	"10-out7764"	.43378	190	248	438
10	"10-out7765"	.52500	84	76	160
10	"10-out7766"	.34863	243	454	697
10	"10-out7767"	.25428	89	261	350
10	"10-out7768"	.18181	18	81	99
10	"10-out7769"	.51685	92	86	178
10	"10-out7770"	.43670	138	178	316
10	"10-out7771"	.24855	43	130	173
10	"10-out7772"	.22816	128	433	561
10	"10-out7773"	.42541	154	208	362
10	"10-out7774"	.99574	234	1	235
10	"10-out7775"	.41891	124	172	296
10	"10-out7776"	.73333	220	80	300
10	"10-out7777"	.99740	384	1	385
10	"10-out7778"	.22360	36	125	161
10	"10-out7779"	.24836	152	460	612
10	"10-out7780"	.32850	68	139	207
10	"10-out7781"	.30036	82	191	273
10	"10-out7782"	.35840	81	145	226
10	"10-out7783"	.27102	29	78	107
10	"10-out7784"	.29868	227	533	760
10	"10-out7785"	.33454	92	183	275
10	"10-out7786"	.33090	364	736	1100
10	"10-out7787"	.30467	202	461	663
10	"10-out7788"	.49624	66	67	133
10	"10-out7789"	.40590	261	382	643
10	"10-out7790"	.32723	161	331	492
10	"10-out7791"	.20779	48	183	231
10	"10-out7792"	.35398	80	146	226
10	"10-out7793"	.46351	108	125	233
10	"10-out7794"	.41463	102	144	246
10	"10-out7795"	.52830	84	75	159
10	"10-out7796"	.27540	84	221	305
10	"10-out7797"	.45000	63	77	140
10	"10-out7798"	.39779	253	383	636
10	"10-out7799"	.35820	120	215	335
10	"10-out7800"	.94482	137	8	145
10	"10-out7801"	.37949	581	950	1531
10	"10-out7802"	.34426	168	320	488
10	"10-out7803"	.28514	359	900	1259
10	"10-out7804"	.94693	232	13	245
10	"10-out7805"	.22352	38	132	170
10	"10-out7806"	.50704	144	140	284
10	"10-out7807"	.26730	139	381	520
10	"10-out7808"	.35520	157	285	442
10	"10-out7809"	.99122	113	1	114
10	"10-out7810"	.99122	113	1	114
10	"10-out7811"	.99122	113	1	114
10	"10-out7812"	.99899	992	1	993
10	"10-out7813"	.30645	38	86	124
10	"10-out7814"	.26020	51	145	196
10	"10-out7815"	.46006	144	169	313
10	"10-out7816"	.99295	141	1	142
10	"10-out7817"	.49575	409	416	825
10	"10-out7818"	.25203	62	184	246
10	"10-out7819"	.72916	175	65	240
10	"10-out7820"	.40039	205	307	512
10	"10-out7821"	.78313	65	18	83
10	"10-out7822"	.34633	151	285	436
10	"10-out7823"	.99000	99	1	100
10	"10-out7824"	.34782	40	75	115
10	"10-out7825"	.24413	52	161	213
10	"10-out7826"	.14814	28	161	189
10	"10-out7827"	.27983	68	175	243
10	"10-out7828"	.24752	175	532	707
10	"10-out7829"	.98319	117	2	119
10	"10-out7830"	.57627	68	50	118
10	"10-out7831"	.42968	55	73	128
10	"10-out7832"	.25833	93	267	360
10	"10-out7833"	.90797	148	15	163
10	"10-out7834"	.43529	74	96	170
10	"10-out7835"	.51829	85	79	164
10	"10-out7836"	.30131	138	320	458
10	"10-out7837"	.18506	57	251	308
10	"10-out7838"	.98437	63	1	64
10	"10-out7839"	.39569	349	533	882
10	"10-out7840"	.27272	228	608	836
10	"10-out7841"	.35321	77	141	218
10	"10-out7842"	.49532	159	162	321
10	"10-out7843"	.98513	265	4	269
10	"10-out7844"	.34736	165	310	475
10	"10-out7845"	.35231	99	182	281
10	"10-out7846"	.31658	63	136	199
10	"10-out7847"	.18229	35	157	192
10	"10-out7848"	.37666	113	187	300
10	"10-out7849"	.45098	92	112	204
10	"10-out7850"	.31190	131	289	420
10	"10-out7851"	.21004	46	173	219
10	"10-out7852"	.26162	45	127	172
10	"10-out7853"	.18120	27	122	149
10	"10-out7854"	.18371	97	431	528
10	"10-out7855"	.35361	215	393	608
10	"10-out7856"	.60227	318	210	528
10	"10-out7857"	.87168	197	29	226
10	"10-out7858"	.65853	81	42	123
10	"10-out7859"	.34682	180	339	519
10	"10-out7860"	.98666	74	1	75
10	"10-out7861"	.99350	153	1	154
10	"10-out7862"	.82068	119	26	145
10	"10-out7863"	.23689	253	815	1068
10	"10-out7864"	.33467	83	165	248
10	"10-out7865"	.91694	276	25	301
10	"10-out7866"	.98275	114	2	116
10	"10-out7867"	.29381	57	137	194
10	"10-out7868"	.92098	711	61	772
10	"10-out7869"	.34418	74	141	215
10	"10-out7870"	.40779	314	456	770
10	"10-out7871"	.34090	90	174	264
10	"10-out7872"	.41232	87	124	211
10	"10-out7873"	.29629	64	152	216
10	"10-out7874"	.45945	85	100	185
10	"10-out7875"	.53097	60	53	113
10	"10-out7876"	.67353	196	95	291
10	"10-out7877"	.27227	55	147	202
10	"10-out7878"	.45506	400	479	879
10	"10-out7879"	.28039	113	290	403
10	"10-out7880"	.99543	218	1	219
10	"10-out7881"	.68037	215	101	316
10	"10-out7882"	.99280	138	1	139
10	"10-out7883"	.64125	143	80	223
10	"10-out7884"	.34562	75	142	217
10	"10-out7885"	.37614	41	68	109
10	"10-out7886"	.34234	190	365	555
10	"10-out7887"	.16170	38	197	235
10	"10-out7888"	.57324	90	67	157
10	"10-out7889"	.59762	352	237	589
10	"10-out7890"	.24050	190	600	790
10	"10-out7891"	.59405	120	82	202
10	"10-out7892"	.96666	203	7	210
10	"10-out7893"	.40919	187	270	457
10	"10-out7894"	.32377	79	165	244
10	"10-out7895"	.45425	144	173	317
10	"10-out7896"	.99645	281	1	282
10	"10-out7897"	.20765	38	145	183
10	"10-out7898"	.75000	210	70	280
10	"10-out7899"	.65558	276	145	421
10	"10-out7900"	.24431	43	133	176
10	"10-out7901"	.43321	120	157	277
10	"10-out7902"	.42248	109	149	258
10	"10-out7903"	.99638	276	1	277
10	"10-out7904"	.31196	73	161	234
10	"10-out7905"	.30332	556	1277	1833
10	"10-out7906"	.65145	157	84	241
10	"10-out7907"	.29565	102	243	345
10	"10-out7908"	.32967	150	305	455
10	"10-out7909"	.31019	143	318	461
10	"10-out7910"	.28627	73	182	255
10	"10-out7911"	.42446	177	240	417
10	"10-out7912"	.82432	61	13	74
10	"10-out7913"	.36569	113	196	309
10	"10-out7914"	.97506	352	9	361
10	"10-out7915"	.52450	428	388	816
10	"10-out7916"	.24553	55	169	224
10	"10-out7917"	.77844	130	37	167
10	"10-out7918"	.72068	209	81	290
10	"10-out7919"	.37241	54	91	145
10	"10-out7920"	.37240	880	1483	2363
10	"10-out7921"	.82661	205	43	248
10	"10-out7922"	.56399	401	310	711
10	"10-out7923"	.35341	264	483	747
10	"10-out7924"	.67181	174	85	259
10	"10-out7925"	1.00000	153	0	153
10	"10-out7926"	.38657	167	265	432
10	"10-out7927"	.25151	83	247	330
10	"10-out7928"	.61417	78	49	127
10	"10-out7929"	.97727	43	1	44
10	"10-out7930"	.93893	123	8	131
10	"10-out7931"	.33628	38	75	113
10	"10-out7932"	.46526	221	254	475
10	"10-out7933"	.72916	175	65	240
10	"10-out7934"	.38320	146	235	381
10	"10-out7935"	.54057	413	351	764
10	"10-out7936"	.40172	186	277	463
10	"10-out7937"	.29629	120	285	405
10	"10-out7938"	.61993	199	122	321
10	"10-out7939"	.33500	67	133	200
10	"10-out7940"	.99019	101	1	102
10	"10-out7941"	.27037	146	394	540
10	"10-out7942"	.52136	61	56	117
10	"10-out7943"	.99363	156	1	157
10	"10-out7944"	.59770	104	70	174
10	"10-out7945"	.75342	55	18	73
10	"10-out7946"	.29969	395	923	1318
10	"10-out7947"	.35802	406	728	1134
10	"10-out7948"	.23174	200	663	863
10	"10-out7949"	.34892	470	877	1347
10	"10-out7950"	.50828	399	386	785
10	"10-out7951"	.86340	689	109	798
10	"10-out7952"	.38022	373	608	981
10	"10-out7953"	.35071	370	685	1055
10	"10-out7954"	.91129	339	33	372
10	"10-out7955"	.36773	1304	2242	3546
10	"10-out7956"	.29984	397	927	1324
10	"10-out7957"	.45770	422	500	922
10	"10-out7958"	.99738	381	1	382
10	"10-out7959"	.37857	53	87	140
10	"10-out7960"	.10000	18	162	180
10	"10-out7961"	.99275	137	1	138
10	"10-out7962"	.72427	528	201	729
10	"10-out7963"	.44890	738	906	1644
10	"10-out7964"	.34944	412	767	1179
10	"10-out7965"	.99512	204	1	205
10	"10-out7966"	.99122	113	1	114
10	"10-out7967"	.99074	107	1	108
10	"10-out7968"	.99056	105	1	106
10	"10-out7969"	.99107	111	1	112
10	"10-out7970"	.99107	111	1	112
10	"10-out7971"	.99137	115	1	116
10	"10-out7972"	.99107	111	1	112
10	"10-out7973"	.99090	109	1	110
10	"10-out7974"	.99082	108	1	109
10	"10-out7975"	.99242	131	1	132
10	"10-out7976"	.99115	112	1	113
10	"10-out7977"	.99115	112	1	113
10	"10-out7978"	.99130	114	1	115
10	"10-out7979"	.99107	111	1	112
10	"10-out7980"	.99107	111	1	112
10	"10-out7981"	.99130	114	1	115
10	"10-out7982"	.99107	111	1	112
10	"10-out7983"	.99115	112	1	113
10	"10-out7984"	.99082	108	1	109
10	"10-out7985"	.99130	114	1	115
10	"10-out7986"	.99130	114	1	115
10	"10-out7987"	.99130	114	1	115
10	"10-out7988"	.99130	114	1	115
10	"10-out7989"	.99130	114	1	115
10	"10-out7990"	.99122	113	1	114
10	"10-out7991"	.99099	110	1	111
10	"10-out7992"	.99122	113	1	114
10	"10-out7993"	.99122	113	1	114
10	"10-out7994"	.99122	113	1	114
10	"10-out7995"	.99122	113	1	114
10	"10-out7996"	.99859	713	1	714
10	"10-out7997"	.29787	196	462	658
10	"10-out7998"	.97727	43	1	44
10	"10-out7999"	.49723	180	182	362
10	"10-out8000"	.53180	301	265	566
10	"10-out16001"	.36127	125	221	346
10	"10-out16002"	.44921	115	141	256
10	"10-out16003"	.59200	370	255	625
10	"10-out16004"	.22033	78	276	354
10	"10-out16005"	.24918	152	458	610
10	"10-out16006"	.32545	124	257	381
10	"10-out16007"	.30790	109	245	354
10	"10-out16008"	.98795	82	1	83
10	"10-out16009"	.26478	94	261	355
10	"10-out16010"	.17737	58	269	327
10	"10-out16011"	.81164	237	55	292
10	"10-out16012"	.28623	158	394	552
10	"10-out16013"	.41945	388	537	925
10	"10-out16014"	.99841	631	1	632
10	"10-out16015"	.99841	631	1	632
10	"10-out16016"	.73722	101	36	137
10	"10-out16017"	.78602	360	98	458
10	"10-out16018"	.42289	181	247	428
10	"10-out16019"	.24337	147	457	604
10	"10-out16020"	.88275	384	51	435
10	"10-out16021"	.31590	139	301	440
10	"10-out16022"	.31045	303	673	976
10	"10-out16023"	.90160	394	43	437
10	"10-out16024"	.37456	215	359	574
10	"10-out16025"	.22248	93	325	418
10	"10-out16026"	.50143	175	174	349
10	"10-out16027"	.27419	119	315	434
10	"10-out16028"	.41711	156	218	374
10	"10-out16029"	.50657	231	225	456
10	"10-out16030"	.53488	253	220	473
10	"10-out16031"	.50000	142	142	284
10	"10-out16032"	.38965	226	354	580
10	"10-out16033"	.30530	276	628	904
10	"10-out16034"	.37362	102	171	273
10	"10-out16035"	.83908	219	42	261
10	"10-out16036"	.18738	104	451	555
10	"10-out16037"	.33369	309	617	926
10	"10-out16038"	.44196	99	125	224
10	"10-out16039"	.23818	247	790	1037
10	"10-out16040"	.24227	251	785	1036
10	"10-out16041"	.15566	33	179	212
10	"10-out16042"	.37677	532	880	1412
10	"10-out16043"	.60544	89	58	147
10	"10-out16044"	.31460	112	244	356
10	"10-out16045"	.28260	234	594	828
10	"10-out16046"	.20689	60	230	290
10	"10-out16047"	.99874	794	1	795
10	"10-out16048"	.52586	366	330	696
10	"10-out16049"	.58394	320	228	548
10	"10-out16050"	.99047	104	1	105
10	"10-out16051"	.30346	105	241	346
10	"10-out16052"	.46376	224	259	483
10	"10-out16053"	.22573	107	367	474
10	"10-out16054"	.32631	155	320	475
10	"10-out16055"	.52350	245	223	468
10	"10-out16056"	.67875	393	186	579
10	"10-out16057"	.38758	181	286	467
10	"10-out16058"	.27047	109	294	403
10	"10-out16059"	.26757	118	323	441
10	"10-out16060"	.39740	368	558	926
10	"10-out16061"	.37684	153	253	406
10	"10-out16062"	.70876	752	309	1061
10	"10-out16063"	.78723	333	90	423
10	"10-out16064"	.17782	77	356	433
10	"10-out16065"	.99790	476	1	477
10	"10-out16066"	.46473	336	387	723
10	"10-out16067"	.54716	174	144	318
10	"10-out16068"	.38116	85	138	223
10	"10-out16069"	.30434	56	128	184
10	"10-out16070"	.95433	815	39	854
10	"10-out16071"	.99549	221	1	222
10	"10-out16072"	.30588	182	413	595
10	"10-out16073"	.22063	77	272	349
10	"10-out16074"	.32399	185	386	571
10	"10-out16075"	.67652	389	186	575
10	"10-out16076"	.26241	74	208	282
10	"10-out16077"	.15489	171	933	1104
10	"10-out16078"	.48317	445	476	921
10	"10-out16079"	.20880	185	701	886
10	"10-out16080"	.65766	609	317	926
10	"10-out16081"	.98305	58	1	59
10	"10-out16082"	.98305	58	1	59
10	"10-out16083"	.98305	58	1	59
10	"10-out16084"	.49549	165	168	333
10	"10-out16085"	.25283	156	461	617
10	"10-out16086"	.71111	64	26	90
10	"10-out16087"	.44094	112	142	254
10	"10-out16088"	.19274	85	356	441
10	"10-out16089"	.52834	233	208	441
10	"10-out16090"	.24884	54	163	217
10	"10-out16091"	.55151	91	74	165
10	"10-out16092"	.45535	204	244	448
10	"10-out16093"	.26682	111	305	416
10	"10-out16094"	.53071	216	191	407
10	"10-out16095"	.26559	132	365	497
10	"10-out16096"	.41189	187	267	454
10	"10-out16097"	.27340	330	877	1207
10	"10-out16098"	.31622	228	493	721
10	"10-out16099"	.24031	93	294	387
10	"10-out16100"	.47350	277	308	585
10	"10-out16101"	.32310	200	419	619
10	"10-out16102"	.19676	73	298	371
10	"10-out16103"	.56115	156	122	278
10	"10-out16104"	.55936	212	167	379
10	"10-out16105"	.22734	138	469	607
10	"10-out16106"	.30740	162	365	527
10	"10-out16107"	.34049	222	430	652
10	"10-out16108"	.38509	124	198	322
10	"10-out16109"	.48299	142	152	294
10	"10-out16110"	.37039	553	940	1493
10	"10-out16111"	.35858	142	254	396
10	"10-out16112"	.24464	320	988	1308
10	"10-out16113"	.29906	64	150	214
10	"10-out16114"	.25699	147	425	572
10	"10-out16115"	.99118	225	2	227
10	"10-out16116"	.69185	586	261	847
10	"10-out16117"	.38028	270	440	710
10	"10-out16118"	.29866	112	263	375
10	"10-out16119"	.45634	392	467	859
10	"10-out16120"	.30107	168	390	558
10	"10-out16121"	.38058	349	568	917
10	"10-out16122"	.24186	52	163	215
10	"10-out16123"	.22679	237	808	1045
10	"10-out16124"	.26002	1193	3395	4588
10	"10-out16125"	.23971	1194	3787	4981
10	"10-out16126"	.40563	144	211	355
10	"10-out16127"	.27094	97	261	358
10	"10-out16128"	.32091	112	237	349
10	"10-out16129"	.35796	155	278	433
10	"10-out16130"	.38834	440	693	1133
10	"10-out16131"	.40398	284	419	703
10	"10-out16132"	.30827	365	819	1184
10	"10-out16133"	.20993	93	350	443
10	"10-out16134"	.42679	137	184	321
10	"10-out16135"	.42567	126	170	296
10	"10-out16136"	.43785	310	398	708
10	"10-out16137"	.99642	279	1	280
10	"10-out16138"	.19424	81	336	417
10	"10-out16139"	.32558	28	58	86
10	"10-out16140"	.84708	349	63	412
10	"10-out16141"	.30565	173	393	566
10	"10-out16142"	.31149	875	1934	2809
10	"10-out16143"	.29285	41	99	140
10	"10-out16144"	.33719	204	401	605
10	"10-out16145"	.29346	184	443	627
10	"10-out16146"	.43529	37	48	85
10	"10-out16147"	.73632	754	270	1024
10	"10-out16148"	.28125	36	92	128
10	"10-out16149"	.75000	99	33	132
10	"10-out16150"	.35606	47	85	132
10	"10-out16151"	.22598	40	137	177
10	"10-out16152"	.55000	99	81	180
10	"10-out16153"	.26650	109	300	409
10	"10-out16154"	.25391	81	238	319
10	"10-out16155"	.78932	281	75	356
10	"10-out16156"	.99699	332	1	333
10	"10-out16157"	.28473	125	314	439
10	"10-out16158"	.32252	179	376	555
10	"10-out16159"	.44686	164	203	367
10	"10-out16160"	.88958	282	35	317
10	"10-out16161"	.25791	114	328	442
10	"10-out16162"	.21739	65	234	299
10	"10-out16163"	.45371	397	478	875
10	"10-out16164"	.51636	142	133	275
10	"10-out16165"	.29497	182	435	617
10	"10-out16166"	.28610	105	262	367
10	"10-out16167"	.36649	140	242	382
10	"10-out16168"	.68067	162	76	238
10	"10-out16169"	.27806	109	283	392
10	"10-out16170"	.29552	284	677	961
10	"10-out16171"	.29923	196	459	655
10	"10-out16172"	.43181	38	50	88
10	"10-out16173"	.31838	71	152	223
10	"10-out16174"	.99305	286	2	288
10	"10-out16175"	.34782	184	345	529
10	"10-out16176"	.30476	320	730	1050
10	"10-out16177"	.79158	809	213	1022
10	"10-out16178"	.29945	109	255	364
10	"10-out16179"	.38492	189	302	491
10	"10-out16180"	.41785	117	163	280
10	"10-out16181"	.13461	28	180	208
10	"10-out16182"	.33915	272	530	802
10	"10-out16183"	.46575	102	117	219
10	"10-out16184"	.23923	50	159	209
10	"10-out16185"	.90864	3690	371	4061
10	"10-out16186"	.36902	162	277	439
10	"10-out16187"	.99295	141	1	142
10	"10-out16188"	.21323	58	214	272
10	"10-out16189"	.31025	121	269	390
10	"10-out16190"	.51428	90	85	175
10	"10-out16191"	.97468	77	2	79
10	"10-out16192"	.46711	348	397	745
10	"10-out16193"	.99450	181	1	182
10	"10-out16194"	.99275	137	1	138
10	"10-out16195"	.99242	131	1	132
10	"10-out16196"	.44864	83	102	185
10	"10-out16197"	.73170	150	55	205
10	"10-out16198"	.38522	193	308	501
10	"10-out16199"	.70886	56	23	79
10	"10-out16200"	.35918	88	157	245
10	"10-out16201"	.29646	201	477	678
10	"10-out16202"	.29037	196	479	675
10	"10-out16203"	.57352	39	29	68
10	"10-out16204"	.27157	129	346	475
10	"10-out16205"	.45535	51	61	112
10	"10-out16206"	.37826	261	429	690
10	"10-out16207"	.21385	142	522	664
10	"10-out16208"	.37451	970	1620	2590
10	"10-out16209"	.37814	301	495	796
10	"10-out16210"	.29878	147	345	492
10	"10-out16211"	.60651	447	290	737
10	"10-out16212"	.35117	269	497	766
10	"10-out16213"	.35838	310	555	865
10	"10-out16214"	.21380	192	706	898
10	"10-out16215"	.20509	177	686	863
10	"10-out16216"	.98993	295	3	298
10	"10-out16217"	.99371	158	1	159
10	"10-out16218"	.72697	221	83	304
10	"10-out16219"	.76724	89	27	116
10	"10-out16220"	.77486	148	43	191
10	"10-out16221"	.75903	315	100	415
10	"10-out16222"	.36185	148	261	409
10	"10-out16223"	.98989	98	1	99
10	"10-out16224"	.31902	327	698	1025
10	"10-out16225"	.22027	126	446	572
10	"10-out16226"	.24825	142	430	572
10	"10-out16227"	.18771	107	463	570
10	"10-out16228"	.70279	402	170	572
10	"10-out16229"	.27836	157	407	564
10	"10-out16230"	.96992	258	8	266
10	"10-out16231"	.98496	262	4	266
10	"10-out16232"	.98120	261	5	266
10	"10-out16233"	.51224	230	219	449
10	"10-out16234"	.34063	280	542	822
10	"10-out16235"	.37702	279	461	740
10	"10-out16236"	.41942	203	281	484
10	"10-out16237"	.16443	86	437	523
10	"10-out16238"	.35983	172	306	478
10	"10-out16239"	.34930	175	326	501
10	"10-out16240"	.35510	261	474	735
10	"10-out16241"	.32837	287	587	874
10	"10-out16242"	.52044	140	129	269
10	"10-out16243"	.35891	159	284	443
10	"10-out16244"	.24215	108	338	446
10	"10-out16245"	.18961	84	359	443
10	"10-out16246"	.25000	100	300	400
10	"10-out16247"	.69379	324	143	467
10	"10-out16248"	.83438	398	79	477
10	"10-out16249"	.42372	275	374	649
10	"10-out16250"	.90190	331	36	367
10	"10-out16251"	.15659	57	307	364
10	"10-out16252"	.46768	123	140	263
10	"10-out16253"	.77292	177	52	229
10	"10-out16254"	.11384	37	288	325
10	"10-out16255"	.46474	145	167	312
10	"10-out16256"	.95212	179	9	188
10	"10-out16257"	.04040	8	190	198
10	"10-out16258"	.99248	132	1	133
10	"10-out16259"	.97058	33	1	34
10	"10-out16260"	.40455	142	209	351
10	"10-out16261"	.59782	110	74	184
10	"10-out16262"	.60666	91	59	150
10	"10-out16263"	.05687	12	199	211
10	"10-out16264"	.38169	442	716	1158
10	"10-out16265"	.74431	131	45	176
10	"10-out16266"	.93650	59	4	63
10	"10-out16267"	.23732	117	376	493
10	"10-out16268"	.89855	248	28	276
10	"10-out16269"	.38780	159	251	410
10	"10-out16270"	.36784	1176	2021	3197
10	"10-out16271"	.76865	103	31	134
10	"10-out16272"	.29964	169	395	564
10	"10-out16273"	.18758	145	628	773
10	"10-out16274"	.28744	71	176	247
10	"10-out16275"	.87077	438	65	503
10	"10-out16276"	.97368	74	2	76
10	"10-out16277"	.99532	213	1	214
10	"10-out16278"	.73658	151	54	205
10	"10-out16279"	.45190	249	302	551
10	"10-out16280"	.99879	1653	2	1655
10	"10-out16281"	.30997	115	256	371
10	"10-out16282"	.46179	139	162	301
10	"10-out16283"	.16171	49	254	303
10	"10-out16284"	.24563	267	820	1087
10	"10-out16285"	.46794	73	83	156
10	"10-out16286"	.99099	110	1	111
10	"10-out16287"	.32908	258	526	784
10	"10-out16288"	.36805	53	91	144
10	"10-out16289"	.27809	391	1015	1406
10	"10-out16290"	.16571	29	146	175
10	"10-out16291"	.35494	208	378	586
10	"10-out16292"	.99720	357	1	358
10	"10-out16293"	.99082	108	1	109
10	"10-out16294"	.35007	230	427	657
10	"10-out16295"	.29972	110	257	367
10	"10-out16296"	.52649	477	429	906
10	"10-out16297"	.30422	216	494	710
10	"10-out16298"	.46042	413	484	897
10	"10-out16299"	.37234	245	413	658
10	"10-out16300"	.32914	131	267	398
10	"10-out16301"	.32954	87	177	264
10	"10-out16302"	.29008	588	1439	2027
10	"10-out16303"	.99324	147	1	148
10	"10-out16304"	.26232	250	703	953
10	"10-out16305"	.27692	216	564	780
10	"10-out16306"	.38202	68	110	178
10	"10-out16307"	.28163	345	880	1225
10	"10-out16308"	.34511	586	1112	1698
10	"10-out16309"	.99563	228	1	229
10	"10-out16310"	.41176	175	250	425
10	"10-out16311"	.99771	436	1	437
10	"10-out16312"	.32634	280	578	858
10	"10-out16313"	.37007	47	80	127
10	"10-out16314"	.32515	53	110	163
10	"10-out16315"	.38461	220	352	572
10	"10-out16316"	.75642	736	237	973
10	"10-out16317"	.45656	226	269	495
10	"10-out16318"	.99828	583	1	584
10	"10-out16319"	.99810	526	1	527
10	"10-out16320"	.71428	285	114	399
10	"10-out16321"	.38987	154	241	395
10	"10-out16322"	.52606	111	100	211
10	"10-out16323"	.40425	38	56	94
10	"10-out16324"	.46081	147	172	319
10	"10-out16325"	.51987	327	302	629
10	"10-out16326"	.30379	24	55	79
10	"10-out16327"	.98356	359	6	365
10	"10-out16328"	.97120	371	11	382
10	"10-out16329"	.95759	271	12	283
10	"10-out16330"	.44736	51	63	114
10	"10-out16331"	.43750	56	72	128
10	"10-out16332"	.24610	79	242	321
10	"10-out16333"	.58850	256	179	435
10	"10-out16334"	.37475	193	322	515
10	"10-out16335"	.19602	69	283	352
10	"10-out16336"	.26262	52	146	198
10	"10-out16337"	.81343	109	25	134
10	"10-out16338"	.99122	226	2	228
10	"10-out16339"	.94038	489	31	520
10	"10-out16340"	.42807	488	652	1140
10	"10-out16341"	.51497	258	243	501
10	"10-out16342"	.45284	3428	4142	7570
10	"10-out16343"	.99801	504	1	505
10	"10-out16344"	.42242	324	443	767
10	"10-out16345"	.29155	214	520	734
10	"10-out16346"	.92101	583	50	633
10	"10-out16347"	.79282	398	104	502
10	"10-out16348"	.98245	56	1	57
10	"10-out16349"	.56657	1068	817	1885
10	"10-out16350"	.24954	136	409	545
10	"10-out16351"	.27709	202	527	729
10	"10-out16352"	.11507	29	223	252
10	"10-out16353"	.29807	155	365	520
10	"10-out16354"	.59219	273	188	461
10	"10-out16355"	.37084	145	246	391
10	"10-out16356"	.33119	464	937	1401
10	"10-out16357"	.26614	169	466	635
10	"10-out16358"	.40639	267	390	657
10	"10-out16359"	.43052	505	668	1173
10	"10-out16360"	.29238	169	409	578
10	"10-out16361"	.30901	288	644	932
10	"10-out16362"	.37992	424	692	1116
10	"10-out16363"	.42797	407	544	951
10	"10-out16364"	.28731	333	826	1159
10	"10-out16365"	.27000	54	146	200
10	"10-out16366"	.38541	185	295	480
10	"10-out16367"	.75751	353	113	466
10	"10-out16368"	.29945	498	1165	1663
10	"10-out16369"	.39150	83	129	212
10	"10-out16370"	.38964	286	448	734
10	"10-out16371"	.99280	138	1	139
10	"10-out16372"	.99346	152	1	153
10	"10-out16373"	.99295	141	1	142
10	"10-out16374"	.65853	54	28	82
10	"10-out16375"	.51948	733	678	1411
10	"10-out16376"	.58276	257	184	441
10	"10-out16377"	.23725	135	434	569
10	"10-out16378"	.39119	151	235	386
10	"10-out16379"	.99783	461	1	462
10	"10-out16380"	.55025	427	349	776
10	"10-out16381"	.33253	837	1680	2517
10	"10-out16382"	.37677	344	569	913
10	"10-out16383"	.34065	93	180	273
10	"10-out16384"	.28378	42	106	148
10	"10-out16385"	.62913	95	56	151
10	"10-out16386"	.99411	169	1	170
10	"10-out16387"	.50000	71	71	142
10	"10-out16388"	.92031	231	20	251
10	"10-out16389"	.99644	280	1	281
10	"10-out16390"	.52533	477	431	908
10	"10-out16391"	.99696	329	1	330
10	"10-out16392"	.20275	147	578	725
10	"10-out16393"	.42796	202	270	472
10	"10-out16394"	.98734	78	1	79
10	"10-out16395"	.99367	157	1	158
10	"10-out16396"	.99367	157	1	158
10	"10-out16397"	.99305	143	1	144
10	"10-out16398"	.37055	73	124	197
10	"10-out16399"	.59531	356	242	598
10	"10-out16400"	.99453	182	1	183
10	"10-out16401"	.68604	59	27	86
10	"10-out16402"	.99801	502	1	503
10	"10-out16403"	.98863	87	1	88
10	"10-out16404"	.40147	218	325	543
10	"10-out16405"	.30973	70	156	226
10	"10-out16406"	.29729	99	234	333
10	"10-out16407"	.31203	83	183	266
10	"10-out16408"	.33333	91	182	273
10	"10-out16409"	.34078	122	236	358
10	"10-out16410"	.34099	89	172	261
10	"10-out16411"	.75985	212	67	279
10	"10-out16412"	.23228	59	195	254
10	"10-out16413"	.32795	122	250	372
10	"10-out16414"	.31474	79	172	251
10	"10-out16415"	.35664	102	184	286
10	"10-out16416"	.20855	39	148	187
10	"10-out16417"	.36134	301	532	833
10	"10-out16418"	.27187	174	466	640
10	"10-out16419"	.63839	715	405	1120
10	"10-out16420"	.61168	178	113	291
10	"10-out16421"	.41293	83	118	201
10	"10-out16422"	.91040	315	31	346
10	"10-out16423"	.20420	68	265	333
10	"10-out16424"	.50882	173	167	340
10	"10-out16425"	.25453	309	905	1214
10	"10-out16426"	.98347	1250	21	1271
10	"10-out16427"	.41587	131	184	315
10	"10-out16428"	.27054	79	213	292
10	"10-out16429"	.28076	73	187	260
10	"10-out16430"	.41803	102	142	244
10	"10-out16431"	.36723	325	560	885
10	"10-out16432"	.62673	858	511	1369
10	"10-out16433"	.77852	116	33	149
10	"10-out16434"	.59466	223	152	375
10	"10-out16435"	.22932	61	205	266
10	"10-out16436"	.27153	186	499	685
10	"10-out16437"	.31010	89	198	287
10	"10-out16438"	.16571	29	146	175
10	"10-out16439"	.44535	436	543	979
10	"10-out16440"	.65361	534	283	817
10	"10-out16441"	.44444	376	470	846
10	"10-out16442"	.30849	592	1327	1919
10	"10-out16443"	.54006	310	264	574
10	"10-out16444"	.19976	852	3413	4265
10	"10-out16445"	.46096	124	145	269
10	"10-out16446"	.22804	174	589	763
10	"10-out16447"	.35639	1535	2772	4307
10	"10-out16448"	.30757	1389	3127	4516
10	"10-out16449"	.97860	183	4	187
10	"10-out16450"	.45405	2026	2436	4462
10	"10-out16451"	.14455	85	503	588
10	"10-out16452"	.28586	265	662	927
10	"10-out16453"	.31343	147	322	469
10	"10-out16454"	.18529	63	277	340
10	"10-out16455"	.23678	206	664	870
10	"10-out16456"	.24117	82	258	340
10	"10-out16457"	.22094	192	677	869
10	"10-out16458"	.25185	136	404	540
10	"10-out16459"	.20480	128	497	625
10	"10-out16460"	.33944	148	288	436
10	"10-out16461"	.28063	142	364	506
10	"10-out16462"	.21340	570	2101	2671
10	"10-out16463"	.51401	220	208	428
10	"10-out16464"	.31506	138	300	438
10	"10-out16465"	.36423	165	288	453
10	"10-out16466"	.56046	241	189	430
10	"10-out16467"	.99728	367	1	368
10	"10-out16468"	.28824	260	642	902
10	"10-out16469"	.38368	348	559	907
10	"10-out16470"	.27886	186	481	667
10	"10-out16471"	.42675	437	587	1024
10	"10-out16472"	.48484	256	272	528
10	"10-out16473"	.33424	608	1211	1819
10	"10-out16474"	.51480	400	377	777
10	"10-out16475"	.39325	70	108	178
10	"10-out16476"	.96764	987	33	1020
10	"10-out16477"	.43920	177	226	403
10	"10-out16478"	.32028	221	469	690
10	"10-out16479"	.40573	297	435	732
10	"10-out16480"	.26171	162	457	619
10	"10-out16481"	.58346	360	257	617
10	"10-out16482"	.99796	490	1	491
10	"10-out16483"	.30879	172	385	557
10	"10-out16484"	.45569	72	86	158
10	"10-out16485"	.56250	90	70	160
10	"10-out16486"	.57768	145	106	251
10	"10-out16487"	.44493	101	126	227
10	"10-out16488"	.31512	150	326	476
10	"10-out16489"	.99837	615	1	616
10	"10-out16490"	.13023	28	187	215
10	"10-out16491"	.54545	120	100	220
10	"10-out16492"	.30594	108	245	353
10	"10-out16493"	.42676	169	227	396
10	"10-out16494"	.39951	165	248	413
10	"10-out16495"	.19517	97	400	497
10	"10-out16496"	.70361	311	131	442
10	"10-out16497"	.60459	500	327	827
10	"10-out16498"	.98124	680	13	693
10	"10-out16499"	.37150	146	247	393
10	"10-out16500"	.52558	113	102	215
10	"10-out16501"	.38388	162	260	422
10	"10-out16502"	.21348	38	140	178
10	"10-out16503"	.99038	103	1	104
10	"10-out16504"	.99462	185	1	186
10	"10-out16505"	.99549	221	1	222
10	"10-out16506"	.98910	726	8	734
10	"10-out16507"	.34686	188	354	542
10	"10-out16508"	.30111	243	564	807
10	"10-out16509"	.31954	255	543	798
10	"10-out16510"	.28435	149	375	524
10	"10-out16511"	.36940	99	169	268
10	"10-out16512"	.99750	399	1	400
10	"10-out16513"	.35265	73	134	207
10	"10-out16514"	.34857	122	228	350
10	"10-out16515"	.31533	292	634	926
10	"10-out16516"	.19111	86	364	450
10	"10-out16517"	.57787	256	187	443
10	"10-out16518"	.98633	361	5	366
10	"10-out16519"	.31498	103	224	327
10	"10-out16520"	.26909	74	201	275
10	"10-out16521"	.29166	77	187	264
10	"10-out16522"	.97087	200	6	206
10	"10-out16523"	.31065	1055	2341	3396
10	"10-out16524"	.84974	164	29	193
10	"10-out16525"	.24226	47	147	194
10	"10-out16526"	.32305	199	417	616
10	"10-out16527"	.37414	55	92	147
10	"10-out16528"	.75471	120	39	159
10	"10-out16529"	.51633	79	74	153
10	"10-out16530"	.99484	193	1	194
10	"10-out16531"	.98941	187	2	189
10	"10-out16532"	.99470	188	1	189
10	"10-out16533"	.99470	188	1	189
10	"10-out16534"	.99470	188	1	189
10	"10-out16535"	.99470	188	1	189
10	"10-out16536"	.99470	188	1	189
10	"10-out16537"	.99470	188	1	189
10	"10-out16538"	.98750	158	2	160
10	"10-out16539"	.41137	376	538	914
10	"10-out16540"	.36651	243	420	663
10	"10-out16541"	.49381	359	368	727
10	"10-out16542"	.86292	384	61	445
10	"10-out16543"	.94899	707	38	745
10	"10-out16544"	.99367	157	1	158
10	"10-out16545"	.98841	768	9	777
10	"10-out16546"	.77611	156	45	201
10	"10-out16547"	.19196	86	362	448
10	"10-out16548"	.40888	267	386	653
10	"10-out16549"	.23688	149	480	629
10	"10-out16550"	.30856	191	428	619
10	"10-out16551"	.27238	73	195	268
10	"10-out16552"	.99788	471	1	472
10	"10-out16553"	.34461	275	523	798
10	"10-out16554"	.71551	249	99	348
10	"10-out16555"	.39805	205	310	515
10	"10-out16556"	.19214	186	782	968
10	"10-out16557"	.29039	124	303	427
10	"10-out16558"	.51851	42	39	81
10	"10-out16559"	.99285	139	1	140
10	"10-out16560"	.95945	71	3	74
10	"10-out16561"	.34389	152	290	442
10	"10-out16562"	.99393	164	1	165
10	"10-out16563"	.99668	301	1	302
10	"10-out16564"	.52525	1903	1720	3623
10	"10-out16565"	.99783	461	1	462
10	"10-out16566"	.36933	106	181	287
10	"10-out16567"	.99784	462	1	463
10	"10-out16568"	.36644	273	472	745
10	"10-out16569"	.36312	65	114	179
10	"10-out16570"	.32903	281	573	854
10	"10-out16571"	.50555	182	178	360
10	"10-out16572"	.48275	672	720	1392
10	"10-out16573"	.25764	59	170	229
10	"10-out16574"	.67333	101	49	150
10	"10-out16575"	.31954	278	592	870
10	"10-out16576"	.68750	66	30	96
10	"10-out16577"	.48148	247	266	513
10	"10-out16578"	.99545	219	1	220
10	"10-out16579"	.99479	191	1	192
10	"10-out16580"	.34473	262	498	760
10	"10-out16581"	.55177	357	290	647
10	"10-out16582"	.32581	130	269	399
10	"10-out16583"	.41578	79	111	190
10	"10-out16584"	.25714	27	78	105
10	"10-out16585"	.30416	146	334	480
10	"10-out16586"	.42569	169	228	397
10	"10-out16587"	.92352	314	26	340
10	"10-out16588"	.88275	128	17	145
10	"10-out16589"	.51132	158	151	309
10	"10-out16590"	.39484	199	305	504
10	"10-out16591"	.98161	267	5	272
10	"10-out16592"	.95275	242	12	254
10	"10-out16593"	.95294	243	12	255
10	"10-out16594"	.20502	147	570	717
10	"10-out16595"	.23404	99	324	423
10	"10-out16596"	.99748	397	1	398
10	"10-out16597"	.32018	138	293	431
10	"10-out16598"	.22268	53	185	238
10	"10-out16599"	.45945	102	120	222
10	"10-out16600"	.31889	81	173	254
10	"10-out16601"	.16182	39	202	241
10	"10-out16602"	.16487	92	466	558
10	"10-out16603"	.31412	109	238	347
10	"10-out16604"	.41114	155	222	377
10	"10-out16605"	.29797	59	139	198
10	"10-out16606"	.31428	209	456	665
10	"10-out16607"	.30517	112	255	367
10	"10-out16608"	.99197	371	3	374
10	"10-out16609"	.38407	164	263	427
10	"10-out16610"	.64800	81	44	125
10	"10-out16611"	.39053	264	412	676
10	"10-out16612"	.26348	1182	3304	4486
10	"10-out16613"	.44843	300	369	669
10	"10-out16614"	.42245	365	499	864
10	"10-out16615"	.42897	305	406	711
10	"10-out16616"	.23383	47	154	201
10	"10-out16617"	.36399	186	325	511
10	"10-out16618"	.10909	60	490	550
10	"10-out16619"	.99598	248	1	249
10	"10-out16620"	.35860	175	313	488
10	"10-out16621"	.22480	87	300	387
10	"10-out16622"	.22840	238	804	1042
10	"10-out16623"	.44949	178	218	396
10	"10-out16624"	.17344	64	305	369
10	"10-out16625"	.36604	138	239	377
10	"10-out16626"	.23003	72	241	313
10	"10-out16627"	.38244	122	197	319
10	"10-out16628"	.33967	232	451	683
10	"10-out16629"	.44690	101	125	226
10	"10-out16630"	.33886	245	478	723
10	"10-out16631"	.32364	568	1187	1755
10	"10-out16632"	.42931	164	218	382
10	"10-out16633"	.34819	367	687	1054
10	"10-out16634"	.29122	136	331	467
10	"10-out16635"	.35377	375	685	1060
10	"10-out16636"	.35552	251	455	706
10	"10-out16637"	.32869	260	531	791
10	"10-out16638"	.28840	276	681	957
10	"10-out16639"	.98713	614	8	622
10	"10-out16640"	.40135	297	443	740
10	"10-out16641"	.27140	168	451	619
10	"10-out16642"	.30000	66	154	220
10	"10-out16643"	.25103	121	361	482
10	"10-out16644"	.31176	106	234	340
10	"10-out16645"	.67457	199	96	295
10	"10-out16646"	.59907	130	87	217
10	"10-out16647"	.46028	197	231	428
10	"10-out16648"	.33333	132	264	396
10	"10-out16649"	.78921	161	43	204
10	"10-out16650"	.15916	46	243	289
10	"10-out16651"	.33687	95	187	282
10	"10-out16652"	.94444	306	18	324
10	"10-out16653"	.48071	162	175	337
10	"10-out16654"	.29885	104	244	348
10	"10-out16655"	.78220	255	71	326
10	"10-out16656"	.16379	38	194	232
10	"10-out16657"	.47085	105	118	223
10	"10-out16658"	.68760	427	194	621
10	"10-out16659"	.27385	132	350	482
10	"10-out16660"	.18382	75	333	408
10	"10-out16661"	.91940	308	27	335
10	"10-out16662"	.41811	217	302	519
10	"10-out16663"	.98850	258	3	261
10	"10-out16664"	.74253	199	69	268
10	"10-out16665"	.88967	250	31	281
10	"10-out16666"	.96956	223	7	230
10	"10-out16667"	.21405	67	246	313
10	"10-out16668"	.23456	114	372	486
10	"10-out16669"	.22556	60	206	266
10	"10-out16670"	.66762	233	116	349
10	"10-out16671"	.30985	110	245	355
10	"10-out16672"	.23410	81	265	346
10	"10-out16673"	.20728	74	283	357
10	"10-out16674"	.99805	514	1	515
10	"10-out16675"	.27797	77	200	277
10	"10-out16676"	.28476	86	216	302
10	"10-out16677"	.32466	624	1298	1922
10	"10-out16678"	.33923	230	448	678
10	"10-out16679"	.27721	331	863	1194
10	"10-out16680"	.30726	110	248	358
10	"10-out16681"	.28125	63	161	224
10	"10-out16682"	.13333	34	221	255
10	"10-out16683"	.50592	299	292	591
10	"10-out16684"	.86260	609	97	706
10	"10-out16685"	.36099	87	154	241
10	"10-out16686"	.26403	127	354	481
10	"10-out16687"	.76190	192	60	252
10	"10-out16688"	.98235	167	3	170
10	"10-out16689"	.99492	196	1	197
10	"10-out16690"	.30167	216	500	716
10	"10-out16691"	.90746	608	62	670
10	"10-out16692"	.97058	33	1	34
10	"10-out16693"	.99849	665	1	666
10	"10-out16694"	.52863	360	321	681
10	"10-out16695"	.40227	354	526	880
10	"10-out16696"	.42939	298	396	694
10	"10-out16697"	.30403	211	483	694
10	"10-out16698"	.98954	568	6	574
10	"10-out16699"	.20939	927	3500	4427
10	"10-out16700"	.30801	1383	3107	4490
10	"10-out16701"	.26966	24	65	89
10	"10-out16702"	.90265	102	11	113
10	"10-out16703"	.37880	311	510	821
10	"10-out16704"	.63917	62	35	97
10	"10-out16705"	.42438	275	373	648
10	"10-out16706"	.21779	93	334	427
10	"10-out16707"	.56101	354	277	631
10	"10-out16708"	.19178	56	236	292
10	"10-out16709"	.58133	218	157	375
10	"10-out16710"	.29397	844	2027	2871
10	"10-out16711"	.99545	219	1	220
10	"10-out16712"	.26042	206	585	791
10	"10-out16713"	.22666	68	232	300
10	"10-out16714"	.54444	147	123	270
10	"10-out16715"	.96043	267	11	278
10	"10-out16716"	.34271	475	911	1386
10	"10-out16717"	.23232	46	152	198
10	"10-out16718"	.22151	348	1223	1571
10	"10-out16719"	.27713	120	313	433
10	"10-out16720"	.28871	440	1084	1524
10	"10-out16721"	.30769	172	387	559
10	"10-out16722"	.37405	839	1404	2243
10	"10-out16723"	.26631	102	281	383
10	"10-out16724"	.11583	30	229	259
10	"10-out16725"	.42073	138	190	328
10	"10-out16726"	.36575	94	163	257
10	"10-out16727"	.32439	121	252	373
10	"10-out16728"	.94117	96	6	102
10	"10-out16729"	.29885	78	183	261
10	"10-out16730"	.38010	1154	1882	3036
10	"10-out16731"	.26733	401	1099	1500
10	"10-out16732"	.19960	100	401	501
10	"10-out16733"	.18683	193	840	1033
10	"10-out16734"	.32522	214	444	658
10	"10-out16735"	.96836	551	18	569
10	"10-out16736"	.49001	270	281	551
10	"10-out16737"	.99082	108	1	109
10	"10-out16738"	.34416	593	1130	1723
10	"10-out16739"	.75690	2248	722	2970
10	"10-out16740"	.61421	121	76	197
10	"10-out16741"	.43010	480	636	1116
10	"10-out16742"	.31724	263	566	829
10	"10-out16743"	.59595	59	40	99
10	"10-out16744"	.49310	143	147	290
10	"10-out16745"	.42619	179	241	420
10	"10-out16746"	.40222	181	269	450
10	"10-out16747"	.37296	160	269	429
10	"10-out16748"	.34272	219	420	639
10	"10-out16749"	.27737	114	297	411
10	"10-out16750"	.50289	174	172	346
10	"10-out16751"	.89323	251	30	281
10	"10-out16752"	.40804	71	103	174
10	"10-out16753"	.18012	58	264	322
10	"10-out16754"	.26061	270	766	1036
10	"10-out16755"	.32098	78	165	243
10	"10-out16756"	.99730	370	1	371
10	"10-out16757"	.24034	305	964	1269
10	"10-out16758"	.22701	200	681	881
10	"10-out16759"	.38706	389	616	1005
10	"10-out16760"	.34924	256	477	733
10	"10-out16761"	.45000	405	495	900
10	"10-out16762"	.99775	445	1	446
10	"10-out16763"	.32589	73	151	224
10	"10-out16764"	.47704	613	672	1285
10	"10-out16765"	.60000	72	48	120
10	"10-out16766"	.25062	202	604	806
10	"10-out16767"	.98717	77	1	78
10	"10-out16768"	.99212	126	1	127
10	"10-out16769"	.24216	139	435	574
10	"10-out16770"	.94117	144	9	153
10	"10-out16771"	.18035	101	459	560
10	"10-out16772"	.26907	959	2605	3564
10	"10-out16773"	.23143	807	2680	3487
10	"10-out16774"	.29970	1111	2596	3707
10	"10-out16775"	.34313	105	201	306
10	"10-out16776"	.93779	196	13	209
10	"10-out16777"	.57894	33	24	57
10	"10-out16778"	.25064	193	577	770
10	"10-out16779"	.33908	275	536	811
10	"10-out16780"	.37261	468	788	1256
10	"10-out16781"	.85058	649	114	763
10	"10-out16782"	.72573	344	130	474
10	"10-out16783"	.33561	98	194	292
10	"10-out16784"	.53465	162	141	303
10	"10-out16785"	.42541	231	312	543
10	"10-out16786"	.20207	39	154	193
10	"10-out16787"	.22530	130	447	577
10	"10-out16788"	.68275	99	46	145
10	"10-out16789"	.35261	128	235	363
10	"10-out16790"	.21443	205	751	956
10	"10-out16791"	.40076	105	157	262
10	"10-out16792"	.31515	52	113	165
10	"10-out16793"	.53020	79	70	149
10	"10-out16794"	.99019	101	1	102
10	"10-out16795"	.30076	354	823	1177
10	"10-out16796"	.36363	44	77	121
10	"10-out16797"	.99444	179	1	180
10	"10-out16798"	.98648	73	1	74
10	"10-out16799"	.99356	772	5	777
10	"10-out16800"	.99356	772	5	777
10	"10-out16801"	.99809	523	1	524
10	"10-out16802"	.43573	278	360	638
10	"10-out16803"	.15591	58	314	372
10	"10-out16804"	.31034	45	100	145
10	"10-out16805"	.48818	62	65	127
10	"10-out16806"	.30054	278	647	925
10	"10-out16807"	.48586	464	491	955
10	"10-out16808"	.61904	78	48	126
10	"10-out16809"	.27838	385	998	1383
10	"10-out16810"	.35869	66	118	184
10	"10-out16811"	.39776	107	162	269
10	"10-out16812"	.98529	268	4	272
10	"10-out16813"	.98606	283	4	287
10	"10-out16814"	.50000	70	70	140
10	"10-out16815"	.39916	192	289	481
10	"10-out16816"	.28333	51	129	180
10	"10-out16817"	.21528	293	1068	1361
10	"10-out16818"	.47976	1494	1620	3114
10	"10-out16819"	.70850	175	72	247
10	"10-out16820"	.70400	352	148	500
10	"10-out16821"	.60751	647	418	1065
10	"10-out16822"	.25000	43	129	172
10	"10-out16823"	.47121	221	248	469
10	"10-out16824"	.29842	57	134	191
10	"10-out16825"	.41269	130	185	315
10	"10-out16826"	.37329	246	413	659
10	"10-out16827"	.34397	237	452	689
10	"10-out16828"	.99218	127	1	128
10	"10-out16829"	.45791	321	380	701
10	"10-out16830"	.43564	44	57	101
10	"10-out16831"	.53263	204	179	383
10	"10-out16832"	.44827	130	160	290
10	"10-out16833"	.49546	273	278	551
10	"10-out16834"	.42578	109	147	256
10	"10-out16835"	.35665	311	561	872
10	"10-out16836"	.98888	89	1	90
10	"10-out16837"	.99386	162	1	163
10	"10-out16838"	.54152	163	138	301
10	"10-out16839"	.34729	514	966	1480
10	"10-out16840"	.99019	101	1	102
10	"10-out16841"	.35545	150	272	422
10	"10-out16842"	.36346	189	331	520
10	"10-out16843"	.46052	35	41	76
10	"10-out16844"	.35849	95	170	265
10	"10-out16845"	.99310	144	1	145
10	"10-out16846"	.29652	94	223	317
10	"10-out16847"	.33084	133	269	402
10	"10-out16848"	.30303	40	92	132
10	"10-out16849"	.34042	208	403	611
10	"10-out16850"	.98571	483	7	490
10	"10-out16851"	.99387	487	3	490
10	"10-out16852"	.99801	503	1	504
10	"10-out16853"	.92175	483	41	524
10	"10-out16854"	.90176	459	50	509
10	"10-out16855"	.32193	160	337	497
10	"10-out16856"	.57541	103	76	179
10	"10-out16857"	.47826	66	72	138
10	"10-out16858"	.23178	35	116	151
10	"10-out16859"	.30656	42	95	137
10	"10-out16860"	.64625	95	52	147
10	"10-out16861"	.58000	29	21	50
10	"10-out16862"	.27699	177	462	639
10	"10-out16863"	.99470	188	1	189
10	"10-out16864"	.99470	188	1	189
10	"10-out16865"	.99470	188	1	189
10	"10-out16866"	.49264	67	69	136
10	"10-out16867"	.99512	204	1	205
10	"10-out16868"	.58932	254	177	431
10	"10-out16869"	.31637	286	618	904
10	"10-out16870"	.35000	154	286	440
10	"10-out16871"	.40959	111	160	271
10	"10-out16872"	.38051	371	604	975
10	"10-out16873"	.99356	772	5	777
10	"10-out16874"	.44126	154	195	349
10	"10-out16875"	.28372	61	154	215
10	"10-out16876"	.17847	126	580	706
10	"10-out16877"	.45267	110	133	243
10	"10-out16878"	.29096	174	424	598
10	"10-out16879"	.28789	207	512	719
10	"10-out16880"	.32874	167	341	508
10	"10-out16881"	.99378	160	1	161
10	"10-out16882"	.86311	227	36	263
10	"10-out16883"	.93536	246	17	263
10	"10-out16884"	.99811	529	1	530
10	"10-out16885"	.25698	230	665	895
10	"10-out16886"	.29449	230	551	781
10	"10-out16887"	.47478	113	125	238
10	"10-out16888"	.09876	8	73	81
10	"10-out16889"	.98765	80	1	81
10	"10-out16890"	.42592	46	62	108
10	"10-out16891"	.47826	154	168	322
10	"10-out16892"	.17351	38	181	219
10	"10-out16893"	.60784	124	80	204
10	"10-out16894"	.98076	51	1	52
10	"10-out16895"	.99206	125	1	126
10	"10-out16896"	.98437	63	1	64
10	"10-out16897"	.98701	76	1	77
10	"10-out16898"	.98305	58	1	59
10	"10-out16899"	.98181	54	1	55
10	"10-out16900"	.37560	465	773	1238
10	"10-out16901"	.41796	321	447	768
10	"10-out16902"	.37564	293	487	780
10	"10-out16903"	.99555	224	1	225
10	"10-out16904"	.57762	253	185	438
10	"10-out16905"	.98387	61	1	62
10	"10-out16906"	.30579	459	1042	1501
10	"10-out16907"	.99200	124	1	125
10	"10-out16908"	.99610	512	2	514
10	"10-out16909"	.96330	105	4	109
10	"10-out16910"	.93243	207	15	222
10	"10-out16911"	.60824	59	38	97
10	"10-out16912"	.71686	238	94	332
10	"10-out16913"	.99074	107	1	108
10	"10-out16914"	.99074	107	1	108
10	"10-out16915"	.99425	173	1	174
10	"10-out16916"	.27180	240	643	883
10	"10-out16917"	.39612	143	218	361
10	"10-out16918"	.41690	148	207	355
10	"10-out16919"	.78313	65	18	83
10	"10-out16920"	.98765	80	1	81
10	"10-out16921"	.66666	76	38	114
10	"10-out16922"	.35380	121	221	342
10	"10-out16923"	.62571	219	131	350
10	"10-out16924"	.46188	103	120	223
10	"10-out16925"	.99065	106	1	107
10	"10-out16926"	.63716	72	41	113
10	"10-out16927"	.32315	307	643	950
10	"10-out16928"	.33282	217	435	652
10	"10-out16929"	.47046	223	251	474
10	"10-out16930"	.52599	172	155	327
10	"10-out16931"	.41090	113	162	275
10	"10-out16932"	.34813	149	279	428
10	"10-out16933"	.25000	111	333	444
10	"10-out16934"	.27956	26	67	93
10	"10-out16935"	.40833	49	71	120
10	"10-out16936"	.27184	84	225	309
10	"10-out16937"	.44814	121	149	270
10	"10-out16938"	.99418	342	2	344
10	"10-out16939"	.32258	110	231	341
10	"10-out16940"	.22904	194	653	847
10	"10-out16941"	.22666	85	290	375
10	"10-out16942"	.97500	78	2	80
10	"10-out16943"	.24666	74	226	300
10	"10-out16944"	.55670	216	172	388
10	"10-out16945"	.32857	184	376	560
10	"10-out16946"	.87623	354	50	404
10	"10-out16947"	.99523	209	1	210
10	"10-out16948"	.74610	623	212	835
10	"10-out16949"	.39195	78	121	199
10	"10-out16950"	.35028	186	345	531
10	"10-out16951"	.37456	215	359	574
10	"10-out16952"	.33333	71	142	213
10	"10-out16953"	.36026	107	190	297
10	"10-out16954"	.99468	187	1	188
10	"10-out16955"	.91085	235	23	258
10	"10-out16956"	.23498	133	433	566
10	"10-out16957"	.24598	46	141	187
10	"10-out16958"	.30237	153	353	506
10	"10-out16959"	.41891	248	344	592
10	"10-out16960"	.47368	810	900	1710
10	"10-out16961"	.24161	360	1130	1490
10	"10-out16962"	.38364	61	98	159
10	"10-out16963"	.30967	144	321	465
10	"10-out16964"	.24449	111	343	454
10	"10-out16965"	.71747	193	76	269
10	"10-out16966"	.23750	19	61	80
10	"10-out16967"	.59776	214	144	358
10	"10-out16968"	.44961	116	142	258
10	"10-out16969"	.43604	150	194	344
10	"10-out16970"	.99832	595	1	596
10	"10-out16971"	.98634	289	4	293
10	"10-out16972"	.36794	1109	1905	3014
10	"10-out16973"	.46607	158	181	339
10	"10-out16974"	.39333	118	182	300
10	"10-out16975"	.52313	1413	1288	2701
10	"10-out16976"	.22727	20	68	88
10	"10-out16977"	.23437	90	294	384
10	"10-out16978"	.38709	24	38	62
10	"10-out16979"	.97560	280	7	287
10	"10-out16980"	.56228	668	520	1188
10	"10-out16981"	.40573	99	145	244
10	"10-out16982"	.35880	108	193	301
10	"10-out16983"	.48328	159	170	329
10	"10-out16984"	.26022	299	850	1149
10	"10-out16985"	.21562	69	251	320
10	"10-out16986"	.31377	123	269	392
10	"10-out16987"	.43086	268	354	622
10	"10-out16988"	.37458	1017	1698	2715
10	"10-out16989"	.51503	274	258	532
10	"10-out16990"	.99967	3095	1	3096
10	"10-out16991"	.57391	66	49	115
10	"10-out16992"	.34968	392	729	1121
10	"10-out16993"	.44480	137	171	308
10	"10-out16994"	.99019	101	1	102
10	"10-out16995"	.65682	356	186	542
10	"10-out16996"	.86000	86	14	100
10	"10-out16997"	.44406	262	328	590
10	"10-out16998"	.18079	32	145	177
10	"10-out16999"	.99590	243	1	244
10	"10-out17000"	.98765	80	1	81
10	"10-out17001"	.37752	262	432	694
10	"10-out17002"	.30086	173	402	575
10	"10-out17003"	.26254	157	441	598
10	"10-out17004"	.59259	656	451	1107
10	"10-out17005"	.99786	468	1	469
10	"10-out17006"	.40772	190	276	466
10	"10-out17007"	.16822	18	89	107
10	"10-out17008"	.20516	469	1817	2286
10	"10-out17009"	.41935	221	306	527
10	"10-out17010"	.44217	65	82	147
10	"10-out17011"	.35897	42	75	117
10	"10-out17012"	.28732	356	883	1239
10	"10-out17013"	.25154	122	363	485
10	"10-out17014"	.27564	403	1059	1462
10	"10-out17015"	.42686	143	192	335
10	"10-out17016"	.27652	159	416	575
10	"10-out17017"	.52226	258	236	494
10	"10-out17018"	.39555	356	544	900
10	"10-out17019"	.38475	207	331	538
10	"10-out17020"	.77967	1235	349	1584
10	"10-out17021"	.98734	78	1	79
10	"10-out17022"	.90942	502	50	552
10	"10-out17023"	.88000	286	39	325
10	"10-out17024"	.52147	340	312	652
10	"10-out17025"	.50555	182	178	360
10	"10-out17026"	.55056	98	80	178
10	"10-out17027"	.46331	341	395	736
10	"10-out17028"	.43640	398	514	912
10	"10-out17029"	.21101	180	673	853
10	"10-out17030"	.36010	139	247	386
10	"10-out17031"	.29740	469	1108	1577
10	"10-out17032"	.23019	372	1244	1616
10	"10-out17033"	.25052	119	356	475
10	"10-out17034"	.52298	91	83	174
10	"10-out17035"	.15000	54	306	360
10	"10-out17036"	.26315	95	266	361
10	"10-out17037"	.71192	215	87	302
10	"10-out17038"	.44147	132	167	299
10	"10-out17039"	.33770	103	202	305
10	"10-out17040"	.40400	101	149	250
10	"10-out17041"	.46153	126	147	273
10	"10-out17042"	.37328	816	1370	2186
10	"10-out17043"	.78147	1620	453	2073
10	"10-out17044"	.20500	82	318	400
10	"10-out17045"	.89805	370	42	412
10	"10-out17046"	.28310	528	1337	1865
10	"10-out17047"	.23169	424	1406	1830
10	"10-out17048"	.19704	400	1630	2030
10	"10-out17049"	.37080	729	1237	1966
10	"10-out17050"	.27593	516	1354	1870
10	"10-out17051"	.26722	547	1500	2047
10	"10-out17052"	.32616	698	1442	2140
10	"10-out17053"	.31348	658	1441	2099
10	"10-out17054"	.28999	600	1469	2069
10	"10-out17055"	.50331	152	150	302
10	"10-out17056"	.73388	353	128	481
10	"10-out17057"	.25485	105	307	412
10	"10-out17058"	.44354	220	276	496
10	"10-out17059"	.27914	91	235	326
10	"10-out17060"	.22875	70	236	306
10	"10-out17061"	.21450	71	260	331
10	"10-out17062"	.47817	241	263	504
10	"10-out17063"	.26394	142	396	538
10	"10-out17064"	.56713	321	245	566
10	"10-out17065"	.32292	796	1669	2465
10	"10-out17066"	.27458	631	1667	2298
10	"10-out17067"	.99152	117	1	118
10	"10-out17068"	.18152	112	505	617
10	"10-out17069"	.03361	8	230	238
10	"10-out17070"	.30513	469	1068	1537
10	"10-out17071"	.25655	88	255	343
10	"10-out17072"	.24375	78	242	320
10	"10-out17073"	.41889	297	412	709
10	"10-out17074"	.32379	215	449	664
10	"10-out17075"	.99186	122	1	123
10	"10-out17076"	.48076	125	135	260
10	"10-out17077"	.60852	157	101	258
10	"10-out17078"	.95930	165	7	172
10	"10-out17079"	.15763	32	171	203
10	"10-out17080"	.99756	410	1	411
10	"10-out17081"	.36419	177	309	486
10	"10-out17082"	.34836	170	318	488
10	"10-out17083"	.46052	175	205	380
10	"10-out17084"	.44444	168	210	378
10	"10-out17085"	.27765	123	320	443
10	"10-out17086"	.67484	330	159	489
10	"10-out17087"	.96153	75	3	78
10	"10-out17088"	.74390	61	21	82
10	"10-out17089"	.48771	139	146	285
10	"10-out17090"	.32209	86	181	267
10	"10-out17091"	.50442	228	224	452
10	"10-out17092"	.47692	124	136	260
10	"10-out17093"	.54761	46	38	84
10	"10-out17094"	.61956	57	35	92
10	"10-out17095"	.18918	42	180	222
10	"10-out17096"	.28571	80	200	280
10	"10-out17097"	.55056	49	40	89
10	"10-out17098"	.58035	65	47	112
10	"10-out17099"	.08695	18	189	207
10	"10-out17100"	.73983	91	32	123
10	"10-out17101"	.53879	250	214	464
10	"10-out17102"	.30769	136	306	442
10	"10-out17103"	.42857	63	84	147
10	"10-out17104"	.99537	215	1	216
10	"10-out17105"	.99618	261	1	262
10	"10-out17106"	.62295	152	92	244
10	"10-out17107"	.79629	559	143	702
10	"10-out17108"	.48387	225	240	465
10	"10-out17109"	.32171	120	253	373
10	"10-out17110"	.31730	132	284	416
10	"10-out17111"	.56363	155	120	275
10	"10-out17112"	.70502	533	223	756
10	"10-out17113"	.39506	32	49	81
10	"10-out17114"	.22807	13	44	57
10	"10-out17115"	.34003	220	427	647
10	"10-out17116"	.43269	225	295	520
10	"10-out17117"	.38596	132	210	342
10	"10-out17118"	.35564	271	491	762
10	"10-out17119"	.36294	143	251	394
10	"10-out17120"	.32073	246	521	767
10	"10-out17121"	.52059	139	128	267
10	"10-out17122"	.54248	249	210	459
10	"10-out17123"	.39883	205	309	514
10	"10-out17124"	.21465	164	600	764
10	"10-out17125"	.20725	40	153	193
10	"10-out17126"	.99242	131	1	132
10	"10-out17127"	.99563	228	1	229
10	"10-out17128"	.39737	91	138	229
10	"10-out17129"	.99565	229	1	230
10	"10-out17130"	.86301	315	50	365
10	"10-out17131"	.99465	186	1	187
10	"10-out17132"	.99393	164	1	165
10	"10-out17133"	.16766	28	139	167
10	"10-out17134"	.99145	116	1	117
10	"10-out17135"	.28741	121	300	421
10	"10-out17136"	.51030	99	95	194
10	"10-out17137"	.95750	338	15	353
10	"10-out17138"	.27815	205	532	737
10	"10-out17139"	.27624	1313	3440	4753
10	"10-out17140"	.40201	80	119	199
10	"10-out17141"	.16931	32	157	189
10	"10-out17142"	.85894	341	56	397
10	"10-out17143"	.21116	87	325	412
10	"10-out17144"	.54040	107	91	198
10	"10-out17145"	.66396	328	166	494
10	"10-out17146"	.98418	249	4	253
10	"10-out17147"	.90000	234	26	260
10	"10-out17148"	.25462	234	685	919
10	"10-out17149"	.19127	193	816	1009
10	"10-out17150"	.45883	418	493	911
10	"10-out17151"	.15384	26	143	169
10	"10-out17152"	.47802	87	95	182
10	"10-out17153"	.34426	63	120	183
10	"10-out17154"	.22069	273	964	1237
10	"10-out17155"	.51479	87	82	169
10	"10-out17156"	.34583	166	314	480
10	"10-out17157"	.40096	83	124	207
10	"10-out17158"	.99315	145	1	146
10	"10-out17159"	.36315	138	242	380
10	"10-out17160"	.34259	74	142	216
10	"10-out17161"	.26503	119	330	449
10	"10-out17162"	.37241	216	364	580
10	"10-out17163"	.98850	86	1	87
10	"10-out17164"	.39485	353	541	894
10	"10-out17165"	.42730	385	516	901
10	"10-out17166"	.45982	412	484	896
10	"10-out17167"	.22763	458	1554	2012
10	"10-out17168"	.22065	453	1600	2053
10	"10-out17169"	.46127	137	160	297
10	"10-out17170"	.75423	89	29	118
10	"10-out17171"	.38947	74	116	190
10	"10-out17172"	.70103	68	29	97
10	"10-out17173"	.99328	148	1	149
10	"10-out17174"	.33003	400	812	1212
10	"10-out17175"	.80375	770	188	958
10	"10-out17176"	.25071	263	786	1049
10	"10-out17177"	.39266	439	679	1118
10	"10-out17178"	.32232	322	677	999
10	"10-out17179"	.27596	287	753	1040
10	"10-out17180"	.28370	101	255	356
10	"10-out17181"	.66794	869	432	1301
10	"10-out17182"	.31402	385	841	1226
10	"10-out17183"	.08612	18	191	209
10	"10-out17184"	.55357	93	75	168
10	"10-out17185"	.44558	348	433	781
10	"10-out17186"	.32465	237	493	730
10	"10-out17187"	.24495	182	561	743
10	"10-out17188"	.17384	109	518	627
10	"10-out17189"	.92434	281	23	304
10	"10-out17190"	.81879	244	54	298
10	"10-out17191"	.51451	319	301	620
10	"10-out17192"	.99292	421	3	424
10	"10-out17193"	.99292	421	3	424
10	"10-out17194"	.99289	419	3	422
10	"10-out17195"	.99292	421	3	424
10	"10-out17196"	.99292	421	3	424
10	"10-out17197"	.99292	421	3	424
10	"10-out17198"	.52740	818	733	1551
10	"10-out17199"	.64405	997	551	1548
10	"10-out17200"	.19473	37	153	190
10	"10-out17201"	.99056	105	1	106
10	"10-out17202"	.61173	271	172	443
10	"10-out17203"	.28769	187	463	650
10	"10-out17204"	.29189	54	131	185
10	"10-out17205"	.51419	163	154	317
10	"10-out17206"	.36802	145	249	394
10	"10-out17207"	.20472	78	303	381
10	"10-out17208"	.92187	354	30	384
10	"10-out17209"	.60727	167	108	275
10	"10-out17210"	.51012	277	266	543
10	"10-out17211"	.43798	226	290	516
10	"10-out17212"	.45695	552	656	1208
10	"10-out17213"	.52491	158	143	301
10	"10-out17214"	.35381	190	347	537
10	"10-out17215"	.58142	839	604	1443
10	"10-out17216"	.31597	176	381	557
10	"10-out17217"	.28571	216	540	756
10	"10-out17218"	.49152	58	60	118
10	"10-out17219"	.62272	137	83	220
10	"10-out17220"	.81930	331	73	404
10	"10-out17221"	.28061	55	141	196
10	"10-out17222"	.24659	163	498	661
10	"10-out17223"	.35573	270	489	759
10	"10-out17224"	.31827	479	1026	1505
10	"10-out17225"	.44414	660	826	1486
10	"10-out17226"	.26523	161	446	607
10	"10-out17227"	.41250	66	94	160
10	"10-out17228"	.30344	88	202	290
10	"10-out17229"	.36625	89	154	243
10	"10-out17230"	.99248	132	1	133
10	"10-out17231"	.68468	76	35	111
10	"10-out17232"	.31893	96	205	301
10	"10-out17233"	.44377	667	836	1503
10	"10-out17234"	.53600	67	58	125
10	"10-out17235"	.69047	203	91	294
10	"10-out17236"	.49189	182	188	370
10	"10-out17237"	.99512	204	1	205
10	"10-out17238"	.60277	261	172	433
10	"10-out17239"	.91588	98	9	107
10	"10-out17240"	.40760	150	218	368
10	"10-out17241"	.51020	50	48	98
10	"10-out17242"	.65831	289	150	439
10	"10-out17243"	.52127	49	45	94
10	"10-out17244"	.44036	48	61	109
10	"10-out17245"	.41441	46	65	111
10	"10-out17246"	.60504	72	47	119
10	"10-out17247"	.18140	119	537	656
10	"10-out17248"	.21403	122	448	570
10	"10-out17249"	.87368	166	24	190
10	"10-out17250"	.29500	118	282	400
10	"10-out17251"	.29834	108	254	362
10	"10-out17252"	.44027	129	164	293
10	"10-out17253"	.56687	89	68	157
10	"10-out17254"	.30891	97	217	314
10	"10-out17255"	.22445	123	425	548
10	"10-out17256"	.99621	263	1	264
10	"10-out17257"	.90721	88	9	97
10	"10-out17258"	.51271	121	115	236
10	"10-out17259"	.19041	147	625	772
10	"10-out17260"	.99703	673	2	675
10	"10-out17261"	.32579	144	298	442
10	"10-out17262"	.33164	131	264	395
10	"10-out17263"	.30000	36	84	120
10	"10-out17264"	.74603	470	160	630
10	"10-out17265"	.50166	151	150	301
10	"10-out17266"	.55425	189	152	341
10	"10-out17267"	.57610	950	699	1649
10	"10-out17268"	.35942	124	221	345
10	"10-out17269"	.20078	102	406	508
10	"10-out17270"	.29954	133	311	444
10	"10-out17271"	.68000	119	56	175
10	"10-out17272"	.57471	100	74	174
10	"10-out17273"	.39846	363	548	911
10	"10-out17274"	.34140	296	571	867
10	"10-out17275"	.98701	76	1	77
10	"10-out17276"	.99519	207	1	208
10	"10-out17277"	.42396	92	125	217
10	"10-out17278"	.47791	119	130	249
10	"10-out17279"	.31836	78	167	245
10	"10-out17280"	.36674	311	537	848
10	"10-out17281"	.59621	378	256	634
10	"10-out17282"	.30210	187	432	619
10	"10-out17283"	.33110	99	200	299
10	"10-out17284"	.46212	61	71	132
10	"10-out17285"	.94520	621	36	657
10	"10-out17286"	.38922	260	408	668
10	"10-out17287"	.28840	92	227	319
10	"10-out17288"	.37261	117	197	314
10	"10-out17289"	.31197	185	408	593
10	"10-out17290"	.30555	297	675	972
10	"10-out17291"	.32692	85	175	260
10	"10-out17292"	.99539	216	1	217
10	"10-out17293"	.34210	286	550	836
10	"10-out17294"	.70157	134	57	191
10	"10-out17295"	.97747	217	5	222
10	"10-out17296"	.23750	57	183	240
10	"10-out17297"	.25581	55	160	215
10	"10-out17298"	.50000	66	66	132
10	"10-out17299"	.34191	93	179	272
10	"10-out17300"	.28078	114	292	406
10	"10-out17301"	.79715	1851	471	2322
10	"10-out17302"	.36925	209	357	566
10	"10-out17303"	.43633	281	363	644
10	"10-out17304"	.25956	217	619	836
10	"10-out17305"	.40399	324	478	802
10	"10-out17306"	.99526	210	1	211
10	"10-out17307"	.22452	130	449	579
10	"10-out17308"	.46575	68	78	146
10	"10-out17309"	.28055	101	259	360
10	"10-out17310"	.98271	739	13	752
10	"10-out17311"	.97687	338	8	346
10	"10-out17312"	.47464	234	259	493
10	"10-out17313"	.32876	480	980	1460
10	"10-out17314"	.31947	315	671	986
10	"10-out17315"	.86337	297	47	344
10	"10-out17316"	.36794	528	907	1435
10	"10-out17317"	.75362	260	85	345
10	"10-out17318"	.72490	195	74	269
10	"10-out17319"	.99595	246	1	247
10	"10-out17320"	.61600	770	480	1250
10	"10-out17321"	.56513	295	227	522
10	"10-out17322"	.33834	180	352	532
10	"10-out17323"	.36050	115	204	319
10	"10-out17324"	.99378	160	1	161
10	"10-out17325"	.30092	65	151	216
10	"10-out17326"	.86400	540	85	625
10	"10-out17327"	.30570	284	645	929
10	"10-out17328"	.99290	140	1	141
10	"10-out17329"	.37593	50	83	133
10	"10-out17330"	.31696	71	153	224
10	"10-out17331"	.31094	162	359	521
10	"10-out17332"	.34791	175	328	503
10	"10-out17333"	.39130	396	616	1012
10	"10-out17334"	.33982	157	305	462
10	"10-out17335"	.44506	482	601	1083
10	"10-out17336"	.99595	492	2	494
10	"10-out17337"	.80916	424	100	524
10	"10-out17338"	.24519	510	1570	2080
10	"10-out17339"	.99805	514	1	515
10	"10-out17340"	.36678	212	366	578
10	"10-out17341"	.33909	255	497	752
10	"10-out17342"	.26963	127	344	471
10	"10-out17343"	.50176	284	282	566
10	"10-out17344"	.36538	152	264	416
10	"10-out17345"	.94038	489	31	520
10	"10-out17346"	.53361	127	111	238
10	"10-out17347"	.58512	299	212	511
10	"10-out17348"	.45189	155	188	343
10	"10-out17349"	.46441	248	286	534
10	"10-out17350"	.61336	257	162	419
10	"10-out17351"	.31666	38	82	120
10	"10-out17352"	.48910	202	211	413
10	"10-out17353"	.53313	177	155	332
10	"10-out17354"	.79722	287	73	360
10	"10-out17355"	.39189	116	180	296
10	"10-out17356"	.34261	160	307	467
10	"10-out17357"	.99872	781	1	782
10	"10-out17358"	.84134	175	33	208
10	"10-out17359"	.99792	481	1	482
10	"10-out17360"	.27607	495	1298	1793
10	"10-out17361"	.98936	93	1	94
10	"10-out17362"	.30828	160	359	519
10	"10-out17363"	.42473	79	107	186
10	"10-out17364"	.99115	112	1	113
10	"10-out17365"	.29870	115	270	385
10	"10-out17366"	.31250	90	198	288
10	"10-out17367"	.22775	64	217	281
10	"10-out17368"	.99502	200	1	201
10	"10-out17369"	.32707	209	430	639
10	"10-out17370"	.61301	179	113	292
10	"10-out17371"	.36423	55	96	151
10	"10-out17372"	.83544	264	52	316
10	"10-out17373"	.94230	147	9	156
10	"10-out17374"	.88198	142	19	161
10	"10-out17375"	.36618	929	1608	2537
10	"10-out17376"	.63478	73	42	115
10	"10-out17377"	.82539	208	44	252
10	"10-out17378"	.37020	405	689	1094
10	"10-out17379"	.37921	1182	1935	3117
10	"10-out17380"	.66792	177	88	265
10	"10-out17381"	.91956	423	37	460
10	"10-out17382"	.93703	253	17	270
10	"10-out17383"	.45143	581	706	1287
10	"10-out17384"	.33127	161	325	486
10	"10-out17385"	.94630	141	8	149
10	"10-out17386"	.98529	268	4	272
10	"10-out17387"	.34782	1152	2160	3312
10	"10-out17388"	.71770	300	118	418
10	"10-out17389"	.35641	139	251	390
10	"10-out17390"	.51639	63	59	122
10	"10-out17391"	.37755	111	183	294
10	"10-out17392"	.49096	163	169	332
10	"10-out17393"	.68750	264	120	384
10	"10-out17394"	.44868	188	231	419
10	"10-out17395"	.99152	117	1	118
10	"10-out17396"	.37721	149	246	395
10	"10-out17397"	.56593	103	79	182
10	"10-out17398"	.38124	435	706	1141
10	"10-out17399"	.99206	125	1	126
10	"10-out17400"	.27290	137	365	502
10	"10-out17401"	.44357	228	286	514
10	"10-out17402"	.32580	173	358	531
10	"10-out17403"	.30000	147	343	490
10	"10-out17404"	.37714	198	327	525
10	"10-out17405"	.98651	512	7	519
10	"10-out17406"	.98210	494	9	503
10	"10-out17407"	.37084	290	492	782
10	"10-out17408"	.85820	115	19	134
10	"10-out17409"	.62643	109	65	174
10	"10-out17410"	.87330	193	28	221
10	"10-out17411"	.99290	140	1	141
10	"10-out17412"	.44029	118	150	268
10	"10-out17413"	.67489	164	79	243
10	"10-out17414"	.22727	35	119	154
10	"10-out17415"	.98947	94	1	95
10	"10-out17416"	.99107	111	1	112
10	"10-out17417"	.34200	92	177	269
10	"10-out17418"	.18483	39	172	211
10	"10-out17419"	.70036	194	83	277
10	"10-out17420"	.31103	386	855	1241
10	"10-out17421"	.31250	75	165	240
10	"10-out17422"	.64030	251	141	392
10	"10-out17423"	.30222	68	157	225
10	"10-out17424"	.50000	55	55	110
10	"10-out17425"	.26623	246	678	924
10	"10-out17426"	.20758	93	355	448
10	"10-out17427"	.24425	117	362	479
10	"10-out17428"	.32330	129	270	399
10	"10-out17429"	.31019	219	487	706
10	"10-out17430"	.41916	70	97	167
10	"10-out17431"	.40697	35	51	86
10	"10-out17432"	.47180	502	562	1064
10	"10-out17433"	.25531	24	70	94
10	"10-out17434"	.40824	525	761	1286
10	"10-out17435"	.46835	37	42	79
10	"10-out17436"	.53571	45	39	84
10	"10-out17437"	.27586	128	336	464
10	"10-out17438"	.99740	384	1	385
10	"10-out17439"	.98863	87	1	88
10	"10-out17440"	.34348	327	625	952
10	"10-out17441"	.33733	281	552	833
10	"10-out17442"	.38245	109	176	285
10	"10-out17443"	.25823	345	991	1336
10	"10-out17444"	.20385	254	992	1246
10	"10-out17445"	.20843	84	319	403
10	"10-out17446"	.32930	109	222	331
10	"10-out17447"	.99683	315	1	316
10	"10-out17448"	.30835	107	240	347
10	"10-out17449"	.98989	98	1	99
10	"10-out17450"	.35576	608	1101	1709
10	"10-out17451"	.38795	393	620	1013
10	"10-out17452"	.36743	255	439	694
10	"10-out17453"	.25772	417	1201	1618
10	"10-out17454"	.25148	465	1384	1849
10	"10-out17455"	.39095	683	1064	1747
10	"10-out17456"	.44789	533	657	1190
10	"10-out17457"	.51027	298	286	584
10	"10-out17458"	.39136	281	437	718
10	"10-out17459"	.30769	152	342	494
10	"10-out17460"	.26913	1347	3658	5005
10	"10-out17461"	.76500	306	94	400
10	"10-out17462"	.84778	401	72	473
10	"10-out17463"	.34669	147	277	424
10	"10-out17464"	.87268	377	55	432
10	"10-out17465"	.45111	203	247	450
10	"10-out17466"	.98139	422	8	430
10	"10-out17467"	.85638	483	81	564
10	"10-out17468"	.87056	491	73	564
10	"10-out17469"	.66949	790	390	1180
10	"10-out17470"	.53816	275	236	511
10	"10-out17471"	.46009	294	345	639
10	"10-out17472"	.57277	303	226	529
10	"10-out17473"	.54503	351	293	644
10	"10-out17474"	.95859	463	20	483
10	"10-out17475"	.31172	327	722	1049
10	"10-out17476"	.57104	426	320	746
10	"10-out17477"	.32524	228	473	701
10	"10-out17478"	.49415	169	173	342
10	"10-out17479"	.47863	112	122	234
10	"10-out17480"	.38440	143	229	372
10	"10-out17481"	.23019	93	311	404
10	"10-out17482"	.28947	55	135	190
10	"10-out17483"	.38797	142	224	366
10	"10-out17484"	.39966	241	362	603
10	"10-out17485"	.47346	116	129	245
10	"10-out17486"	.99735	377	1	378
10	"10-out17487"	.99735	377	1	378
10	"10-out17488"	.49180	120	124	244
10	"10-out17489"	.28278	69	175	244
10	"10-out17490"	.27341	108	287	395
10	"10-out17491"	.61012	241	154	395
10	"10-out17492"	.31782	41	88	129
10	"10-out17493"	.31457	123	268	391
10	"10-out17494"	.99936	1567	1	1568
10	"10-out17495"	.90963	151	15	166
10	"10-out17496"	.33018	35	71	106
10	"10-out17497"	.38625	163	259	422
10	"10-out17498"	.60030	398	265	663
10	"10-out17499"	.37295	91	153	244
10	"10-out17500"	.42822	179	239	418
10	"10-out17501"	.20055	72	287	359
10	"10-out17502"	.98039	50	1	51
10	"10-out17503"	.32678	133	274	407
10	"10-out17504"	.16761	59	293	352
10	"10-out17505"	.33460	88	175	263
10	"10-out17506"	.28857	101	249	350
10	"10-out17507"	.99844	643	1	644
10	"10-out17508"	.63725	325	185	510
10	"10-out17509"	.24458	113	349	462
10	"10-out17510"	.24256	253	790	1043
10	"10-out17511"	.34362	178	340	518
10	"10-out17512"	.40124	386	576	962
10	"10-out17513"	.50862	59	57	116
10	"10-out17514"	.28473	250	628	878
10	"10-out17515"	.39926	109	164	273
10	"10-out17516"	.30654	103	233	336
10	"10-out17517"	.73816	265	94	359
10	"10-out17518"	.26540	56	155	211
10	"10-out17519"	.31937	305	650	955
10	"10-out17520"	.40486	383	563	946
10	"10-out17521"	.31039	212	471	683
10	"10-out17522"	.28957	150	368	518
10	"10-out17523"	.32863	140	286	426
10	"10-out17524"	.21682	116	419	535
10	"10-out17525"	.47435	37	41	78
10	"10-out17526"	.77631	59	17	76
10	"10-out17527"	.95192	396	20	416
10	"10-out17528"	.41846	408	567	975
10	"10-out17529"	.40706	392	571	963
10	"10-out17530"	.27844	301	780	1081
10	"10-out17531"	.88535	919	119	1038
10	"10-out17532"	.41562	431	606	1037
10	"10-out17533"	.98048	201	4	205
10	"10-out17534"	.92682	190	15	205
10	"10-out17535"	.45213	222	269	491
10	"10-out17536"	.28153	154	393	547
10	"10-out17537"	.29310	119	287	406
10	"10-out17538"	.42814	143	191	334
10	"10-out17539"	.88581	256	33	289
10	"10-out17540"	.99144	811	7	818
10	"10-out17541"	.29784	207	488	695
10	"10-out17542"	.40975	84	121	205
10	"10-out17543"	.68902	113	51	164
10	"10-out17544"	.40259	62	92	154
10	"10-out17545"	.67567	100	48	148
10	"10-out17546"	.29406	302	725	1027
10	"10-out17547"	.99800	500	1	501
10	"10-out17548"	.30847	364	816	1180
10	"10-out17549"	.54822	648	534	1182
10	"10-out17550"	.26855	445	1212	1657
10	"10-out17551"	.29858	487	1144	1631
10	"10-out17552"	.37300	210	353	563
10	"10-out17553"	.35651	282	509	791
10	"10-out17554"	.30201	180	416	596
10	"10-out17555"	.18153	59	266	325
10	"10-out17556"	.41121	396	567	963
10	"10-out17557"	.20402	142	554	696
10	"10-out17558"	.23469	161	525	686
10	"10-out17559"	.38405	477	765	1242
10	"10-out17560"	.48505	649	689	1338
10	"10-out17561"	.87531	344	49	393
10	"10-out17562"	.35510	174	316	490
10	"10-out17563"	.36470	31	54	85
10	"10-out17564"	.31958	31	66	97
10	"10-out17565"	.55813	48	38	86
10	"10-out17566"	.35097	126	233	359
10	"10-out17567"	.26040	194	551	745
10	"10-out17568"	.27570	118	310	428
10	"10-out17569"	.56917	325	246	571
10	"10-out17570"	.38926	116	182	298
10	"10-out17571"	.31891	177	378	555
10	"10-out17572"	.50689	147	143	290
10	"10-out17573"	.99145	116	1	117
10	"10-out17574"	.80869	186	44	230
10	"10-out17575"	.21518	119	434	553
10	"10-out17576"	.41399	142	201	343
10	"10-out17577"	.44230	299	377	676
10	"10-out17578"	.99145	116	1	117
10	"10-out17579"	.99173	120	1	121
10	"10-out17580"	.99166	119	1	120
10	"10-out17581"	.28409	75	189	264
10	"10-out17582"	.35000	147	273	420
10	"10-out17583"	.36533	156	271	427
10	"10-out17584"	.99145	116	1	117
10	"10-out17585"	.17850	103	474	577
10	"10-out17586"	.91318	547	52	599
10	"10-out17587"	.64875	338	183	521
10	"10-out17588"	.32629	170	351	521
10	"10-out17589"	.85214	438	76	514
10	"10-out17590"	.35628	445	804	1249
10	"10-out17591"	.33537	164	325	489
10	"10-out17592"	.28783	97	240	337
10	"10-out17593"	.24675	114	348	462
10	"10-out17594"	.98666	592	8	600
10	"10-out17595"	.58185	295	212	507
10	"10-out17596"	.31056	191	424	615
10	"10-out17597"	.32199	265	558	823
10	"10-out17598"	.30134	201	466	667
10	"10-out17599"	.52796	236	211	447
10	"10-out17600"	.26113	129	365	494
10	"10-out17601"	.41290	128	182	310
10	"10-out17602"	.21577	249	905	1154
10	"10-out17603"	.29187	115	279	394
10	"10-out17604"	.68390	476	220	696
10	"10-out17605"	.39171	293	455	748
10	"10-out17606"	.32230	380	799	1179
10	"10-out17607"	.34358	402	768	1170
10	"10-out17608"	.56772	197	150	347
10	"10-out17609"	.32304	722	1513	2235
10	"10-out17610"	.53258	425	373	798
10	"10-out17611"	.29906	320	750	1070
10	"10-out17612"	.42565	438	591	1029
10	"10-out17613"	.28461	148	372	520
10	"10-out17614"	.33750	405	795	1200
10	"10-out17615"	.99621	263	1	264
10	"10-out17616"	.56798	259	197	456
10	"10-out17617"	.88120	497	67	564
10	"10-out17618"	.62906	329	194	523
10	"10-out17619"	.84134	350	66	416
10	"10-out17620"	.39800	837	1266	2103
10	"10-out17621"	.58703	317	223	540
10	"10-out17622"	.56055	324	254	578
10	"10-out17623"	.96162	451	18	469
10	"10-out17624"	.20078	51	203	254
10	"10-out17625"	.47231	145	162	307
10	"10-out17626"	.42324	193	263	456
10	"10-out17627"	.26689	229	629	858
10	"10-out17628"	.34113	175	338	513
10	"10-out17629"	.39600	198	302	500
10	"10-out17630"	.29474	522	1249	1771
10	"10-out17631"	.74308	376	130	506
10	"10-out17632"	.28461	481	1209	1690
10	"10-out17633"	.27644	115	301	416
10	"10-out17634"	.51059	241	231	472
10	"10-out17635"	.99521	208	1	209
10	"10-out17636"	.38050	121	197	318
10	"10-out17637"	.39197	430	667	1097
10	"10-out17638"	.27377	285	756	1041
10	"10-out17639"	.99024	203	2	205
10	"10-out17640"	.99504	201	1	202
10	"10-out17641"	.41267	241	343	584
10	"10-out17642"	.45869	211	249	460
10	"10-out17643"	.33810	118	231	349
10	"10-out17644"	.28603	129	322	451
10	"10-out17645"	.30321	151	347	498
10	"10-out17646"	.59006	285	198	483
10	"10-out17647"	.99224	128	1	129
10	"10-out17648"	.27350	32	85	117
10	"10-out17649"	.32152	699	1475	2174
10	"10-out17650"	.19811	42	170	212
10	"10-out17651"	.61111	88	56	144
10	"10-out17652"	.30000	60	140	200
10	"10-out17653"	.29532	404	964	1368
10	"10-out17654"	.40298	108	160	268
10	"10-out17655"	.50000	73	73	146
10	"10-out17656"	.32704	156	321	477
10	"10-out17657"	.99663	296	1	297
10	"10-out17658"	.76945	267	80	347
10	"10-out17659"	.99820	555	1	556
10	"10-out17660"	.42192	381	522	903
10	"10-out17661"	.72511	612	232	844
10	"10-out17662"	.30100	90	209	299
10	"10-out17663"	.30872	92	206	298
10	"10-out17664"	.38303	298	480	778
10	"10-out17665"	.41900	194	269	463
10	"10-out17666"	.37765	71	117	188
10	"10-out17667"	.38834	40	63	103
10	"10-out17668"	.34024	197	382	579
10	"10-out17669"	.33824	344	673	1017
10	"10-out17670"	.26113	258	730	988
10	"10-out17671"	.42756	425	569	994
10	"10-out17672"	.29873	236	554	790
10	"10-out17673"	.32839	266	544	810
10	"10-out17674"	.78594	973	265	1238
10	"10-out17675"	.40490	66	97	163
10	"10-out17676"	.36219	410	722	1132
10	"10-out17677"	.59466	490	334	824
10	"10-out17678"	.41287	109	155	264
10	"10-out17679"	.56847	357	271	628
10	"10-out17680"	.25789	49	141	190
10	"10-out17681"	.36344	507	888	1395
10	"10-out17682"	.31156	334	738	1072
10	"10-out17683"	.48526	280	297	577
10	"10-out17684"	.27076	528	1422	1950
10	"10-out17685"	.50271	649	642	1291
10	"10-out17686"	.99618	784	3	787
10	"10-out17687"	.87984	1589	217	1806
10	"10-out17688"	.38154	488	791	1279
10	"10-out17689"	.63268	453	263	716
10	"10-out17690"	.52136	244	224	468
10	"10-out17691"	.40517	188	276	464
10	"10-out17692"	.36426	157	274	431
10	"10-out17693"	.45585	284	339	623
10	"10-out17694"	.99053	628	6	634
10	"10-out17695"	.56250	252	196	448
10	"10-out17696"	.69435	443	195	638
10	"10-out17697"	.58439	322	229	551
10	"10-out17698"	.47884	249	271	520
10	"10-out17699"	.48411	259	276	535
10	"10-out17700"	.38123	130	211	341
10	"10-out17701"	.60828	382	246	628
10	"10-out17702"	.50000	267	267	534
10	"10-out17703"	.33552	102	202	304
10	"10-out17704"	.25050	125	374	499
10	"10-out17705"	.26198	82	231	313
10	"10-out17706"	.29044	79	193	272
10	"10-out17707"	.37807	200	329	529
10	"10-out17708"	.64591	166	91	257
10	"10-out17709"	.27981	122	314	436
10	"10-out17710"	.99307	287	2	289
10	"10-out17711"	.29357	256	616	872
10	"10-out17712"	.17839	71	327	398
10	"10-out17713"	.18377	77	342	419
10	"10-out17714"	.42136	359	493	852
10	"10-out17715"	.30018	317	739	1056
10	"10-out17716"	.33682	450	886	1336
10	"10-out17717"	.26619	411	1133	1544
10	"10-out17718"	.71794	1120	440	1560
10	"10-out17719"	.39622	651	992	1643
10	"10-out17720"	.63230	184	107	291
10	"10-out17721"	.95563	280	13	293
10	"10-out17722"	.23453	326	1064	1390
10	"10-out17723"	.24077	137	432	569
10	"10-out17724"	.76482	387	119	506
10	"10-out17725"	.41002	180	259	439
10	"10-out17726"	.80431	596	145	741
10	"10-out17727"	.28082	82	210	292
10	"10-out17728"	.34340	125	239	364
10	"10-out17729"	.41076	313	449	762
10	"10-out17730"	.99159	118	1	119
10	"10-out17731"	.45501	263	315	578
10	"10-out17732"	.30330	303	696	999
10	"10-out17733"	.99152	117	1	118
10	"10-out17734"	.99159	118	1	119
10	"10-out17735"	.16077	50	261	311
10	"10-out17736"	.36559	136	236	372
10	"10-out17737"	.17759	65	301	366
10	"10-out17738"	.38659	75	119	194
10	"10-out17739"	.22857	88	297	385
10	"10-out17740"	.73671	305	109	414
10	"10-out17741"	.77639	125	36	161
10	"10-out17742"	.48430	108	115	223
10	"10-out17743"	.99818	549	1	550
10	"10-out17744"	.43491	284	369	653
10	"10-out17745"	.58333	91	65	156
10	"10-out17746"	.40290	500	741	1241
10	"10-out17747"	.99567	230	1	231
10	"10-out17748"	.20000	25	100	125
10	"10-out17749"	.63008	155	91	246
10	"10-out17750"	.58726	461	324	785
10	"10-out17751"	.40540	60	88	148
10	"10-out17752"	.98798	329	4	333
10	"10-out17753"	.37460	118	197	315
10	"10-out17754"	.99346	152	1	153
10	"10-out17755"	.56732	316	241	557
10	"10-out17756"	.20312	39	153	192
10	"10-out17757"	.32142	90	190	280
10	"10-out17758"	.70422	100	42	142
10	"10-out17759"	.28514	71	178	249
10	"10-out17760"	.21481	29	106	135
10	"10-out17761"	.59426	145	99	244
10	"10-out17762"	.40264	122	181	303
10	"10-out17763"	.35585	374	677	1051
10	"10-out17764"	.25841	307	881	1188
10	"10-out17765"	.35786	282	506	788
10	"10-out17766"	.36814	416	714	1130
10	"10-out17767"	.32061	168	356	524
10	"10-out17768"	.41755	195	272	467
10	"10-out17769"	.40755	205	298	503
10	"10-out17770"	.32159	137	289	426
10	"10-out17771"	.37500	180	300	480
10	"10-out17772"	.25571	123	358	481
10	"10-out17773"	.41436	75	106	181
10	"10-out17774"	.29534	184	439	623
10	"10-out17775"	.29820	133	313	446
10	"10-out17776"	.90259	139	15	154
10	"10-out17777"	.41344	203	288	491
10	"10-out17778"	.30789	1723	3873	5596
10	"10-out17779"	.36250	29	51	80
10	"10-out17780"	.99393	164	1	165
10	"10-out17781"	.23204	42	139	181
10	"10-out17782"	.18911	66	283	349
10	"10-out17783"	.42109	539	741	1280
10	"10-out17784"	.79381	77	20	97
10	"10-out17785"	.60714	85	55	140
10	"10-out17786"	.99512	204	1	205
10	"10-out17787"	.50332	227	224	451
10	"10-out17788"	.99572	233	1	234
10	"10-out17789"	.79562	218	56	274
10	"10-out17790"	.88268	316	42	358
10	"10-out17791"	.27567	51	134	185
10	"10-out17792"	.26809	100	273	373
10	"10-out17793"	.95590	2081	96	2177
10	"10-out17794"	.99731	372	1	373
10	"10-out17795"	.60407	267	175	442
10	"10-out17796"	.82133	308	67	375
10	"10-out17797"	.19969	130	521	651
10	"10-out17798"	.42166	253	347	600
10	"10-out17799"	.23277	196	646	842
10	"10-out17800"	.27422	334	884	1218
10	"10-out17801"	.41653	1058	1482	2540
10	"10-out17802"	.28115	291	744	1035
10	"10-out17803"	.71059	825	336	1161
10	"10-out17804"	.57792	89	65	154
10	"10-out17805"	.28645	330	822	1152
10	"10-out17806"	.33396	350	698	1048
10	"10-out17807"	.53623	74	64	138
10	"10-out17808"	.99600	249	1	250
10	"10-out17809"	.44282	426	536	962
10	"10-out17810"	.43031	176	233	409
10	"10-out17811"	.56958	221	167	388
10	"10-out17812"	.99145	116	1	117
10	"10-out17813"	.99152	117	1	118
10	"10-out17814"	.51546	100	94	194
10	"10-out17815"	.99333	149	1	150
10	"10-out17816"	.59090	65	45	110
10	"10-out17817"	.99145	116	1	117
10	"10-out17818"	.99285	139	1	140
10	"10-out17819"	.22424	37	128	165
10	"10-out17820"	.32575	301	623	924
10	"10-out17821"	.78902	187	50	237
10	"10-out17822"	.32977	216	439	655
10	"10-out17823"	.43203	979	1287	2266
10	"10-out17824"	.85947	844	138	982
10	"10-out17825"	.37378	77	129	206
10	"10-out17826"	.38763	395	624	1019
10	"10-out17827"	.19327	23	96	119
10	"10-out17828"	.69827	81	35	116
10	"10-out17829"	.76211	173	54	227
10	"10-out17830"	.41850	95	132	227
10	"10-out17831"	.67400	490	237	727
10	"10-out17832"	.83419	483	96	579
10	"10-out17833"	.25543	47	137	184
10	"10-out17834"	.31844	164	351	515
10	"10-out17835"	.26285	409	1147	1556
10	"10-out17836"	.39222	222	344	566
10	"10-out17837"	.55725	73	58	131
10	"10-out17838"	.45323	63	76	139
10	"10-out17839"	.87500	140	20	160
10	"10-out17840"	.26139	172	486	658
10	"10-out17841"	.77881	750	213	963
10	"10-out17842"	.32090	327	692	1019
10	"10-out17843"	.37048	349	593	942
10	"10-out17844"	.22816	243	822	1065
10	"10-out17845"	.33706	723	1422	2145
10	"10-out17846"	.40529	291	427	718
10	"10-out17847"	.95121	195	10	205
10	"10-out17848"	.76588	458	140	598
10	"10-out17849"	.30257	141	325	466
10	"10-out17850"	.15887	17	90	107
10	"10-out17851"	.50943	81	78	159
10	"10-out17852"	.35191	101	186	287
10	"10-out17853"	.25337	244	719	963
10	"10-out17854"	.57661	858	630	1488
10	"10-out17855"	.33714	531	1044	1575
10	"10-out17856"	.54878	45	37	82
10	"10-out17857"	.99859	711	1	712
10	"10-out17858"	.31360	196	429	625
10	"10-out17859"	.32642	189	390	579
10	"10-out17860"	.20971	272	1025	1297
10	"10-out17861"	.22431	310	1072	1382
10	"10-out17862"	.37037	50	85	135
10	"10-out17863"	.44600	95	118	213
10	"10-out17864"	.32890	396	808	1204
10	"10-out17865"	.26940	590	1600	2190
10	"10-out17866"	.76239	446	139	585
10	"10-out17867"	.42642	426	573	999
10	"10-out17868"	.80110	145	36	181
10	"10-out17869"	.25301	63	186	249
10	"10-out17870"	.20065	61	243	304
10	"10-out17871"	.39316	138	213	351
10	"10-out17872"	.32171	711	1499	2210
10	"10-out17873"	.99765	426	1	427
10	"10-out17874"	.49044	231	240	471
10	"10-out17875"	.41527	522	735	1257
10	"10-out17876"	.66267	332	169	501
10	"10-out17877"	.84585	439	80	519
10	"10-out17878"	.39775	284	430	714
10	"10-out17879"	.31463	387	843	1230
10	"10-out17880"	.40740	198	288	486
10	"10-out17881"	.22427	146	505	651
10	"10-out17882"	.17307	36	172	208
10	"10-out17883"	.22454	355	1226	1581
10	"10-out17884"	.35128	137	253	390
10	"10-out17885"	.30294	103	237	340
10	"10-out17886"	.29937	338	791	1129
10	"10-out17887"	.48258	374	401	775
10	"10-out17888"	.97237	704	20	724
10	"10-out17889"	.74102	475	166	641
10	"10-out17890"	.69856	292	126	418
10	"10-out17891"	.31210	147	324	471
10	"10-out17892"	.99159	118	1	119
10	"10-out17893"	.99145	116	1	117
10	"10-out17894"	.99145	116	1	117
10	"10-out17895"	.35215	106	195	301
10	"10-out17896"	.99145	116	1	117
10	"10-out17897"	.46666	154	176	330
10	"10-out17898"	.36678	212	366	578
10	"10-out17899"	.30967	48	107	155
10	"10-out17900"	.42338	105	143	248
10	"10-out17901"	.62889	222	131	353
10	"10-out17902"	.80800	101	24	125
10	"10-out17903"	.88721	118	15	133
10	"10-out17904"	.64395	378	209	587
10	"10-out17905"	.71161	343	139	482
10	"10-out17906"	.52205	142	130	272
10	"10-out17907"	.34378	592	1130	1722
10	"10-out17908"	.41384	293	415	708
10	"10-out17909"	.31750	127	273	400
10	"10-out17910"	.64882	194	105	299
10	"10-out17911"	.36573	222	385	607
10	"10-out17912"	.51428	162	153	315
10	"10-out17913"	.25438	58	170	228
10	"10-out17914"	.98412	186	3	189
10	"10-out17915"	.92063	174	15	189
10	"10-out17916"	.98941	187	2	189
10	"10-out17917"	.33689	63	124	187
10	"10-out17918"	.52693	313	281	594
10	"10-out17919"	.96500	193	7	200
10	"10-out17920"	.99489	195	1	196
10	"10-out17921"	.99441	178	1	179
10	"10-out17922"	.59915	284	190	474
10	"10-out17923"	.15277	22	122	144
10	"10-out17924"	.35995	293	521	814
10	"10-out17925"	.15581	213	1154	1367
10	"10-out17926"	.98387	122	2	124
10	"10-out17927"	.27098	339	912	1251
10	"10-out17928"	1.00000	384	0	384
10	"10-out17929"	.35849	57	102	159
10	"10-out17930"	1.00000	106	0	106
10	"10-out17931"	.87793	187	26	213
10	"10-out17932"	.89276	333	40	373
10	"10-out17933"	.29235	264	639	903
10	"10-out17934"	.29166	56	136	192
10	"10-out17935"	.27395	366	970	1336
10	"10-out17936"	.77135	921	273	1194
10	"10-out17937"	.40540	165	242	407
10	"10-out17938"	.97903	467	10	477
10	"10-out17939"	.37575	310	515	825
10	"10-out17940"	.43790	67	86	153
10	"10-out17941"	.36111	65	115	180
10	"10-out17942"	.31666	171	369	540
10	"10-out17943"	.19858	84	339	423
10	"10-out17944"	.24579	146	448	594
10	"10-out17945"	.70833	272	112	384
10	"10-out17946"	.45344	112	135	247
10	"10-out17947"	.46329	183	212	395
10	"10-out17948"	.99305	143	1	144
10	"10-out17949"	.40892	229	331	560
10	"10-out17950"	.27000	54	146	200
10	"10-out17951"	.41405	277	392	669
10	"10-out17952"	.50986	155	149	304
10	"10-out17953"	.99074	107	1	108
10	"10-out17954"	.27169	191	512	703
10	"10-out17955"	.30927	60	134	194
10	"10-out17956"	.28959	64	157	221
10	"10-out17957"	.22566	51	175	226
10	"10-out17958"	.99145	116	1	117
10	"10-out17959"	.99145	116	1	117
10	"10-out17960"	.39423	123	189	312
10	"10-out17961"	.99861	723	1	724
10	"10-out17962"	.43063	149	197	346
10	"10-out17963"	.70612	173	72	245
10	"10-out17964"	.61437	94	59	153
10	"10-out17965"	.33291	528	1058	1586
10	"10-out17966"	.21428	57	209	266
10	"10-out17967"	.30967	192	428	620
10	"10-out17968"	.40800	51	74	125
10	"10-out17969"	1.00000	326	0	326
10	"10-out17970"	.87164	292	43	335
10	"10-out17971"	.29113	46	112	158
10	"10-out17972"	.99390	163	1	164
10	"10-out17973"	.98113	104	2	106
10	"10-out17974"	.99470	376	2	378
10	"10-out17975"	.16306	98	503	601
10	"10-out17976"	.29047	122	298	420
10	"10-out17977"	.71241	654	264	918
10	"10-out17978"	.31827	162	347	509
10	"10-out17979"	.28758	132	327	459
10	"10-out17980"	.42424	42	57	99
10	"10-out17981"	.28472	41	103	144
10	"10-out17982"	.33150	181	365	546
10	"10-out17983"	.39749	254	385	639
10	"10-out17984"	.30867	121	271	392
10	"10-out17985"	.58789	204	143	347
10	"10-out17986"	.38303	280	451	731
10	"10-out17987"	.49833	299	301	600
10	"10-out17988"	.32758	285	585	870
10	"10-out17989"	.99701	334	1	335
10	"10-out17990"	.25000	95	285	380
10	"10-out17991"	.36131	439	776	1215
10	"10-out17992"	.61538	304	190	494
10	"10-out17993"	.32861	116	237	353
10	"10-out17994"	.63017	213	125	338
10	"10-out17995"	.64603	261	143	404
10	"10-out17996"	.34534	115	218	333
10	"10-out17997"	.65400	465	246	711
10	"10-out17998"	.40825	178	258	436
10	"10-out17999"	.48627	248	262	510
10	"10-out18000"	.19279	182	762	944
10	"10-out18001"	.48169	421	453	874
10	"10-out18002"	.30031	94	219	313
10	"10-out18003"	.69733	288	125	413
10	"10-out18004"	.71739	264	104	368
10	"10-out18005"	.11428	8	62	70
10	"10-out18006"	.92905	550	42	592
10	"10-out18007"	.71562	458	182	640
10	"10-out18008"	.26048	118	335	453
10	"10-out18009"	.32835	22	45	67
10	"10-out18010"	.14473	66	390	456
10	"10-out18011"	.19140	98	414	512
10	"10-out18012"	.69418	1169	515	1684
10	"10-out18013"	.43413	145	189	334
10	"10-out18014"	.46231	92	107	199
10	"10-out18015"	.26630	49	135	184
10	"10-out18016"	.29608	53	126	179
10	"10-out18017"	.39805	82	124	206
10	"10-out18018"	.23728	42	135	177
10	"10-out18019"	.66375	152	77	229
10	"10-out18020"	.29102	133	324	457
10	"10-out18021"	.73964	125	44	169
10	"10-out18022"	.81818	171	38	209
10	"10-out18023"	.33333	156	312	468
10	"10-out18024"	.99232	517	4	521
10	"10-out18025"	.38522	146	233	379
10	"10-out18026"	.12168	55	397	452
10	"10-out18027"	.99820	555	1	556
10	"10-out18028"	.19304	111	464	575
10	"10-out18029"	.66589	289	145	434
10	"10-out18030"	.20073	109	434	543
10	"10-out18031"	.28955	97	238	335
10	"10-out18032"	.86138	1131	182	1313
10	"10-out18033"	.38547	138	220	358
10	"10-out18034"	.25438	174	510	684
10	"10-out18035"	.43750	70	90	160
10	"10-out18036"	.23140	56	186	242
10	"10-out18037"	.37903	94	154	248
10	"10-out18038"	.47995	898	973	1871
10	"10-out18039"	.99705	338	1	339
10	"10-out18040"	.28317	175	443	618
10	"10-out18041"	.60590	349	227	576
10	"10-out18042"	.52062	631	581	1212
10	"10-out18043"	.43155	227	299	526
10	"10-out18044"	.51152	355	339	694
10	"10-out18045"	.99849	665	1	666
10	"10-out18046"	.20522	55	213	268
10	"10-out18047"	.30406	142	325	467
10	"10-out18048"	.46839	163	185	348
10	"10-out18049"	.14666	11	64	75
10	"10-out18050"	.25879	103	295	398
10	"10-out18051"	.24848	82	248	330
10	"10-out18052"	.40966	424	611	1035
10	"10-out18053"	.30650	99	224	323
10	"10-out18054"	.33773	179	351	530
10	"10-out18055"	.34263	135	259	394
10	"10-out18056"	.21428	18	66	84
10	"10-out18057"	.43026	145	192	337
10	"10-out18058"	.99082	108	1	109
10	"10-out18059"	.99850	667	1	668
10	"10-out18060"	.29509	445	1063	1508
10	"10-out18061"	.40835	176	255	431
10	"10-out18062"	.27597	85	223	308
10	"10-out18063"	.93750	150	10	160
10	"10-out18064"	.37469	154	257	411
10	"10-out18065"	.43602	259	335	594
10	"10-out18066"	.24622	114	349	463
10	"10-out18067"	.24290	77	240	317
10	"10-out18068"	.27308	139	370	509
10	"10-out18069"	.99497	198	1	199
10	"10-out18070"	.36986	81	138	219
10	"10-out18071"	.36585	120	208	328
10	"10-out18072"	.54320	88	74	162
10	"10-out18073"	.05161	8	147	155
10	"10-out18074"	.36787	71	122	193
10	"10-out18075"	.23163	41	136	177
10	"10-out18076"	.44561	254	316	570
10	"10-out18077"	.34317	93	178	271
10	"10-out18078"	.51898	287	266	553
10	"10-out18079"	.42911	227	302	529
10	"10-out18080"	.30483	82	187	269
10	"10-out18081"	.34868	53	99	152
10	"10-out18082"	.40949	233	336	569
10	"10-out18083"	.27683	49	128	177
10	"10-out18084"	.21022	37	139	176
10	"10-out18085"	.27137	146	392	538
10	"10-out18086"	.44444	76	95	171
10	"10-out18087"	.41911	114	158	272
10	"10-out18088"	.83363	466	93	559
10	"10-out18089"	.99728	368	1	369
10	"10-out18090"	.18918	56	240	296
10	"10-out18091"	.77324	474	139	613
10	"10-out18092"	.31818	203	435	638
10	"10-out18093"	.23846	93	297	390
10	"10-out18094"	.61382	302	190	492
10	"10-out18095"	.99561	227	1	228
10	"10-out18096"	.99242	131	1	132
10	"10-out18097"	.93650	177	12	189
10	"10-out18098"	.98941	187	2	189
10	"10-out18099"	.99470	188	1	189
10	"10-out18100"	.31280	127	279	406
10	"10-out18101"	.48192	80	86	166
10	"10-out18102"	.99500	199	1	200
10	"10-out18103"	.32372	146	305	451
10	"10-out18104"	.38486	117	187	304
10	"10-out18105"	.50295	340	336	676
10	"10-out18106"	.41538	81	114	195
10	"10-out18107"	.75555	136	44	180
10	"10-out18108"	.37464	133	222	355
10	"10-out18109"	.93452	314	22	336
10	"10-out18110"	.45248	100	121	221
10	"10-out18111"	.38620	112	178	290
10	"10-out18112"	.65040	160	86	246
10	"10-out18113"	.21525	127	463	590
10	"10-out18114"	.33224	305	613	918
10	"10-out18115"	.91625	186	17	203
10	"10-out18116"	.31362	191	418	609
10	"10-out18117"	.88000	198	27	225
10	"10-out18118"	.35632	372	672	1044
10	"10-out18119"	.35618	613	1108	1721
10	"10-out18120"	.39461	176	270	446
10	"10-out18121"	.44613	381	473	854
10	"10-out18122"	.43558	71	92	163
10	"10-out18123"	.99305	143	1	144
10	"10-out18124"	.11748	43	323	366
10	"10-out18125"	.30188	112	259	371
10	"10-out18126"	.37164	194	328	522
10	"10-out18127"	.29829	227	534	761
10	"10-out18128"	.51351	152	144	296
10	"10-out18129"	.58757	104	73	177
10	"10-out18130"	.71538	279	111	390
10	"10-out18131"	.17897	160	734	894
10	"10-out18132"	.63333	76	44	120
10	"10-out18133"	.71887	1611	630	2241
10	"10-out18134"	.42028	58	80	138
10	"10-out18135"	.22434	94	325	419
10	"10-out18136"	.44680	210	260	470
10	"10-out18137"	.99803	507	1	508
10	"10-out18138"	.55500	338	271	609
10	"10-out18139"	.35626	290	524	814
10	"10-out18140"	.51851	42	39	81
10	"10-out18141"	.20983	64	241	305
10	"10-out18142"	.40909	189	273	462
10	"10-out18143"	.20037	106	423	529
10	"10-out18144"	.27891	164	424	588
10	"10-out18145"	.21075	192	719	911
10	"10-out18146"	.74524	705	241	946
10	"10-out18147"	.27078	241	649	890
10	"10-out18148"	.26451	246	684	930
10	"10-out18149"	.28878	121	298	419
10	"10-out18150"	.32044	116	246	362
10	"10-out18151"	.22419	139	481	620
10	"10-out18152"	.45535	153	183	336
10	"10-out18153"	.55591	174	139	313
10	"10-out18154"	.98305	116	2	118
10	"10-out18155"	.25417	137	402	539
10	"10-out18156"	.33333	115	230	345
10	"10-out18157"	.99648	567	2	569
10	"10-out18158"	.74285	208	72	280
10	"10-out18159"	.33834	225	440	665
10	"10-out18160"	.99539	216	1	217
10	"10-out18161"	.31736	53	114	167
10	"10-out18162"	.85950	208	34	242
10	"10-out18163"	.44247	200	252	452
10	"10-out18164"	.47897	262	285	547
10	"10-out18165"	.33962	18	35	53
10	"10-out18166"	1.00000	106	0	106
10	"10-out18167"	.38883	397	624	1021
10	"10-out18168"	.38174	92	149	241
10	"10-out18169"	.23672	107	345	452
10	"10-out18170"	.29268	48	116	164
10	"10-out18171"	.30455	127	290	417
10	"10-out18172"	.40909	99	143	242
10	"10-out18173"	.33931	227	442	669
10	"10-out18174"	.56013	163	128	291
10	"10-out18175"	.32014	178	378	556
10	"10-out18176"	.29707	183	433	616
10	"10-out18177"	.32427	179	373	552
10	"10-out18178"	.26704	141	387	528
10	"10-out18179"	.28773	61	151	212
10	"10-out18180"	.40220	146	217	363
10	"10-out18181"	.82006	474	104	578
10	"10-out18182"	.31111	210	465	675
10	"10-out18183"	.29696	98	232	330
10	"10-out18184"	.27099	71	191	262
10	"10-out18185"	.20488	109	423	532
10	"10-out18186"	.20066	181	721	902
10	"10-out18187"	.25245	103	305	408
10	"10-out18188"	.13604	137	870	1007
10	"10-out18189"	.19226	169	710	879
10	"10-out18190"	.23713	189	608	797
10	"10-out18191"	.28160	176	449	625
10	"10-out18192"	.35233	309	568	877
10	"10-out18193"	.96195	354	14	368
10	"10-out18194"	.18498	170	749	919
10	"10-out18195"	.35572	323	585	908
10	"10-out18196"	.36401	348	608	956
10	"10-out18197"	.45161	98	119	217
10	"10-out18198"	.31224	306	674	980
10	"10-out18199"	.83946	570	109	679
10	"10-out18200"	.33098	894	1807	2701
10	"10-out18201"	.68313	235	109	344
10	"10-out18202"	.42708	205	275	480
10	"10-out18203"	.33928	114	222	336
10	"10-out18204"	.35886	609	1088	1697
10	"10-out18205"	.41211	619	883	1502
10	"10-out18206"	.13257	35	229	264
10	"10-out18207"	.26261	229	643	872
10	"10-out18208"	.28913	181	445	626
10	"10-out18209"	.21192	192	714	906
10	"10-out18210"	.47321	477	531	1008
10	"10-out18211"	.37837	56	92	148
10	"10-out18212"	.99658	292	1	293
10	"10-out18213"	.19953	85	341	426
10	"10-out18214"	.80487	165	40	205
10	"10-out18215"	.49027	126	131	257
10	"10-out18216"	.33669	167	329	496
10	"10-out18217"	.38582	196	312	508
10	"10-out18218"	.70041	339	145	484
10	"10-out18219"	.99581	238	1	239
10	"10-out18220"	.30603	71	161	232
10	"10-out18221"	.30372	106	243	349
10	"10-out18222"	.57299	157	117	274
10	"10-out18223"	.31868	203	434	637
10	"10-out18224"	.94144	209	13	222
10	"10-out18225"	.37121	98	166	264
10	"10-out18226"	.94036	205	13	218
10	"10-out18227"	.99051	940	9	949
10	"10-out18228"	.31229	188	414	602
10	"10-out18229"	.35408	256	467	723
10	"10-out18230"	.20261	31	122	153
10	"10-out18231"	.34025	131	254	385
10	"10-out18232"	.38336	189	304	493
10	"10-out18233"	.99694	326	1	327
10	"10-out18234"	.36666	110	190	300
10	"10-out18235"	.30092	130	302	432
10	"10-out18236"	.51674	108	101	209
10	"10-out18237"	.64242	212	118	330
10	"10-out18238"	.25484	184	538	722
10	"10-out18239"	.57926	95	69	164
10	"10-out18240"	.19181	89	375	464
10	"10-out18241"	.30348	183	420	603
10	"10-out18242"	.29069	175	427	602
10	"10-out18243"	.32013	186	395	581
10	"10-out18244"	.36306	232	407	639
10	"10-out18245"	.39277	174	269	443
10	"10-out18246"	.42809	256	342	598
10	"10-out18247"	.42537	57	77	134
10	"10-out18248"	.81039	265	62	327
10	"10-out18249"	.48322	72	77	149
10	"10-out18250"	.31052	59	131	190
10	"10-out18251"	.10160	19	168	187
10	"10-out18252"	.25505	101	295	396
10	"10-out18253"	.34449	72	137	209
10	"10-out18254"	.99881	840	1	841
10	"10-out18255"	.47982	214	232	446
10	"10-out18256"	.89122	254	31	285
10	"10-out18257"	.43765	530	681	1211
10	"10-out18258"	.27069	242	652	894
10	"10-out18259"	.43785	155	199	354
10	"10-out18260"	.97026	979	30	1009
10	"10-out18261"	.33044	191	387	578
10	"10-out18262"	.30741	170	383	553
10	"10-out18263"	.43597	143	185	328
10	"10-out18264"	.99065	106	1	107
10	"10-out18265"	.35663	449	810	1259
10	"10-out18266"	.49033	203	211	414
10	"10-out18267"	.22915	632	2126	2758
10	"10-out18268"	.20816	556	2115	2671
10	"10-out18269"	.10416	40	344	384
10	"10-out18270"	.30370	41	94	135
10	"10-out18271"	.73992	606	213	819
10	"10-out18272"	.40632	167	244	411
10	"10-out18273"	.63485	153	88	241
10	"10-out18274"	.33544	159	315	474
10	"10-out18275"	.26337	64	179	243
10	"10-out18276"	.36690	51	88	139
10	"10-out18277"	.93286	931	67	998
10	"10-out18278"	.33783	25	49	74
10	"10-out18279"	.99876	809	1	810
10	"10-out18280"	.42832	251	335	586
10	"10-out18281"	.98198	109	2	111
10	"10-out18282"	.42333	127	173	300
10	"10-out18283"	.47712	73	80	153
10	"10-out18284"	.99447	180	1	181
10	"10-out18285"	.92628	377	30	407
10	"10-out18286"	.32207	515	1084	1599
10	"10-out18287"	.39621	628	957	1585
10	"10-out18288"	.39170	85	132	217
10	"10-out18289"	.24339	221	687	908
10	"10-out18290"	.26160	231	652	883
10	"10-out18291"	.34401	204	389	593
10	"10-out18292"	.27386	327	867	1194
10	"10-out18293"	.99590	243	1	244
10	"10-out18294"	.46138	227	265	492
10	"10-out18295"	.28521	81	203	284
10	"10-out18296"	.52678	59	53	112
10	"10-out18297"	.28855	58	143	201
10	"10-out18298"	.55000	132	108	240
10	"10-out18299"	.48435	325	346	671
10	"10-out18300"	.27164	709	1901	2610
10	"10-out18301"	.18306	294	1312	1606
10	"10-out18302"	.22010	346	1226	1572
10	"10-out18303"	.99915	1180	1	1181
10	"10-out18304"	.36784	508	873	1381
10	"10-out18305"	.35202	295	543	838
10	"10-out18306"	.46829	96	109	205
10	"10-out18307"	.38671	227	360	587
10	"10-out18308"	.45432	189	227	416
10	"10-out18309"	.37626	409	678	1087
10	"10-out18310"	.35130	189	349	538
10	"10-out18311"	.49342	150	154	304
10	"10-out18312"	.74463	312	107	419
10	"10-out18313"	.35265	219	402	621
10	"10-out18314"	.18848	36	155	191
10	"10-out18315"	.91839	619	55	674
10	"10-out18316"	.66374	454	230	684
10	"10-out18317"	.43767	158	203	361
10	"10-out18318"	.69139	233	104	337
10	"10-out18319"	.75964	256	81	337
10	"10-out18320"	.24819	103	312	415
10	"10-out18321"	.24759	103	313	416
10	"10-out18322"	.25592	108	314	422
10	"10-out18323"	.56144	233	182	415
10	"10-out18324"	.21252	95	352	447
10	"10-out18325"	.27788	142	369	511
10	"10-out18326"	.35083	147	272	419
10	"10-out18327"	.31351	116	254	370
10	"10-out18328"	.29090	112	273	385
10	"10-out18329"	.36554	174	302	476
10	"10-out18330"	.35094	93	172	265
10	"10-out18331"	.24568	57	175	232
10	"10-out18332"	.22897	98	330	428
10	"10-out18333"	.25059	105	314	419
10	"10-out18334"	.26872	61	166	227
10	"10-out18335"	.34814	94	176	270
10	"10-out18336"	.31662	120	259	379
10	"10-out18337"	.28717	112	278	390
10	"10-out18338"	.45531	107	128	235
10	"10-out18339"	.74193	207	72	279
10	"10-out18340"	.38297	162	261	423
10	"10-out18341"	.62406	83	50	133
10	"10-out18342"	.28106	95	243	338
10	"10-out18343"	.15584	72	390	462
10	"10-out18344"	.60714	51	33	84
10	"10-out18345"	.55384	180	145	325
10	"10-out18346"	.39543	104	159	263
10	"10-out18347"	.49624	132	134	266
10	"10-out18348"	.36704	98	169	267
10	"10-out18349"	.18452	31	137	168
10	"10-out18350"	.34161	165	318	483
10	"10-out18351"	.17787	119	550	669
10	"10-out18352"	.99324	147	1	148
10	"10-out18353"	.92741	460	36	496
10	"10-out18354"	.38104	189	307	496
10	"10-out18355"	.96035	218	9	227
10	"10-out18356"	.99551	222	1	223
10	"10-out18357"	.57287	397	296	693
10	"10-out18358"	.55913	52	41	93
10	"10-out18359"	.55482	339	272	611
10	"10-out18360"	.48913	90	94	184
10	"10-out18361"	.27027	70	189	259
10	"10-out18362"	.21115	53	198	251
10	"10-out18363"	.29300	356	859	1215
10	"10-out18364"	.29831	284	668	952
10	"10-out18365"	.36817	317	544	861
10	"10-out18366"	.25222	255	756	1011
10	"10-out18367"	.99824	569	1	570
10	"10-out18368"	.08994	17	172	189
10	"10-out18369"	.26446	64	178	242
10	"10-out18370"	.29843	191	449	640
10	"10-out18371"	.42448	208	282	490
10	"10-out18372"	.30030	200	466	666
10	"10-out18373"	.24448	122	377	499
10	"10-out18374"	.21863	122	436	558
10	"10-out18375"	.49221	158	163	321
10	"10-out18376"	.32629	139	287	426
10	"10-out18377"	.25050	124	371	495
10	"10-out18378"	.32521	187	388	575
10	"10-out18379"	.17434	87	412	499
10	"10-out18380"	.31454	106	231	337
10	"10-out18381"	.34463	183	348	531
10	"10-out18382"	.99839	621	1	622
10	"10-out18383"	.35334	459	840	1299
10	"10-out18384"	.57142	356	267	623
10	"10-out18385"	.18800	47	203	250
10	"10-out18386"	.31306	103	226	329
10	"10-out18387"	.21739	230	828	1058
10	"10-out18388"	.99559	905	4	909
10	"10-out18389"	.99825	573	1	574
10	"10-out18390"	.48159	314	338	652
10	"10-out18391"	.42857	357	476	833
10	"10-out18392"	.25659	107	310	417
10	"10-out18393"	.99090	109	1	110
10	"10-out18394"	.98319	117	2	119
10	"10-out18395"	1.00000	353	0	353
10	"10-out18396"	1.00000	340	0	340
10	"10-out18397"	1.00000	377	0	377
10	"10-out18398"	1.00000	453	0	453
10	"10-out18399"	1.00000	106	0	106
10	"10-out18400"	.29336	137	330	467
10	"10-out18401"	.38019	119	194	313
10	"10-out18402"	.34341	159	304	463
10	"10-out18403"	.33996	188	365	553
10	"10-out18404"	.18245	52	233	285
10	"10-out18405"	.84666	127	23	150
10	"10-out18406"	.98901	90	1	91
10	"10-out18407"	.32865	117	239	356
10	"10-out18408"	.43769	137	176	313
10	"10-out18409"	.12716	66	453	519
10	"10-out18410"	.24524	129	397	526
10	"10-out18411"	.33593	43	85	128
10	"10-out18412"	.16923	99	486	585
10	"10-out18413"	.35322	148	271	419
10	"10-out18414"	.40449	72	106	178
10	"10-out18415"	.98717	77	1	78
10	"10-out18416"	.31506	46	100	146
10	"10-out18417"	.28378	378	954	1332
10	"10-out18418"	.51666	93	87	180
10	"10-out18419"	.32994	65	132	197
10	"10-out18420"	.68811	139	63	202
10	"10-out18421"	.20245	33	130	163
10	"10-out18422"	.43622	236	305	541
10	"10-out18423"	.83544	462	91	553
10	"10-out18424"	.43467	173	225	398
10	"10-out18425"	.33548	52	103	155
10	"10-out18426"	.30158	57	132	189
10	"10-out18427"	.33863	213	416	629
10	"10-out18428"	.90123	219	24	243
10	"10-out18429"	.39019	215	336	551
10	"10-out18430"	.25490	39	114	153
10	"10-out18431"	.82802	130	27	157
10	"10-out18432"	.26639	195	537	732
10	"10-out18433"	.90598	212	22	234
10	"10-out18434"	.41851	113	157	270
10	"10-out18435"	.30181	150	347	497
10	"10-out18436"	.99541	217	1	218
10	"10-out18437"	.37235	334	563	897
10	"10-out18438"	.31578	48	104	152
10	"10-out18439"	.42641	113	152	265
10	"10-out18440"	.36513	222	386	608
10	"10-out18441"	.27419	153	405	558
10	"10-out18442"	.30971	188	419	607
10	"10-out18443"	.25378	134	394	528
10	"10-out18444"	.22666	119	406	525
10	"10-out18445"	.47407	256	284	540
10	"10-out18446"	.23868	459	1464	1923
10	"10-out18447"	.19815	43	174	217
10	"10-out18448"	.32989	64	130	194
10	"10-out18449"	.31965	623	1326	1949
10	"10-out18450"	.92617	966	77	1043
10	"10-out18451"	.38194	165	267	432
10	"10-out18452"	.32608	60	124	184
10	"10-out18453"	.95945	213	9	222
10	"10-out18454"	.96396	214	8	222
10	"10-out18455"	.99590	243	1	244
10	"10-out18456"	.53333	112	98	210
10	"10-out18457"	.38337	452	727	1179
10	"10-out18458"	.55683	534	425	959
10	"10-out18459"	.99583	239	1	240
10	"10-out18460"	.99051	940	9	949
10	"10-out18461"	.33118	206	416	622
10	"10-out18462"	.25138	181	539	720
10	"10-out18463"	.99612	514	2	516
10	"10-out18464"	.43851	838	1073	1911
10	"10-out18465"	.31938	145	309	454
10	"10-out18466"	.98659	589	8	597
10	"10-out18467"	.85644	352	59	411
10	"10-out18468"	.55118	140	114	254
10	"10-out18469"	.47215	195	218	413
10	"10-out18470"	.31687	154	332	486
10	"10-out18471"	.33092	686	1387	2073
10	"10-out18472"	.29895	200	469	669
10	"10-out18473"	.36095	196	347	543
10	"10-out18474"	.38114	186	302	488
10	"10-out18475"	.31830	120	257	377
10	"10-out18476"	.38917	302	474	776
10	"10-out18477"	.35427	688	1254	1942
10	"10-out18478"	.40871	450	651	1101
10	"10-out18479"	.30303	140	322	462
10	"10-out18480"	.36363	48	84	132
10	"10-out18481"	.20997	80	301	381
10	"10-out18482"	.97749	695	16	711
10	"10-out18483"	.63095	53	31	84
10	"10-out18484"	.52444	118	107	225
10	"10-out18485"	.94036	205	13	218
10	"10-out18486"	.37601	185	307	492
10	"10-out18487"	.32805	352	721	1073
10	"10-out18488"	.41626	87	122	209
10	"10-out18489"	.46153	150	175	325
10	"10-out18490"	.29411	75	180	255
10	"10-out18491"	.24048	120	379	499
10	"10-out18492"	.24038	175	553	728
10	"10-out18493"	.22148	268	942	1210
10	"10-out18494"	.36916	182	311	493
10	"10-out18495"	.24877	253	764	1017
10	"10-out18496"	.24778	56	170	226
10	"10-out18497"	.41693	261	365	626
10	"10-out18498"	.34957	208	387	595
10	"10-out18499"	.26804	52	142	194
10	"10-out18500"	.93846	488	32	520
10	"10-out18501"	.22707	104	354	458
10	"10-out18502"	.28053	147	377	524
10	"10-out18503"	.25748	43	124	167
10	"10-out18504"	.35859	194	347	541
10	"10-out18505"	.23888	129	411	540
10	"10-out18506"	.31138	175	387	562
10	"10-out18507"	.24217	116	363	479
10	"10-out18508"	.95041	345	18	363
10	"10-out18509"	.26053	68	193	261
10	"10-out18510"	.33146	295	595	890
10	"10-out18511"	.27014	114	308	422
10	"10-out18512"	.33383	669	1335	2004
10	"10-out18513"	.43832	199	255	454
10	"10-out18514"	.28118	133	340	473
10	"10-out18515"	.26644	81	223	304
10	"10-out18516"	.55388	406	327	733
10	"10-out18517"	.98969	96	1	97
10	"10-out18518"	.99056	105	1	106
10	"10-out18519"	.32126	213	450	663
10	"10-out18520"	.21645	50	181	231
10	"10-out18521"	.20916	73	276	349
10	"10-out18522"	.28089	300	768	1068
10	"10-out18523"	.37200	93	157	250
10	"10-out18524"	.75981	329	104	433
10	"10-out18525"	.25277	91	269	360
10	"10-out18526"	.23853	104	332	436
10	"10-out18527"	.25600	96	279	375
10	"10-out18528"	.25598	107	311	418
10	"10-out18529"	.80369	348	85	433
10	"10-out18530"	.33252	411	825	1236
10	"10-out18531"	.26178	50	141	191
10	"10-out18532"	.20476	43	167	210
10	"10-out18533"	.41984	165	228	393
10	"10-out18534"	.30083	108	251	359
10	"10-out18535"	.71929	82	32	114
10	"10-out18536"	.47232	367	410	777
10	"10-out18537"	.34235	177	340	517
10	"10-out18538"	.85279	168	29	197
10	"10-out18539"	.39263	64	99	163
10	"10-out18540"	.26785	90	246	336
10	"10-out18541"	.13636	18	114	132
10	"10-out18542"	.21428	150	550	700
10	"10-out18543"	.24837	153	463	616
10	"10-out18544"	.99264	135	1	136
10	"10-out18545"	.99718	354	1	355
10	"10-out18546"	.26744	46	126	172
10	"10-out18547"	.25519	135	394	529
10	"10-out18548"	.89622	95	11	106
10	"10-out18549"	.95238	120	6	126
10	"10-out18550"	.75698	271	87	358
10	"10-out18551"	.98843	342	4	346
10	"10-out18552"	.99408	336	2	338
10	"10-out18553"	.98895	358	4	362
10	"10-out18554"	.33966	161	313	474
10	"10-out18555"	.97560	40	1	41
10	"10-out18556"	.95833	23	1	24
10	"10-out18557"	.96296	26	1	27
10	"10-out18558"	.24088	152	479	631
10	"10-out18559"	.49095	353	366	719
10	"10-out18560"	.21374	84	309	393
10	"10-out18561"	.97701	340	8	348
10	"10-out18562"	.22968	65	218	283
10	"10-out18563"	.28725	266	660	926
10	"10-out18564"	.32307	84	176	260
10	"10-out18565"	.30067	89	207	296
10	"10-out18566"	.48475	159	169	328
10	"10-out18567"	.30755	171	385	556
10	"10-out18568"	.40338	167	247	414
10	"10-out18569"	.26262	26	73	99
10	"10-out18570"	.44732	293	362	655
10	"10-out18571"	.14524	174	1024	1198
10	"10-out18572"	.99719	355	1	356
10	"10-out18573"	.71929	41	16	57
10	"10-out18574"	.30769	56	126	182
10	"10-out18575"	.64705	33	18	51
10	"10-out18576"	.99295	1128	8	1136
10	"10-out18577"	.42490	116	157	273
10	"10-out18578"	.40566	129	189	318
10	"10-out18579"	.60426	255	167	422
10	"10-out18580"	.42000	126	174	300
10	"10-out18581"	.99145	116	1	117
10	"10-out18582"	.99145	116	1	117
10	"10-out18583"	.99145	116	1	117
10	"10-out18584"	.33715	235	462	697
10	"10-out18585"	.50000	183	183	366
10	"10-out18586"	.43710	278	358	636
10	"10-out18587"	.94827	385	21	406
10	"10-out18588"	.27423	116	307	423
10	"10-out18589"	.99555	224	1	225
10	"10-out18590"	.99541	217	1	218
10	"10-out18591"	.25358	177	521	698
10	"10-out18592"	1.00000	330	0	330
10	"10-out18593"	1.00000	327	0	327
10	"10-out18594"	1.00000	106	0	106
10	"10-out18595"	.39384	371	571	942
10	"10-out18596"	.83657	215	42	257
10	"10-out18597"	.26756	99	271	370
10	"10-out18598"	.32579	72	149	221
10	"10-out18599"	.99585	240	1	241
10	"10-out18600"	.95495	212	10	222
10	"10-out18601"	.99418	171	1	172
10	"10-out18602"	.43792	194	249	443
10	"10-out18603"	.34015	299	580	879
10	"10-out18604"	.24830	183	554	737
10	"10-out18605"	.36153	47	83	130
10	"10-out18606"	.32307	42	88	130
10	"10-out18607"	.31250	40	88	128
10	"10-out18608"	.31007	40	89	129
10	"10-out18609"	.26923	35	95	130
10	"10-out18610"	.99130	114	1	115
10	"10-out18611"	.24193	90	282	372
10	"10-out18612"	.93750	120	8	128
10	"10-out18613"	.64285	81	45	126
10	"10-out18614"	.64285	81	45	126
10	"10-out18615"	.68253	86	40	126
10	"10-out18616"	.65079	82	44	126
10	"10-out18617"	.65079	82	44	126
10	"10-out18618"	.66666	84	42	126
10	"10-out18619"	.68253	86	40	126
10	"10-out18620"	.18382	25	111	136
10	"10-out18621"	.37500	51	85	136
10	"10-out18622"	.26470	36	100	136
10	"10-out18623"	.73103	212	78	290
10	"10-out18624"	.35912	427	762	1189
10	"10-out18625"	.28648	106	264	370
10	"10-out18626"	.70473	253	106	359
10	"10-out18627"	.30706	113	255	368
10	"10-out18628"	.36341	149	261	410
10	"10-out18629"	.99295	141	1	142
10	"10-out18630"	.98591	140	2	142
10	"10-out18631"	.98617	214	3	217
10	"10-out18632"	.35505	158	287	445
10	"10-out18633"	.40484	117	172	289
10	"10-out18634"	.29745	362	855	1217
10	"10-out18635"	.16285	57	293	350
10	"10-out18636"	.35294	78	143	221
10	"10-out18637"	.78343	369	102	471
10	"10-out18638"	.30000	126	294	420
10	"10-out18639"	.23222	147	486	633
10	"10-out18640"	.99082	216	2	218
10	"10-out18641"	.99264	135	1	136
10	"10-out18642"	.41602	161	226	387
10	"10-out18643"	.37125	186	315	501
10	"10-out18644"	.27714	171	446	617
10	"10-out18645"	.36268	173	304	477
10	"10-out18646"	.28558	315	788	1103
10	"10-out18647"	.37500	90	150	240
10	"10-out18648"	.99606	253	1	254
10	"10-out18649"	.83636	368	72	440
10	"10-out18650"	.36568	260	451	711
10	"10-out18651"	.19534	42	173	215
10	"10-out18652"	.26291	56	157	213
10	"10-out18653"	.22374	49	170	219
10	"10-out18654"	.23529	60	195	255
10	"10-out18655"	.98969	96	1	97
10	"10-out18656"	.27551	108	284	392
10	"10-out18657"	.25954	34	97	131
10	"10-out18658"	.29230	38	92	130
10	"10-out18659"	.23076	30	100	130
10	"10-out18660"	.31250	40	88	128
10	"10-out18661"	.16153	21	109	130
10	"10-out18662"	.26573	38	105	143
10	"10-out18663"	.44094	56	71	127
10	"10-out18664"	.93264	180	13	193
10	"10-out18665"	.92073	151	13	164
10	"10-out18666"	.68253	86	40	126
10	"10-out18667"	.66666	84	42	126
10	"10-out18668"	.65873	83	43	126
10	"10-out18669"	.65873	83	43	126
10	"10-out18670"	.59530	431	293	724
10	"10-out18671"	.90596	2582	268	2850
10	"10-out18672"	.96428	27	1	28
10	"10-out18673"	.99527	421	2	423
10	"10-out18674"	.98798	329	4	333
10	"10-out18675"	.99750	400	1	401
10	"10-out18676"	.24147	85	267	352
10	"10-out18677"	.99152	117	1	118
10	"10-out18678"	.48881	153	160	313
10	"10-out18679"	.99145	116	1	117
10	"10-out18680"	.34722	150	282	432
10	"10-out18681"	.51282	140	133	273
10	"10-out18682"	.99130	114	1	115
10	"10-out18683"	.30994	53	118	171
10	"10-out18684"	.99578	236	1	237
10	"10-out18685"	.44725	106	131	237
10	"10-out18686"	.06557	8	114	122
10	"10-out18687"	.94067	444	28	472
10	"10-out18688"	.33246	127	255	382
10	"10-out18689"	.43551	206	267	473
10	"10-out18690"	.29661	35	83	118
10	"10-out18691"	.34421	116	221	337
10	"10-out18692"	.50149	168	167	335
10	"10-out18693"	.34615	180	340	520
10	"10-out18694"	.79819	265	67	332
10	"10-out18695"	.76492	205	63	268
10	"10-out18696"	.11620	38	289	327
10	"10-out18697"	.58718	165	116	281
10	"10-out18698"	.48679	848	894	1742
10	"10-out18699"	.38408	111	178	289
10	"10-out18700"	.49593	122	124	246
10	"10-out18701"	.10276	26	227	253
10	"10-out18702"	.33902	139	271	410
10	"10-out18703"	.41726	116	162	278
10	"10-out18704"	.28021	255	655	910
10	"10-out18705"	.30539	215	489	704
10	"10-out18706"	.42268	123	168	291
10	"10-out18707"	.45664	158	188	346
10	"10-out18708"	.33663	272	536	808
10	"10-out18709"	.53731	216	186	402
10	"10-out18710"	.19748	157	638	795
10	"10-out18711"	.44035	347	441	788
10	"10-out18712"	.20717	156	597	753
10	"10-out18713"	.34441	259	493	752
10	"10-out18714"	.38095	144	234	378
10	"10-out18715"	.54506	381	318	699
10	"10-out18716"	.32361	222	464	686
10	"10-out18717"	.40127	630	940	1570
10	"10-out18718"	.39543	711	1087	1798
10	"10-out18719"	.27043	354	955	1309
10	"10-out18720"	.25924	680	1943	2623
10	"10-out18721"	.33975	141	274	415
10	"10-out18722"	.39316	92	142	234
10	"10-out18723"	.24307	79	246	325
10	"10-out18724"	.40453	125	184	309
10	"10-out18725"	.16766	56	278	334
10	"10-out18726"	.45167	229	278	507
10	"10-out18727"	.14484	52	307	359
10	"10-out18728"	.12256	44	315	359
10	"10-out18729"	.99152	117	1	118
10	"10-out18730"	.99186	122	1	123
10	"10-out18731"	.99200	124	1	125
10	"10-out18732"	.41516	115	162	277
10	"10-out18733"	.32416	165	344	509
10	"10-out18734"	.41471	124	175	299
10	"10-out18735"	.29528	119	284	403
10	"10-out18736"	.30991	75	167	242
10	"10-out18737"	.21116	87	325	412
10	"10-out18738"	.99145	116	1	117
10	"10-out18739"	.27946	83	214	297
10	"10-out18740"	.51345	248	235	483
10	"10-out18741"	.99236	130	1	131
10	"10-out18742"	.38200	191	309	500
10	"10-out18743"	.33614	279	551	830
10	"10-out18744"	.97222	35	1	36
10	"10-out18745"	.19592	77	316	393
10	"10-out18746"	.97826	225	5	230
10	"10-out18747"	.30496	43	98	141
10	"10-out18748"	.99305	143	1	144
10	"10-out18749"	.22254	77	269	346
10	"10-out18750"	.42231	106	145	251
10	"10-out18751"	.26128	382	1080	1462
10	"10-out18752"	.82954	73	15	88
10	"10-out18753"	.41116	280	401	681
10	"10-out18754"	.37196	199	336	535
10	"10-out18755"	.29927	82	192	274
10	"10-out18756"	.54523	1139	950	2089
10	"10-out18757"	.99470	188	1	189
10	"10-out18758"	.38211	94	152	246
10	"10-out18759"	.44308	109	137	246
10	"10-out18760"	.45336	209	252	461
10	"10-out18761"	.32217	308	648	956
10	"10-out18762"	.18367	81	360	441
10	"10-out18763"	.19024	78	332	410
10	"10-out18764"	.24324	135	420	555
10	"10-out18765"	.43421	33	43	76
10	"10-out18766"	.95833	23	1	24
10	"10-out18767"	.95833	23	1	24
10	"10-out18768"	.64761	340	185	525
10	"10-out18769"	.16666	28	140	168
10	"10-out18770"	.18892	58	249	307
10	"10-out18771"	.67938	570	269	839
10	"10-out18772"	.29878	49	115	164
10	"10-out18773"	.99705	338	1	339
10	"10-out18774"	.37327	81	136	217
10	"10-out18775"	.81851	221	49	270
10	"10-out18776"	.58806	207	145	352
10	"10-out18777"	.25074	84	251	335
10	"10-out18778"	.55910	175	138	313
10	"10-out18779"	.25369	120	353	473
10	"10-out18780"	.99145	116	1	117
10	"10-out18781"	.44527	297	370	667
10	"10-out18782"	.99130	114	1	115
10	"10-out18783"	.50190	132	131	263
10	"10-out18784"	.35048	1533	2841	4374
10	"10-out18785"	.22945	134	450	584
10	"10-out18786"	.99145	116	1	117
10	"10-out18787"	.22733	168	571	739
10	"10-out18788"	.67991	325	153	478
10	"10-out18789"	.39615	103	157	260
10	"10-out18790"	.31336	361	791	1152
10	"10-out18791"	.46740	380	433	813
10	"10-out18792"	.43124	323	426	749
10	"10-out18793"	.65378	423	224	647
10	"10-out18794"	.43250	173	227	400
10	"10-out18795"	.99152	117	1	118
10	"10-out18796"	.24827	108	327	435
10	"10-out18797"	.99152	117	1	118
10	"10-out18798"	.94063	4817	304	5121
10	"10-out18799"	.99145	116	1	117
10	"10-out18800"	.99137	115	1	116
10	"10-out18801"	.25714	117	338	455
10	"10-out18802"	.99159	118	1	119
10	"10-out18803"	.27939	221	570	791
10	"10-out18804"	.99145	116	1	117
10	"10-out18805"	.33593	43	85	128
10	"10-out18806"	.48920	136	142	278
10	"10-out18807"	.43125	69	91	160
10	"10-out18808"	.32563	310	642	952
10	"10-out18809"	.30663	134	303	437
10	"10-out18810"	.54838	85	70	155
10	"10-out18811"	.38867	199	313	512
10	"10-out18812"	.35731	149	268	417
10	"10-out18813"	.70642	231	96	327
10	"10-out18814"	.99519	207	1	208
10	"10-out18815"	.99519	207	1	208
10	"10-out18816"	.99519	207	1	208
10	"10-out18817"	.93383	494	35	529
10	"10-out18818"	.28624	154	384	538
10	"10-out18819"	.30223	162	374	536
10	"10-out18820"	.41714	73	102	175
10	"10-out18821"	.61797	220	136	356
10	"10-out18822"	.20274	59	232	291
10	"10-out18823"	.37766	301	496	797
10	"10-out18824"	.35838	329	589	918
10	"10-out18825"	.36462	101	176	277
10	"10-out18826"	.52000	104	96	200
10	"10-out18827"	.20618	20	77	97
10	"10-out18828"	.27323	194	516	710
10	"10-out18829"	.24573	72	221	293
10	"10-out18830"	.37195	366	618	984
10	"10-out18831"	.37746	325	536	861
10	"10-out18832"	.81961	727	160	887
10	"10-out18833"	.33567	334	661	995
10	"10-out18834"	.85121	349	61	410
10	"10-out18835"	.40730	145	211	356
10	"10-out18836"	.32712	123	253	376
10	"10-out18837"	.93023	120	9	129
10	"10-out18838"	.35955	32	57	89
10	"10-out18839"	.51890	151	140	291
10	"10-out18840"	.57553	160	118	278
10	"10-out18841"	.29545	169	403	572
10	"10-out18842"	.58000	290	210	500
10	"10-out18843"	.43832	167	214	381
10	"10-out18844"	.34122	245	473	718
10	"10-out18845"	.89428	313	37	350
10	"10-out18846"	.38523	287	458	745
10	"10-out18847"	.20370	154	602	756
10	"10-out18848"	.33659	241	475	716
10	"10-out18849"	.29746	188	444	632
10	"10-out18850"	.54297	259	218	477
10	"10-out18851"	.28937	79	194	273
10	"10-out18852"	.38244	122	197	319
10	"10-out18853"	.19889	72	290	362
10	"10-out18854"	.99519	207	1	208
10	"10-out18855"	.23711	69	222	291
10	"10-out18856"	.46802	161	183	344
10	"10-out18857"	.31264	136	299	435
10	"10-out18858"	.39425	192	295	487
10	"10-out18859"	.66949	316	156	472
10	"10-out18860"	.23446	83	271	354
10	"10-out18861"	.32565	99	205	304
10	"10-out18862"	.49677	308	312	620
10	"10-out18863"	.23386	192	629	821
10	"10-out18864"	.19471	140	579	719
10	"10-out18865"	.46547	391	449	840
10	"10-out18866"	.32545	372	771	1143
10	"10-out18867"	.28544	153	383	536
10	"10-out18868"	.62015	320	196	516
10	"10-out18869"	.98113	52	1	53
10	"10-out18870"	.39568	55	84	139
10	"10-out18871"	.96428	27	1	28
10	"10-out18872"	.58757	208	146	354
10	"10-out18873"	.35454	195	355	550
10	"10-out18874"	.36629	263	455	718
10	"10-out18875"	.25116	215	641	856
10	"10-out18876"	.97385	298	8	306
10	"10-out18877"	.29032	63	154	217
10	"10-out18878"	.50787	419	406	825
10	"10-out18879"	.53424	39	34	73
10	"10-out18880"	.96829	336	11	347
10	"10-out18881"	.92857	377	29	406
10	"10-out18882"	.99145	116	1	117
10	"10-out18883"	.99145	116	1	117
10	"10-out18884"	.20294	69	271	340
10	"10-out18885"	.99145	116	1	117
10	"10-out18886"	.52589	132	119	251
10	"10-out18887"	.88602	241	31	272
10	"10-out18888"	.99115	112	1	113
10	"10-out18889"	.12820	15	102	117
10	"10-out18890"	.33057	80	162	242
10	"10-out18891"	.37198	308	520	828
10	"10-out18892"	.55598	144	115	259
10	"10-out18893"	.99145	116	1	117
10	"10-out18894"	.49754	607	613	1220
10	"10-out18895"	.78938	461	123	584
10	"10-out18896"	.36423	220	384	604
10	"10-out18897"	.41834	187	260	447
10	"10-out18898"	.35051	68	126	194
10	"10-out18899"	.99509	203	1	204
10	"10-out18900"	.30346	403	925	1328
10	"10-out18901"	.58898	139	97	236
10	"10-out18902"	.26152	471	1330	1801
10	"10-out18903"	.20833	60	228	288
10	"10-out18904"	.36150	154	272	426
10	"10-out18905"	.35192	183	337	520
10	"10-out18906"	.31228	89	196	285
10	"10-out18907"	.30639	91	206	297
10	"10-out18908"	.99820	557	1	558
10	"10-out18909"	.23132	226	751	977
10	"10-out18910"	.32615	106	219	325
10	"10-out18911"	.46746	194	221	415
10	"10-out18912"	.95833	23	1	24
10	"10-out18913"	.33466	336	668	1004
10	"10-out18914"	.23389	167	547	714
10	"10-out18915"	.27184	28	75	103
10	"10-out18916"	.36000	45	80	125
10	"10-out18917"	.99159	118	1	119
10	"10-out18918"	.99159	118	1	119
10	"10-out18919"	.99137	115	1	116
10	"10-out18920"	.99145	116	1	117
10	"10-out18921"	.28776	120	297	417
10	"10-out18922"	.19883	68	274	342
10	"10-out18923"	.51693	229	214	443
10	"10-out18924"	.29466	254	608	862
10	"10-out18925"	.33665	169	333	502
10	"10-out18926"	.99145	116	1	117
10	"10-out18927"	.99145	116	1	117
10	"10-out18928"	.44221	352	444	796
10	"10-out18929"	.41860	108	150	258
10	"10-out18930"	.22909	63	212	275
10	"10-out18931"	.30258	82	189	271
10	"10-out18932"	.35416	85	155	240
10	"10-out18933"	.49963	676	677	1353
10	"10-out18934"	.99468	187	1	188
10	"10-out18935"	.32706	174	358	532
10	"10-out18936"	.21854	66	236	302
10	"10-out18937"	.85820	115	19	134
10	"10-out18938"	.22641	48	164	212
10	"10-out18939"	.67857	190	90	280
10	"10-out18940"	.99145	116	1	117
10	"10-out18941"	.28345	305	771	1076
10	"10-out18942"	.99145	116	1	117
10	"10-out18943"	.26765	72	197	269
10	"10-out18944"	.99145	116	1	117
10	"10-out18945"	.38619	207	329	536
10	"10-out18946"	.70312	225	95	320
10	"10-out18947"	.17021	40	195	235
10	"10-out18948"	.70769	92	38	130
10	"10-out18949"	.25075	249	744	993
10	"10-out18950"	.62124	538	328	866
10	"10-out18951"	.81679	749	168	917
10	"10-out18952"	.27848	176	456	632
10	"10-out18953"	.48148	78	84	162
10	"10-out18954"	.54964	155	127	282
10	"10-out18955"	.34859	99	185	284
10	"10-out18956"	.30491	186	424	610
10	"10-out18957"	.19597	39	160	199
10	"10-out18958"	.27818	153	397	550
10	"10-out18959"	.50395	191	188	379
10	"10-out18960"	.29646	134	318	452
10	"10-out18961"	.74752	302	102	404
10	"10-out18962"	.39922	103	155	258
10	"10-out18963"	.99305	143	1	144
10	"10-out18964"	.43470	253	329	582
10	"10-out18965"	.30588	535	1214	1749
10	"10-out18966"	.85714	78	13	91
10	"10-out18967"	.61538	64	40	104
10	"10-out18968"	.53846	42	36	78
10	"10-out18969"	.96822	457	15	472
10	"10-out18970"	.38666	29	46	75
10	"10-out18971"	.34741	222	417	639
10	"10-out18972"	.94894	316	17	333
10	"10-out18973"	.94029	504	32	536
10	"10-out18974"	.29338	142	342	484
10	"10-out18975"	.35144	97	179	276
10	"10-out18976"	.98296	404	7	411
10	"10-out18977"	.89919	223	25	248
10	"10-out18978"	.87012	134	20	154
10	"10-out18979"	.42448	208	282	490
10	"10-out18980"	.35892	173	309	482
10	"10-out18981"	.25480	53	155	208
10	"10-out18982"	.46859	97	110	207
10	"10-out18983"	.86666	169	26	195
10	"10-out18984"	.44230	92	116	208
10	"10-out18985"	.46833	281	319	600
10	"10-out18986"	.71428	120	48	168
10	"10-out18987"	.99115	112	1	113
10	"10-out18988"	.96165	326	13	339
10	"10-out18989"	.38480	481	769	1250
10	"10-out18990"	1.00000	107	0	107
10	"10-out18991"	.85514	183	31	214
10	"10-out18992"	.35989	944	1679	2623
10	"10-out18993"	.39490	124	190	314
10	"10-out18994"	.39622	126	192	318
10	"10-out18995"	.99324	147	1	148
10	"10-out18996"	.37519	245	408	653
10	"10-out18997"	.68702	90	41	131
10	"10-out18998"	.50090	276	275	551
10	"10-out18999"	.99555	224	1	225
10	"10-out19000"	.32695	171	352	523
10	"10-out19001"	.51785	116	108	224
10	"10-out19002"	.21582	341	1239	1580
10	"10-out19003"	.64037	276	155	431
10	"10-out19004"	.45974	257	302	559
10	"10-out19005"	.43907	227	290	517
10	"10-out19006"	.99236	130	1	131
10	"10-out19007"	.43442	53	69	122
10	"10-out19008"	.20769	27	103	130
10	"10-out19009"	.46439	476	549	1025
10	"10-out19010"	.35169	166	306	472
10	"10-out19011"	.99200	124	1	125
10	"10-out19012"	.99242	131	1	132
10	"10-out19013"	.99248	132	1	133
10	"10-out19014"	.98941	187	2	189
10	"10-out19015"	.98941	187	2	189
10	"10-out19016"	.98941	187	2	189
10	"10-out19017"	.99468	187	1	188
10	"10-out19018"	.99470	188	1	189
10	"10-out19019"	.36363	184	322	506
10	"10-out19020"	.81818	108	24	132
10	"10-out19021"	.42702	79	106	185
10	"10-out19022"	.40860	76	110	186
10	"10-out19023"	.30434	133	304	437
10	"10-out19024"	.30144	167	387	554
10	"10-out19025"	.36130	155	274	429
10	"10-out19026"	.67953	528	249	777
10	"10-out19027"	.28253	89	226	315
10	"10-out19028"	.99784	462	1	463
10	"10-out19029"	.31506	92	200	292
10	"10-out19030"	.20685	157	602	759
10	"10-out19031"	.99000	99	1	100
10	"10-out19032"	.43922	271	346	617
10	"10-out19033"	.99836	610	1	611
10	"10-out19034"	.32763	230	472	702
10	"10-out19035"	.95852	208	9	217
10	"10-out19036"	.17241	20	96	116
10	"10-out19037"	.34351	180	344	524
10	"10-out19038"	1.00000	428	0	428
10	"10-out19039"	1.00000	106	0	106
10	"10-out19040"	.29853	183	430	613
10	"10-out19041"	.98936	93	1	94
10	"10-out19042"	.82825	299	62	361
10	"10-out19043"	.98039	400	8	408
10	"10-out19044"	.22889	122	411	533
10	"10-out19045"	.99145	116	1	117
10	"10-out19046"	.34281	217	416	633
10	"10-out19047"	.82926	170	35	205
10	"10-out19048"	.30769	56	126	182
10	"10-out19049"	.24666	37	113	150
10	"10-out19050"	.57647	98	72	170
10	"10-out19051"	.21247	395	1464	1859
10	"10-out19052"	.98529	67	1	68
10	"10-out19053"	.17970	85	388	473
10	"10-out19054"	.89705	61	7	68
10	"10-out19055"	.23230	105	347	452
10	"10-out19056"	.30537	142	323	465
10	"10-out19057"	.99421	172	1	173
10	"10-out19058"	.23605	165	534	699
10	"10-out19059"	.32864	257	525	782
10	"10-out19060"	.29875	216	507	723
10	"10-out19061"	.27800	139	361	500
10	"10-out19062"	.20382	32	125	157
10	"10-out19063"	.31354	206	451	657
10	"10-out19064"	.56355	133	103	236
10	"10-out19065"	.54228	327	276	603
10	"10-out19066"	.32611	241	498	739
10	"10-out19067"	.66594	929	466	1395
10	"10-out19068"	.28333	136	344	480
10	"10-out19069"	.88636	468	60	528
10	"10-out19070"	.90735	333	34	367
10	"10-out19071"	.28546	165	413	578
10	"10-out19072"	.69852	95	41	136
10	"10-out19073"	.25295	107	316	423
10	"10-out19074"	.20588	70	270	340
10	"10-out19075"	.50724	35	34	69
10	"10-out19076"	.64383	47	26	73
10	"10-out19077"	.31929	144	307	451
10	"10-out19078"	1.00000	17	0	17
10	"10-out19079"	.62466	233	140	373
10	"10-out19080"	.35828	268	480	748
10	"10-out19081"	.23990	202	640	842
10	"10-out19082"	.57659	335	246	581
10	"10-out19083"	.41507	325	458	783
10	"10-out19084"	.42692	631	847	1478
10	"10-out19085"	.99137	115	1	116
10	"10-out19086"	.99145	116	1	117
10	"10-out19087"	.32929	652	1328	1980
10	"10-out19088"	.87557	190	27	217
10	"10-out19089"	.30870	117	262	379
10	"10-out19090"	.37027	147	250	397
10	"10-out19091"	.43035	275	364	639
10	"10-out19092"	.53781	320	275	595
10	"10-out19093"	.32478	38	79	117
10	"10-out19094"	.97314	616	17	633
10	"10-out19095"	.45600	114	136	250
10	"10-out19096"	.22602	99	339	438
10	"10-out19097"	.31659	208	449	657
10	"10-out19098"	.36616	171	296	467
10	"10-out19099"	.14662	100	582	682
10	"10-out19100"	.99648	567	2	569
10	"10-out19101"	.37402	144	241	385
10	"10-out19102"	.68617	129	59	188
10	"10-out19103"	.99137	115	1	116
10	"10-out19104"	.26888	178	484	662
10	"10-out19105"	.82275	376	81	457
10	"10-out19106"	.89968	287	32	319
10	"10-out19107"	.67142	235	115	350
10	"10-out19108"	.28251	202	513	715
10	"10-out19109"	.32272	213	447	660
10	"10-out19110"	.40192	125	186	311
10	"10-out19111"	.99612	257	1	258
10	"10-out19112"	.84698	393	71	464
10	"10-out19113"	.24029	724	2289	3013
10	"10-out19114"	.27237	283	756	1039
10	"10-out19115"	.27442	587	1552	2139
10	"10-out19116"	.56760	743	566	1309
10	"10-out19117"	.99558	1802	8	1810
10	"10-out19118"	.85192	420	73	493
10	"10-out19119"	.22829	142	480	622
10	"10-out19120"	.32911	130	265	395
10	"10-out19121"	.98648	73	1	74
10	"10-out19122"	.99766	428	1	429
10	"10-out19123"	.99849	665	1	666
10	"10-out19124"	.38924	181	284	465
10	"10-out19125"	.37032	287	488	775
10	"10-out19126"	.53649	419	362	781
10	"10-out19127"	.37473	175	292	467
10	"10-out19128"	.34151	153	295	448
10	"10-out19129"	.99895	960	1	961
10	"10-out19130"	.17564	88	413	501
10	"10-out19131"	.99849	665	1	666
10	"10-out19132"	.22388	60	208	268
10	"10-out19133"	.25507	113	330	443
10	"10-out19134"	.54524	241	201	442
10	"10-out19135"	.37857	318	522	840
10	"10-out19136"	.72291	467	179	646
10	"10-out19137"	.41650	212	297	509
10	"10-out19138"	.30425	286	654	940
10	"10-out19139"	.11764	8	60	68
10	"10-out19140"	.83760	98	19	117
10	"10-out19141"	.16967	94	460	554
10	"10-out19142"	.86890	517	78	595
10	"10-out19143"	.22045	97	343	440
10	"10-out19144"	.25158	159	473	632
10	"10-out19145"	.17299	82	392	474
10	"10-out19146"	.26760	19	52	71
10	"10-out19147"	.99768	431	1	432
10	"10-out19148"	.99808	521	1	522
10	"10-out19149"	.99818	549	1	550
10	"10-out19150"	.29411	90	216	306
10	"10-out19151"	.45689	212	252	464
10	"10-out19152"	.50909	308	297	605
10	"10-out19153"	.99806	517	1	518
10	"10-out19154"	.99145	116	1	117
10	"10-out19155"	.43776	204	262	466
10	"10-out19156"	.71335	219	88	307
10	"10-out19157"	.42406	148	201	349
10	"10-out19158"	.42660	279	375	654
10	"10-out19159"	.32478	38	79	117
10	"10-out19160"	.97872	46	1	47
10	"10-out19161"	.99779	905	2	907
10	"10-out19162"	.90259	139	15	154
10	"10-out19163"	.29294	324	782	1106
10	"10-out19164"	.62234	234	142	376
10	"10-out19165"	.26193	203	572	775
10	"10-out19166"	.22857	56	189	245
10	"10-out19167"	.26573	38	105	143
10	"10-out19168"	.34684	154	290	444
10	"10-out19169"	.74267	355	123	478
10	"10-out19170"	.94708	179	10	189
10	"10-out19171"	.47230	162	181	343
10	"10-out19172"	.31049	145	322	467
10	"10-out19173"	.67611	167	80	247
10	"10-out19174"	.33253	139	279	418
10	"10-out19175"	.20781	101	385	486
10	"10-out19176"	.35754	192	345	537
10	"10-out19177"	.98750	79	1	80
10	"10-out19178"	.99280	138	1	139
10	"10-out19179"	.36224	142	250	392
10	"10-out19180"	.28165	129	329	458
10	"10-out19181"	.34666	26	49	75
10	"10-out19182"	.96615	571	20	591
10	"10-out19183"	.40918	196	283	479
10	"10-out19184"	.97178	620	18	638
10	"10-out19185"	.91452	107	10	117
10	"10-out19186"	.60055	218	145	363
10	"10-out19187"	.21341	105	387	492
10	"10-out19188"	.43675	221	285	506
10	"10-out19189"	.32048	291	617	908
10	"10-out19190"	.48895	155	162	317
10	"10-out19191"	.99719	355	1	356
10	"10-out19192"	.29381	114	274	388
10	"10-out19193"	.52941	549	488	1037
10	"10-out19194"	.99426	5030	29	5059
10	"10-out19195"	.22747	202	686	888
10	"10-out19196"	.69047	290	130	420
10	"10-out19197"	.48630	355	375	730
10	"10-out19198"	.40883	222	321	543
10	"10-out19199"	.15753	23	123	146
10	"10-out19200"	.32284	277	581	858
10	"10-out19201"	.21798	80	287	367
10	"10-out19202"	.96584	707	25	732
10	"10-out19203"	.35454	117	213	330
10	"10-out19204"	.50000	243	243	486
10	"10-out19205"	.36629	163	282	445
10	"10-out19206"	.29756	183	432	615
10	"10-out19207"	.99295	141	1	142
10	"10-out19208"	.99743	389	1	390
10	"10-out19209"	.43348	290	379	669
10	"10-out19210"	.83678	323	63	386
10	"10-out19211"	.21893	266	949	1215
10	"10-out19212"	.08668	28	295	323
10	"10-out19213"	.19893	75	302	377
10	"10-out19214"	.12698	8	55	63
10	"10-out19215"	.27953	97	250	347
10	"10-out19216"	.24685	1391	4244	5635
10	"10-out19217"	.51153	266	254	520
10	"10-out19218"	.62500	245	147	392
10	"10-out19219"	.97849	91	2	93
10	"10-out19220"	.34615	99	187	286
10	"10-out19221"	.26903	212	576	788
10	"10-out19222"	.48260	111	119	230
10	"10-out19223"	.95907	750	32	782
10	"10-out19224"	.65883	477	247	724
10	"10-out19225"	.41600	104	146	250
10	"10-out19226"	.43705	243	313	556
10	"10-out19227"	.50545	510	499	1009
10	"10-out19228"	.22619	95	325	420
10	"10-out19229"	.37288	132	222	354
10	"10-out19230"	.82758	288	60	348
10	"10-out19231"	.37009	151	257	408
10	"10-out19232"	.29892	139	326	465
10	"10-out19233"	.95833	23	1	24
10	"10-out19234"	.77777	70	20	90
10	"10-out19235"	.40384	294	434	728
10	"10-out19236"	.32612	196	405	601
10	"10-out19237"	.25675	152	440	592
10	"10-out19238"	.23853	78	249	327
10	"10-out19239"	.30944	95	212	307
10	"10-out19240"	.98920	458	5	463
10	"10-out19241"	.71631	202	80	282
10	"10-out19242"	.56124	252	197	449
10	"10-out19243"	.50458	110	108	218
10	"10-out19244"	.36923	144	246	390
10	"10-out19245"	.87037	141	21	162
10	"10-out19246"	.26219	43	121	164
10	"10-out19247"	.82432	61	13	74
10	"10-out19248"	.43829	103	132	235
10	"10-out19249"	.21348	76	280	356
10	"10-out19250"	.40947	147	212	359
10	"10-out19251"	.38876	173	272	445
10	"10-out19252"	.81343	436	100	536
10	"10-out19253"	.39837	196	296	492
10	"10-out19254"	.15686	8	43	51
10	"10-out19255"	.49230	128	132	260
10	"10-out19256"	.34400	86	164	250
10	"10-out19257"	.99145	116	1	117
10	"10-out19258"	.25724	142	410	552
10	"10-out19259"	.99159	118	1	119
10	"10-out19260"	.35925	97	173	270
10	"10-out19261"	.57012	187	141	328
10	"10-out19262"	.99145	116	1	117
10	"10-out19263"	.44326	125	157	282
10	"10-out19264"	.99130	114	1	115
10	"10-out19265"	.30050	180	419	599
10	"10-out19266"	.46208	195	227	422
10	"10-out19267"	.44968	286	350	636
10	"10-out19268"	.46461	151	174	325
10	"10-out19269"	.19378	106	441	547
10	"10-out19270"	.99275	137	1	138
10	"10-out19271"	.35646	113	204	317
10	"10-out19272"	.24606	125	383	508
10	"10-out19273"	.50750	169	164	333
10	"10-out19274"	.80845	287	68	355
10	"10-out19275"	.27058	138	372	510
10	"10-out19276"	.13194	38	250	288
10	"10-out19277"	.61290	209	132	341
10	"10-out19278"	.40036	217	325	542
10	"10-out19279"	.35277	127	233	360
10	"10-out19280"	.87912	80	11	91
10	"10-out19281"	.28296	191	484	675
10	"10-out19282"	.37026	254	432	686
10	"10-out19283"	.97667	335	8	343
10	"10-out19284"	.36842	168	288	456
10	"10-out19285"	.48888	66	69	135
10	"10-out19286"	.43032	210	278	488
10	"10-out19287"	.43137	154	203	357
10	"10-out19288"	.95833	23	1	24
10	"10-out19289"	.87500	21	3	24
10	"10-out19290"	.95833	23	1	24
10	"10-out19291"	.82828	82	17	99
10	"10-out19292"	.95755	564	25	589
10	"10-out19293"	.84911	529	94	623
10	"10-out19294"	.44202	61	77	138
10	"10-out19295"	.81115	189	44	233
10	"10-out19296"	.67455	228	110	338
10	"10-out19297"	.99145	116	1	117
10	"10-out19298"	.99152	117	1	118
10	"10-out19299"	.31250	70	154	224
10	"10-out19300"	.23867	137	437	574
10	"10-out19301"	.18918	42	180	222
10	"10-out19302"	.39602	219	334	553
10	"10-out19303"	.72916	245	91	336
10	"10-out19304"	.99145	116	1	117
10	"10-out19305"	.43678	152	196	348
10	"10-out19306"	.48501	696	739	1435
10	"10-out19307"	.92417	195	16	211
10	"10-out19308"	.24060	96	303	399
10	"10-out19309"	.35956	297	529	826
10	"10-out19310"	.99295	141	1	142
10	"10-out19311"	.21515	71	259	330
10	"10-out19312"	.99801	503	1	504
10	"10-out19313"	.21481	29	106	135
10	"10-out19314"	.48518	131	139	270
10	"10-out19315"	.58163	57	41	98
10	"10-out19316"	.38305	113	182	295
10	"10-out19317"	.40270	149	221	370
10	"10-out19318"	.41807	148	206	354
10	"10-out19319"	.34079	137	265	402
10	"10-out19320"	.95833	23	1	24
10	"10-out19321"	.83333	20	4	24
10	"10-out19322"	.31506	92	200	292
10	"10-out19323"	.98976	290	3	293
10	"10-out19324"	.98976	290	3	293
10	"10-out19325"	.29113	92	224	316
10	"10-out19326"	.46033	708	830	1538
10	"10-out19327"	.25711	298	861	1159
10	"10-out19328"	.35804	198	355	553
10	"10-out19329"	.18926	67	287	354
10	"10-out19330"	.48000	336	364	700
10	"10-out19331"	.99913	1157	1	1158
10	"10-out19332"	.62608	72	43	115
10	"10-out19333"	.50993	385	370	755
10	"10-out19334"	.29166	28	68	96
10	"10-out19335"	.16030	21	110	131
10	"10-out19336"	.38262	163	263	426
10	"10-out19337"	.26408	75	209	284
10	"10-out19338"	.99159	118	1	119
10	"10-out19339"	.99159	118	1	119
10	"10-out19340"	.43063	149	197	346
10	"10-out19341"	.98275	57	1	58
10	"10-out19342"	.99145	116	1	117
10	"10-out19343"	.99152	117	1	118
10	"10-out19344"	.25201	94	279	373
10	"10-out19345"	.28947	88	216	304
10	"10-out19346"	.88000	88	12	100
10	"10-out19347"	.32132	116	245	361
10	"10-out19348"	.66666	60	30	90
10	"10-out19349"	.25852	144	413	557
10	"10-out19350"	.34805	260	487	747
10	"10-out19351"	.24797	92	279	371
10	"10-out19352"	.85025	335	59	394
10	"10-out19353"	.92196	319	27	346
10	"10-out19354"	.52849	102	91	193
10	"10-out19355"	.33165	66	133	199
10	"10-out19356"	.99551	222	1	223
10	"10-out19357"	.46236	129	150	279
10	"10-out19358"	.99700	333	1	334
10	"10-out19359"	.33675	164	323	487
10	"10-out19360"	.74358	290	100	390
10	"10-out19361"	.74102	475	166	641
10	"10-out19362"	.52418	336	305	641
10	"10-out19363"	.85526	65	11	76
10	"10-out19364"	.40453	214	315	529
10	"10-out19365"	.21257	71	263	334
10	"10-out19366"	.98798	329	4	333
10	"10-out19367"	.98976	290	3	293
10	"10-out19368"	.98976	290	3	293
10	"10-out19369"	.61469	276	173	449
10	"10-out19370"	.45086	156	190	346
10	"10-out19371"	.40042	187	280	467
10	"10-out19372"	.71879	455	178	633
10	"10-out19373"	.99721	358	1	359
10	"10-out19374"	.17277	33	158	191
10	"10-out19375"	.46113	89	104	193
10	"10-out19376"	.37429	265	443	708
10	"10-out19377"	.99043	414	4	418
10	"10-out19378"	.30635	106	240	346
10	"10-out19379"	.91228	312	30	342
10	"10-out19380"	.89162	362	44	406
10	"10-out19381"	.34563	206	390	596
10	"10-out19382"	.95833	23	1	24
10	"10-out19383"	.75000	60	20	80
10	"10-out19384"	.25899	72	206	278
10	"10-out19385"	.31428	88	192	280
10	"10-out19386"	.99152	117	1	118
10	"10-out19387"	.99145	116	1	117
10	"10-out19388"	.30196	77	178	255
10	"10-out19389"	.42226	220	301	521
10	"10-out19390"	.25027	231	692	923
10	"10-out19391"	.24897	61	184	245
10	"10-out19392"	.32751	338	694	1032
10	"10-out19393"	.31284	570	1252	1822
10	"10-out19394"	.24250	283	884	1167
10	"10-out19395"	.30162	241	558	799
10	"10-out19396"	.24310	194	604	798
10	"10-out19397"	.36477	379	660	1039
10	"10-out19398"	.36109	477	844	1321
10	"10-out19399"	.30601	56	127	183
10	"10-out19400"	.35526	351	637	988
10	"10-out19401"	.28969	270	662	932
10	"10-out19402"	.30297	163	375	538
10	"10-out19403"	.35746	79	142	221
10	"10-out19404"	.43091	184	243	427
10	"10-out19405"	.50381	198	195	393
10	"10-out19406"	.31376	171	374	545
10	"10-out19407"	.24735	117	356	473
10	"10-out19408"	.31712	861	1854	2715
10	"10-out19409"	.44267	2174	2737	4911
10	"10-out19410"	.31370	1737	3800	5537
10	"10-out19411"	.89956	412	46	458
10	"10-out19412"	.31336	387	848	1235
10	"10-out19413"	.26041	175	497	672
10	"10-out19414"	.25644	189	548	737
10	"10-out19415"	.26233	101	284	385
10	"10-out19416"	.84934	451	80	531
10	"10-out19417"	.99375	159	1	160
10	"10-out19418"	.35036	48	89	137
10	"10-out19419"	.82716	67	14	81
10	"10-out19420"	.76190	64	20	84
10	"10-out19421"	.88888	56	7	63
10	"10-out19422"	.93971	265	17	282
10	"10-out19423"	.88627	226	29	255
10	"10-out19424"	.92307	204	17	221
10	"10-out19425"	.98974	193	2	195
10	"10-out19426"	.97512	196	5	201
10	"10-out19427"	.99504	201	1	202
10	"10-out19428"	.99358	155	1	156
10	"10-out19429"	.93725	239	16	255
10	"10-out19430"	.94915	168	9	177
10	"10-out19431"	.73958	71	25	96
10	"10-out19432"	.85714	96	16	112
10	"10-out19433"	.97674	168	4	172
10	"10-out19434"	.95918	94	4	98
10	"10-out19435"	.96938	95	3	98
10	"10-out19436"	.97058	132	4	136
10	"10-out19437"	.86666	169	26	195
10	"10-out19438"	.93373	155	11	166
10	"10-out19439"	.96685	175	6	181
10	"10-out19440"	.97073	199	6	205
10	"10-out19441"	.97619	205	5	210
10	"10-out19442"	.97297	180	5	185
10	"10-out19443"	.96666	203	7	210
10	"10-out19444"	.90647	252	26	278
10	"10-out19445"	.98312	233	4	237
10	"10-out19446"	.94573	122	7	129
10	"10-out19447"	.99393	164	1	165
10	"10-out19448"	.98930	185	2	187
10	"10-out19449"	.99408	168	1	169
10	"10-out19450"	.90140	64	7	71
10	"10-out19451"	.80645	50	12	62
10	"10-out19452"	.88349	91	12	103
10	"10-out19453"	.77600	194	56	250
10	"10-out19454"	.97701	170	4	174
10	"10-out19455"	.96226	153	6	159
10	"10-out19456"	.97402	150	4	154
10	"10-out19457"	.95000	152	8	160
10	"10-out19458"	.95857	162	7	169
10	"10-out19459"	.99371	158	1	159
10	"10-out19460"	.26427	125	348	473
10	"10-out19461"	.46116	475	555	1030
10	"10-out19462"	.47656	61	67	128
10	"10-out19463"	.93567	160	11	171
10	"10-out19464"	.66593	303	152	455
10	"10-out19465"	.92650	416	33	449
10	"10-out19466"	.88815	405	51	456
10	"10-out19467"	.84584	417	76	493
10	"10-out19468"	.22510	165	568	733
10	"10-out19469"	.97508	900	23	923
10	"10-out19470"	.34210	325	625	950
10	"10-out19471"	.24273	117	365	482
10	"10-out19472"	.25234	269	797	1066
10	"10-out19473"	.54878	225	185	410
10	"10-out19474"	.90346	365	39	404
10	"10-out19475"	.48529	66	70	136
10	"10-out19476"	.98113	52	1	53
10	"10-out19477"	.99236	130	1	131
10	"10-out19478"	.99605	1009	4	1013
10	"10-out19479"	.83333	65	13	78
10	"10-out19480"	.91629	208	19	227
10	"10-out19481"	.24822	279	845	1124
10	"10-out19482"	.98955	379	4	383
10	"10-out19483"	.28151	134	342	476
10	"10-out19484"	.56226	298	232	530
10	"10-out19485"	.64529	302	166	468
10	"10-out19486"	.99641	834	3	837
10	"10-out19487"	.47861	235	256	491
10	"10-out19488"	.28278	455	1154	1609
10	"10-out19489"	.37876	667	1094	1761
10	"10-out19490"	.23805	284	909	1193
10	"10-out19491"	.36507	575	1000	1575
10	"10-out19492"	.59047	248	172	420
10	"10-out19493"	.81388	258	59	317
10	"10-out19494"	.89237	655	79	734
10	"10-out19495"	.28053	317	813	1130
10	"10-out19496"	.52671	138	124	262
10	"10-out19497"	.96568	394	14	408
10	"10-out19498"	.44332	309	388	697
10	"10-out19499"	.31121	319	706	1025
10	"10-out19500"	.43272	566	742	1308
10	"10-out19501"	.24532	118	363	481
10	"10-out19502"	.90677	107	11	118
10	"10-out19503"	.89830	106	12	118
10	"10-out19504"	.45033	68	83	151
10	"10-out19505"	.26627	229	631	860
10	"10-out19506"	.50541	140	137	277
10	"10-out19507"	.22413	52	180	232
10	"10-out19508"	.48577	222	235	457
10	"10-out19509"	.27554	213	560	773
10	"10-out19510"	.22598	40	137	177
10	"10-out19511"	.28744	213	528	741
10	"10-out19512"	.30264	891	2053	2944
10	"10-out19513"	.28469	240	603	843
10	"10-out19514"	.27956	208	536	744
10	"10-out19515"	.34417	201	383	584
10	"10-out19516"	.25247	51	151	202
10	"10-out19517"	.29315	270	651	921
10	"10-out19518"	.45718	315	374	689
10	"10-out19519"	.30821	45	101	146
10	"10-out19520"	.33333	29	58	87
10	"10-out19521"	.57012	187	141	328
10	"10-out19522"	.30795	89	200	289
10	"10-out19523"	.98936	93	1	94
10	"10-out19524"	.68778	1194	542	1736
10	"10-out19525"	.39700	478	726	1204
10	"10-out19526"	.68075	145	68	213
10	"10-out19527"	.38191	621	1005	1626
10	"10-out19528"	.09473	18	172	190
10	"10-out19529"	.37688	75	124	199
10	"10-out19530"	.32820	64	131	195
10	"10-out19531"	.71356	142	57	199
10	"10-out19532"	.79464	178	46	224
10	"10-out19533"	.19170	37	156	193
10	"10-out19534"	.30808	61	137	198
10	"10-out19535"	.36288	176	309	485
10	"10-out19536"	.23241	76	251	327
10	"10-out19537"	.38036	62	101	163
10	"10-out19538"	.55428	97	78	175
10	"10-out19539"	.25210	30	89	119
10	"10-out19540"	.47222	255	285	540
10	"10-out19541"	.38214	655	1059	1714
10	"10-out19542"	.41053	374	537	911
10	"10-out19543"	.75102	549	182	731
10	"10-out19544"	.70694	234	97	331
10	"10-out19545"	.45000	225	275	500
10	"10-out19546"	.42369	211	287	498
10	"10-out19547"	.25661	97	281	378
10	"10-out19548"	.29146	123	299	422
10	"10-out19549"	.27248	103	275	378
10	"10-out19550"	.22903	71	239	310
10	"10-out19551"	.99696	328	1	329
10	"10-out19552"	.19699	105	428	533
10	"10-out19553"	.38339	217	349	566
10	"10-out19554"	.35470	354	644	998
10	"10-out19555"	.85081	884	155	1039
10	"10-out19556"	.44974	179	219	398
10	"10-out19557"	.26623	82	226	308
10	"10-out19558"	.45555	82	98	180
10	"10-out19559"	.99047	104	1	105
10	"10-out19560"	.99694	326	1	327
10	"10-out19561"	.27972	40	103	143
10	"10-out19562"	.26254	136	382	518
10	"10-out19563"	.31610	104	225	329
10	"10-out19564"	.99206	250	2	252
10	"10-out19565"	.27848	88	228	316
10	"10-out19566"	.17365	87	414	501
10	"10-out19567"	.28301	75	190	265
10	"10-out19568"	.21217	122	453	575
10	"10-out19569"	.28623	158	394	552
10	"10-out19570"	.30341	142	326	468
10	"10-out19571"	.26728	58	159	217
10	"10-out19572"	.41279	71	101	172
10	"10-out19573"	.45350	356	429	785
10	"10-out19574"	.66804	161	80	241
10	"10-out19575"	.36477	116	202	318
10	"10-out19576"	.30749	119	268	387
10	"10-out19577"	.29390	82	197	279
10	"10-out19578"	.23312	114	375	489
10	"10-out19579"	.20000	105	420	525
10	"10-out19580"	.32956	613	1247	1860
10	"10-out19581"	.70044	159	68	227
10	"10-out19582"	.44023	685	871	1556
10	"10-out19583"	.20665	149	572	721
10	"10-out19584"	.92918	433	33	466
10	"10-out19585"	.94403	388	23	411
10	"10-out19586"	.21621	152	551	703
10	"10-out19587"	.53136	144	127	271
10	"10-out19588"	.27071	49	132	181
10	"10-out19589"	.26112	135	382	517
10	"10-out19590"	.43704	847	1091	1938
10	"10-out19591"	.51256	204	194	398
10	"10-out19592"	.26419	121	337	458
10	"10-out19593"	.99173	120	1	121
10	"10-out19594"	.99230	129	1	130
10	"10-out19595"	.26280	118	331	449
10	"10-out19596"	.57188	179	134	313
10	"10-out19597"	.86425	191	30	221
10	"10-out19598"	.54314	107	90	197
10	"10-out19599"	.55958	108	85	193
10	"10-out19600"	.45918	45	53	98
10	"10-out19601"	.99770	434	1	435
10	"10-out19602"	.22985	385	1290	1675
10	"10-out19603"	.18109	297	1343	1640
10	"10-out19604"	.46587	273	313	586
10	"10-out19605"	.88663	219	28	247
10	"10-out19606"	.78656	199	54	253
10	"10-out19607"	.37413	538	900	1438
10	"10-out19608"	.25959	142	405	547
10	"10-out19609"	.73553	89	32	121
10	"10-out19610"	.55609	114	91	205
10	"10-out19611"	.69196	155	69	224
10	"10-out19612"	.27622	79	207	286
10	"10-out19613"	.38061	322	524	846
10	"10-out19614"	.30853	452	1013	1465
10	"10-out19615"	.28941	123	302	425
10	"10-out19616"	.21186	75	279	354
10	"10-out19617"	.30581	100	227	327
10	"10-out19618"	.28529	97	243	340
10	"10-out19619"	.99390	163	1	164
10	"10-out19620"	.99692	324	1	325
10	"10-out19621"	.99528	211	1	212
10	"10-out19622"	.48582	257	272	529
10	"10-out19623"	.40247	130	193	323
10	"10-out19624"	.50111	225	224	449
10	"10-out19625"	.43129	113	149	262
10	"10-out19626"	.28742	240	595	835
10	"10-out19627"	.42786	1741	2328	4069
10	"10-out19628"	.44285	62	78	140
10	"10-out19629"	.98795	82	1	83
10	"10-out19630"	.98148	53	1	54
10	"10-out19631"	.99324	147	1	148
10	"10-out19632"	.51250	82	78	160
10	"10-out19633"	.32369	291	608	899
10	"10-out19634"	.36526	122	212	334
10	"10-out19635"	.91262	282	27	309
10	"10-out19636"	.27428	240	635	875
10	"10-out19637"	.57708	408	299	707
10	"10-out19638"	.39247	292	452	744
10	"10-out19639"	.38627	197	313	510
10	"10-out19640"	.55434	51	41	92
10	"10-out19641"	.16313	77	395	472
10	"10-out19642"	.41388	149	211	360
10	"10-out19643"	.21414	218	800	1018
10	"10-out19644"	.39818	438	662	1100
10	"10-out19645"	.24943	332	999	1331
10	"10-out19646"	.98936	93	1	94
10	"10-out19647"	.47752	85	93	178
10	"10-out19648"	.43935	460	587	1047
10	"10-out19649"	.72549	111	42	153
10	"10-out19650"	.32740	92	189	281
10	"10-out19651"	.50279	90	89	179
10	"10-out19652"	.24590	45	138	183
10	"10-out19653"	.48447	78	83	161
10	"10-out19654"	.30857	54	121	175
10	"10-out19655"	.99173	120	1	121
10	"10-out19656"	.33879	496	968	1464
10	"10-out19657"	.33086	492	995	1487
10	"10-out19658"	.75646	1258	405	1663
10	"10-out19659"	.35590	594	1075	1669
10	"10-out19660"	.30432	521	1191	1712
10	"10-out19661"	.32581	549	1136	1685
10	"10-out19662"	.99885	1742	2	1744
10	"10-out19663"	.99885	1742	2	1744
10	"10-out19664"	.28619	429	1070	1499
10	"10-out19665"	.20914	215	813	1028
10	"10-out19666"	.19921	203	816	1019
10	"10-out19667"	.25276	572	1691	2263
10	"10-out19668"	.38543	360	574	934
10	"10-out19669"	.51920	365	338	703
10	"10-out19670"	.31810	188	403	591
10	"10-out19671"	.35526	243	441	684
10	"10-out19672"	.46332	259	300	559
10	"10-out19673"	.24528	26	80	106
10	"10-out19674"	.72972	54	20	74
10	"10-out19675"	.66400	83	42	125
10	"10-out19676"	.32900	76	155	231
10	"10-out19677"	.34411	234	446	680
10	"10-out19678"	.38482	695	1111	1806
10	"10-out19679"	.47977	605	656	1261
10	"10-out19680"	.35678	492	887	1379
10	"10-out19681"	.33691	282	555	837
10	"10-out19682"	.28268	547	1388	1935
10	"10-out19683"	.34039	900	1744	2644
10	"10-out19684"	.23934	264	839	1103
10	"10-out19685"	.28526	271	679	950
10	"10-out19686"	.32602	357	738	1095
10	"10-out19687"	.35791	432	775	1207
10	"10-out19688"	.26105	124	351	475
10	"10-out19689"	.99534	1070	5	1075
10	"10-out19690"	.32432	48	100	148
10	"10-out19691"	.40707	138	201	339
10	"10-out19692"	.51260	183	174	357
10	"10-out19693"	.87593	353	50	403
10	"10-out19694"	.86337	297	47	344
10	"10-out19695"	.30525	935	2128	3063
10	"10-out19696"	.36363	200	350	550
10	"10-out19697"	.32078	230	487	717
10	"10-out19698"	.27820	254	659	913
10	"10-out19699"	.20507	105	407	512
10	"10-out19700"	.18274	108	483	591
10	"10-out19701"	.23478	135	440	575
10	"10-out19702"	.84337	140	26	166
10	"10-out19703"	.47668	92	101	193
10	"10-out19704"	.46987	78	88	166
10	"10-out19705"	.34438	478	910	1388
10	"10-out19706"	.26215	221	622	843
10	"10-out19707"	.23883	107	341	448
10	"10-out19708"	.99782	459	1	460
10	"10-out19709"	.24458	192	593	785
10	"10-out19710"	.20084	142	565	707
10	"10-out19711"	.17189	115	554	669
10	"10-out19712"	.63963	142	80	222
10	"10-out19713"	.65346	66	35	101
10	"10-out19714"	.26057	117	332	449
10	"10-out19715"	.41482	543	766	1309
10	"10-out19716"	.50896	142	137	279
10	"10-out19717"	.24292	292	910	1202
10	"10-out19718"	.36753	283	487	770
10	"10-out19719"	.25650	138	400	538
10	"10-out19720"	.99145	116	1	117
10	"10-out19721"	.38400	48	77	125
10	"10-out19722"	.83606	102	20	122
10	"10-out19723"	.53086	172	152	324
10	"10-out19724"	.14964	63	358	421
10	"10-out19725"	.43348	189	247	436
10	"10-out19726"	.19965	115	461	576
10	"10-out19727"	.65024	660	355	1015
10	"10-out19728"	.26168	392	1106	1498
10	"10-out19729"	.29388	149	358	507
10	"10-out19730"	.38049	476	775	1251
10	"10-out19731"	.39555	320	489	809
10	"10-out19732"	.49305	71	73	144
10	"10-out19733"	.23750	38	122	160
10	"10-out19734"	.74100	103	36	139
10	"10-out19735"	.44984	148	181	329
10	"10-out19736"	.42166	401	550	951
10	"10-out19737"	.38967	302	473	775
10	"10-out19738"	.20000	108	432	540
10	"10-out19739"	.40504	305	448	753
10	"10-out19740"	.37500	63	105	168
10	"10-out19741"	.41758	76	106	182
10	"10-out19742"	.42805	119	159	278
10	"10-out19743"	.44965	326	399	725
10	"10-out19744"	.96506	1243	45	1288
10	"10-out19745"	.28210	290	738	1028
10	"10-out19746"	.96428	1242	46	1288
10	"10-out19747"	.39908	522	786	1308
10	"10-out19748"	.27641	361	945	1306
10	"10-out19749"	.41720	970	1355	2325
10	"10-out19750"	.48407	76	81	157
10	"10-out19751"	.30673	419	947	1366
10	"10-out19752"	.31377	460	1006	1466
10	"10-out19753"	.82550	246	52	298
10	"10-out19754"	.98214	55	1	56
10	"10-out19755"	.50490	103	101	204
10	"10-out19756"	.25000	141	423	564
10	"10-out19757"	.59748	95	64	159
10	"10-out19758"	.38685	306	485	791
10	"10-out19759"	.41937	801	1109	1910
10	"10-out19760"	.34599	419	792	1211
10	"10-out19761"	.56661	1412	1080	2492
10	"10-out19762"	.24516	228	702	930
10	"10-out19763"	.32622	520	1074	1594
10	"10-out19764"	.99779	453	1	454
10	"10-out19765"	.32542	398	825	1223
10	"10-out19766"	.25735	315	909	1224
10	"10-out19767"	.28955	280	687	967
10	"10-out19768"	.31349	216	473	689
10	"10-out19769"	.32269	263	552	815
10	"10-out19770"	.98750	79	1	80
10	"10-out19771"	.53239	189	166	355
10	"10-out19772"	.84487	305	56	361
10	"10-out19773"	.31715	98	211	309
10	"10-out19774"	.39078	492	767	1259
10	"10-out19775"	.26862	220	599	819
10	"10-out19776"	.32267	212	445	657
10	"10-out19777"	.32614	242	500	742
10	"10-out19778"	.18181	28	126	154
10	"10-out19779"	.64462	78	43	121
10	"10-out19780"	.37362	170	285	455
10	"10-out19781"	.52678	59	53	112
10	"10-out19782"	.20171	47	186	233
10	"10-out19783"	.65882	56	29	85
10	"10-out19784"	.44000	88	112	200
10	"10-out19785"	.62295	114	69	183
10	"10-out19786"	.31818	63	135	198
10	"10-out19787"	.44554	90	112	202
10	"10-out19788"	.43814	85	109	194
10	"10-out19789"	.97604	326	8	334
10	"10-out19790"	.24174	183	574	757
10	"10-out19791"	.25092	68	203	271
10	"10-out19792"	.32876	408	833	1241
10	"10-out19793"	.35551	438	794	1232
10	"10-out19794"	.31129	306	677	983
10	"10-out19795"	.64827	94	51	145
10	"10-out19796"	.32634	109	225	334
10	"10-out19797"	.40866	132	191	323
10	"10-out19798"	.24006	157	497	654
10	"10-out19799"	.96716	324	11	335
10	"10-out19800"	.27696	339	885	1224
10	"10-out19801"	.48614	193	204	397
10	"10-out19802"	.44044	159	202	361
10	"10-out19803"	.20370	77	301	378
10	"10-out19804"	.24539	80	246	326
10	"10-out19805"	.21505	80	292	372
10	"10-out19806"	.44571	78	97	175
10	"10-out19807"	.22900	90	303	393
10	"10-out19808"	.32848	113	231	344
10	"10-out19809"	.20942	80	302	382
10	"10-out19810"	.55789	212	168	380
10	"10-out19811"	.36927	137	234	371
10	"10-out19812"	.80962	370	87	457
10	"10-out19813"	.46666	42	48	90
10	"10-out19814"	.25055	112	335	447
10	"10-out19815"	.68985	238	107	345
10	"10-out19816"	.38162	432	700	1132
10	"10-out19817"	.26958	320	867	1187
10	"10-out19818"	.59454	1569	1070	2639
10	"10-out19819"	.99871	779	1	780
10	"10-out19820"	.39837	196	296	492
10	"10-out19821"	.36012	233	414	647
10	"10-out19822"	.76829	189	57	246
10	"10-out19823"	.46850	119	135	254
10	"10-out19824"	.29324	139	335	474
10	"10-out19825"	.29610	114	271	385
10	"10-out19826"	.34996	519	964	1483
10	"10-out19827"	.53543	68	59	127
10	"10-out19828"	.48016	1041	1127	2168
10	"10-out19829"	.23200	29	96	125
10	"10-out19830"	.33380	237	473	710
10	"10-out19831"	.34110	161	311	472
10	"10-out19832"	.37586	327	543	870
10	"10-out19833"	.26712	156	428	584
10	"10-out19834"	.43617	205	265	470
10	"10-out19835"	.41499	227	320	547
10	"10-out19836"	.44739	421	520	941
10	"10-out19837"	.70598	1239	516	1755
10	"10-out19838"	.47136	214	240	454
10	"10-out19839"	.27620	195	511	706
10	"10-out19840"	.97000	97	3	100
10	"10-out19841"	.39426	591	908	1499
10	"10-out19842"	.24544	350	1076	1426
10	"10-out19843"	.34985	120	223	343
10	"10-out19844"	.63490	1666	958	2624
10	"10-out19845"	.36087	214	379	593
10	"10-out19846"	.58579	99	70	169
10	"10-out19847"	.49462	138	141	279
10	"10-out19848"	.42774	222	297	519
10	"10-out19849"	.27521	161	424	585
10	"10-out19850"	.20958	140	528	668
10	"10-out19851"	.82000	123	27	150
10	"10-out19852"	.80000	60	15	75
10	"10-out19853"	.88750	71	9	80
10	"10-out19854"	.97169	103	3	106
10	"10-out19855"	.60869	42	27	69
10	"10-out19856"	.93600	117	8	125
10	"10-out19857"	.73873	82	29	111
10	"10-out19858"	.65833	79	41	120
10	"10-out19859"	.99099	110	1	111
10	"10-out19860"	.30000	135	315	450
10	"10-out19861"	.33834	225	440	665
10	"10-out19862"	.58072	241	174	415
10	"10-out19863"	.30871	209	468	677
10	"10-out19864"	.99435	352	2	354
10	"10-out19865"	.98492	392	6	398
10	"10-out19866"	.60619	137	89	226
10	"10-out19867"	.32314	74	155	229
10	"10-out19868"	.25000	89	267	356
10	"10-out19869"	.40214	150	223	373
10	"10-out19870"	.93968	296	19	315
10	"10-out19871"	.70000	112	48	160
10	"10-out19872"	.30061	49	114	163
10	"10-out19873"	.75229	246	81	327
10	"10-out19874"	.13368	25	162	187
10	"10-out19875"	.99543	218	1	219
10	"10-out19876"	.69747	166	72	238
10	"10-out19877"	.29790	171	403	574
10	"10-out19878"	.27787	329	855	1184
10	"10-out19879"	.40094	85	127	212
10	"10-out19880"	.44611	178	221	399
10	"10-out19881"	.20029	136	543	679
10	"10-out19882"	.16981	18	88	106
10	"10-out19883"	.34392	249	475	724
10	"10-out19884"	.18157	134	604	738
10	"10-out19885"	.36890	159	272	431
10	"10-out19886"	.98958	95	1	96
10	"10-out19887"	.27557	369	970	1339
10	"10-out19888"	.31986	459	976	1435
10	"10-out19889"	.18165	206	928	1134
10	"10-out19890"	.35514	418	759	1177
10	"10-out19891"	.46947	223	252	475
10	"10-out19892"	.15697	189	1015	1204
10	"10-out19893"	.36440	430	750	1180
10	"10-out19894"	.44779	549	677	1226
10	"10-out19895"	.30852	369	827	1196
10	"10-out19896"	.23491	292	951	1243
10	"10-out19897"	.88530	247	32	279
10	"10-out19898"	.59154	84	58	142
10	"10-out19899"	.35191	303	558	861
10	"10-out19900"	.29473	28	67	95
10	"10-out19901"	.30666	138	312	450
10	"10-out19902"	.35309	411	753	1164
10	"10-out19903"	.53546	151	131	282
10	"10-out19904"	.19137	71	300	371
10	"10-out19905"	.31940	214	456	670
10	"10-out19906"	.30434	315	720	1035
10	"10-out19907"	.16838	49	242	291
10	"10-out19908"	.38427	88	141	229
10	"10-out19909"	.83555	188	37	225
10	"10-out19910"	.44433	439	549	988
10	"10-out19911"	.89320	92	11	103
10	"10-out19912"	.41447	315	445	760
10	"10-out19913"	.24596	198	607	805
10	"10-out19914"	.38493	92	147	239
10	"10-out19915"	.26315	60	168	228
10	"10-out19916"	.26637	61	168	229
10	"10-out19917"	.99065	212	2	214
10	"10-out19918"	.24505	62	191	253
10	"10-out19919"	.99557	225	1	226
10	"10-out19920"	.29338	142	342	484
10	"10-out19921"	.19750	95	386	481
10	"10-out19922"	.46551	135	155	290
10	"10-out19923"	.45771	92	109	201
10	"10-out19924"	.44972	161	197	358
10	"10-out19925"	.35280	151	277	428
10	"10-out19926"	.32156	173	365	538
10	"10-out19927"	.23686	248	799	1047
10	"10-out19928"	.98529	67	1	68
10	"10-out19929"	.37931	88	144	232
10	"10-out19930"	.43091	577	762	1339
10	"10-out19931"	.38150	132	214	346
10	"10-out19932"	.39225	162	251	413
10	"10-out19933"	.35407	165	301	466
10	"10-out19934"	.99319	146	1	147
10	"10-out19935"	.34817	86	161	247
10	"10-out19936"	.95442	356	17	373
10	"10-out19937"	.27017	452	1221	1673
10	"10-out19938"	.41317	69	98	167
10	"10-out19939"	.32580	101	209	310
10	"10-out19940"	.99047	104	1	105
10	"10-out19941"	.08641	7	74	81
10	"10-out19942"	.09638	8	75	83
10	"10-out19943"	.49607	695	706	1401
10	"10-out19944"	.39895	456	687	1143
10	"10-out19945"	.32231	195	410	605
10	"10-out19946"	.31250	225	495	720
10	"10-out19947"	.43326	448	586	1034
10	"10-out19948"	.29729	165	390	555
10	"10-out19949"	.16161	48	249	297
10	"10-out19950"	.80900	449	106	555
10	"10-out19951"	.26262	624	1752	2376
10	"10-out19952"	.34086	196	379	575
10	"10-out19953"	.33034	184	373	557
10	"10-out19954"	.89122	254	31	285
10	"10-out19955"	.43493	127	165	292
10	"10-out19956"	.29431	88	211	299
10	"10-out19957"	.46097	189	221	410
10	"10-out19958"	.58467	145	103	248
10	"10-out19959"	.44827	39	48	87
10	"10-out19960"	.41463	68	96	164
10	"10-out19961"	.26666	88	242	330
10	"10-out19962"	.42345	130	177	307
10	"10-out19963"	.39247	146	226	372
10	"10-out19964"	.29500	59	141	200
10	"10-out19965"	.47615	669	736	1405
10	"10-out19966"	.30673	319	721	1040
10	"10-out19967"	.24171	248	778	1026
10	"10-out19968"	.34241	352	676	1028
10	"10-out19969"	.14017	194	1190	1384
10	"10-out19970"	.28571	258	645	903
10	"10-out19971"	.23936	180	572	752
10	"10-out19972"	.43532	727	943	1670
10	"10-out19973"	.35798	605	1085	1690
10	"10-out19974"	.37137	628	1063	1691
10	"10-out19975"	.28237	519	1319	1838
10	"10-out19976"	.44527	777	968	1745
10	"10-out19977"	.30847	517	1159	1676
10	"10-out19978"	.20900	664	2513	3177
10	"10-out19979"	.31586	826	1789	2615
10	"10-out19980"	.99603	251	1	252
10	"10-out19981"	.16985	71	347	418
10	"10-out19982"	.43151	230	303	533
10	"10-out19983"	.43648	189	244	433
10	"10-out19984"	.76818	169	51	220
10	"10-out19985"	.99393	164	1	165
10	"10-out19986"	.31462	185	403	588
10	"10-out19987"	.43050	127	168	295
10	"10-out19988"	.46113	89	104	193
10	"10-out19989"	.27992	145	373	518
10	"10-out19990"	.16352	52	266	318
10	"10-out19991"	.77891	229	65	294
10	"10-out19992"	.71502	138	55	193
10	"10-out19993"	.50160	156	155	311
10	"10-out19994"	.36274	74	130	204
10	"10-out19995"	.28217	57	145	202
10	"10-out19996"	.31896	74	158	232
10	"10-out19997"	.30586	193	438	631
10	"10-out19998"	.25054	114	341	455
10	"10-out19999"	.46264	161	187	348
10	"10-out20000"	.38775	342	540	882
10	"10-out20001"	.30310	117	269	386
10	"10-out20002"	.13915	59	365	424
10	"10-out20003"	.32279	143	300	443
10	"10-out20004"	.35795	126	226	352
10	"10-out20005"	.38647	160	254	414
10	"10-out20006"	.42133	233	320	553
10	"10-out20007"	.50649	39	38	77
10	"10-out20008"	.45744	172	204	376
10	"10-out20009"	.75362	52	17	69
10	"10-out20010"	.34198	369	710	1079
10	"10-out20011"	.99473	189	1	190
10	"10-out20012"	.38912	93	146	239
10	"10-out20013"	.57425	58	43	101
10	"10-out20014"	.43349	88	115	203
10	"10-out20015"	.77777	84	24	108
10	"10-out20016"	.34645	44	83	127
10	"10-out20017"	.50433	930	914	1844
10	"10-out20018"	.63400	220	127	347
10	"10-out20019"	.96538	1255	45	1300
10	"10-out20020"	.35234	420	772	1192
10	"10-out20021"	.43884	610	780	1390
10	"10-out20022"	.91975	596	52	648
10	"10-out20023"	.35135	182	336	518
10	"10-out20024"	.31781	157	337	494
10	"10-out20025"	.85000	119	21	140
10	"10-out20026"	.26424	51	142	193
10	"10-out20027"	.31713	659	1419	2078
10	"10-out20028"	.42011	71	98	169
10	"10-out20029"	.99206	125	1	126
10	"10-out20030"	.98360	120	2	122
10	"10-out20031"	.24791	208	631	839
10	"10-out20032"	.55086	509	415	924
10	"10-out20033"	.24528	26	80	106
10	"10-out20034"	.45514	274	328	602
10	"10-out20035"	.20601	363	1399	1762
10	"10-out20036"	.70977	675	276	951
10	"10-out20037"	.48067	199	215	414
10	"10-out20038"	.99212	126	1	127
10	"10-out20039"	.63665	396	226	622
10	"10-out20040"	.51836	127	118	245
10	"10-out20041"	.54198	71	60	131
10	"10-out20042"	.23493	39	127	166
10	"10-out20043"	.31235	139	306	445
10	"10-out20044"	.99397	165	1	166
10	"10-out20045"	.99628	268	1	269
10	"10-out20046"	.85915	61	10	71
10	"10-out20047"	.99684	316	1	317
10	"10-out20048"	.22068	32	113	145
10	"10-out20049"	.24193	135	423	558
10	"10-out20050"	.30703	179	404	583
10	"10-out20051"	.38447	208	333	541
10	"10-out20052"	.98924	92	1	93
10	"10-out20053"	.59915	713	477	1190
10	"10-out20054"	.37288	132	222	354
10	"10-out20055"	.35524	335	608	943
10	"10-out20056"	.99563	684	3	687
10	"10-out20057"	.38630	316	502	818
10	"10-out20058"	.23056	172	574	746
10	"10-out20059"	.21058	183	686	869
10	"10-out20060"	.28947	66	162	228
10	"10-out20061"	.34426	84	160	244
10	"10-out20062"	.15325	40	221	261
10	"10-out20063"	.36018	76	135	211
10	"10-out20064"	.34347	79	151	230
10	"10-out20065"	.36363	80	140	220
10	"10-out20066"	.90000	198	22	220
10	"10-out20067"	.21777	49	176	225
10	"10-out20068"	.17964	30	137	167
10	"10-out20069"	.78423	189	52	241
10	"10-out20070"	.41525	98	138	236
10	"10-out20071"	.61931	436	268	704
10	"10-out20072"	.45768	292	346	638
10	"10-out20073"	.60309	117	77	194
10	"10-out20074"	.32831	109	223	332
10	"10-out20075"	.47989	179	194	373
10	"10-out20076"	.26800	402	1098	1500
10	"10-out20077"	.89330	494	59	553
10	"10-out20078"	.41548	263	370	633
10	"10-out20079"	.29203	66	160	226
10	"10-out20080"	.99703	336	1	337
10	"10-out20081"	.43801	53	68	121
10	"10-out20082"	.24212	346	1083	1429
10	"10-out20083"	.17759	214	991	1205
10	"10-out20084"	.25604	286	831	1117
10	"10-out20085"	.89976	1517	169	1686
10	"10-out20086"	.39145	348	541	889
10	"10-out20087"	.35038	500	927	1427
10	"10-out20088"	.24324	297	924	1221
10	"10-out20089"	.45544	598	715	1313
10	"10-out20090"	.36322	324	568	892
10	"10-out20091"	.24634	101	309	410
10	"10-out20092"	.54972	199	163	362
10	"10-out20093"	.24691	160	488	648
10	"10-out20094"	.26530	39	108	147
10	"10-out20095"	.37037	190	323	513
10	"10-out20096"	.26006	155	441	596
10	"10-out20097"	.49335	297	305	602
10	"10-out20098"	.30066	540	1256	1796
10	"10-out20099"	.99085	325	3	328
10	"10-out20100"	.26726	89	244	333
10	"10-out20101"	.98230	333	6	339
10	"10-out20102"	.98165	321	6	327
10	"10-out20103"	.39130	396	616	1012
10	"10-out20104"	.33526	289	573	862
10	"10-out20105"	.53826	211	181	392
10	"10-out20106"	.22448	220	760	980
10	"10-out20107"	.25609	189	549	738
10	"10-out20108"	.36111	299	529	828
10	"10-out20109"	.37187	312	527	839
10	"10-out20110"	.41558	320	450	770
10	"10-out20111"	.38398	235	377	612
10	"10-out20112"	.36907	592	1012	1604
10	"10-out20113"	.34535	517	980	1497
10	"10-out20114"	.34378	603	1151	1754
10	"10-out20115"	.92187	531	45	576
10	"10-out20116"	.31611	361	781	1142
10	"10-out20117"	.41043	527	757	1284
10	"10-out20118"	.20216	56	221	277
10	"10-out20119"	.26937	73	198	271
10	"10-out20120"	.33855	324	633	957
10	"10-out20121"	.99193	123	1	124
10	"10-out20122"	.35205	94	173	267
10	"10-out20123"	.42000	42	58	100
10	"10-out20124"	.64427	259	143	402
10	"10-out20125"	.25000	93	279	372
10	"10-out20126"	.38020	146	238	384
10	"10-out20127"	.41396	166	235	401
10	"10-out20128"	.38035	151	246	397
10	"10-out20129"	.28918	262	644	906
10	"10-out20130"	.31269	298	655	953
10	"10-out20131"	.20240	84	331	415
10	"10-out20132"	.36594	187	324	511
10	"10-out20133"	.25980	53	151	204
10	"10-out20134"	.23798	208	666	874
10	"10-out20135"	.87370	761	110	871
10	"10-out20136"	.34688	145	273	418
10	"10-out20137"	.22938	89	299	388
10	"10-out20138"	.36778	121	208	329
10	"10-out20139"	.99456	183	1	184
10	"10-out20140"	.80000	152	38	190
10	"10-out20141"	.41253	158	225	383
10	"10-out20142"	.32768	58	119	177
10	"10-out20143"	.46666	98	112	210
10	"10-out20144"	.27445	202	534	736
10	"10-out20145"	.28656	241	600	841
10	"10-out20146"	.25559	80	233	313
10	"10-out20147"	.41463	153	216	369
10	"10-out20148"	.54761	92	76	168
10	"10-out20149"	.98876	88	1	89
10	"10-out20150"	.36018	76	135	211
10	"10-out20151"	.18348	60	267	327
10	"10-out20152"	.97674	42	1	43
10	"10-out20153"	.99082	108	1	109
10	"10-out20154"	.99082	108	1	109
10	"10-out20155"	.97435	38	1	39
10	"10-out20156"	.97674	42	1	43
10	"10-out20157"	.92417	195	16	211
10	"10-out20158"	.26923	70	190	260
10	"10-out20159"	.83236	432	87	519
10	"10-out20160"	.29492	215	514	729
10	"10-out20161"	.39522	215	329	544
10	"10-out20162"	.38837	127	200	327
10	"10-out20163"	.28117	124	317	441
10	"10-out20164"	.91757	423	38	461
10	"10-out20165"	.47361	368	409	777
10	"10-out20166"	.23958	115	365	480
10	"10-out20167"	.53284	146	128	274
10	"10-out20168"	.76245	199	62	261
10	"10-out20169"	.87046	168	25	193
10	"10-out20170"	.30095	189	439	628
10	"10-out20171"	.56190	59	46	105
10	"10-out20172"	.28121	232	593	825
10	"10-out20173"	.49363	155	159	314
10	"10-out20174"	.45023	95	116	211
10	"10-out20175"	.38666	435	690	1125
10	"10-out20176"	.53900	228	195	423
10	"10-out20177"	.45410	188	226	414
10	"10-out20178"	.49560	169	172	341
10	"10-out20179"	.24514	101	311	412
10	"10-out20180"	.38626	90	143	233
10	"10-out20181"	.37656	90	149	239
10	"10-out20182"	.42805	1306	1745	3051
10	"10-out20183"	.95918	235	10	245
10	"10-out20184"	.33590	87	172	259
10	"10-out20185"	.30000	135	315	450
10	"10-out20186"	.99071	427	4	431
10	"10-out20187"	.46088	218	255	473
10	"10-out20188"	.76576	85	26	111
10	"10-out20189"	.92063	58	5	63
10	"10-out20190"	.81944	59	13	72
10	"10-out20191"	.86792	92	14	106
10	"10-out20192"	.55696	44	35	79
10	"10-out20193"	.84375	108	20	128
10	"10-out20194"	.77427	295	86	381
10	"10-out20195"	.32546	193	400	593
10	"10-out20196"	.20000	357	1428	1785
10	"10-out20197"	.25970	214	610	824
10	"10-out20198"	.99797	493	1	494
10	"10-out20199"	.97916	141	3	144
10	"10-out20200"	.39952	167	251	418
10	"10-out20201"	.43074	992	1311	2303
10	"10-out20202"	.18181	18	81	99
10	"10-out20203"	.42664	221	297	518
10	"10-out20204"	.38181	42	68	110
10	"10-out20205"	.29508	54	129	183
10	"10-out20206"	.31000	31	69	100
10	"10-out20207"	.32135	161	340	501
10	"10-out20208"	.99430	349	2	351
10	"10-out20209"	.09045	18	181	199
10	"10-out20210"	.29404	227	545	772
10	"10-out20211"	.40404	160	236	396
10	"10-out20212"	.65648	86	45	131
10	"10-out20213"	.99698	331	1	332
10	"10-out20214"	.35893	215	384	599
10	"10-out20215"	.32125	133	281	414
10	"10-out20216"	.37799	158	260	418
10	"10-out20217"	.40371	457	675	1132
10	"10-out20218"	.22843	233	787	1020
10	"10-out20219"	.29931	308	721	1029
10	"10-out20220"	.38505	469	749	1218
10	"10-out20221"	.68316	207	96	303
10	"10-out20222"	.34173	122	235	357
10	"10-out20223"	.27049	330	890	1220
10	"10-out20224"	.23448	68	222	290
10	"10-out20225"	.24657	306	935	1241
10	"10-out20226"	.27094	249	670	919
10	"10-out20227"	.67000	67	33	100
10	"10-out20228"	.30232	78	180	258
10	"10-out20229"	.39814	473	715	1188
10	"10-out20230"	.82547	998	211	1209
10	"10-out20231"	.99500	199	1	200
10	"10-out20232"	.36080	324	574	898
10	"10-out20233"	.64516	60	33	93
10	"10-out20234"	.18543	28	123	151
10	"10-out20235"	.41704	93	130	223
10	"10-out20236"	.50000	117	117	234
10	"10-out20237"	.45312	58	70	128
10	"10-out20238"	.99074	107	1	108
10	"10-out20239"	.40000	60	90	150
10	"10-out20240"	.32976	154	313	467
10	"10-out20241"	.45454	60	72	132
10	"10-out20242"	.99319	146	1	147
10	"10-out20243"	.99539	216	1	217
10	"10-out20244"	.36636	122	211	333
10	"10-out20245"	.45901	56	66	122
10	"10-out20246"	.42758	62	83	145
10	"10-out20247"	.38909	107	168	275
10	"10-out20248"	.25203	31	92	123
10	"10-out20249"	.15677	37	199	236
10	"10-out20250"	.46031	145	170	315
10	"10-out20251"	.42808	125	167	292
10	"10-out20252"	.59130	68	47	115
10	"10-out20253"	.48717	38	40	78
10	"10-out20254"	.33438	633	1260	1893
10	"10-out20255"	.88339	447	59	506
10	"10-out20256"	.99853	682	1	683
10	"10-out20257"	.30068	611	1421	2032
10	"10-out20258"	.24305	411	1280	1691
10	"10-out20259"	.29534	311	742	1053
10	"10-out20260"	.39571	425	649	1074
10	"10-out20261"	.99775	445	1	446
10	"10-out20262"	.99775	445	1	446
10	"10-out20263"	.99264	135	1	136
10	"10-out20264"	.99750	399	1	400
10	"10-out20265"	.32998	427	867	1294
10	"10-out20266"	.40117	1226	1830	3056
10	"10-out20267"	.22153	72	253	325
10	"10-out20268"	.40804	71	103	174
10	"10-out20269"	.32984	63	128	191
10	"10-out20270"	.34848	23	43	66
10	"10-out20271"	.53289	81	71	152
10	"10-out20272"	.55451	178	143	321
10	"10-out20273"	.35823	211	378	589
10	"10-out20274"	.58373	122	87	209
10	"10-out20275"	.37246	92	155	247
10	"10-out20276"	.28884	264	650	914
10	"10-out20277"	.32926	81	165	246
10	"10-out20278"	.97709	256	6	262
10	"10-out20279"	.68145	169	79	248
10	"10-out20280"	.92156	47	4	51
10	"10-out20281"	.99378	160	1	161
10	"10-out20282"	.33938	187	364	551
10	"10-out20283"	.97101	67	2	69
10	"10-out20284"	.96069	660	27	687
10	"10-out20285"	.90740	98	10	108
10	"10-out20286"	.33532	56	111	167
10	"10-out20287"	.20489	184	714	898
10	"10-out20288"	.46976	101	114	215
10	"10-out20289"	.35748	74	133	207
10	"10-out20290"	.26229	80	225	305
10	"10-out20291"	.25446	57	167	224
10	"10-out20292"	.31250	70	154	224
10	"10-out20293"	.34703	76	143	219
10	"10-out20294"	.85454	188	32	220
10	"10-out20295"	.23630	69	223	292
10	"10-out20296"	.89090	196	24	220
10	"10-out20297"	.42105	88	121	209
10	"10-out20298"	.26146	57	161	218
10	"10-out20299"	.61611	130	81	211
10	"10-out20300"	.57603	125	92	217
10	"10-out20301"	.47540	290	320	610
10	"10-out20302"	.24146	99	311	410
10	"10-out20303"	.33078	346	700	1046
10	"10-out20304"	.34042	240	465	705
10	"10-out20305"	.74348	371	128	499
10	"10-out20306"	.70568	211	88	299
10	"10-out20307"	.32934	330	672	1002
10	"10-out20308"	.72146	316	122	438
10	"10-out20309"	.52090	162	149	311
10	"10-out20310"	.26939	309	838	1147
10	"10-out20311"	.31818	84	180	264
10	"10-out20312"	.24615	64	196	260
10	"10-out20313"	.27058	46	124	170
10	"10-out20314"	.81725	161	36	197
10	"10-out20315"	.99767	430	1	431
10	"10-out20316"	.47027	87	98	185
10	"10-out20317"	.31117	117	259	376
10	"10-out20318"	.29292	116	280	396
10	"10-out20319"	.99622	264	1	265
10	"10-out20320"	.99371	158	1	159
10	"10-out20321"	.99507	202	1	203
10	"10-out20322"	.77662	299	86	385
10	"10-out20323"	.26368	53	148	201
10	"10-out20324"	.26139	109	308	417
10	"10-out20325"	.24541	107	329	436
10	"10-out20326"	.22823	97	328	425
10	"10-out20327"	.60264	502	331	833
10	"10-out20328"	.68858	199	90	289
10	"10-out20329"	.47120	450	505	955
10	"10-out20330"	.99300	142	1	143
10	"10-out20331"	.43918	130	166	296
10	"10-out20332"	.99746	394	1	395
10	"10-out20333"	.99434	703	4	707
10	"10-out20334"	.99746	394	1	395
10	"10-out20335"	.33212	92	185	277
10	"10-out20336"	.40000	460	690	1150
10	"10-out20337"	.38775	38	60	98
10	"10-out20338"	.26868	248	675	923
10	"10-out20339"	.51674	324	303	627
10	"10-out20340"	.71052	486	198	684
10	"10-out20341"	.29129	164	399	563
10	"10-out20342"	.38888	119	187	306
10	"10-out20343"	.36363	36	63	99
10	"10-out20344"	.37195	244	412	656
10	"10-out20345"	.49494	49	50	99
10	"10-out20346"	.63698	186	106	292
10	"10-out20347"	.28048	115	295	410
10	"10-out20348"	.36692	193	333	526
10	"10-out20349"	.28450	101	254	355
10	"10-out20350"	.68523	246	113	359
10	"10-out20351"	.48882	350	366	716
10	"10-out20352"	.97368	74	2	76
10	"10-out20353"	.84459	1212	223	1435
10	"10-out20354"	.63421	430	248	678
10	"10-out20355"	.58838	233	163	396
10	"10-out20356"	.61904	78	48	126
10	"10-out20357"	.99200	124	1	125
10	"10-out20358"	.40020	794	1190	1984
10	"10-out20359"	.43986	256	326	582
10	"10-out20360"	.27862	219	567	786
10	"10-out20361"	.99521	208	1	209
10	"10-out20362"	.25827	39	112	151
10	"10-out20363"	.42141	185	254	439
10	"10-out20364"	.61214	131	83	214
10	"10-out20365"	.35804	256	459	715
10	"10-out20366"	.99572	233	1	234
10	"10-out20367"	.99502	200	1	201
10	"10-out20368"	.86546	431	67	498
10	"10-out20369"	.99746	394	1	395
10	"10-out20370"	.95078	425	22	447
10	"10-out20371"	.98920	275	3	278
10	"10-out20372"	.70078	178	76	254
10	"10-out20373"	.98913	91	1	92
10	"10-out20374"	.99905	1062	1	1063
10	"10-out20375"	.44628	108	134	242
10	"10-out20376"	.65106	153	82	235
10	"10-out20377"	.99735	377	1	378
10	"10-out20378"	.53285	300	263	563
10	"10-out20379"	.99009	100	1	101
10	"10-out20380"	.68551	194	89	283
10	"10-out20381"	.33625	384	758	1142
10	"10-out20382"	.45074	151	184	335
10	"10-out20383"	.68085	64	30	94
10	"10-out20384"	.96739	89	3	92
10	"10-out20385"	.47214	178	199	377
10	"10-out20386"	.49760	415	419	834
10	"10-out20387"	.47093	162	182	344
10	"10-out20388"	.41782	150	209	359
10	"10-out20389"	.36524	103	179	282
10	"10-out20390"	.52188	155	142	297
10	"10-out20391"	.37444	170	284	454
10	"10-out20392"	.43328	328	429	757
10	"10-out20393"	.46177	151	176	327
10	"10-out20394"	.38575	130	207	337
10	"10-out20395"	.37611	126	209	335
10	"10-out20396"	.90180	450	49	499
10	"10-out20397"	.39318	127	196	323
10	"10-out20398"	.98823	84	1	85
10	"10-out20399"	.75806	376	120	496
10	"10-out20400"	.99445	538	3	541
10	"10-out20401"	.29708	306	724	1030
10	"10-out20402"	.41379	36	51	87
10	"10-out20403"	.31538	41	89	130
10	"10-out20404"	.52313	147	134	281
10	"10-out20405"	.37525	182	303	485
10	"10-out20406"	.97773	922	21	943
10	"10-out20407"	.46163	379	442	821
10	"10-out20408"	.52083	150	138	288
10	"10-out20409"	.53107	94	83	177
10	"10-out20410"	.36046	62	110	172
10	"10-out20411"	.90316	485	52	537
10	"10-out20412"	.34482	170	323	493
11	"11-out1"	.97647	415	10	425
11	"11-out2"	.99691	647	2	649
11	"11-out3"	.34393	119	227	346
11	"11-out4"	.42372	150	204	354
11	"11-out5"	.41851	113	157	270
11	"11-out6"	.37573	127	211	338
11	"11-out7"	.80389	619	151	770
11	"11-out8"	.35714	225	405	630
11	"11-out9"	.40374	151	223	374
11	"11-out10"	.36624	716	1239	1955
11	"11-out11"	.98252	787	14	801
11	"11-out12"	.30836	1017	2281	3298
11	"11-out13"	.27437	318	841	1159
11	"11-out14"	.31365	356	779	1135
11	"11-out15"	.88190	814	109	923
11	"11-out16"	.88051	818	111	929
11	"11-out17"	.29294	295	712	1007
11	"11-out18"	.25105	237	707	944
11	"11-out19"	.85392	795	136	931
11	"11-out20"	.87768	818	114	932
11	"11-out21"	.32668	508	1047	1555
11	"11-out22"	.41279	142	202	344
11	"11-out23"	.19600	49	201	250
11	"11-out24"	.42540	211	285	496
11	"11-out25"	.53503	420	365	785
11	"11-out26"	.75769	197	63	260
11	"11-out27"	.83046	627	128	755
11	"11-out28"	.33230	322	647	969
11	"11-out29"	.33333	123	246	369
11	"11-out30"	.24336	495	1539	2034
11	"11-out31"	.39419	462	710	1172
11	"11-out32"	.33798	121	237	358
11	"11-out33"	.99652	287	1	288
11	"11-out34"	.99709	343	1	344
11	"11-out35"	.73464	335	121	456
11	"11-out36"	.67494	598	288	886
11	"11-out37"	.73185	625	229	854
11	"11-out38"	.41841	359	499	858
11	"11-out39"	.29032	99	242	341
11	"11-out40"	.45183	197	239	436
11	"11-out41"	.16758	61	303	364
11	"11-out42"	.38669	157	249	406
11	"11-out43"	.72661	404	152	556
11	"11-out44"	.40700	186	271	457
11	"11-out45"	.78115	257	72	329
11	"11-out46"	.90557	796	83	879
11	"11-out47"	.19180	103	434	537
11	"11-out48"	.65355	515	273	788
11	"11-out49"	.27819	74	192	266
11	"11-out50"	.71004	311	127	438
11	"11-out51"	.76486	283	87	370
11	"11-out52"	.99682	314	1	315
11	"11-out53"	.34634	213	402	615
11	"11-out54"	.25609	168	488	656
11	"11-out55"	.36167	268	473	741
11	"11-out56"	.58647	373	263	636
11	"11-out57"	.36550	303	526	829
11	"11-out58"	.56846	274	208	482
11	"11-out59"	.45477	367	440	807
11	"11-out60"	.36412	272	475	747
11	"11-out61"	.46232	135	157	292
11	"11-out62"	.36875	177	303	480
11	"11-out63"	.32694	290	597	887
11	"11-out64"	.34567	859	1626	2485
11	"11-out65"	.29570	351	836	1187
11	"11-out66"	.21971	185	657	842
11	"11-out67"	.39257	349	540	889
11	"11-out68"	.28965	126	309	435
11	"11-out69"	.48822	394	413	807
11	"11-out70"	.29584	484	1152	1636
11	"11-out71"	.84578	351	64	415
11	"11-out72"	.23986	219	694	913
11	"11-out73"	.55588	189	151	340
11	"11-out74"	.56250	72	56	128
11	"11-out75"	.30588	182	413	595
11	"11-out76"	.88063	664	90	754
11	"11-out77"	.50049	508	507	1015
11	"11-out78"	.28428	228	574	802
11	"11-out79"	.28943	578	1419	1997
11	"11-out80"	.43797	572	734	1306
11	"11-out81"	.28421	542	1365	1907
11	"11-out82"	.59013	658	457	1115
11	"11-out83"	.19903	289	1163	1452
11	"11-out84"	.99673	610	2	612
11	"11-out85"	.34831	31	58	89
11	"11-out86"	.35615	515	931	1446
11	"11-out87"	.41360	383	543	926
11	"11-out88"	.34558	47	89	136
11	"11-out89"	.20503	57	221	278
11	"11-out90"	.25573	145	422	567
11	"11-out91"	.99763	422	1	423
11	"11-out92"	.99888	896	1	897
11	"11-out93"	.51146	223	213	436
11	"11-out94"	.63888	115	65	180
11	"11-out95"	.99705	338	1	339
11	"11-out96"	.51876	235	218	453
11	"11-out97"	.36686	124	214	338
11	"11-out98"	.54389	917	769	1686
11	"11-out99"	.93114	284	21	305
11	"11-out100"	.38764	207	327	534
11	"11-out101"	.39889	217	327	544
11	"11-out102"	.33078	130	263	393
11	"11-out103"	.38640	216	343	559
11	"11-out104"	.98328	353	6	359
11	"11-out105"	.34391	65	124	189
11	"11-out106"	.26053	309	877	1186
11	"11-out107"	.53291	170	149	319
11	"11-out108"	.79039	181	48	229
11	"11-out109"	.99567	230	1	231
11	"11-out110"	.31775	238	511	749
11	"11-out111"	.41959	227	314	541
11	"11-out112"	.50000	71	71	142
11	"11-out113"	.30357	51	117	168
11	"11-out114"	.95757	158	7	165
11	"11-out115"	.95675	354	16	370
11	"11-out116"	.20938	375	1416	1791
11	"11-out117"	.31921	196	418	614
11	"11-out118"	.99897	975	1	976
11	"11-out119"	.41198	220	314	534
11	"11-out120"	.27731	66	172	238
11	"11-out121"	.99804	1023	2	1025
11	"11-out122"	.23261	97	320	417
11	"11-out123"	.42647	87	117	204
11	"11-out124"	.59480	229	156	385
11	"11-out125"	.30635	106	240	346
11	"11-out126"	.37914	160	262	422
11	"11-out127"	.29354	91	219	310
11	"11-out128"	.35714	460	828	1288
11	"11-out129"	.85300	795	137	932
11	"11-out130"	.25046	135	404	539
11	"11-out131"	.16167	151	783	934
11	"11-out132"	.89451	848	100	948
11	"11-out133"	.52803	565	505	1070
11	"11-out134"	.87969	819	112	931
11	"11-out135"	.39869	183	276	459
11	"11-out136"	.87875	819	113	932
11	"11-out137"	.89052	846	104	950
11	"11-out138"	.89684	852	98	950
11	"11-out139"	.34749	90	169	259
11	"11-out140"	.95428	334	16	350
11	"11-out141"	.71064	307	125	432
11	"11-out142"	.32613	1677	3465	5142
11	"11-out143"	.73946	193	68	261
11	"11-out144"	.58064	36	26	62
11	"11-out145"	.17594	79	370	449
11	"11-out146"	.99065	106	1	107
11	"11-out147"	.27956	520	1340	1860
11	"11-out148"	.56130	206	161	367
11	"11-out149"	.26868	629	1712	2341
11	"11-out150"	.35732	139	250	389
11	"11-out151"	.51415	109	103	212
11	"11-out152"	.30423	237	542	779
11	"11-out153"	.64329	312	173	485
11	"11-out154"	.34696	246	463	709
11	"11-out155"	.36131	340	601	941
11	"11-out156"	.34881	398	743	1141
11	"11-out157"	.43360	209	273	482
11	"11-out158"	.16222	73	377	450
11	"11-out159"	.32121	866	1830	2696
11	"11-out160"	.34957	122	227	349
11	"11-out161"	.54000	189	161	350
11	"11-out162"	.99186	244	2	246
11	"11-out163"	.44062	141	179	320
11	"11-out164"	.98684	75	1	76
11	"11-out165"	.34184	308	593	901
11	"11-out166"	.23820	106	339	445
11	"11-out167"	.44522	252	314	566
11	"11-out168"	.37781	252	415	667
11	"11-out169"	.75271	554	182	736
11	"11-out170"	.87254	89	13	102
11	"11-out171"	.68439	193	89	282
11	"11-out172"	.41789	397	553	950
11	"11-out173"	.35892	201	359	560
11	"11-out174"	.28316	143	362	505
11	"11-out175"	.45434	209	251	460
11	"11-out176"	.37793	370	609	979
11	"11-out177"	.33645	395	779	1174
11	"11-out178"	.20300	54	212	266
11	"11-out179"	.18269	57	255	312
11	"11-out180"	.97297	36	1	37
11	"11-out181"	.50215	465	461	926
11	"11-out182"	.35752	202	363	565
11	"11-out183"	.28611	103	257	360
11	"11-out184"	.43001	255	338	593
11	"11-out185"	.25000	25	75	100
11	"11-out186"	.99328	148	1	149
11	"11-out187"	.74299	159	55	214
11	"11-out188"	.37125	124	210	334
11	"11-out189"	.31210	98	216	314
11	"11-out190"	.30167	108	250	358
11	"11-out191"	.29342	424	1021	1445
11	"11-out192"	.29693	397	940	1337
11	"11-out193"	.79519	1588	409	1997
11	"11-out194"	.36986	243	414	657
11	"11-out195"	.33008	643	1305	1948
11	"11-out196"	.45312	58	70	128
11	"11-out197"	.56615	184	141	325
11	"11-out198"	.26388	76	212	288
11	"11-out199"	.36760	851	1464	2315
11	"11-out200"	.33447	98	195	293
11	"11-out201"	.62068	90	55	145
11	"11-out202"	.29889	81	190	271
11	"11-out203"	.24000	102	323	425
11	"11-out204"	.46231	184	214	398
11	"11-out205"	.96050	1070	44	1114
11	"11-out206"	.99532	213	1	214
11	"11-out207"	.39606	141	215	356
11	"11-out208"	.44886	158	194	352
11	"11-out209"	.25141	89	265	354
11	"11-out210"	.59640	232	157	389
11	"11-out211"	.99766	427	1	428
11	"11-out212"	.99903	1034	1	1035
11	"11-out213"	.33466	168	334	502
11	"11-out214"	.32346	153	320	473
11	"11-out215"	.41887	426	591	1017
11	"11-out216"	.99641	278	1	279
11	"11-out217"	.99641	278	1	279
11	"11-out218"	.96534	195	7	202
11	"11-out219"	.99285	139	1	140
11	"11-out220"	.99261	269	2	271
11	"11-out221"	.20222	127	501	628
11	"11-out222"	.43073	199	263	462
11	"11-out223"	.95555	473	22	495
11	"11-out224"	.44537	106	132	238
11	"11-out225"	.49261	300	309	609
11	"11-out226"	.75466	283	92	375
11	"11-out227"	.91701	221	20	241
11	"11-out228"	.30383	182	417	599
11	"11-out229"	.20024	164	655	819
11	"11-out230"	.34837	633	1184	1817
11	"11-out231"	.96884	311	10	321
11	"11-out232"	.58412	184	131	315
11	"11-out233"	.94966	283	15	298
11	"11-out234"	.88993	283	35	318
11	"11-out235"	.95873	302	13	315
11	"11-out236"	.94888	297	16	313
11	"11-out237"	.99361	311	2	313
11	"11-out238"	.31172	101	223	324
11	"11-out239"	.93788	302	20	322
11	"11-out240"	.56112	179	140	319
11	"11-out241"	.97394	299	8	307
11	"11-out242"	.67313	208	101	309
11	"11-out243"	.88996	275	34	309
11	"11-out244"	.96308	287	11	298
11	"11-out245"	.99085	325	3	328
11	"11-out246"	.43729	136	175	311
11	"11-out247"	.53164	168	148	316
11	"11-out248"	.46774	145	165	310
11	"11-out249"	.45987	149	175	324
11	"11-out250"	.47237	171	191	362
11	"11-out251"	.98387	305	5	310
11	"11-out252"	.98722	309	4	313
11	"11-out253"	.98076	306	6	312
11	"11-out254"	.99679	311	1	312
11	"11-out255"	.99038	309	3	312
11	"11-out256"	.96153	300	12	312
11	"11-out257"	.98397	307	5	312
11	"11-out258"	.98717	308	4	312
11	"11-out259"	.97050	329	10	339
11	"11-out260"	.98355	299	5	304
11	"11-out261"	.42320	259	353	612
11	"11-out262"	.43478	110	143	253
11	"11-out263"	.33600	84	166	250
11	"11-out264"	.99725	363	1	364
11	"11-out265"	.99725	363	1	364
11	"11-out266"	.29376	99	238	337
11	"11-out267"	.28857	202	498	700
11	"11-out268"	.77496	551	160	711
11	"11-out269"	.61538	424	265	689
11	"11-out270"	.52669	148	133	281
11	"11-out271"	.36111	91	161	252
11	"11-out272"	.98759	398	5	403
11	"11-out273"	.33810	118	231	349
11	"11-out274"	.65243	214	114	328
11	"11-out275"	.83969	110	21	131
11	"11-out276"	.95979	573	24	597
11	"11-out277"	.68714	604	275	879
11	"11-out278"	.38812	255	402	657
11	"11-out279"	.51875	401	372	773
11	"11-out280"	.50802	190	184	374
11	"11-out281"	.97772	1317	30	1347
11	"11-out282"	.99850	1338	2	1340
11	"11-out283"	.35096	365	675	1040
11	"11-out284"	.27956	331	853	1184
11	"11-out285"	.49379	199	204	403
11	"11-out286"	.27441	118	312	430
11	"11-out287"	.43406	316	412	728
11	"11-out288"	.35801	411	737	1148
11	"11-out289"	.88159	819	110	929
11	"11-out290"	.88082	813	110	923
11	"11-out291"	.88279	821	109	930
11	"11-out292"	.21806	210	753	963
11	"11-out293"	.66666	624	312	936
11	"11-out294"	.29830	369	868	1237
11	"11-out295"	.88046	825	112	937
11	"11-out296"	.85368	811	139	950
11	"11-out297"	.31404	76	166	242
11	"11-out298"	.31350	195	427	622
11	"11-out299"	.55955	202	159	361
11	"11-out300"	.99438	177	1	178
11	"11-out301"	.23529	32	104	136
11	"11-out302"	.25708	127	367	494
11	"11-out303"	.35164	96	177	273
11	"11-out304"	.49113	194	201	395
11	"11-out305"	.25373	119	350	469
11	"11-out306"	.32154	300	633	933
11	"11-out307"	.94400	118	7	125
11	"11-out308"	.99476	190	1	191
11	"11-out309"	.28171	151	385	536
11	"11-out310"	.72199	174	67	241
11	"11-out311"	.48735	347	365	712
11	"11-out312"	.39555	320	489	809
11	"11-out313"	.42356	471	641	1112
11	"11-out314"	.38721	321	508	829
11	"11-out315"	.35932	318	567	885
11	"11-out316"	.23783	88	282	370
11	"11-out317"	.20666	31	119	150
11	"11-out318"	.37440	79	132	211
11	"11-out319"	.41092	173	248	421
11	"11-out320"	.97227	491	14	505
11	"11-out321"	.39004	94	147	241
11	"11-out322"	.24078	98	309	407
11	"11-out323"	.33030	109	221	330
11	"11-out324"	.49832	297	299	596
11	"11-out325"	.98232	389	7	396
11	"11-out326"	.25308	41	121	162
11	"11-out327"	.23717	74	238	312
11	"11-out328"	.39370	100	154	254
11	"11-out329"	.98195	381	7	388
11	"11-out330"	.33380	237	473	710
11	"11-out331"	.31443	122	266	388
11	"11-out332"	.40632	347	507	854
11	"11-out333"	.77777	105	30	135
11	"11-out334"	.53761	393	338	731
11	"11-out335"	.33333	96	192	288
11	"11-out336"	.21024	78	293	371
11	"11-out337"	.98993	787	8	795
11	"11-out338"	.98236	780	14	794
11	"11-out339"	.98113	780	15	795
11	"11-out340"	.88021	823	112	935
11	"11-out341"	.98212	934	17	951
11	"11-out342"	.99046	727	7	734
11	"11-out343"	.31447	917	1999	2916
11	"11-out344"	.88701	840	107	947
11	"11-out345"	.88210	838	112	950
11	"11-out346"	.88090	821	111	932
11	"11-out347"	.88141	825	111	936
11	"11-out348"	.42650	177	238	415
11	"11-out349"	.38872	269	423	692
11	"11-out350"	.29012	620	1517	2137
11	"11-out351"	.30099	152	353	505
11	"11-out352"	.24827	72	218	290
11	"11-out353"	.37047	133	226	359
11	"11-out354"	.59562	517	351	868
11	"11-out355"	.15435	94	515	609
11	"11-out356"	.37196	199	336	535
11	"11-out357"	.34573	158	299	457
11	"11-out358"	.99581	238	1	239
11	"11-out359"	.34103	251	485	736
11	"11-out360"	.39085	342	533	875
11	"11-out361"	.40813	351	509	860
11	"11-out362"	.23116	135	449	584
11	"11-out363"	.25000	127	381	508
11	"11-out364"	.38920	137	215	352
11	"11-out365"	.24545	108	332	440
11	"11-out366"	.44047	37	47	84
11	"11-out367"	.30812	163	366	529
11	"11-out368"	.24060	32	101	133
11	"11-out369"	.70318	199	84	283
11	"11-out370"	.99786	468	1	469
11	"11-out371"	.89285	125	15	140
11	"11-out372"	.31102	883	1956	2839
11	"11-out373"	.99884	865	1	866
11	"11-out374"	.54627	785	652	1437
11	"11-out375"	.58241	371	266	637
11	"11-out376"	.31962	676	1439	2115
11	"11-out377"	.86324	202	32	234
11	"11-out378"	.68627	175	80	255
11	"11-out379"	.56321	147	114	261
11	"11-out380"	.77914	254	72	326
11	"11-out381"	.44785	146	180	326
11	"11-out382"	.56052	213	167	380
11	"11-out383"	.47081	121	136	257
11	"11-out384"	.31887	125	267	392
11	"11-out385"	.23411	70	229	299
11	"11-out386"	.32258	90	189	279
11	"11-out387"	.34251	87	167	254
11	"11-out388"	.22307	29	101	130
11	"11-out389"	.47413	165	183	348
11	"11-out390"	.43916	148	189	337
11	"11-out391"	.95890	70	3	73
11	"11-out392"	.41975	34	47	81
11	"11-out393"	.32163	110	232	342
11	"11-out394"	.50746	204	198	402
11	"11-out395"	.99725	363	1	364
11	"11-out396"	.54425	289	242	531
11	"11-out397"	.36534	194	337	531
11	"11-out398"	.33695	186	366	552
11	"11-out399"	.28818	417	1030	1447
11	"11-out400"	.98863	87	1	88
11	"11-out401"	.42274	145	198	343
11	"11-out402"	.29439	126	302	428
11	"11-out403"	.44444	140	175	315
11	"11-out404"	.35491	285	518	803
11	"11-out405"	.28636	313	780	1093
11	"11-out406"	.30876	222	497	719
11	"11-out407"	.31428	121	264	385
11	"11-out408"	.69473	66	29	95
11	"11-out409"	.38485	249	398	647
11	"11-out410"	.46130	745	870	1615
11	"11-out411"	.60439	55	36	91
11	"11-out412"	.58762	57	40	97
11	"11-out413"	.35930	83	148	231
11	"11-out414"	.99107	111	1	112
11	"11-out415"	.99145	116	1	117
11	"11-out416"	.40746	742	1079	1821
11	"11-out417"	.54026	322	274	596
11	"11-out418"	.30745	99	223	322
11	"11-out419"	.81756	121	27	148
11	"11-out420"	.35177	426	785	1211
11	"11-out421"	.46786	182	207	389
11	"11-out422"	.99280	138	1	139
11	"11-out423"	.24418	42	130	172
11	"11-out424"	.56355	368	285	653
11	"11-out425"	.61846	201	124	325
11	"11-out426"	.64343	240	133	373
11	"11-out427"	.72413	231	88	319
11	"11-out428"	.84419	298	55	353
11	"11-out429"	.28627	73	182	255
11	"11-out430"	.33852	1195	2335	3530
11	"11-out431"	.65961	1279	660	1939
11	"11-out432"	.75193	1458	481	1939
11	"11-out433"	.44306	716	900	1616
11	"11-out434"	.29828	400	941	1341
11	"11-out435"	.32927	839	1709	2548
11	"11-out436"	.34415	53	101	154
11	"11-out437"	.99935	1561	1	1562
11	"11-out438"	.25793	187	538	725
11	"11-out439"	.57396	97	72	169
11	"11-out440"	.44405	127	159	286
11	"11-out441"	.30378	401	919	1320
11	"11-out442"	.83401	819	163	982
11	"11-out443"	.23796	168	538	706
11	"11-out444"	.99686	636	2	638
11	"11-out445"	.99762	420	1	421
11	"11-out446"	.99768	863	2	865
11	"11-out447"	.99701	668	2	670
11	"11-out448"	.35551	187	339	526
11	"11-out449"	.23319	170	559	729
11	"11-out450"	.15214	103	574	677
11	"11-out451"	.43229	2883	3786	6669
11	"11-out452"	.43518	47	61	108
11	"11-out453"	.32418	260	542	802
11	"11-out454"	.99922	1287	1	1288
11	"11-out455"	.38805	156	246	402
11	"11-out456"	.46756	173	197	370
11	"11-out457"	.12068	42	306	348
11	"11-out458"	.23493	78	254	332
11	"11-out459"	.75320	235	77	312
11	"11-out460"	.99358	310	2	312
11	"11-out461"	.95859	301	13	314
11	"11-out462"	.97832	316	7	323
11	"11-out463"	.98542	338	5	343
11	"11-out464"	.70512	220	92	312
11	"11-out465"	.96474	301	11	312
11	"11-out466"	.41944	151	209	360
11	"11-out467"	.85530	266	45	311
11	"11-out468"	.85014	295	52	347
11	"11-out469"	.44694	139	172	311
11	"11-out470"	.53333	176	154	330
11	"11-out471"	.93081	296	22	318
11	"11-out472"	.76205	237	74	311
11	"11-out473"	.58823	210	147	357
11	"11-out474"	.94230	294	18	312
11	"11-out475"	.47318	150	167	317
11	"11-out476"	.95192	297	15	312
11	"11-out477"	.42187	135	185	320
11	"11-out478"	.96428	297	11	308
11	"11-out479"	.47272	156	174	330
11	"11-out480"	.98738	313	4	317
11	"11-out481"	.42718	132	177	309
11	"11-out482"	.79746	252	64	316
11	"11-out483"	.95886	303	13	316
11	"11-out484"	.87179	272	40	312
11	"11-out485"	.53623	185	160	345
11	"11-out486"	.92307	288	24	312
11	"11-out487"	.91666	286	26	312
11	"11-out488"	.96794	302	10	312
11	"11-out489"	.94236	327	20	347
11	"11-out490"	.42122	131	180	311
11	"11-out491"	.92307	288	24	312
11	"11-out492"	.67398	215	104	319
11	"11-out493"	.44986	166	203	369
11	"11-out494"	.90517	315	33	348
11	"11-out495"	.51948	160	148	308
11	"11-out496"	.92207	284	24	308
11	"11-out497"	.99687	319	1	320
11	"11-out498"	.95597	304	14	318
11	"11-out499"	.98563	343	5	348
11	"11-out500"	.97993	293	6	299
11	"11-out501"	.69867	211	91	302
11	"11-out502"	.96932	316	10	326
11	"11-out503"	.60000	186	124	310
11	"11-out504"	.96116	297	12	309
11	"11-out505"	.62258	193	117	310
11	"11-out506"	.87579	275	39	314
11	"11-out507"	.65286	205	109	314
11	"11-out508"	.59294	185	127	312
11	"11-out509"	.98407	309	5	314
11	"11-out510"	.94252	328	20	348
11	"11-out511"	.91987	287	25	312
11	"11-out512"	.99680	312	1	313
11	"11-out513"	.96202	304	12	316
11	"11-out514"	.75000	231	77	308
11	"11-out515"	.96463	300	11	311
11	"11-out516"	.42222	133	182	315
11	"11-out517"	.97452	306	8	314
11	"11-out518"	.55095	173	141	314
11	"11-out519"	.55732	175	139	314
11	"11-out520"	.83706	262	51	313
11	"11-out521"	.96178	302	12	314
11	"11-out522"	.74840	235	79	314
11	"11-out523"	.56369	177	137	314
11	"11-out524"	.74766	240	81	321
11	"11-out525"	.72585	233	88	321
11	"11-out526"	.87296	268	39	307
11	"11-out527"	.85530	266	45	311
11	"11-out528"	.60655	185	120	305
11	"11-out529"	.61093	190	121	311
11	"11-out530"	.44135	143	181	324
11	"11-out531"	.90490	295	31	326
11	"11-out532"	.97058	330	10	340
11	"11-out533"	.39549	123	188	311
11	"11-out534"	.89102	278	34	312
11	"11-out535"	.98717	308	4	312
11	"11-out536"	.98705	305	4	309
11	"11-out537"	.99135	344	3	347
11	"11-out538"	.53776	178	153	331
11	"11-out539"	.45192	141	171	312
11	"11-out540"	.44479	141	176	317
11	"11-out541"	.34294	107	205	312
11	"11-out542"	.80877	258	61	319
11	"11-out543"	.88996	275	34	309
11	"11-out544"	.94230	294	18	312
11	"11-out545"	.97427	303	8	311
11	"11-out546"	.96153	300	12	312
11	"11-out547"	.96451	299	11	310
11	"11-out548"	.96784	301	10	311
11	"11-out549"	.85443	270	46	316
11	"11-out550"	.48656	163	172	335
11	"11-out551"	.50000	155	155	310
11	"11-out552"	.77388	243	71	314
11	"11-out553"	.47457	140	155	295
11	"11-out554"	.79189	293	77	370
11	"11-out555"	.17464	135	638	773
11	"11-out556"	.32743	148	304	452
11	"11-out557"	.23214	91	301	392
11	"11-out558"	.40723	259	377	636
11	"11-out559"	.33371	290	579	869
11	"11-out560"	.33258	297	596	893
11	"11-out561"	.40301	187	277	464
11	"11-out562"	.99074	107	1	108
11	"11-out563"	.43218	803	1055	1858
11	"11-out564"	.28350	110	278	388
11	"11-out565"	.32637	469	968	1437
11	"11-out566"	.98294	2306	40	2346
11	"11-out567"	.38586	71	113	184
11	"11-out568"	.20308	145	569	714
11	"11-out569"	.34025	377	731	1108
11	"11-out570"	.42748	790	1058	1848
11	"11-out571"	.65832	1368	710	2078
11	"11-out572"	.47325	115	128	243
11	"11-out573"	.43507	258	335	593
11	"11-out574"	.17733	36	167	203
11	"11-out575"	.40461	263	387	650
11	"11-out576"	.69870	269	116	385
11	"11-out577"	.51219	189	180	369
11	"11-out578"	.27319	106	282	388
11	"11-out579"	.93801	227	15	242
11	"11-out580"	.99725	363	1	364
11	"11-out581"	.56325	325	252	577
11	"11-out582"	.68284	211	98	309
11	"11-out583"	.78964	244	65	309
11	"11-out584"	.98713	307	4	311
11	"11-out585"	.97626	329	8	337
11	"11-out586"	.59424	186	127	313
11	"11-out587"	.48450	172	183	355
11	"11-out588"	.62732	202	120	322
11	"11-out589"	.47284	148	165	313
11	"11-out590"	.53164	168	148	316
11	"11-out591"	.50809	157	152	309
11	"11-out592"	.97419	302	8	310
11	"11-out593"	.97419	302	8	310
11	"11-out594"	.45192	141	171	312
11	"11-out595"	.93589	292	20	312
11	"11-out596"	.35625	114	206	320
11	"11-out597"	.42675	134	180	314
11	"11-out598"	.39808	125	189	314
11	"11-out599"	.67301	212	103	315
11	"11-out600"	.80373	258	63	321
11	"11-out601"	.82315	256	55	311
11	"11-out602"	.93114	284	21	305
11	"11-out603"	.95394	290	14	304
11	"11-out604"	.98402	308	5	313
11	"11-out605"	.92948	290	22	312
11	"11-out606"	.57377	175	130	305
11	"11-out607"	.53135	161	142	303
11	"11-out608"	.44753	145	179	324
11	"11-out609"	.99029	306	3	309
11	"11-out610"	.95222	299	15	314
11	"11-out611"	.52750	163	146	309
11	"11-out612"	.33437	107	213	320
11	"11-out613"	.49044	154	160	314
11	"11-out614"	.95731	314	14	328
11	"11-out615"	.97468	308	8	316
11	"11-out616"	.42367	136	185	321
11	"11-out617"	.46451	144	166	310
11	"11-out618"	.47094	154	173	327
11	"11-out619"	.89728	297	34	331
11	"11-out620"	.98070	305	6	311
11	"11-out621"	.44805	138	170	308
11	"11-out622"	.55102	189	154	343
11	"11-out623"	.57188	179	134	313
11	"11-out624"	.41087	136	195	331
11	"11-out625"	.50159	157	156	313
11	"11-out626"	.78683	251	68	319
11	"11-out627"	.95512	298	14	312
11	"11-out628"	.95846	300	13	313
11	"11-out629"	.47572	147	162	309
11	"11-out630"	.67202	209	102	311
11	"11-out631"	.55519	171	137	308
11	"11-out632"	.54983	171	140	311
11	"11-out633"	.94603	298	17	315
11	"11-out634"	.49038	153	159	312
11	"11-out635"	.36211	130	229	359
11	"11-out636"	.73462	227	82	309
11	"11-out637"	.87378	270	39	309
11	"11-out638"	.65923	207	107	314
11	"11-out639"	.49847	163	164	327
11	"11-out640"	.76065	232	73	305
11	"11-out641"	.57006	179	135	314
11	"11-out642"	.41732	106	148	254
11	"11-out643"	.31939	275	586	861
11	"11-out644"	.61461	185	116	301
11	"11-out645"	.99019	101	1	102
11	"11-out646"	.21428	117	429	546
11	"11-out647"	.39860	285	430	715
11	"11-out648"	.43353	287	375	662
11	"11-out649"	.46685	162	185	347
11	"11-out650"	.33472	401	797	1198
11	"11-out651"	.30965	218	486	704
11	"11-out652"	.45719	251	298	549
11	"11-out653"	.44658	347	430	777
11	"11-out654"	.33004	234	475	709
11	"11-out655"	.28412	102	257	359
11	"11-out656"	.28143	141	360	501
11	"11-out657"	.99567	230	1	231
11	"11-out658"	.90711	918	94	1012
11	"11-out659"	.32885	294	600	894
11	"11-out660"	.37428	131	219	350
11	"11-out661"	.38963	406	636	1042
11	"11-out662"	.40428	302	445	747
11	"11-out663"	.35433	450	820	1270
11	"11-out664"	.66539	175	88	263
11	"11-out665"	.33861	342	668	1010
11	"11-out666"	.71402	387	155	542
11	"11-out667"	.48153	326	351	677
11	"11-out668"	.89759	4917	561	5478
11	"11-out669"	.39062	200	312	512
11	"11-out670"	.51441	232	219	451
11	"11-out671"	.98076	14228	279	14507
11	"11-out672"	.85866	3858	635	4493
11	"11-out673"	.31269	202	444	646
11	"11-out674"	.99988	8383	1	8384
11	"11-out675"	.81912	1028	227	1255
11	"11-out676"	.78975	447	119	566
11	"11-out677"	.99943	1772	1	1773
11	"11-out678"	.72523	3756	1423	5179
11	"11-out679"	.98893	2145	24	2169
11	"11-out680"	.99115	5604	50	5654
11	"11-out681"	.72679	274	103	377
11	"11-out682"	.69731	182	79	261
11	"11-out683"	.42222	38	52	90
11	"11-out684"	.50096	259	258	517
11	"11-out685"	.19082	104	441	545
11	"11-out686"	.25396	64	188	252
11	"11-out687"	.55753	281	223	504
11	"11-out688"	.82793	409	85	494
11	"11-out689"	.36075	57	101	158
11	"11-out690"	.76536	137	42	179
11	"11-out691"	.39007	55	86	141
11	"11-out692"	.42028	145	200	345
11	"11-out693"	.98969	96	1	97
11	"11-out694"	.28585	295	737	1032
11	"11-out695"	.32377	271	566	837
11	"11-out696"	.97794	532	12	544
11	"11-out697"	.29768	103	243	346
11	"11-out698"	.82842	478	99	577
11	"11-out699"	.81145	581	135	716
11	"11-out700"	.73754	222	79	301
11	"11-out701"	.68299	237	110	347
11	"11-out702"	.90880	289	29	318
11	"11-out703"	.84493	267	49	316
11	"11-out704"	.68085	224	105	329
11	"11-out705"	.99035	308	3	311
11	"11-out706"	.46278	143	166	309
11	"11-out707"	.25000	38	114	152
11	"11-out708"	.31175	260	574	834
11	"11-out709"	.99684	316	1	317
11	"11-out710"	.35670	117	211	328
11	"11-out711"	.54985	386	316	702
11	"11-out712"	.40625	78	114	192
11	"11-out713"	.96721	59	2	61
11	"11-out714"	.55963	122	96	218
11	"11-out715"	.44897	110	135	245
11	"11-out716"	.38636	102	162	264
11	"11-out717"	.38259	699	1128	1827
11	"11-out718"	.40265	364	540	904
11	"11-out719"	.58258	194	139	333
11	"11-out720"	.46373	358	414	772
11	"11-out721"	.44026	328	417	745
11	"11-out722"	.30088	34	79	113
11	"11-out723"	.54042	127	108	235
11	"11-out724"	.55882	1083	855	1938
11	"11-out725"	.42702	831	1115	1946
11	"11-out726"	.27939	575	1483	2058
11	"11-out727"	.30082	620	1441	2061
11	"11-out728"	.38232	359	580	939
11	"11-out729"	.21856	73	261	334
11	"11-out730"	.99401	166	1	167
11	"11-out731"	.27019	97	262	359
11	"11-out732"	.93750	15	1	16
11	"11-out733"	.30136	44	102	146
11	"11-out734"	.58671	910	641	1551
11	"11-out735"	.99653	288	1	289
11	"11-out736"	.28090	434	1111	1545
11	"11-out737"	.98136	316	6	322
11	"11-out738"	.98136	316	6	322
11	"11-out739"	.23000	92	308	400
11	"11-out740"	.46226	147	171	318
11	"11-out741"	.47133	148	166	314
11	"11-out742"	.64217	201	112	313
11	"11-out743"	.39814	129	195	324
11	"11-out744"	.94888	297	16	313
11	"11-out745"	.98484	325	5	330
11	"11-out746"	.60828	191	123	314
11	"11-out747"	.91076	296	29	325
11	"11-out748"	.99384	323	2	325
11	"11-out749"	.97419	302	8	310
11	"11-out750"	.45047	141	172	313
11	"11-out751"	.52076	163	150	313
11	"11-out752"	.99369	315	2	317
11	"11-out753"	.40063	127	190	317
11	"11-out754"	.93037	294	22	316
11	"11-out755"	.91987	287	25	312
11	"11-out756"	.92948	290	22	312
11	"11-out757"	.91318	284	27	311
11	"11-out758"	.96153	300	12	312
11	"11-out759"	.91666	286	26	312
11	"11-out760"	.96296	312	12	324
11	"11-out761"	.97169	309	9	318
11	"11-out762"	.93333	294	21	315
11	"11-out763"	.95512	298	14	312
11	"11-out764"	.87301	275	40	315
11	"11-out765"	.80000	252	63	315
11	"11-out766"	.43408	135	176	311
11	"11-out767"	.95015	305	16	321
11	"11-out768"	.98730	311	4	315
11	"11-out769"	.97460	307	8	315
11	"11-out770"	.76051	235	74	309
11	"11-out771"	.90938	281	28	309
11	"11-out772"	.97734	302	7	309
11	"11-out773"	.56329	178	138	316
11	"11-out774"	.66129	205	105	310
11	"11-out775"	.70032	215	92	307
11	"11-out776"	.36163	115	203	318
11	"11-out777"	.92282	287	24	311
11	"11-out778"	.95873	302	13	315
11	"11-out779"	.37060	116	197	313
11	"11-out780"	.96794	302	10	312
11	"11-out781"	.93114	284	21	305
11	"11-out782"	.45659	142	169	311
11	"11-out783"	.95555	301	14	315
11	"11-out784"	.50464	163	160	323
11	"11-out785"	.40000	124	186	310
11	"11-out786"	.48253	152	163	315
11	"11-out787"	.93485	287	20	307
11	"11-out788"	.95114	292	15	307
11	"11-out789"	.96166	301	12	313
11	"11-out790"	.63430	196	113	309
11	"11-out791"	.88535	278	36	314
11	"11-out792"	.97444	305	8	313
11	"11-out793"	.98769	321	4	325
11	"11-out794"	.96428	297	11	308
11	"11-out795"	.54807	171	141	312
11	"11-out796"	.95779	295	13	308
11	"11-out797"	.90996	283	28	311
11	"11-out798"	.94533	294	17	311
11	"11-out799"	.92698	292	23	315
11	"11-out800"	.56774	176	134	310
11	"11-out801"	.95555	301	14	315
11	"11-out802"	.57763	186	136	322
11	"11-out803"	.68523	246	113	359
11	"11-out804"	.99358	310	2	312
11	"11-out805"	.99044	311	3	314
11	"11-out806"	.23456	76	248	324
11	"11-out807"	.51104	162	155	317
11	"11-out808"	.48895	155	162	317
11	"11-out809"	.28792	93	230	323
11	"11-out810"	.42153	137	188	325
11	"11-out811"	.94193	292	18	310
11	"11-out812"	.92233	285	24	309
11	"11-out813"	.80625	258	62	320
11	"11-out814"	.96296	312	12	324
11	"11-out815"	.64417	210	116	326
11	"11-out816"	.94568	296	17	313
11	"11-out817"	.74838	232	78	310
11	"11-out818"	.54140	170	144	314
11	"11-out819"	.97109	336	10	346
11	"11-out820"	.88102	274	37	311
11	"11-out821"	.96153	300	12	312
11	"11-out822"	.97115	303	9	312
11	"11-out823"	.94838	294	16	310
11	"11-out824"	.85396	269	46	315
11	"11-out825"	.42006	134	185	319
11	"11-out826"	.42019	129	178	307
11	"11-out827"	.74608	238	81	319
11	"11-out828"	.99239	261	2	263
11	"11-out829"	.71935	223	87	310
11	"11-out830"	.73770	225	80	305
11	"11-out831"	.15686	24	129	153
11	"11-out832"	.33986	52	101	153
11	"11-out833"	.47176	142	159	301
11	"11-out834"	.39240	93	144	237
11	"11-out835"	.99534	214	1	215
11	"11-out836"	.31220	133	293	426
11	"11-out837"	.38286	219	353	572
11	"11-out838"	.35753	197	354	551
11	"11-out839"	.24834	150	454	604
11	"11-out840"	.66666	202	101	303
11	"11-out841"	.28642	173	431	604
11	"11-out842"	.92000	322	28	350
11	"11-out843"	.39960	203	305	508
11	"11-out844"	.34072	630	1219	1849
11	"11-out845"	.31046	371	824	1195
11	"11-out846"	.32312	211	442	653
11	"11-out847"	.35426	220	401	621
11	"11-out848"	.34848	230	430	660
11	"11-out849"	.54845	249	205	454
11	"11-out850"	.28080	196	502	698
11	"11-out851"	.41567	175	246	421
11	"11-out852"	.17783	69	319	388
11	"11-out853"	.42731	585	784	1369
11	"11-out854"	.17016	73	356	429
11	"11-out855"	.90343	421	45	466
11	"11-out856"	.47270	433	483	916
11	"11-out857"	.99576	706	3	709
11	"11-out858"	.36548	72	125	197
11	"11-out859"	.99969	3322	1	3323
11	"11-out860"	.99919	1236	1	1237
11	"11-out861"	.74592	4298	1464	5762
11	"11-out862"	.49692	1212	1227	2439
11	"11-out863"	.20738	73	279	352
11	"11-out864"	.37132	101	171	272
11	"11-out865"	.42944	280	372	652
11	"11-out866"	.36263	99	174	273
11	"11-out867"	.47137	247	277	524
11	"11-out868"	.37916	364	596	960
11	"11-out869"	.35146	168	310	478
11	"11-out870"	.41408	241	341	582
11	"11-out871"	.84000	273	52	325
11	"11-out872"	.20276	44	173	217
11	"11-out873"	.39610	122	186	308
11	"11-out874"	.98989	98	1	99
11	"11-out875"	.51129	430	411	841
11	"11-out876"	.48450	297	316	613
11	"11-out877"	.28440	31	78	109
11	"11-out878"	.28875	149	367	516
11	"11-out879"	.85500	342	58	400
11	"11-out880"	.45253	143	173	316
11	"11-out881"	.96979	289	9	298
11	"11-out882"	.91111	287	28	315
11	"11-out883"	.97463	269	7	276
11	"11-out884"	.70287	220	93	313
11	"11-out885"	.35185	190	350	540
11	"11-out886"	.53354	167	146	313
11	"11-out887"	.98466	321	5	326
11	"11-out888"	.47252	559	624	1183
11	"11-out889"	.54411	111	93	204
11	"11-out890"	.68809	289	131	420
11	"11-out891"	.45931	175	206	381
11	"11-out892"	.33830	136	266	402
11	"11-out893"	.23645	96	310	406
11	"11-out894"	.26470	135	375	510
11	"11-out895"	.77859	211	60	271
11	"11-out896"	.63157	204	119	323
11	"11-out897"	.33733	253	497	750
11	"11-out898"	.46080	194	227	421
11	"11-out899"	.33181	146	294	440
11	"11-out900"	.33128	54	109	163
11	"11-out901"	.99082	108	1	109
11	"11-out902"	.57718	86	63	149
11	"11-out903"	.99186	122	1	123
11	"11-out904"	.99481	192	1	193
11	"11-out905"	.22881	81	273	354
11	"11-out906"	.34677	129	243	372
11	"11-out907"	.23421	89	291	380
11	"11-out908"	.43103	150	198	348
11	"11-out909"	.76092	296	93	389
11	"11-out910"	.53910	1027	878	1905
11	"11-out911"	.24940	104	313	417
11	"11-out912"	.32766	212	435	647
11	"11-out913"	.35947	55	98	153
11	"11-out914"	.40701	232	338	570
11	"11-out915"	.30428	206	471	677
11	"11-out916"	.43642	254	328	582
11	"11-out917"	.34173	556	1071	1627
11	"11-out918"	.37490	496	827	1323
11	"11-out919"	.40476	51	75	126
11	"11-out920"	.44897	44	54	98
11	"11-out921"	.32894	75	153	228
11	"11-out922"	.99162	355	3	358
11	"11-out923"	.42567	126	170	296
11	"11-out924"	.46044	908	1064	1972
11	"11-out925"	.99726	1094	3	1097
11	"11-out926"	.69468	1347	592	1939
11	"11-out927"	.42449	253	343	596
11	"11-out928"	.32419	686	1430	2116
11	"11-out929"	.29258	493	1192	1685
11	"11-out930"	.40625	221	323	544
11	"11-out931"	.42622	260	350	610
11	"11-out932"	.34609	642	1213	1855
11	"11-out933"	.32441	97	202	299
11	"11-out934"	.41666	110	154	264
11	"11-out935"	.25595	129	375	504
11	"11-out936"	.91766	535	48	583
11	"11-out937"	.58646	234	165	399
11	"11-out938"	.99530	212	1	213
11	"11-out939"	.36972	149	254	403
11	"11-out940"	.99663	296	1	297
11	"11-out941"	.23611	51	165	216
11	"11-out942"	.80681	71	17	88
11	"11-out943"	.27358	58	154	212
11	"11-out944"	.16666	36	180	216
11	"11-out945"	.25092	68	203	271
11	"11-out946"	.33891	162	316	478
11	"11-out947"	.90076	354	39	393
11	"11-out948"	.19875	32	129	161
11	"11-out949"	.91089	276	27	303
11	"11-out950"	.98397	307	5	312
11	"11-out951"	.99356	309	2	311
11	"11-out952"	.52812	169	151	320
11	"11-out953"	.75320	235	77	312
11	"11-out954"	.51757	162	151	313
11	"11-out955"	.98466	321	5	326
11	"11-out956"	.68720	591	269	860
11	"11-out957"	.30310	127	292	419
11	"11-out958"	.75433	261	85	346
11	"11-out959"	.86400	108	17	125
11	"11-out960"	.37184	103	174	277
11	"11-out961"	.39204	69	107	176
11	"11-out962"	.22978	54	181	235
11	"11-out963"	.15697	27	145	172
11	"11-out964"	.31250	125	275	400
11	"11-out965"	.27315	404	1075	1479
11	"11-out966"	.32653	112	231	343
11	"11-out967"	.90993	293	29	322
11	"11-out968"	.90000	297	33	330
11	"11-out969"	.98974	193	2	195
11	"11-out970"	.24100	67	211	278
11	"11-out971"	.42628	399	537	936
11	"11-out972"	.36544	497	863	1360
11	"11-out973"	.98214	55	1	56
11	"11-out974"	.65196	133	71	204
11	"11-out975"	.38179	281	455	736
11	"11-out976"	.34400	258	492	750
11	"11-out977"	.22750	91	309	400
11	"11-out978"	.34858	716	1338	2054
11	"11-out979"	.37556	83	138	221
11	"11-out980"	.24641	361	1104	1465
11	"11-out981"	.83177	178	36	214
11	"11-out982"	.98780	81	1	82
11	"11-out983"	.42978	101	134	235
11	"11-out984"	.43750	140	180	320
11	"11-out985"	.33471	81	161	242
11	"11-out986"	.32869	118	241	359
11	"11-out987"	.46116	475	555	1030
11	"11-out988"	.25752	77	222	299
11	"11-out989"	.36793	241	414	655
11	"11-out990"	.98574	484	7	491
11	"11-out991"	.21505	40	146	186
11	"11-out992"	.28980	162	397	559
11	"11-out993"	.31085	106	235	341
11	"11-out994"	.63492	320	184	504
11	"11-out995"	.26825	169	461	630
11	"11-out996"	.61400	377	237	614
11	"11-out997"	.50877	58	56	114
11	"11-out998"	.48854	64	67	131
11	"11-out999"	.99580	712	3	715
11	"11-out1000"	.71161	190	77	267
11	"11-out1001"	.97959	48	1	49
11	"11-out1002"	.99630	270	1	271
11	"11-out1003"	.96721	59	2	61
11	"11-out1004"	.56130	293	229	522
11	"11-out1005"	.99082	108	1	109
11	"11-out1006"	.26168	28	79	107
11	"11-out1007"	.25128	98	292	390
11	"11-out1008"	.49720	89	90	179
11	"11-out1009"	.26359	189	528	717
11	"11-out1010"	.55084	65	53	118
11	"11-out1011"	.36464	132	230	362
11	"11-out1012"	.32252	199	418	617
11	"11-out1013"	.35894	271	484	755
11	"11-out1014"	.20610	27	104	131
11	"11-out1015"	.28846	90	222	312
11	"11-out1016"	.43714	153	197	350
11	"11-out1017"	.51097	163	156	319
11	"11-out1018"	.38550	133	212	345
11	"11-out1019"	.30136	110	255	365
11	"11-out1020"	.39520	132	202	334
11	"11-out1021"	.27246	285	761	1046
11	"11-out1022"	.99747	395	1	396
11	"11-out1023"	.94047	790	50	840
11	"11-out1024"	.32158	73	154	227
11	"11-out1025"	.22698	143	487	630
11	"11-out1026"	.35205	94	173	267
11	"11-out1027"	.37500	57	95	152
11	"11-out1028"	.36445	484	844	1328
11	"11-out1029"	.26086	300	850	1150
11	"11-out1030"	.29295	104	251	355
11	"11-out1031"	.41580	121	170	291
11	"11-out1032"	.85714	150	25	175
11	"11-out1033"	.64634	106	58	164
11	"11-out1034"	.98648	73	1	74
11	"11-out1035"	.46723	385	439	824
11	"11-out1036"	.25267	118	349	467
11	"11-out1037"	.32699	361	743	1104
11	"11-out1038"	.85882	73	12	85
11	"11-out1039"	.35656	880	1588	2468
11	"11-out1040"	.30439	291	665	956
11	"11-out1041"	.96511	83	3	86
11	"11-out1042"	.30909	153	342	495
11	"11-out1043"	.35748	454	816	1270
11	"11-out1044"	.38613	117	186	303
11	"11-out1045"	.29479	153	366	519
11	"11-out1046"	.32996	261	530	791
11	"11-out1047"	.37078	165	280	445
11	"11-out1048"	.19831	94	380	474
11	"11-out1049"	.23863	42	134	176
11	"11-out1050"	.75675	112	36	148
11	"11-out1051"	.60696	122	79	201
11	"11-out1052"	.49799	124	125	249
11	"11-out1053"	.99782	459	1	460
11	"11-out1054"	.31958	217	462	679
11	"11-out1055"	.36239	133	234	367
11	"11-out1056"	.99711	346	1	347
11	"11-out1057"	.34923	205	382	587
11	"11-out1058"	.42769	349	467	816
11	"11-out1059"	.43382	236	308	544
11	"11-out1060"	.30350	173	397	570
11	"11-out1061"	.32108	236	499	735
11	"11-out1062"	.29245	124	300	424
11	"11-out1063"	.31730	132	284	416
11	"11-out1064"	.40236	204	303	507
11	"11-out1065"	.96969	32	1	33
11	"11-out1066"	.99551	222	1	223
11	"11-out1067"	.44924	447	548	995
11	"11-out1068"	.32102	113	239	352
11	"11-out1069"	.55944	80	63	143
11	"11-out1070"	.99130	114	1	115
11	"11-out1071"	.39353	146	225	371
11	"11-out1072"	.35272	194	356	550
11	"11-out1073"	.50672	113	110	223
11	"11-out1074"	.50232	865	857	1722
11	"11-out1075"	.47899	114	124	238
11	"11-out1076"	.36276	226	397	623
11	"11-out1077"	.59000	295	205	500
11	"11-out1078"	.41422	99	140	239
11	"11-out1079"	.35198	541	996	1537
11	"11-out1080"	.61511	529	331	860
11	"11-out1081"	.32364	167	349	516
11	"11-out1082"	.48872	65	68	133
11	"11-out1083"	.41411	135	191	326
11	"11-out1084"	.62803	233	138	371
11	"11-out1085"	.99186	122	1	123
11	"11-out1086"	.99145	116	1	117
11	"11-out1087"	.99145	116	1	117
11	"11-out1088"	.22539	158	543	701
11	"11-out1089"	.41124	278	398	676
11	"11-out1090"	.75952	319	101	420
11	"11-out1091"	.92567	137	11	148
11	"11-out1092"	.38898	445	699	1144
11	"11-out1093"	.76190	112	35	147
11	"11-out1094"	.50868	527	509	1036
11	"11-out1095"	.28109	174	445	619
11	"11-out1096"	.79361	323	84	407
11	"11-out1097"	.99681	313	1	314
11	"11-out1098"	.75862	110	35	145
11	"11-out1099"	.44672	327	405	732
11	"11-out1100"	.92045	162	14	176
11	"11-out1101"	.75427	485	158	643
11	"11-out1102"	.38331	363	584	947
11	"11-out1103"	.33000	99	201	300
11	"11-out1104"	.59329	779	534	1313
11	"11-out1105"	.25462	55	161	216
11	"11-out1106"	.58202	557	400	957
11	"11-out1107"	.34985	240	446	686
11	"11-out1108"	.43669	338	436	774
11	"11-out1109"	.27822	138	358	496
11	"11-out1110"	.26851	145	395	540
11	"11-out1111"	.29032	72	176	248
11	"11-out1112"	.99624	265	1	266
11	"11-out1113"	.36559	102	177	279
11	"11-out1114"	.96511	83	3	86
11	"11-out1115"	.27528	313	824	1137
11	"11-out1116"	.53076	276	244	520
11	"11-out1117"	.50833	244	236	480
11	"11-out1118"	.28517	152	381	533
11	"11-out1119"	.36764	125	215	340
11	"11-out1120"	.51456	53	50	103
11	"11-out1121"	.44986	323	395	718
11	"11-out1122"	.39870	185	279	464
11	"11-out1123"	.38055	137	223	360
11	"11-out1124"	.33150	121	244	365
11	"11-out1125"	.36666	132	228	360
11	"11-out1126"	.61818	306	189	495
11	"11-out1127"	.97513	353	9	362
11	"11-out1128"	.40989	464	668	1132
11	"11-out1129"	.34813	298	558	856
11	"11-out1130"	.77941	1219	345	1564
11	"11-out1131"	.32032	558	1184	1742
11	"11-out1132"	.76736	221	67	288
11	"11-out1133"	.22294	138	481	619
11	"11-out1134"	.92125	117	10	127
11	"11-out1135"	.99361	622	4	626
11	"11-out1136"	.96221	382	15	397
11	"11-out1137"	.20675	49	188	237
11	"11-out1138"	.67620	378	181	559
11	"11-out1139"	.42200	211	289	500
11	"11-out1140"	.24808	162	491	653
11	"11-out1141"	.40289	834	1236	2070
11	"11-out1142"	.42748	224	300	524
11	"11-out1143"	.96307	313	12	325
11	"11-out1144"	.37854	120	197	317
11	"11-out1145"	.31896	185	395	580
11	"11-out1146"	.94193	292	18	310
11	"11-out1147"	.44108	146	185	331
11	"11-out1148"	.66871	218	108	326
11	"11-out1149"	.71464	283	113	396
11	"11-out1150"	.66376	229	116	345
11	"11-out1151"	.98466	321	5	326
11	"11-out1152"	.55555	180	144	324
11	"11-out1153"	.65798	202	105	307
11	"11-out1154"	.63636	343	196	539
11	"11-out1155"	.32220	164	345	509
11	"11-out1156"	.68299	237	110	347
11	"11-out1157"	.89308	284	34	318
11	"11-out1158"	.40384	126	186	312
11	"11-out1159"	.55663	172	137	309
11	"11-out1160"	.86104	378	61	439
11	"11-out1161"	.38683	670	1062	1732
11	"11-out1162"	.36119	618	1093	1711
11	"11-out1163"	.45794	98	116	214
11	"11-out1164"	.97802	890	20	910
11	"11-out1165"	.83729	1374	267	1641
11	"11-out1166"	.41811	554	771	1325
11	"11-out1167"	.36571	497	862	1359
11	"11-out1168"	.33187	76	153	229
11	"11-out1169"	.38317	82	132	214
11	"11-out1170"	.73417	116	42	158
11	"11-out1171"	.44140	113	143	256
11	"11-out1172"	.69588	389	170	559
11	"11-out1173"	.81818	225	50	275
11	"11-out1174"	.36787	71	122	193
11	"11-out1175"	.44057	152	193	345
11	"11-out1176"	.36851	419	718	1137
11	"11-out1177"	.36363	164	287	451
11	"11-out1178"	.39837	49	74	123
11	"11-out1179"	.72025	5739	2229	7968
11	"11-out1180"	.42352	803	1093	1896
11	"11-out1181"	.39412	188	289	477
11	"11-out1182"	.50000	41	41	82
11	"11-out1183"	.99824	569	1	570
11	"11-out1184"	.96774	60	2	62
11	"11-out1185"	.71615	164	65	229
11	"11-out1186"	.39682	25	38	63
11	"11-out1187"	.30303	80	184	264
11	"11-out1188"	.63235	43	25	68
11	"11-out1189"	.91169	413	40	453
11	"11-out1190"	.28571	116	290	406
11	"11-out1191"	.99681	313	1	314
11	"11-out1192"	.86407	267	42	309
11	"11-out1193"	.43540	91	118	209
11	"11-out1194"	.85901	981	161	1142
11	"11-out1195"	.28804	53	131	184
11	"11-out1196"	.42093	370	509	879
11	"11-out1197"	.45180	150	182	332
11	"11-out1198"	.72287	493	189	682
11	"11-out1199"	.29371	257	618	875
11	"11-out1200"	.16825	53	262	315
11	"11-out1201"	.99776	446	1	447
11	"11-out1202"	.42430	199	270	469
11	"11-out1203"	.99636	274	1	275
11	"11-out1204"	.99576	235	1	236
11	"11-out1205"	.99212	126	1	127
11	"11-out1206"	.29571	76	181	257
11	"11-out1207"	.74285	156	54	210
11	"11-out1208"	.50000	156	156	312
11	"11-out1209"	.19730	44	179	223
11	"11-out1210"	.27915	79	204	283
11	"11-out1211"	.99316	872	6	878
11	"11-out1212"	.99316	872	6	878
11	"11-out1213"	.99255	800	6	806
11	"11-out1214"	.99316	872	6	878
11	"11-out1215"	.99206	750	6	756
11	"11-out1216"	.99190	735	6	741
11	"11-out1217"	.28942	156	383	539
11	"11-out1218"	.36792	195	335	530
11	"11-out1219"	.61578	117	73	190
11	"11-out1220"	.35167	147	271	418
11	"11-out1221"	.43414	178	232	410
11	"11-out1222"	.45348	156	188	344
11	"11-out1223"	.38567	307	489	796
11	"11-out1224"	.28588	235	587	822
11	"11-out1225"	.30512	256	583	839
11	"11-out1226"	.34918	323	602	925
11	"11-out1227"	.37110	429	727	1156
11	"11-out1228"	.43593	643	832	1475
11	"11-out1229"	.43350	603	788	1391
11	"11-out1230"	.27855	400	1036	1436
11	"11-out1231"	.30703	537	1212	1749
11	"11-out1232"	.99685	317	1	318
11	"11-out1233"	.25745	518	1494	2012
11	"11-out1234"	.27511	575	1515	2090
11	"11-out1235"	.98571	69	1	70
11	"11-out1236"	.50647	313	305	618
11	"11-out1237"	.34142	211	407	618
11	"11-out1238"	.99543	218	1	219
11	"11-out1239"	.68131	248	116	364
11	"11-out1240"	.29039	124	303	427
11	"11-out1241"	.67526	314	151	465
11	"11-out1242"	.37130	264	447	711
11	"11-out1243"	.99704	337	1	338
11	"11-out1244"	.15708	41	220	261
11	"11-out1245"	.72478	582	221	803
11	"11-out1246"	.39024	80	125	205
11	"11-out1247"	.32890	99	202	301
11	"11-out1248"	.56360	638	494	1132
11	"11-out1249"	.30769	92	207	299
11	"11-out1250"	.99706	340	1	341
11	"11-out1251"	.38488	326	521	847
11	"11-out1252"	.99919	1248	1	1249
11	"11-out1253"	.99325	736	5	741
11	"11-out1254"	.37257	326	549	875
11	"11-out1255"	.26642	150	413	563
11	"11-out1256"	.49197	92	95	187
11	"11-out1257"	.45729	423	502	925
11	"11-out1258"	.30882	105	235	340
11	"11-out1259"	.46151	1313	1532	2845
11	"11-out1260"	.39912	275	414	689
11	"11-out1261"	.53445	318	277	595
11	"11-out1262"	.29802	377	888	1265
11	"11-out1263"	.22266	112	391	503
11	"11-out1264"	.58035	325	235	560
11	"11-out1265"	.20722	109	417	526
11	"11-out1266"	.26341	54	151	205
11	"11-out1267"	.70689	164	68	232
11	"11-out1268"	.92653	227	18	245
11	"11-out1269"	.21899	83	296	379
11	"11-out1270"	.94313	680	41	721
11	"11-out1271"	.96928	284	9	293
11	"11-out1272"	.95850	462	20	482
11	"11-out1273"	.98350	477	8	485
11	"11-out1274"	.24686	138	421	559
11	"11-out1275"	.82456	141	30	171
11	"11-out1276"	.84302	145	27	172
11	"11-out1277"	.55791	236	187	423
11	"11-out1278"	.37840	333	547	880
11	"11-out1279"	.34420	190	362	552
11	"11-out1280"	.68750	429	195	624
11	"11-out1281"	.89416	414	49	463
11	"11-out1282"	.45424	139	167	306
11	"11-out1283"	.49029	101	105	206
11	"11-out1284"	.98360	60	1	61
11	"11-out1285"	.93918	139	9	148
11	"11-out1286"	.36250	87	153	240
11	"11-out1287"	.24434	54	167	221
11	"11-out1288"	.43582	146	189	335
11	"11-out1289"	.29459	365	874	1239
11	"11-out1290"	.70854	141	58	199
11	"11-out1291"	.63538	237	136	373
11	"11-out1292"	.43768	151	194	345
11	"11-out1293"	.78995	173	46	219
11	"11-out1294"	.41558	160	225	385
11	"11-out1295"	.31084	281	623	904
11	"11-out1296"	.43714	153	197	350
11	"11-out1297"	.56586	189	145	334
11	"11-out1298"	.34155	180	347	527
11	"11-out1299"	.27441	281	743	1024
11	"11-out1300"	.34419	507	966	1473
11	"11-out1301"	.32915	341	695	1036
11	"11-out1302"	.38391	210	337	547
11	"11-out1303"	.28717	112	278	390
11	"11-out1304"	.47933	58	63	121
11	"11-out1305"	.30044	335	780	1115
11	"11-out1306"	.66251	691	352	1043
11	"11-out1307"	.80119	403	100	503
11	"11-out1308"	.23702	347	1117	1464
11	"11-out1309"	.24932	370	1114	1484
11	"11-out1310"	.47201	582	651	1233
11	"11-out1311"	.57709	771	565	1336
11	"11-out1312"	.46695	438	500	938
11	"11-out1313"	.72289	60	23	83
11	"11-out1314"	.40065	123	184	307
11	"11-out1315"	.80286	224	55	279
11	"11-out1316"	.35179	108	199	307
11	"11-out1317"	.41666	105	147	252
11	"11-out1318"	.33779	101	198	299
11	"11-out1319"	.21568	33	120	153
11	"11-out1320"	.41975	34	47	81
11	"11-out1321"	.41210	143	204	347
11	"11-out1322"	.51941	388	359	747
11	"11-out1323"	.87500	252	36	288
11	"11-out1324"	.99500	199	1	200
11	"11-out1325"	.36575	628	1089	1717
11	"11-out1326"	.22222	48	168	216
11	"11-out1327"	.73043	336	124	460
11	"11-out1328"	.26533	173	479	652
11	"11-out1329"	.26719	268	735	1003
11	"11-out1330"	.34826	661	1237	1898
11	"11-out1331"	.59215	302	208	510
11	"11-out1332"	.67197	211	103	314
11	"11-out1333"	.98070	305	6	311
11	"11-out1334"	.35940	170	303	473
11	"11-out1335"	.90189	285	31	316
11	"11-out1336"	.62154	225	137	362
11	"11-out1337"	.72727	232	87	319
11	"11-out1338"	.48543	150	159	309
11	"11-out1339"	.38688	118	187	305
11	"11-out1340"	.93939	310	20	330
11	"11-out1341"	.95859	301	13	314
11	"11-out1342"	.93203	288	21	309
11	"11-out1343"	.96000	984	41	1025
11	"11-out1344"	.57812	185	135	320
11	"11-out1345"	.99787	470	1	471
11	"11-out1346"	.39024	80	125	205
11	"11-out1347"	.99029	306	3	309
11	"11-out1348"	.94303	298	18	316
11	"11-out1349"	.93333	294	21	315
11	"11-out1350"	.77616	267	77	344
11	"11-out1351"	.44871	140	172	312
11	"11-out1352"	.38141	119	193	312
11	"11-out1353"	.44444	144	180	324
11	"11-out1354"	.38750	124	196	320
11	"11-out1355"	.41121	132	189	321
11	"11-out1356"	.26158	79	223	302
11	"11-out1357"	.50000	158	158	316
11	"11-out1358"	.19365	61	254	315
11	"11-out1359"	.44164	140	177	317
11	"11-out1360"	.52024	167	154	321
11	"11-out1361"	.44871	140	172	312
11	"11-out1362"	.45820	148	175	323
11	"11-out1363"	.36305	114	200	314
11	"11-out1364"	.38805	130	205	335
11	"11-out1365"	.75394	239	78	317
11	"11-out1366"	.99691	323	1	324
11	"11-out1367"	.99714	349	1	350
11	"11-out1368"	.72668	226	85	311
11	"11-out1369"	.98089	308	6	314
11	"11-out1370"	.98089	308	6	314
11	"11-out1371"	.99392	327	2	329
11	"11-out1372"	.99059	316	3	319
11	"11-out1373"	.97791	310	7	317
11	"11-out1374"	.36875	118	202	320
11	"11-out1375"	.56074	180	141	321
11	"11-out1376"	.71913	233	91	324
11	"11-out1377"	.18068	58	263	321
11	"11-out1378"	.99792	482	1	483
11	"11-out1379"	.60034	344	229	573
11	"11-out1380"	.45525	697	834	1531
11	"11-out1381"	.44314	152	191	343
11	"11-out1382"	.49122	112	116	228
11	"11-out1383"	.99470	188	1	189
11	"11-out1384"	.80225	568	140	708
11	"11-out1385"	.34763	81	152	233
11	"11-out1386"	.42555	463	625	1088
11	"11-out1387"	.85220	444	77	521
11	"11-out1388"	.26586	155	428	583
11	"11-out1389"	.75395	334	109	443
11	"11-out1390"	.30769	56	126	182
11	"11-out1391"	.99411	169	1	170
11	"11-out1392"	.99411	169	1	170
11	"11-out1393"	.43548	108	140	248
11	"11-out1394"	.12173	56	404	460
11	"11-out1395"	.54125	164	139	303
11	"11-out1396"	.81967	50	11	61
11	"11-out1397"	.96721	59	2	61
11	"11-out1398"	.96721	59	2	61
11	"11-out1399"	.96721	59	2	61
11	"11-out1400"	.96721	59	2	61
11	"11-out1401"	.91803	56	5	61
11	"11-out1402"	.96721	59	2	61
11	"11-out1403"	.59090	91	63	154
11	"11-out1404"	.39309	296	457	753
11	"11-out1405"	.72438	205	78	283
11	"11-out1406"	.49086	188	195	383
11	"11-out1407"	.41990	270	373	643
11	"11-out1408"	.38474	232	371	603
11	"11-out1409"	.48752	215	226	441
11	"11-out1410"	.78304	314	87	401
11	"11-out1411"	.67896	184	87	271
11	"11-out1412"	.27314	59	157	216
11	"11-out1413"	.43675	183	236	419
11	"11-out1414"	.25506	63	184	247
11	"11-out1415"	.23333	56	184	240
11	"11-out1416"	.99264	135	1	136
11	"11-out1417"	.31456	162	353	515
11	"11-out1418"	.55732	175	139	314
11	"11-out1419"	.82706	330	69	399
11	"11-out1420"	.31083	198	439	637
11	"11-out1421"	.65625	105	55	160
11	"11-out1422"	.30969	131	292	423
11	"11-out1423"	.50632	160	156	316
11	"11-out1424"	.89308	284	34	318
11	"11-out1425"	.36760	118	203	321
11	"11-out1426"	.99270	136	1	137
11	"11-out1427"	.46319	151	175	326
11	"11-out1428"	.14285	42	252	294
11	"11-out1429"	.30726	334	753	1087
11	"11-out1430"	.52631	210	189	399
11	"11-out1431"	.36623	141	244	385
11	"11-out1432"	.39699	264	401	665
11	"11-out1433"	.30487	200	456	656
11	"11-out1434"	.44979	336	411	747
11	"11-out1435"	.40776	168	244	412
11	"11-out1436"	.28915	48	118	166
11	"11-out1437"	.68629	1282	586	1868
11	"11-out1438"	.83832	280	54	334
11	"11-out1439"	.33738	860	1689	2549
11	"11-out1440"	.99085	542	5	547
11	"11-out1441"	.36979	213	363	576
11	"11-out1442"	.33603	83	164	247
11	"11-out1443"	.30544	157	357	514
11	"11-out1444"	.28945	442	1085	1527
11	"11-out1445"	.33106	438	885	1323
11	"11-out1446"	.49787	117	118	235
11	"11-out1447"	.33176	495	997	1492
11	"11-out1448"	.99159	118	1	119
11	"11-out1449"	.21250	51	189	240
11	"11-out1450"	.40899	382	552	934
11	"11-out1451"	.36464	132	230	362
11	"11-out1452"	.24263	140	437	577
11	"11-out1453"	.60409	177	116	293
11	"11-out1454"	.43884	61	78	139
11	"11-out1455"	.49295	105	108	213
11	"11-out1456"	.35135	182	336	518
11	"11-out1457"	.29361	69	166	235
11	"11-out1458"	.28510	67	168	235
11	"11-out1459"	.63793	74	42	116
11	"11-out1460"	.43055	93	123	216
11	"11-out1461"	.77227	78	23	101
11	"11-out1462"	.40101	79	118	197
11	"11-out1463"	.39418	339	521	860
11	"11-out1464"	.29380	280	673	953
11	"11-out1465"	.49402	124	127	251
11	"11-out1466"	.78900	445	119	564
11	"11-out1467"	.30326	232	533	765
11	"11-out1468"	.49240	162	167	329
11	"11-out1469"	.45132	51	62	113
11	"11-out1470"	.47950	351	381	732
11	"11-out1471"	.51052	679	651	1330
11	"11-out1472"	.39906	255	384	639
11	"11-out1473"	.58931	353	246	599
11	"11-out1474"	.63967	158	89	247
11	"11-out1475"	.65991	163	84	247
11	"11-out1476"	.45475	196	235	431
11	"11-out1477"	.30291	83	191	274
11	"11-out1478"	.42448	267	362	629
11	"11-out1479"	.37936	239	391	630
11	"11-out1480"	.35227	124	228	352
11	"11-out1481"	.33125	53	107	160
11	"11-out1482"	.22149	136	478	614
11	"11-out1483"	.34154	194	374	568
11	"11-out1484"	.71904	302	118	420
11	"11-out1485"	.28060	259	664	923
11	"11-out1486"	.48648	324	342	666
11	"11-out1487"	.34817	86	161	247
11	"11-out1488"	.84803	173	31	204
11	"11-out1489"	.31578	96	208	304
11	"11-out1490"	.76209	567	177	744
11	"11-out1491"	.52315	531	484	1015
11	"11-out1492"	.62619	263	157	420
11	"11-out1493"	.99918	1221	1	1222
11	"11-out1494"	.51500	412	388	800
11	"11-out1495"	.45736	236	280	516
11	"11-out1496"	.61948	267	164	431
11	"11-out1497"	.47826	253	276	529
11	"11-out1498"	.44074	212	269	481
11	"11-out1499"	.26063	98	278	376
11	"11-out1500"	.29151	79	192	271
11	"11-out1501"	.40639	814	1189	2003
11	"11-out1502"	.98976	387	4	391
11	"11-out1503"	.75000	222	74	296
11	"11-out1504"	.34274	170	326	496
11	"11-out1505"	.84533	317	58	375
11	"11-out1506"	.53425	616	537	1153
11	"11-out1507"	.99560	1133	5	1138
11	"11-out1508"	.59602	90	61	151
11	"11-out1509"	.27777	355	923	1278
11	"11-out1510"	.32879	169	345	514
11	"11-out1511"	.99056	105	1	106
11	"11-out1512"	.78787	234	63	297
11	"11-out1513"	.99659	293	1	294
11	"11-out1514"	.99523	1045	5	1050
11	"11-out1515"	.99560	1133	5	1138
11	"11-out1516"	.99558	1128	5	1133
11	"11-out1517"	.98823	420	5	425
11	"11-out1518"	.99758	413	1	414
11	"11-out1519"	.98842	427	5	432
11	"11-out1520"	.99766	428	1	429
11	"11-out1521"	.29978	140	327	467
11	"11-out1522"	.29525	168	401	569
11	"11-out1523"	.32380	136	284	420
11	"11-out1524"	.71910	64	25	89
11	"11-out1525"	.99655	289	1	290
11	"11-out1526"	.42083	202	278	480
11	"11-out1527"	.54085	139	118	257
11	"11-out1528"	.38043	175	285	460
11	"11-out1529"	.34660	209	394	603
11	"11-out1530"	.23042	103	344	447
11	"11-out1531"	.51219	210	200	410
11	"11-out1532"	.74257	300	104	404
11	"11-out1533"	.98954	284	3	287
11	"11-out1534"	.39877	520	784	1304
11	"11-out1535"	.46263	130	151	281
11	"11-out1536"	.64974	128	69	197
11	"11-out1537"	.40925	115	166	281
11	"11-out1538"	.49705	169	171	340
11	"11-out1539"	.99425	173	1	174
11	"11-out1540"	.30559	202	459	661
11	"11-out1541"	.93370	169	12	181
11	"11-out1542"	.95121	156	8	164
11	"11-out1543"	.99342	151	1	152
11	"11-out1544"	.69023	205	92	297
11	"11-out1545"	.34146	112	216	328
11	"11-out1546"	.44396	206	258	464
11	"11-out1547"	.99494	197	1	198
11	"11-out1548"	.46315	616	714	1330
11	"11-out1549"	.44525	850	1059	1909
11	"11-out1550"	.26801	119	325	444
11	"11-out1551"	.35483	154	280	434
11	"11-out1552"	.32900	152	310	462
11	"11-out1553"	.56322	1599	1240	2839
11	"11-out1554"	.34602	209	395	604
11	"11-out1555"	.66666	600	300	900
11	"11-out1556"	.92270	191	16	207
11	"11-out1557"	.33715	147	289	436
11	"11-out1558"	.46341	190	220	410
11	"11-out1559"	.14788	21	121	142
11	"11-out1560"	.97402	225	6	231
11	"11-out1561"	.51507	205	193	398
11	"11-out1562"	.42886	208	277	485
11	"11-out1563"	.72949	329	122	451
11	"11-out1564"	.99032	307	3	310
11	"11-out1565"	.73854	274	97	371
11	"11-out1566"	.34065	93	180	273
11	"11-out1567"	.59756	245	165	410
11	"11-out1568"	.66334	400	203	603
11	"11-out1569"	.44753	145	179	324
11	"11-out1570"	.81372	664	152	816
11	"11-out1571"	.44582	288	358	646
11	"11-out1572"	.22397	142	492	634
11	"11-out1573"	.38339	97	156	253
11	"11-out1574"	.53169	151	133	284
11	"11-out1575"	.48814	247	259	506
11	"11-out1576"	.43898	259	331	590
11	"11-out1577"	.56593	103	79	182
11	"11-out1578"	.59888	430	288	718
11	"11-out1579"	.47865	157	171	328
11	"11-out1580"	.40186	129	192	321
11	"11-out1581"	.84800	106	19	125
11	"11-out1582"	.86640	441	68	509
11	"11-out1583"	.33592	389	769	1158
11	"11-out1584"	.52820	103	92	195
11	"11-out1585"	.44622	195	242	437
11	"11-out1586"	.32115	167	353	520
11	"11-out1587"	.40887	175	253	428
11	"11-out1588"	.77419	240	70	310
11	"11-out1589"	.33658	69	136	205
11	"11-out1590"	.94561	313	18	331
11	"11-out1591"	.35031	55	102	157
11	"11-out1592"	.83127	202	41	243
11	"11-out1593"	.95576	605	28	633
11	"11-out1594"	.99686	636	2	638
11	"11-out1595"	.99889	901	1	902
11	"11-out1596"	.46491	53	61	114
11	"11-out1597"	.64516	80	44	124
11	"11-out1598"	.75308	61	20	81
11	"11-out1599"	.50190	132	131	263
11	"11-out1600"	.99590	243	1	244
11	"11-out1601"	.99761	418	1	419
11	"11-out1602"	.29310	187	451	638
11	"11-out1603"	.29025	283	692	975
11	"11-out1604"	.43565	281	364	645
11	"11-out1605"	.46782	458	521	979
11	"11-out1606"	.35873	353	631	984
11	"11-out1607"	.34697	373	702	1075
11	"11-out1608"	.99586	482	2	484
11	"11-out1609"	.37636	172	285	457
11	"11-out1610"	.49473	1034	1056	2090
11	"11-out1611"	.63405	175	101	276
11	"11-out1612"	.41062	85	122	207
11	"11-out1613"	.98958	95	1	96
11	"11-out1614"	.63800	141	80	221
11	"11-out1615"	.25641	130	377	507
11	"11-out1616"	.20704	94	360	454
11	"11-out1617"	.36639	314	543	857
11	"11-out1618"	.87866	420	58	478
11	"11-out1619"	.37121	98	166	264
11	"11-out1620"	.98666	74	1	75
11	"11-out1621"	.28054	225	577	802
11	"11-out1622"	.53557	271	235	506
11	"11-out1623"	.99774	442	1	443
11	"11-out1624"	.24901	190	573	763
11	"11-out1625"	.42163	573	786	1359
11	"11-out1626"	.20070	114	454	568
11	"11-out1627"	.31627	136	294	430
11	"11-out1628"	.36900	100	171	271
11	"11-out1629"	.22203	135	473	608
11	"11-out1630"	.34716	887	1668	2555
11	"11-out1631"	.99714	349	1	350
11	"11-out1632"	.98644	364	5	369
11	"11-out1633"	.99714	349	1	350
11	"11-out1634"	.99728	368	1	369
11	"11-out1635"	.99728	368	1	369
11	"11-out1636"	.62616	134	80	214
11	"11-out1637"	.99200	496	4	500
11	"11-out1638"	.40816	80	116	196
11	"11-out1639"	.99393	164	1	165
11	"11-out1640"	.20134	120	476	596
11	"11-out1641"	.38477	187	299	486
11	"11-out1642"	.17741	77	357	434
11	"11-out1643"	.46916	213	241	454
11	"11-out1644"	.76793	182	55	237
11	"11-out1645"	.18309	26	116	142
11	"11-out1646"	.46113	89	104	193
11	"11-out1647"	.99891	920	1	921
11	"11-out1648"	.37251	450	758	1208
11	"11-out1649"	.42705	161	216	377
11	"11-out1650"	.28210	413	1051	1464
11	"11-out1651"	.39637	153	233	386
11	"11-out1652"	.38941	979	1535	2514
11	"11-out1653"	.32984	63	128	191
11	"11-out1654"	.95212	179	9	188
11	"11-out1655"	.63218	275	160	435
11	"11-out1656"	.99186	244	2	246
11	"11-out1657"	.92134	410	35	445
11	"11-out1658"	.62650	208	124	332
11	"11-out1659"	.39173	237	368	605
11	"11-out1660"	.35491	148	269	417
11	"11-out1661"	.28598	151	377	528
11	"11-out1662"	.34630	525	991	1516
11	"11-out1663"	.34210	130	250	380
11	"11-out1664"	.38690	130	206	336
11	"11-out1665"	.25129	194	578	772
11	"11-out1666"	.33522	236	468	704
11	"11-out1667"	.37076	175	297	472
11	"11-out1668"	.98745	787	10	797
11	"11-out1669"	.36718	141	243	384
11	"11-out1670"	.83098	177	36	213
11	"11-out1671"	.22133	276	971	1247
11	"11-out1672"	.99346	152	1	153
11	"11-out1673"	.33909	157	306	463
11	"11-out1674"	.61692	430	267	697
11	"11-out1675"	.33816	70	137	207
11	"11-out1676"	.30963	135	301	436
11	"11-out1677"	.99918	1221	1	1222
11	"11-out1678"	.99714	349	1	350
11	"11-out1679"	.48314	86	92	178
11	"11-out1680"	.27894	106	274	380
11	"11-out1681"	.26884	107	291	398
11	"11-out1682"	.25721	98	283	381
11	"11-out1683"	.40509	175	257	432
11	"11-out1684"	.38544	143	228	371
11	"11-out1685"	.44270	170	214	384
11	"11-out1686"	.36796	85	146	231
11	"11-out1687"	.98529	67	1	68
11	"11-out1688"	.99082	108	1	109
11	"11-out1689"	.36080	972	1722	2694
11	"11-out1690"	.48963	189	197	386
11	"11-out1691"	.38271	310	500	810
11	"11-out1692"	.99598	248	1	249
11	"11-out1693"	.28095	59	151	210
11	"11-out1694"	.23333	91	299	390
11	"11-out1695"	.30780	213	479	692
11	"11-out1696"	.54039	495	421	916
11	"11-out1697"	.82283	209	45	254
11	"11-out1698"	.40576	366	536	902
11	"11-out1699"	.23892	178	567	745
11	"11-out1700"	.92741	460	36	496
11	"11-out1701"	.30446	109	249	358
11	"11-out1702"	.37371	617	1034	1651
11	"11-out1703"	.36058	1689	2995	4684
11	"11-out1704"	.75714	265	85	350
11	"11-out1705"	.60165	145	96	241
11	"11-out1706"	.43103	100	132	232
11	"11-out1707"	.30827	164	368	532
11	"11-out1708"	.98666	74	1	75
11	"11-out1709"	.27336	392	1042	1434
11	"11-out1710"	.99782	459	1	460
11	"11-out1711"	.99692	324	1	325
11	"11-out1712"	.27450	140	370	510
11	"11-out1713"	.99065	106	1	107
11	"11-out1714"	.51700	76	71	147
11	"11-out1715"	.83217	481	97	578
11	"11-out1716"	.83018	264	54	318
11	"11-out1717"	.29693	155	367	522
11	"11-out1718"	.32889	469	957	1426
11	"11-out1719"	.99823	564	1	565
11	"11-out1720"	.51562	165	155	320
11	"11-out1721"	.33913	234	456	690
11	"11-out1722"	.35990	158	281	439
11	"11-out1723"	.58666	220	155	375
11	"11-out1724"	.26741	119	326	445
11	"11-out1725"	.30927	30	67	97
11	"11-out1726"	.36682	230	397	627
11	"11-out1727"	.54255	255	215	470
11	"11-out1728"	.25693	139	402	541
11	"11-out1729"	.33678	195	384	579
11	"11-out1730"	.20863	29	110	139
11	"11-out1731"	.99762	839	2	841
11	"11-out1732"	.45697	308	366	674
11	"11-out1733"	.33333	67	134	201
11	"11-out1734"	.29702	739	1749	2488
11	"11-out1735"	.35387	844	1541	2385
11	"11-out1736"	.43840	121	155	276
11	"11-out1737"	.22549	92	316	408
11	"11-out1738"	.15891	41	217	258
11	"11-out1739"	.93973	577	37	614
11	"11-out1740"	.55613	1169	933	2102
11	"11-out1741"	.18750	153	663	816
11	"11-out1742"	.43315	81	106	187
11	"11-out1743"	.32485	217	451	668
11	"11-out1744"	.37077	373	633	1006
11	"11-out1745"	.83941	115	22	137
11	"11-out1746"	.15180	63	352	415
11	"11-out1747"	.99086	217	2	219
11	"11-out1748"	.35733	134	241	375
11	"11-out1749"	.40340	142	210	352
11	"11-out1750"	.21875	28	100	128
11	"11-out1751"	.35042	123	228	351
11	"11-out1752"	.98773	805	10	815
11	"11-out1753"	.45422	382	459	841
11	"11-out1754"	.29629	80	190	270
11	"11-out1755"	.67158	182	89	271
11	"11-out1756"	.95939	827	35	862
11	"11-out1757"	.16355	70	358	428
11	"11-out1758"	.22708	161	548	709
11	"11-out1759"	.39762	134	203	337
11	"11-out1760"	.76666	138	42	180
11	"11-out1761"	.98958	95	1	96
11	"11-out1762"	.77490	389	113	502
11	"11-out1763"	.34840	524	980	1504
11	"11-out1764"	.19523	164	676	840
11	"11-out1765"	.64268	545	303	848
11	"11-out1766"	.30364	208	477	685
11	"11-out1767"	.95460	715	34	749
11	"11-out1768"	.45988	321	377	698
11	"11-out1769"	.27830	177	459	636
11	"11-out1770"	.39484	199	305	504
11	"11-out1771"	.98666	74	1	75
11	"11-out1772"	.53468	1241	1080	2321
11	"11-out1773"	.73431	199	72	271
11	"11-out1774"	.31511	294	639	933
11	"11-out1775"	.31384	102	223	325
11	"11-out1776"	.60349	207	136	343
11	"11-out1777"	.99569	1156	5	1161
11	"11-out1778"	.35365	174	318	492
11	"11-out1779"	.25249	76	225	301
11	"11-out1780"	.33682	418	823	1241
11	"11-out1781"	.99748	396	1	397
11	"11-out1782"	.46902	159	180	339
11	"11-out1783"	.99637	275	1	276
11	"11-out1784"	.42328	1247	1699	2946
11	"11-out1785"	.51490	190	179	369
11	"11-out1786"	.37821	250	411	661
11	"11-out1787"	.33149	180	363	543
11	"11-out1788"	.30303	60	138	198
11	"11-out1789"	.83152	153	31	184
11	"11-out1790"	.20238	85	335	420
11	"11-out1791"	.51898	123	114	237
11	"11-out1792"	.56617	154	118	272
11	"11-out1793"	.32151	127	268	395
11	"11-out1794"	.16037	34	178	212
11	"11-out1795"	.99333	149	1	150
11	"11-out1796"	.30733	134	302	436
11	"11-out1797"	.41075	191	274	465
11	"11-out1798"	.29807	62	146	208
11	"11-out1799"	.35211	75	138	213
11	"11-out1800"	.49247	360	371	731
11	"11-out1801"	.78748	919	248	1167
11	"11-out1802"	.49494	294	300	594
11	"11-out1803"	.26909	148	402	550
11	"11-out1804"	.26753	103	282	385
11	"11-out1805"	.29826	516	1214	1730
11	"11-out1806"	.29824	34	80	114
11	"11-out1807"	.19565	117	481	598
11	"11-out1808"	.50798	318	308	626
11	"11-out1809"	.35013	403	748	1151
11	"11-out1810"	.30841	359	805	1164
11	"11-out1811"	.31875	204	436	640
11	"11-out1812"	.39294	334	516	850
11	"11-out1813"	.44274	116	146	262
11	"11-out1814"	.27826	64	166	230
11	"11-out1815"	.34048	127	246	373
11	"11-out1816"	.37588	159	264	423
11	"11-out1817"	.46622	766	877	1643
11	"11-out1818"	.32017	73	155	228
11	"11-out1819"	.37147	237	401	638
11	"11-out1820"	.99921	1266	1	1267
11	"11-out1821"	.64591	166	91	257
11	"11-out1822"	.49709	342	346	688
11	"11-out1823"	.75107	525	174	699
11	"11-out1824"	.19020	66	281	347
11	"11-out1825"	.38694	166	263	429
11	"11-out1826"	.28039	226	580	806
11	"11-out1827"	.84375	54	10	64
11	"11-out1828"	.21543	67	244	311
11	"11-out1829"	.46193	534	622	1156
11	"11-out1830"	.30703	253	571	824
11	"11-out1831"	.39130	234	364	598
11	"11-out1832"	.33333	167	334	501
11	"11-out1833"	.28037	150	385	535
11	"11-out1834"	.08187	14	157	171
11	"11-out1835"	.24274	159	496	655
11	"11-out1836"	.59220	228	157	385
11	"11-out1837"	.36677	117	202	319
11	"11-out1838"	.99408	168	1	169
11	"11-out1839"	.38936	227	356	583
11	"11-out1840"	.93333	168	12	180
11	"11-out1841"	.81707	134	30	164
11	"11-out1842"	.98974	193	2	195
11	"11-out1843"	.67680	178	85	263
11	"11-out1844"	.36098	235	416	651
11	"11-out1845"	.38080	123	200	323
11	"11-out1846"	.21774	54	194	248
11	"11-out1847"	.19933	60	241	301
11	"11-out1848"	.99862	1455	2	1457
11	"11-out1849"	.97979	97	2	99
11	"11-out1850"	.33510	126	250	376
11	"11-out1851"	.21658	141	510	651
11	"11-out1852"	.39411	201	309	510
11	"11-out1853"	.39498	1087	1665	2752
11	"11-out1854"	.35563	202	366	568
11	"11-out1855"	.18571	13	57	70
11	"11-out1856"	.29868	227	533	760
11	"11-out1857"	.98765	80	1	81
11	"11-out1858"	.99137	115	1	116
11	"11-out1859"	.98979	97	1	98
11	"11-out1860"	.35317	178	326	504
11	"11-out1861"	.44808	492	606	1098
11	"11-out1862"	.29378	104	250	354
11	"11-out1863"	.70631	380	158	538
11	"11-out1864"	.29695	400	947	1347
11	"11-out1865"	.37355	226	379	605
11	"11-out1866"	.95244	661	33	694
11	"11-out1867"	.34560	122	231	353
11	"11-out1868"	.61538	144	90	234
11	"11-out1869"	.53133	195	172	367
11	"11-out1870"	.75094	199	66	265
11	"11-out1871"	.40000	66	99	165
11	"11-out1872"	.29508	180	430	610
11	"11-out1873"	.41159	284	406	690
11	"11-out1874"	.54797	217	179	396
11	"11-out1875"	.46504	153	176	329
11	"11-out1876"	.64166	231	129	360
11	"11-out1877"	.66384	235	119	354
11	"11-out1878"	.37250	187	315	502
11	"11-out1879"	.79779	651	165	816
11	"11-out1880"	.56485	135	104	239
11	"11-out1881"	.40845	116	168	284
11	"11-out1882"	.34265	98	188	286
11	"11-out1883"	.46597	452	518	970
11	"11-out1884"	.99702	335	1	336
11	"11-out1885"	.80219	146	36	182
11	"11-out1886"	.20394	31	121	152
11	"11-out1887"	.98300	405	7	412
11	"11-out1888"	.86648	623	96	719
11	"11-out1889"	.38060	263	428	691
11	"11-out1890"	.41025	288	414	702
11	"11-out1891"	.74836	1029	346	1375
11	"11-out1892"	.58086	765	552	1317
11	"11-out1893"	.57161	447	335	782
11	"11-out1894"	.96218	458	18	476
11	"11-out1895"	.99305	286	2	288
11	"11-out1896"	.98666	74	1	75
11	"11-out1897"	.15270	62	344	406
11	"11-out1898"	.60677	179	116	295
11	"11-out1899"	.50371	339	334	673
11	"11-out1900"	.20218	37	146	183
11	"11-out1901"	.70370	114	48	162
11	"11-out1902"	.99682	314	1	315
11	"11-out1903"	.62601	231	138	369
11	"11-out1904"	.99067	425	4	429
11	"11-out1905"	.45883	418	493	911
11	"11-out1906"	.28077	130	333	463
11	"11-out1907"	.41142	72	103	175
11	"11-out1908"	.67047	352	173	525
11	"11-out1909"	.13276	47	307	354
11	"11-out1910"	.19384	63	262	325
11	"11-out1911"	.81818	135	30	165
11	"11-out1912"	.20437	215	837	1052
11	"11-out1913"	.15862	92	488	580
11	"11-out1914"	.33922	192	374	566
11	"11-out1915"	.46067	82	96	178
11	"11-out1916"	.27000	162	438	600
11	"11-out1917"	.99678	310	1	311
11	"11-out1918"	.61851	167	103	270
11	"11-out1919"	.45528	112	134	246
11	"11-out1920"	.38387	200	321	521
11	"11-out1921"	.30570	332	754	1086
11	"11-out1922"	.37900	296	485	781
11	"11-out1923"	.42720	446	598	1044
11	"11-out1924"	.29029	290	709	999
11	"11-out1925"	.44134	79	100	179
11	"11-out1926"	.49898	491	493	984
11	"11-out1927"	.62068	270	165	435
11	"11-out1928"	.33925	191	372	563
11	"11-out1929"	.44680	84	104	188
11	"11-out1930"	.85714	120	20	140
11	"11-out1931"	.40869	47	68	115
11	"11-out1932"	.29067	159	388	547
11	"11-out1933"	.27526	128	337	465
11	"11-out1934"	.40085	467	698	1165
11	"11-out1935"	.39743	31	47	78
11	"11-out1936"	.33211	181	364	545
11	"11-out1937"	.41538	243	342	585
11	"11-out1938"	.46267	440	511	951
11	"11-out1939"	.41234	374	533	907
11	"11-out1940"	.99779	452	1	453
11	"11-out1941"	.34792	302	566	868
11	"11-out1942"	.48466	490	521	1011
11	"11-out1943"	.99376	478	3	481
11	"11-out1944"	.37832	185	304	489
11	"11-out1945"	.60821	888	572	1460
11	"11-out1946"	.99858	706	1	707
11	"11-out1947"	.99224	128	1	129
11	"11-out1948"	.51396	865	818	1683
11	"11-out1949"	.38214	214	346	560
11	"11-out1950"	.99921	1274	1	1275
11	"11-out1951"	.49477	284	290	574
11	"11-out1952"	.18579	34	149	183
11	"11-out1953"	.35825	321	575	896
11	"11-out1954"	.18790	115	497	612
11	"11-out1955"	.43313	217	284	501
11	"11-out1956"	.99750	399	1	400
11	"11-out1957"	.39233	215	333	548
11	"11-out1958"	.65405	242	128	370
11	"11-out1959"	.46153	114	133	247
11	"11-out1960"	.44000	88	112	200
11	"11-out1961"	.47601	258	284	542
11	"11-out1962"	.37198	247	417	664
11	"11-out1963"	.37841	263	432	695
11	"11-out1964"	.57476	246	182	428
11	"11-out1965"	.38308	154	248	402
11	"11-out1966"	.29655	43	102	145
11	"11-out1967"	.44972	246	301	547
11	"11-out1968"	.66804	1294	643	1937
11	"11-out1969"	.46192	91	106	197
11	"11-out1970"	.49029	379	394	773
11	"11-out1971"	.30985	264	588	852
11	"11-out1972"	.24831	221	669	890
11	"11-out1973"	.25969	221	630	851
11	"11-out1974"	.25130	144	429	573
11	"11-out1975"	.20919	141	533	674
11	"11-out1976"	.29069	175	427	602
11	"11-out1977"	.99788	945	2	947
11	"11-out1978"	.56063	282	221	503
11	"11-out1979"	.30625	245	555	800
11	"11-out1980"	.44303	140	176	316
11	"11-out1981"	.60084	143	95	238
11	"11-out1982"	.95081	348	18	366
11	"11-out1983"	.35368	197	360	557
11	"11-out1984"	.23691	86	277	363
11	"11-out1985"	.28325	115	291	406
11	"11-out1986"	.47619	190	209	399
11	"11-out1987"	.32850	68	139	207
11	"11-out1988"	.32544	220	456	676
11	"11-out1989"	.33730	255	501	756
11	"11-out1990"	.28021	102	262	364
11	"11-out1991"	.33834	652	1275	1927
11	"11-out1992"	.13390	47	304	351
11	"11-out1993"	.46393	238	275	513
11	"11-out1994"	.51582	163	153	316
11	"11-out1995"	.32985	221	449	670
11	"11-out1996"	.24242	48	150	198
11	"11-out1997"	.22031	141	499	640
11	"11-out1998"	.99919	1246	1	1247
11	"11-out1999"	.33007	945	1918	2863
11	"11-out2000"	.29045	219	535	754
11	"11-out2001"	.33200	83	167	250
11	"11-out2002"	.47064	449	505	954
11	"11-out2003"	.14045	142	869	1011
11	"11-out2004"	.36997	313	533	846
11	"11-out2005"	.99808	522	1	523
11	"11-out2006"	.38762	119	188	307
11	"11-out2007"	.33802	504	987	1491
11	"11-out2008"	.39619	458	698	1156
11	"11-out2009"	.33975	247	480	727
11	"11-out2010"	.72254	125	48	173
11	"11-out2011"	.34632	160	302	462
11	"11-out2012"	.41419	1161	1642	2803
11	"11-out2013"	.37448	182	304	486
11	"11-out2014"	.26875	43	117	160
11	"11-out2015"	.57983	69	50	119
11	"11-out2016"	.99887	891	1	892
11	"11-out2017"	.72149	715	276	991
11	"11-out2018"	.27076	264	711	975
11	"11-out2019"	.20994	114	429	543
11	"11-out2020"	.25201	125	371	496
11	"11-out2021"	.21285	106	392	498
11	"11-out2022"	.31455	134	292	426
11	"11-out2023"	.33425	486	968	1454
11	"11-out2024"	.45301	188	227	415
11	"11-out2025"	.48275	84	90	174
11	"11-out2026"	.55456	437	351	788
11	"11-out2027"	.41619	365	512	877
11	"11-out2028"	.19696	52	212	264
11	"11-out2029"	.22345	221	768	989
11	"11-out2030"	.38167	50	81	131
11	"11-out2031"	.76404	136	42	178
11	"11-out2032"	.44206	103	130	233
11	"11-out2033"	.33698	123	242	365
11	"11-out2034"	.33403	158	315	473
11	"11-out2035"	.22368	255	885	1140
11	"11-out2036"	.49501	298	304	602
11	"11-out2037"	.99822	562	1	563
11	"11-out2038"	.55163	219	178	397
11	"11-out2039"	.97910	328	7	335
11	"11-out2040"	.43190	222	292	514
11	"11-out2041"	.49806	129	130	259
11	"11-out2042"	.99744	391	1	392
11	"11-out2043"	.42517	125	169	294
11	"11-out2044"	.45525	117	140	257
11	"11-out2045"	.54328	182	153	335
11	"11-out2046"	.35734	253	455	708
11	"11-out2047"	.35945	266	474	740
11	"11-out2048"	.47777	172	188	360
11	"11-out2049"	.50852	179	173	352
11	"11-out2050"	.49357	192	197	389
11	"11-out2051"	.99259	134	1	135
11	"11-out2052"	.42477	48	65	113
11	"11-out2053"	.18943	312	1335	1647
11	"11-out2054"	.99371	316	2	318
11	"11-out2055"	.32573	100	207	307
11	"11-out2056"	.57060	198	149	347
11	"11-out2057"	.38998	335	524	859
11	"11-out2058"	.62099	213	130	343
11	"11-out2059"	.99681	313	1	314
11	"11-out2060"	.86119	273	44	317
11	"11-out2061"	.84677	105	19	124
11	"11-out2062"	.47619	210	231	441
11	"11-out2063"	.52095	174	160	334
11	"11-out2064"	.35294	54	99	153
11	"11-out2065"	.39411	134	206	340
11	"11-out2066"	.37688	225	372	597
11	"11-out2067"	.35171	542	999	1541
11	"11-out2068"	.30455	388	886	1274
11	"11-out2069"	.49142	258	267	525
11	"11-out2070"	.54850	147	121	268
11	"11-out2071"	.97058	66	2	68
11	"11-out2072"	.30204	177	409	586
11	"11-out2073"	.27083	104	280	384
11	"11-out2074"	.45348	156	188	344
11	"11-out2075"	.99576	235	1	236
11	"11-out2076"	.97368	111	3	114
11	"11-out2077"	.87288	103	15	118
11	"11-out2078"	.28787	57	141	198
11	"11-out2079"	.53804	99	85	184
11	"11-out2080"	.99386	162	1	163
11	"11-out2081"	.44000	77	98	175
11	"11-out2082"	.99431	175	1	176
11	"11-out2083"	.35714	215	387	602
11	"11-out2084"	.37500	30	50	80
11	"11-out2085"	.23844	98	313	411
11	"11-out2086"	.16621	62	311	373
11	"11-out2087"	.62349	207	125	332
11	"11-out2088"	.82634	276	58	334
11	"11-out2089"	.89759	298	34	332
11	"11-out2090"	.98630	144	2	146
11	"11-out2091"	.48472	238	253	491
11	"11-out2092"	.23652	158	510	668
11	"11-out2093"	.59894	227	152	379
11	"11-out2094"	.17703	74	344	418
11	"11-out2095"	.93715	343	23	366
11	"11-out2096"	.45185	122	148	270
11	"11-out2097"	.41847	77	107	184
11	"11-out2098"	.42727	94	126	220
11	"11-out2099"	.45852	503	594	1097
11	"11-out2100"	.40843	484	701	1185
11	"11-out2101"	.77288	228	67	295
11	"11-out2102"	.43736	391	503	894
11	"11-out2103"	.50588	215	210	425
11	"11-out2104"	.32624	46	95	141
11	"11-out2105"	.32038	66	140	206
11	"11-out2106"	.47216	687	768	1455
11	"11-out2107"	.44505	81	101	182
11	"11-out2108"	.92810	142	11	153
11	"11-out2109"	.32464	137	285	422
11	"11-out2110"	.77397	113	33	146
11	"11-out2111"	.38482	279	446	725
11	"11-out2112"	.31759	222	477	699
11	"11-out2113"	.50657	231	225	456
11	"11-out2114"	.98280	400	7	407
11	"11-out2115"	.35587	200	362	562
11	"11-out2116"	.32894	150	306	456
11	"11-out2117"	.52338	235	214	449
11	"11-out2118"	.49420	256	262	518
11	"11-out2119"	.36375	279	488	767
11	"11-out2120"	.44660	184	228	412
11	"11-out2121"	.29777	134	316	450
11	"11-out2122"	.96736	415	14	429
11	"11-out2123"	.87077	2190	325	2515
11	"11-out2124"	.99435	528	3	531
11	"11-out2125"	.34029	114	221	335
11	"11-out2126"	.36830	172	295	467
11	"11-out2127"	.35211	50	92	142
11	"11-out2128"	.83962	534	102	636
11	"11-out2129"	.49681	234	237	471
11	"11-out2130"	.99799	498	1	499
11	"11-out2131"	.26760	114	312	426
11	"11-out2132"	.98412	310	5	315
11	"11-out2133"	.44230	138	174	312
11	"11-out2134"	.98713	307	4	311
11	"11-out2135"	.34188	200	385	585
11	"11-out2136"	.30580	137	311	448
11	"11-out2137"	.50000	157	157	314
11	"11-out2138"	.34431	115	219	334
11	"11-out2139"	.40548	133	195	328
11	"11-out2140"	.91823	292	26	318
11	"11-out2141"	.88952	467	58	525
11	"11-out2142"	.29947	746	1745	2491
11	"11-out2143"	.54140	170	144	314
11	"11-out2144"	.34076	107	207	314
11	"11-out2145"	.96753	298	10	308
11	"11-out2146"	.95007	647	34	681
11	"11-out2147"	.99657	291	1	292
11	"11-out2148"	.99827	579	1	580
11	"11-out2149"	.33114	101	204	305
11	"11-out2150"	.99636	274	1	275
11	"11-out2151"	.22511	147	506	653
11	"11-out2152"	.37837	98	161	259
11	"11-out2153"	.42898	148	197	345
11	"11-out2154"	.20810	77	293	370
11	"11-out2155"	.84523	213	39	252
11	"11-out2156"	.99280	138	1	139
11	"11-out2157"	.41756	271	378	649
11	"11-out2158"	.34459	102	194	296
11	"11-out2159"	.33944	111	216	327
11	"11-out2160"	.98989	196	2	198
11	"11-out2161"	.28424	193	486	679
11	"11-out2162"	.27500	220	580	800
11	"11-out2163"	.82493	311	66	377
11	"11-out2164"	.27955	175	451	626
11	"11-out2165"	.36607	123	213	336
11	"11-out2166"	.59133	191	132	323
11	"11-out2167"	.36608	503	871	1374
11	"11-out2168"	.46204	280	326	606
11	"11-out2169"	.28712	174	432	606
11	"11-out2170"	.99750	400	1	401
11	"11-out2171"	.31343	105	230	335
11	"11-out2172"	.87195	143	21	164
11	"11-out2173"	.39093	414	645	1059
11	"11-out2174"	.15346	93	513	606
11	"11-out2175"	.43064	326	431	757
11	"11-out2176"	.40703	162	236	398
11	"11-out2177"	.36879	156	267	423
11	"11-out2178"	.51366	188	178	366
11	"11-out2179"	.33082	132	267	399
11	"11-out2180"	.33707	210	413	623
11	"11-out2181"	.51261	325	309	634
11	"11-out2182"	.49074	265	275	540
11	"11-out2183"	.29315	107	258	365
11	"11-out2184"	.30511	173	394	567
11	"11-out2185"	.31014	214	476	690
11	"11-out2186"	.61600	154	96	250
11	"11-out2187"	.39737	788	1195	1983
11	"11-out2188"	.51326	387	367	754
11	"11-out2189"	.86858	271	41	312
11	"11-out2190"	.31341	236	517	753
11	"11-out2191"	.99242	131	1	132
11	"11-out2192"	.46197	644	750	1394
11	"11-out2193"	.51008	177	170	347
11	"11-out2194"	.28804	53	131	184
11	"11-out2195"	.58213	202	145	347
11	"11-out2196"	.51219	147	140	287
11	"11-out2197"	.44023	302	384	686
11	"11-out2198"	.30065	92	214	306
11	"11-out2199"	.31724	355	764	1119
11	"11-out2200"	.53488	552	480	1032
11	"11-out2201"	.30693	93	210	303
11	"11-out2202"	.99319	146	1	147
11	"11-out2203"	.37387	83	139	222
11	"11-out2204"	.67123	147	72	219
11	"11-out2205"	.99264	135	1	136
11	"11-out2206"	.79661	188	48	236
11	"11-out2207"	.71267	506	204	710
11	"11-out2208"	.62359	719	434	1153
11	"11-out2209"	.45969	1072	1260	2332
11	"11-out2210"	.35384	1035	1890	2925
11	"11-out2211"	.46960	224	253	477
11	"11-out2212"	.31494	177	385	562
11	"11-out2213"	.23455	338	1103	1441
11	"11-out2214"	.36298	306	537	843
11	"11-out2215"	.43971	248	316	564
11	"11-out2216"	.76299	367	114	481
11	"11-out2217"	.39754	227	344	571
11	"11-out2218"	.24774	110	334	444
11	"11-out2219"	.99915	1184	1	1185
11	"11-out2220"	.26666	116	319	435
11	"11-out2221"	.17361	25	119	144
11	"11-out2222"	.63758	95	54	149
11	"11-out2223"	.50344	73	72	145
11	"11-out2224"	.34659	61	115	176
11	"11-out2225"	.84042	158	30	188
11	"11-out2226"	.32932	219	446	665
11	"11-out2227"	.42684	283	380	663
11	"11-out2228"	.22222	104	364	468
11	"11-out2229"	.33333	321	642	963
11	"11-out2230"	.24859	221	668	889
11	"11-out2231"	.36978	328	559	887
11	"11-out2232"	.28539	387	969	1356
11	"11-out2233"	.28938	90	221	311
11	"11-out2234"	.41620	226	317	543
11	"11-out2235"	.88654	336	43	379
11	"11-out2236"	.32967	120	244	364
11	"11-out2237"	.26283	87	244	331
11	"11-out2238"	.33677	163	321	484
11	"11-out2239"	.99601	250	1	251
11	"11-out2240"	.76470	52	16	68
11	"11-out2241"	.55898	199	157	356
11	"11-out2242"	.98996	789	8	797
11	"11-out2243"	.98746	788	10	798
11	"11-out2244"	.88077	820	111	931
11	"11-out2245"	.96823	762	25	787
11	"11-out2246"	.18894	82	352	434
11	"11-out2247"	.33302	356	713	1069
11	"11-out2248"	.88253	849	113	962
11	"11-out2249"	.89778	852	97	949
11	"11-out2250"	.30317	248	570	818
11	"11-out2251"	.70676	564	234	798
11	"11-out2252"	.36328	93	163	256
11	"11-out2253"	.36857	129	221	350
11	"11-out2254"	.39893	150	226	376
11	"11-out2255"	.34907	207	386	593
11	"11-out2256"	.23478	81	264	345
11	"11-out2257"	.99728	367	1	368
11	"11-out2258"	.91619	481	44	525
11	"11-out2259"	.41240	266	379	645
11	"11-out2260"	.38342	199	320	519
11	"11-out2261"	.33819	139	272	411
11	"11-out2262"	.64098	857	480	1337
11	"11-out2263"	.40704	589	858	1447
11	"11-out2264"	.64270	304	169	473
11	"11-out2265"	.36410	142	248	390
11	"11-out2266"	.45814	104	123	227
11	"11-out2267"	.99751	401	1	402
11	"11-out2268"	.99864	737	1	738
11	"11-out2269"	.46229	374	435	809
11	"11-out2270"	.85135	504	88	592
11	"11-out2271"	.46635	298	341	639
11	"11-out2272"	.30531	178	405	583
11	"11-out2273"	.45743	489	580	1069
11	"11-out2274"	.48780	260	273	533
11	"11-out2275"	.32656	193	398	591
11	"11-out2276"	.28298	341	864	1205
11	"11-out2277"	.29976	256	598	854
11	"11-out2278"	.22287	76	265	341
11	"11-out2279"	.47233	956	1068	2024
11	"11-out2280"	.28125	180	460	640
11	"11-out2281"	.54621	195	162	357
11	"11-out2282"	.43764	1460	1876	3336
11	"11-out2283"	.30240	528	1218	1746
11	"11-out2284"	.45805	475	562	1037
11	"11-out2285"	.21291	89	329	418
11	"11-out2286"	.65254	462	246	708
11	"11-out2287"	.62637	114	68	182
11	"11-out2288"	.34653	105	198	303
11	"11-out2289"	.36153	47	83	130
11	"11-out2290"	.26233	101	284	385
11	"11-out2291"	.22222	96	336	432
11	"11-out2292"	.31140	232	513	745
11	"11-out2293"	.36136	434	767	1201
11	"11-out2294"	.38088	259	421	680
11	"11-out2295"	.32820	64	131	195
11	"11-out2296"	.99864	736	1	737
11	"11-out2297"	.42187	135	185	320
11	"11-out2298"	.81496	207	47	254
11	"11-out2299"	.47900	251	273	524
11	"11-out2300"	.62679	131	78	209
11	"11-out2301"	.95225	359	18	377
11	"11-out2302"	.32234	88	185	273
11	"11-out2303"	.21818	72	258	330
11	"11-out2304"	.27055	102	275	377
11	"11-out2305"	.73015	138	51	189
11	"11-out2306"	.85788	1479	245	1724
11	"11-out2307"	.13043	51	340	391
11	"11-out2308"	.27777	125	325	450
11	"11-out2309"	.68219	249	116	365
11	"11-out2310"	.98742	785	10	795
11	"11-out2311"	.97351	772	21	793
11	"11-out2312"	.32397	173	361	534
11	"11-out2313"	.99000	792	8	800
11	"11-out2314"	.98368	784	13	797
11	"11-out2315"	.47610	259	285	544
11	"11-out2316"	.88241	818	109	927
11	"11-out2317"	.97680	758	18	776
11	"11-out2318"	.89894	854	96	950
11	"11-out2319"	.87875	819	113	932
11	"11-out2320"	.87875	819	113	932
11	"11-out2321"	.59047	496	344	840
11	"11-out2322"	.90223	849	92	941
11	"11-out2323"	.36065	176	312	488
11	"11-out2324"	.65924	681	352	1033
11	"11-out2325"	.49337	633	650	1283
11	"11-out2326"	.42857	66	88	154
11	"11-out2327"	.99492	196	1	197
11	"11-out2328"	.40583	153	224	377
11	"11-out2329"	.30128	188	436	624
11	"11-out2330"	.39700	715	1086	1801
11	"11-out2331"	.38790	263	415	678
11	"11-out2332"	.22538	87	299	386
11	"11-out2333"	.47150	273	306	579
11	"11-out2334"	.25882	110	315	425
11	"11-out2335"	.32776	157	322	479
11	"11-out2336"	.63823	217	123	340
11	"11-out2337"	.37477	633	1056	1689
11	"11-out2338"	.40594	205	300	505
11	"11-out2339"	.98245	784	14	798
11	"11-out2340"	.63720	274	156	430
11	"11-out2341"	.89578	851	99	950
11	"11-out2342"	.24307	228	710	938
11	"11-out2343"	.84811	899	161	1060
11	"11-out2344"	.87982	820	112	932
11	"11-out2345"	.40601	162	237	399
11	"11-out2346"	.20880	147	557	704
11	"11-out2347"	.89978	853	95	948
11	"11-out2348"	.97738	778	18	796
11	"11-out2349"	.43140	261	344	605
11	"11-out2350"	.98756	397	5	402
11	"11-out2351"	.20949	75	283	358
11	"11-out2352"	.98395	184	3	187
11	"11-out2353"	.82042	233	51	284
11	"11-out2354"	.41235	287	409	696
11	"11-out2355"	.26254	68	191	259
11	"11-out2356"	.36102	226	400	626
11	"11-out2357"	.69480	107	47	154
11	"11-out2358"	.41428	406	574	980
11	"11-out2359"	.41176	133	190	323
11	"11-out2360"	.99253	133	1	134
11	"11-out2361"	.21666	169	611	780
11	"11-out2362"	.98941	187	2	189
11	"11-out2363"	.74844	2413	811	3224
11	"11-out2364"	.47722	440	482	922
11	"11-out2365"	.35897	70	125	195
11	"11-out2366"	.24512	88	271	359
11	"11-out2367"	.33163	65	131	196
11	"11-out2368"	.48264	306	328	634
11	"11-out2369"	.68250	273	127	400
11	"11-out2370"	.63565	246	141	387
11	"11-out2371"	.72924	773	287	1060
11	"11-out2372"	.30894	76	170	246
11	"11-out2373"	.40128	689	1028	1717
11	"11-out2374"	.99668	1204	4	1208
11	"11-out2375"	.39152	388	603	991
11	"11-out2376"	.99236	130	1	131
11	"11-out2377"	.25559	80	233	313
11	"11-out2378"	.34726	108	203	311
11	"11-out2379"	.87116	284	42	326
11	"11-out2380"	.97000	97	3	100
11	"11-out2381"	.29665	124	294	418
11	"11-out2382"	.39700	106	161	267
11	"11-out2383"	.98195	381	7	388
11	"11-out2384"	.41209	218	311	529
11	"11-out2385"	.31373	459	1004	1463
11	"11-out2386"	.30783	161	362	523
11	"11-out2387"	.32403	569	1187	1756
11	"11-out2388"	.30090	167	388	555
11	"11-out2389"	.86003	510	83	593
11	"11-out2390"	.86091	359	58	417
11	"11-out2391"	.18625	206	900	1106
11	"11-out2392"	.14832	31	178	209
11	"11-out2393"	.26562	153	423	576
11	"11-out2394"	.40071	224	335	559
11	"11-out2395"	.38319	269	433	702
11	"11-out2396"	.25510	100	292	392
11	"11-out2397"	.32712	123	253	376
11	"11-out2398"	.39858	226	341	567
11	"11-out2399"	.32801	411	842	1253
11	"11-out2400"	.98195	381	7	388
11	"11-out2401"	.58333	154	110	264
11	"11-out2402"	.95081	116	6	122
11	"11-out2403"	.39672	121	184	305
11	"11-out2404"	.40482	151	222	373
11	"11-out2405"	.30563	114	259	373
11	"11-out2406"	.43018	382	506	888
11	"11-out2407"	.29482	171	409	580
11	"11-out2408"	.98306	987	17	1004
11	"11-out2409"	.25197	255	757	1012
11	"11-out2410"	.88152	439	59	498
11	"11-out2411"	.28571	116	290	406
11	"11-out2412"	.28969	104	255	359
11	"11-out2413"	.25000	195	585	780
11	"11-out2414"	.47297	280	312	592
11	"11-out2415"	.22243	115	402	517
11	"11-out2416"	.61027	202	129	331
11	"11-out2417"	.50000	290	290	580
11	"11-out2418"	.47686	268	294	562
11	"11-out2419"	.98897	269	3	272
11	"11-out2420"	.38870	117	184	301
11	"11-out2421"	.68065	746	350	1096
11	"11-out2422"	.41785	852	1187	2039
11	"11-out2423"	.36155	363	641	1004
11	"11-out2424"	.29396	112	269	381
11	"11-out2425"	.39077	517	806	1323
11	"11-out2426"	.99773	441	1	442
11	"11-out2427"	.59006	190	132	322
11	"11-out2428"	.37015	439	747	1186
11	"11-out2429"	.34297	83	159	242
11	"11-out2430"	.31030	301	669	970
11	"11-out2431"	.31382	118	258	376
11	"11-out2432"	.27464	312	824	1136
11	"11-out2433"	.42168	210	288	498
11	"11-out2434"	.99367	157	1	158
11	"11-out2435"	.63945	376	212	588
11	"11-out2436"	.38769	271	428	699
11	"11-out2437"	.99430	349	2	351
11	"11-out2438"	.99766	856	2	858
11	"11-out2439"	.99947	3841	2	3843
11	"11-out2440"	.23219	238	787	1025
11	"11-out2441"	.29354	423	1018	1441
11	"11-out2442"	.39719	255	387	642
11	"11-out2443"	.33846	154	301	455
11	"11-out2444"	.35459	139	253	392
11	"11-out2445"	.54398	235	197	432
11	"11-out2446"	.38622	129	205	334
11	"11-out2447"	.97272	107	3	110
11	"11-out2448"	.88764	79	10	89
11	"11-out2449"	.98913	91	1	92
11	"11-out2450"	.40615	132	193	325
11	"11-out2451"	.40577	295	432	727
11	"11-out2452"	.46385	154	178	332
11	"11-out2453"	.37278	189	318	507
11	"11-out2454"	.25966	47	134	181
11	"11-out2455"	.79702	589	150	739
11	"11-out2456"	.64516	40	22	62
11	"11-out2457"	.99730	370	1	371
11	"11-out2458"	.25874	185	530	715
11	"11-out2459"	.38733	208	329	537
11	"11-out2460"	.35572	143	259	402
11	"11-out2461"	.41133	167	239	406
11	"11-out2462"	.41732	53	74	127
11	"11-out2463"	.30487	75	171	246
11	"11-out2464"	.36758	279	480	759
11	"11-out2465"	.45393	542	652	1194
11	"11-out2466"	.59469	157	107	264
11	"11-out2467"	.27544	46	121	167
11	"11-out2468"	.22586	131	449	580
11	"11-out2469"	.43811	223	286	509
11	"11-out2470"	.57077	125	94	219
11	"11-out2471"	.49409	293	300	593
11	"11-out2472"	.68307	222	103	325
11	"11-out2473"	.23167	79	262	341
11	"11-out2474"	.37274	186	313	499
11	"11-out2475"	.97137	475	14	489
11	"11-out2476"	.93788	453	30	483
11	"11-out2477"	.99832	597	1	598
11	"11-out2478"	.24631	117	358	475
11	"11-out2479"	.81271	703	162	865
11	"11-out2480"	.46067	82	96	178
11	"11-out2481"	.84688	177	32	209
11	"11-out2482"	.35851	261	467	728
11	"11-out2483"	.49549	330	336	666
11	"11-out2484"	.93732	329	22	351
11	"11-out2485"	.25897	101	289	390
11	"11-out2486"	.31989	127	270	397
11	"11-out2487"	.57178	227	170	397
11	"11-out2488"	.29310	34	82	116
11	"11-out2489"	.59565	274	186	460
11	"11-out2490"	.54639	212	176	388
11	"11-out2491"	.38778	254	401	655
11	"11-out2492"	.21843	154	551	705
11	"11-out2493"	.48672	110	116	226
11	"11-out2494"	.53092	103	91	194
11	"11-out2495"	.38526	136	217	353
11	"11-out2496"	.44343	294	369	663
11	"11-out2497"	.56686	195	149	344
11	"11-out2498"	.70996	470	192	662
11	"11-out2499"	.52671	69	62	131
11	"11-out2500"	.68325	151	70	221
11	"11-out2501"	.99404	167	1	168
11	"11-out2502"	.21221	66	245	311
11	"11-out2503"	.22752	81	275	356
11	"11-out2504"	.34210	78	150	228
11	"11-out2505"	.78997	993	264	1257
11	"11-out2506"	.34014	366	710	1076
11	"11-out2507"	.28824	130	321	451
11	"11-out2508"	.43225	201	264	465
11	"11-out2509"	.48608	227	240	467
11	"11-out2510"	.80243	329	81	410
11	"11-out2511"	.99776	447	1	448
11	"11-out2512"	.26086	42	119	161
11	"11-out2513"	.52522	177	160	337
11	"11-out2514"	.19503	55	227	282
11	"11-out2515"	.61904	26	16	42
11	"11-out2516"	.47959	235	255	490
11	"11-out2517"	.29075	437	1066	1503
11	"11-out2518"	.35340	135	247	382
11	"11-out2519"	.34470	202	384	586
11	"11-out2520"	.21190	178	662	840
11	"11-out2521"	.24879	103	311	414
11	"11-out2522"	.50950	268	258	526
11	"11-out2523"	.30303	50	115	165
11	"11-out2524"	.99180	121	1	122
11	"11-out2525"	.41379	144	204	348
11	"11-out2526"	.38235	195	315	510
11	"11-out2527"	.14851	30	172	202
11	"11-out2528"	.21129	131	489	620
11	"11-out2529"	.51182	303	289	592
11	"11-out2530"	.44086	164	208	372
11	"11-out2531"	.56583	361	277	638
11	"11-out2532"	.32861	395	807	1202
11	"11-out2533"	.31979	63	134	197
11	"11-out2534"	.54797	257	212	469
11	"11-out2535"	.99661	588	2	590
11	"11-out2536"	.47743	656	718	1374
11	"11-out2537"	.21067	75	281	356
11	"11-out2538"	.68423	1324	611	1935
11	"11-out2539"	.48108	178	192	370
11	"11-out2540"	.27777	215	559	774
11	"11-out2541"	.31488	165	359	524
11	"11-out2542"	.60912	187	120	307
11	"11-out2543"	.48837	168	176	344
11	"11-out2544"	.44852	122	150	272
11	"11-out2545"	.29020	231	565	796
11	"11-out2546"	.25652	59	171	230
11	"11-out2547"	.23154	69	229	298
11	"11-out2548"	.33778	177	347	524
11	"11-out2549"	.27366	159	422	581
11	"11-out2550"	.18653	133	580	713
11	"11-out2551"	.42143	1915	2629	4544
11	"11-out2552"	.31355	185	405	590
11	"11-out2553"	.99019	101	1	102
11	"11-out2554"	.38108	141	229	370
11	"11-out2555"	.32317	212	444	656
11	"11-out2556"	.47855	279	304	583
11	"11-out2557"	.38833	506	797	1303
11	"11-out2558"	.48478	430	457	887
11	"11-out2559"	.99333	149	1	150
11	"11-out2560"	.45413	802	964	1766
11	"11-out2561"	.15885	78	413	491
11	"11-out2562"	.99371	158	1	159
11	"11-out2563"	.35668	112	202	314
11	"11-out2564"	.99581	238	1	239
11	"11-out2565"	.26037	182	517	699
11	"11-out2566"	.22049	213	753	966
11	"11-out2567"	.35828	225	403	628
11	"11-out2568"	.27345	102	271	373
11	"11-out2569"	.50420	240	236	476
11	"11-out2570"	.51704	91	85	176
11	"11-out2571"	.66112	199	102	301
11	"11-out2572"	.27351	221	587	808
11	"11-out2573"	.38517	213	340	553
11	"11-out2574"	.31633	273	590	863
11	"11-out2575"	.22343	164	570	734
11	"11-out2576"	.28994	98	240	338
11	"11-out2577"	.55868	595	470	1065
11	"11-out2578"	.61575	1149	717	1866
11	"11-out2579"	.46869	262	297	559
11	"11-out2580"	.33380	238	475	713
11	"11-out2581"	.37995	326	532	858
11	"11-out2582"	.99479	191	1	192
11	"11-out2583"	.32857	184	376	560
11	"11-out2584"	.35851	261	467	728
11	"11-out2585"	.78723	111	30	141
11	"11-out2586"	.66307	246	125	371
11	"11-out2587"	.99145	116	1	117
11	"11-out2588"	.99186	122	1	123
11	"11-out2589"	.99193	123	1	124
11	"11-out2590"	.99180	121	1	122
11	"11-out2591"	.99186	122	1	123
11	"11-out2592"	.40090	89	133	222
11	"11-out2593"	.41293	83	118	201
11	"11-out2594"	.46564	183	210	393
11	"11-out2595"	.63255	136	79	215
11	"11-out2596"	.32794	284	582	866
11	"11-out2597"	.48947	93	97	190
11	"11-out2598"	.36305	114	200	314
11	"11-out2599"	.99242	131	1	132
11	"11-out2600"	.66025	103	53	156
11	"11-out2601"	.30372	253	580	833
11	"11-out2602"	.39146	321	499	820
11	"11-out2603"	.52626	531	478	1009
11	"11-out2604"	.50867	176	170	346
11	"11-out2605"	.66184	229	117	346
11	"11-out2606"	.99711	346	1	347
11	"11-out2607"	.63580	206	118	324
11	"11-out2608"	.33706	542	1066	1608
11	"11-out2609"	.99681	313	1	314
11	"11-out2610"	.44233	372	469	841
11	"11-out2611"	.56050	491	385	876
11	"11-out2612"	.68468	228	105	333
11	"11-out2613"	.31599	407	881	1288
11	"11-out2614"	.31942	199	424	623
11	"11-out2615"	.99953	2155	1	2156
11	"11-out2616"	.36203	412	726	1138
11	"11-out2617"	.48760	118	124	242
11	"11-out2618"	.29032	162	396	558
11	"11-out2619"	.57111	261	196	457
11	"11-out2620"	.24621	65	199	264
11	"11-out2621"	.27767	148	385	533
11	"11-out2622"	.45856	415	490	905
11	"11-out2623"	.37305	144	242	386
11	"11-out2624"	.51171	284	271	555
11	"11-out2625"	.77600	97	28	125
11	"11-out2626"	.17684	110	512	622
11	"11-out2627"	.84061	712	135	847
11	"11-out2628"	.28173	91	232	323
11	"11-out2629"	.29123	113	275	388
11	"11-out2630"	.89080	155	19	174
11	"11-out2631"	.14754	9	52	61
11	"11-out2632"	.48400	121	129	250
11	"11-out2633"	.43939	261	333	594
11	"11-out2634"	.74595	323	110	433
11	"11-out2635"	.35677	345	622	967
11	"11-out2636"	.67372	159	77	236
11	"11-out2637"	.45393	340	409	749
11	"11-out2638"	.48927	114	119	233
11	"11-out2639"	.25000	219	657	876
11	"11-out2640"	.37662	87	144	231
11	"11-out2641"	.28643	114	284	398
11	"11-out2642"	.99088	435	4	439
11	"11-out2643"	.59793	116	78	194
11	"11-out2644"	.96513	609	22	631
11	"11-out2645"	.35331	165	302	467
11	"11-out2646"	.52908	1037	923	1960
11	"11-out2647"	.34827	334	625	959
11	"11-out2648"	.52307	102	93	195
11	"11-out2649"	.98843	171	2	173
11	"11-out2650"	.73076	152	56	208
11	"11-out2651"	.87417	132	19	151
11	"11-out2652"	.72674	125	47	172
11	"11-out2653"	.41238	313	446	759
11	"11-out2654"	.23560	487	1580	2067
11	"11-out2655"	.40053	149	223	372
11	"11-out2656"	.34240	151	290	441
11	"11-out2657"	.70073	569	243	812
11	"11-out2658"	.25409	124	364	488
11	"11-out2659"	.38006	122	199	321
11	"11-out2660"	.42264	224	306	530
11	"11-out2661"	.41482	319	450	769
11	"11-out2662"	.47770	300	328	628
11	"11-out2663"	.39055	248	387	635
11	"11-out2664"	.27720	107	279	386
11	"11-out2665"	.17891	56	257	313
11	"11-out2666"	.76077	353	111	464
11	"11-out2667"	.43729	272	350	622
11	"11-out2668"	.34464	1585	3014	4599
11	"11-out2669"	.26902	463	1258	1721
11	"11-out2670"	.99193	123	1	124
11	"11-out2671"	.99130	114	1	115
11	"11-out2672"	.99107	111	1	112
11	"11-out2673"	.36401	87	152	239
11	"11-out2674"	.99186	122	1	123
11	"11-out2675"	.34082	91	176	267
11	"11-out2676"	.33640	146	288	434
11	"11-out2677"	.18800	94	406	500
11	"11-out2678"	.50670	189	184	373
11	"11-out2679"	.83567	417	82	499
11	"11-out2680"	.98327	294	5	299
11	"11-out2681"	.93692	609	41	650
11	"11-out2682"	.43044	263	348	611
11	"11-out2683"	.45769	357	423	780
11	"11-out2684"	.21387	37	136	173
11	"11-out2685"	.99873	787	1	788
11	"11-out2686"	.37258	231	389	620
11	"11-out2687"	.34833	209	391	600
11	"11-out2688"	.44655	305	378	683
11	"11-out2689"	.99371	158	1	159
11	"11-out2690"	.34474	272	517	789
11	"11-out2691"	.18260	63	282	345
11	"11-out2692"	.47450	363	402	765
11	"11-out2693"	.48339	262	280	542
11	"11-out2694"	.20325	25	98	123
11	"11-out2695"	.29635	195	463	658
11	"11-out2696"	.99130	114	1	115
11	"11-out2697"	.99130	114	1	115
11	"11-out2698"	.23844	98	313	411
11	"11-out2699"	.38226	125	202	327
11	"11-out2700"	.36145	377	666	1043
11	"11-out2701"	.35590	389	704	1093
11	"11-out2702"	.30437	529	1209	1738
11	"11-out2703"	.99811	1060	2	1062
11	"11-out2704"	.99835	1212	2	1214
11	"11-out2705"	.25396	80	235	315
11	"11-out2706"	.28890	685	1686	2371
11	"11-out2707"	.94174	194	12	206
11	"11-out2708"	.46816	353	401	754
11	"11-out2709"	.26708	172	472	644
11	"11-out2710"	.38743	148	234	382
11	"11-out2711"	.32758	133	273	406
11	"11-out2712"	.18527	78	343	421
11	"11-out2713"	.99662	590	2	592
11	"11-out2714"	.46099	130	152	282
11	"11-out2715"	.31369	197	431	628
11	"11-out2716"	.96453	408	15	423
11	"11-out2717"	.69620	110	48	158
11	"11-out2718"	.19377	112	466	578
11	"11-out2719"	.53763	100	86	186
11	"11-out2720"	.92248	119	10	129
11	"11-out2721"	.98591	70	1	71
11	"11-out2722"	.27519	243	640	883
11	"11-out2723"	.35156	45	83	128
11	"11-out2724"	.49390	162	166	328
11	"11-out2725"	.47368	36	40	76
11	"11-out2726"	.48739	58	61	119
11	"11-out2727"	.43138	569	750	1319
11	"11-out2728"	.43589	442	572	1014
11	"11-out2729"	.87200	109	16	125
11	"11-out2730"	.27492	91	240	331
11	"11-out2731"	.26415	56	156	212
11	"11-out2732"	.26881	50	136	186
11	"11-out2733"	.36184	55	97	152
11	"11-out2734"	.71710	109	43	152
11	"11-out2735"	.33675	492	969	1461
11	"11-out2736"	.32270	243	510	753
11	"11-out2737"	.51450	266	251	517
11	"11-out2738"	.37254	190	320	510
11	"11-out2739"	.26939	125	339	464
11	"11-out2740"	.21854	66	236	302
11	"11-out2741"	.31355	185	405	590
11	"11-out2742"	.35545	316	573	889
11	"11-out2743"	.53333	144	126	270
11	"11-out2744"	.42334	243	331	574
11	"11-out2745"	.27053	303	817	1120
11	"11-out2746"	.19009	142	605	747
11	"11-out2747"	.87287	769	112	881
11	"11-out2748"	.99441	178	1	179
11	"11-out2749"	.21161	51	190	241
11	"11-out2750"	.29431	88	211	299
11	"11-out2751"	.42105	616	847	1463
11	"11-out2752"	.30000	150	350	500
11	"11-out2753"	.34836	479	896	1375
11	"11-out2754"	.34213	272	523	795
11	"11-out2755"	.38900	361	567	928
11	"11-out2756"	.39142	292	454	746
11	"11-out2757"	.88246	458	61	519
11	"11-out2758"	.35048	511	947	1458
11	"11-out2759"	.34978	248	461	709
11	"11-out2760"	.34868	53	99	152
11	"11-out2761"	.24570	100	307	407
11	"11-out2762"	.99115	112	1	113
11	"11-out2763"	.43186	225	296	521
11	"11-out2764"	.32682	67	138	205
11	"11-out2765"	.27540	84	221	305
11	"11-out2766"	.34204	301	579	880
11	"11-out2767"	.37685	127	210	337
11	"11-out2768"	.19005	107	456	563
11	"11-out2769"	.43801	477	612	1089
11	"11-out2770"	.47474	47	52	99
11	"11-out2771"	.60714	51	33	84
11	"11-out2772"	.86004	424	69	493
11	"11-out2773"	.99827	578	1	579
11	"11-out2774"	.38073	332	540	872
11	"11-out2775"	.56395	97	75	172
11	"11-out2776"	.73856	113	40	153
11	"11-out2777"	.96449	163	6	169
11	"11-out2778"	.94339	100	6	106
11	"11-out2779"	.45707	575	683	1258
11	"11-out2780"	.76995	164	49	213
11	"11-out2781"	.39075	93	145	238
11	"11-out2782"	.27174	353	946	1299
11	"11-out2783"	.53987	264	225	489
11	"11-out2784"	.36663	334	577	911
11	"11-out2785"	.27301	86	229	315
11	"11-out2786"	.23098	164	546	710
11	"11-out2787"	.24932	93	280	373
11	"11-out2788"	.44020	173	220	393
11	"11-out2789"	.99658	292	1	293
11	"11-out2790"	.18859	86	370	456
11	"11-out2791"	.32276	112	235	347
11	"11-out2792"	.43902	54	69	123
11	"11-out2793"	.68695	79	36	115
11	"11-out2794"	.46000	230	270	500
11	"11-out2795"	.79571	2006	515	2521
11	"11-out2796"	.71380	212	85	297
11	"11-out2797"	.30111	296	687	983
11	"11-out2798"	.46186	430	501	931
11	"11-out2799"	.38345	51	82	133
11	"11-out2800"	.42361	61	83	144
11	"11-out2801"	.24324	135	420	555
11	"11-out2802"	.20952	22	83	105
11	"11-out2803"	.41085	106	152	258
11	"11-out2804"	.29100	55	134	189
11	"11-out2805"	.34827	101	189	290
11	"11-out2806"	.59365	187	128	315
11	"11-out2807"	.40654	87	127	214
11	"11-out2808"	.98148	53	1	54
11	"11-out2809"	.36363	144	252	396
11	"11-out2810"	.38735	196	310	506
11	"11-out2811"	.41712	229	320	549
11	"11-out2812"	.30136	44	102	146
11	"11-out2813"	.40757	269	391	660
11	"11-out2814"	.44055	415	527	942
11	"11-out2815"	.35200	264	486	750
11	"11-out2816"	.27755	141	367	508
11	"11-out2817"	.56296	380	295	675
11	"11-out2818"	.44318	117	147	264
11	"11-out2819"	.43589	34	44	78
11	"11-out2820"	.29394	102	245	347
11	"11-out2821"	.55866	319	252	571
11	"11-out2822"	.31863	513	1097	1610
11	"11-out2823"	.65665	153	80	233
11	"11-out2824"	.55255	184	149	333
11	"11-out2825"	.98750	237	3	240
11	"11-out2826"	.94936	150	8	158
11	"11-out2827"	.52397	153	139	292
11	"11-out2828"	.44278	178	224	402
11	"11-out2829"	.38723	182	288	470
11	"11-out2830"	.35362	517	945	1462
11	"11-out2831"	.99270	408	3	411
11	"11-out2832"	.28053	271	695	966
11	"11-out2833"	.41988	76	105	181
11	"11-out2834"	.36439	305	532	837
11	"11-out2835"	.37925	501	820	1321
11	"11-out2836"	.39420	136	209	345
11	"11-out2837"	.57517	241	178	419
11	"11-out2838"	.30025	469	1093	1562
11	"11-out2839"	.76562	98	30	128
11	"11-out2840"	.36085	236	418	654
11	"11-out2841"	.86062	883	143	1026
11	"11-out2842"	.21611	110	399	509
11	"11-out2843"	.30026	342	797	1139
11	"11-out2844"	.41721	63	88	151
11	"11-out2845"	.43925	94	120	214
11	"11-out2846"	.77663	226	65	291
11	"11-out2847"	.48022	85	92	177
11	"11-out2848"	.34297	249	477	726
11	"11-out2849"	.98969	96	1	97
11	"11-out2850"	.48806	184	193	377
11	"11-out2851"	.44428	614	768	1382
11	"11-out2852"	.22324	73	254	327
11	"11-out2853"	.66425	184	93	277
11	"11-out2854"	.25480	53	155	208
11	"11-out2855"	.78795	327	88	415
11	"11-out2856"	.41304	209	297	506
11	"11-out2857"	.44670	373	462	835
11	"11-out2858"	.46428	169	195	364
11	"11-out2859"	.34978	163	303	466
11	"11-out2860"	.56810	171	130	301
11	"11-out2861"	.40691	1141	1663	2804
11	"11-out2862"	.46629	83	95	178
11	"11-out2863"	.36823	422	724	1146
11	"11-out2864"	.18200	87	391	478
11	"11-out2865"	.25000	203	609	812
11	"11-out2866"	.97027	457	14	471
11	"11-out2867"	.47960	541	587	1128
11	"11-out2868"	.99559	226	1	227
11	"11-out2869"	.99744	390	1	391
11	"11-out2870"	.99726	365	1	366
11	"11-out2871"	.15168	54	302	356
11	"11-out2872"	.38659	525	833	1358
11	"11-out2873"	.26923	112	304	416
11	"11-out2874"	.27218	46	123	169
11	"11-out2875"	.28148	152	388	540
11	"11-out2876"	.30214	197	455	652
11	"11-out2877"	.25000	63	189	252
11	"11-out2878"	.33423	124	247	371
11	"11-out2879"	.99270	136	1	137
11	"11-out2880"	.21201	187	695	882
11	"11-out2881"	.38487	336	537	873
11	"11-out2882"	.30263	115	265	380
11	"11-out2883"	.72674	125	47	172
11	"11-out2884"	.77090	212	63	275
11	"11-out2885"	.48728	345	363	708
11	"11-out2886"	.69368	813	359	1172
11	"11-out2887"	.39506	224	343	567
11	"11-out2888"	.38448	223	357	580
11	"11-out2889"	.47995	778	843	1621
11	"11-out2890"	.32972	305	620	925
11	"11-out2891"	.23614	98	317	415
11	"11-out2892"	.32128	311	657	968
11	"11-out2893"	.98947	94	1	95
11	"11-out2894"	.31989	881	1873	2754
11	"11-out2895"	.20263	77	303	380
11	"11-out2896"	.99668	301	1	302
11	"11-out2897"	.35668	392	707	1099
11	"11-out2898"	.34557	160	303	463
11	"11-out2899"	.68327	425	197	622
11	"11-out2900"	.99236	260	2	262
11	"11-out2901"	.85587	481	81	562
11	"11-out2902"	.44670	176	218	394
11	"11-out2903"	.31400	195	426	621
11	"11-out2904"	.43989	333	424	757
11	"11-out2905"	.46801	300	341	641
11	"11-out2906"	.47472	263	291	554
11	"11-out2907"	.35678	213	384	597
11	"11-out2908"	.31862	260	556	816
11	"11-out2909"	.74143	238	83	321
11	"11-out2910"	.94094	239	15	254
11	"11-out2911"	.51579	555	521	1076
11	"11-out2912"	.25239	79	234	313
11	"11-out2913"	.39872	376	567	943
11	"11-out2914"	.41628	92	129	221
11	"11-out2915"	.50398	253	249	502
11	"11-out2916"	.25614	73	212	285
11	"11-out2917"	.99618	261	1	262
11	"11-out2918"	.58793	341	239	580
11	"11-out2919"	.32643	205	423	628
11	"11-out2920"	.44117	75	95	170
11	"11-out2921"	.36642	561	970	1531
11	"11-out2922"	.68777	315	143	458
11	"11-out2923"	.53691	640	552	1192
11	"11-out2924"	.33928	171	333	504
11	"11-out2925"	.28052	85	218	303
11	"11-out2926"	.65966	1225	632	1857
11	"11-out2927"	.54878	45	37	82
11	"11-out2928"	.42812	414	553	967
11	"11-out2929"	.58333	147	105	252
11	"11-out2930"	.33679	162	319	481
11	"11-out2931"	.59842	76	51	127
11	"11-out2932"	.87697	278	39	317
11	"11-out2933"	.53354	167	146	313
11	"11-out2934"	.99678	310	1	311
11	"11-out2935"	.99698	331	1	332
11	"11-out2936"	.55223	185	150	335
11	"11-out2937"	.40000	126	189	315
11	"11-out2938"	.52083	300	276	576
11	"11-out2939"	.48136	155	167	322
11	"11-out2940"	.50470	161	158	319
11	"11-out2941"	.36217	113	199	312
11	"11-out2942"	.66053	323	166	489
11	"11-out2943"	.89219	240	29	269
11	"11-out2944"	.56129	174	136	310
11	"11-out2945"	.91935	285	25	310
11	"11-out2946"	.77531	245	71	316
11	"11-out2947"	.42073	138	190	328
11	"11-out2948"	.54925	184	151	335
11	"11-out2949"	.79062	253	67	320
11	"11-out2950"	.97756	305	7	312
11	"11-out2951"	.95312	305	15	320
11	"11-out2952"	.92429	293	24	317
11	"11-out2953"	.97500	312	8	320
11	"11-out2954"	.97169	309	9	318
11	"11-out2955"	.96284	311	12	323
11	"11-out2956"	.97734	302	7	309
11	"11-out2957"	.52580	163	147	310
11	"11-out2958"	.53605	171	148	319
11	"11-out2959"	.51754	177	165	342
11	"11-out2960"	.40764	128	186	314
11	"11-out2961"	.41795	135	188	323
11	"11-out2962"	.29357	96	231	327
11	"11-out2963"	.48427	154	164	318
11	"11-out2964"	.98701	304	4	308
11	"11-out2965"	.81538	265	60	325
11	"11-out2966"	.73520	236	85	321
11	"11-out2967"	.47619	130	143	273
11	"11-out2968"	.31849	229	490	719
11	"11-out2969"	.99793	1453	3	1456
11	"11-out2970"	.40025	311	466	777
11	"11-out2971"	.28865	196	483	679
11	"11-out2972"	.25421	196	575	771
11	"11-out2973"	.26790	217	593	810
11	"11-out2974"	.61904	117	72	189
11	"11-out2975"	.33514	123	244	367
11	"11-out2976"	.39417	203	312	515
11	"11-out2977"	.29429	593	1422	2015
11	"11-out2978"	.42184	1066	1461	2527
11	"11-out2979"	.37545	104	173	277
11	"11-out2980"	.30076	157	365	522
11	"11-out2981"	.81435	658	150	808
11	"11-out2982"	.34913	567	1057	1624
11	"11-out2983"	.17751	60	278	338
11	"11-out2984"	.99115	112	1	113
11	"11-out2985"	.53263	253	222	475
11	"11-out2986"	.44992	301	368	669
11	"11-out2987"	.38624	584	928	1512
11	"11-out2988"	.99193	123	1	124
11	"11-out2989"	.48437	124	132	256
11	"11-out2990"	.61778	396	245	641
11	"11-out2991"	.34230	356	684	1040
11	"11-out2992"	.33865	212	414	626
11	"11-out2993"	.44409	3281	4107	7388
11	"11-out2994"	.20959	83	313	396
11	"11-out2995"	.69895	267	115	382
11	"11-out2996"	.38688	301	477	778
11	"11-out2997"	.49401	165	169	334
11	"11-out2998"	.35636	294	531	825
11	"11-out2999"	.37613	249	413	662
11	"11-out3000"	.92300	983	82	1065
11	"11-out3001"	.43963	244	311	555
11	"11-out3002"	.34104	236	456	692
11	"11-out3003"	.32258	230	483	713
11	"11-out3004"	.25145	216	643	859
11	"11-out3005"	.21893	74	264	338
11	"11-out3006"	.38945	192	301	493
11	"11-out3007"	.23882	171	545	716
11	"11-out3008"	.99931	1452	1	1453
11	"11-out3009"	.27003	1257	3398	4655
11	"11-out3010"	.27366	159	422	581
11	"11-out3011"	.99487	194	1	195
11	"11-out3012"	.39090	301	469	770
11	"11-out3013"	.34173	651	1254	1905
11	"11-out3014"	.24674	398	1215	1613
11	"11-out3015"	.44907	388	476	864
11	"11-out3016"	.23888	86	274	360
11	"11-out3017"	.22627	31	106	137
11	"11-out3018"	.39200	49	76	125
11	"11-out3019"	.98989	98	1	99
11	"11-out3020"	.99180	121	1	122
11	"11-out3021"	.99166	119	1	120
11	"11-out3022"	.34716	184	346	530
11	"11-out3023"	.39463	1500	2301	3801
11	"11-out3024"	.99690	322	1	323
11	"11-out3025"	.75403	187	61	248
11	"11-out3026"	.94848	1436	78	1514
11	"11-out3027"	.36384	310	542	852
11	"11-out3028"	.40000	110	165	275
11	"11-out3029"	.98863	174	2	176
11	"11-out3030"	.38102	253	411	664
11	"11-out3031"	.37204	378	638	1016
11	"11-out3032"	.51991	770	711	1481
11	"11-out3033"	.23201	100	331	431
11	"11-out3034"	.18378	195	866	1061
11	"11-out3035"	.99568	231	1	232
11	"11-out3036"	.95212	179	9	188
11	"11-out3037"	.99672	304	1	305
11	"11-out3038"	.99743	389	1	390
11	"11-out3039"	.69520	406	178	584
11	"11-out3040"	.35294	36	66	102
11	"11-out3041"	.51578	98	92	190
11	"11-out3042"	.99358	155	1	156
11	"11-out3043"	.37745	921	1519	2440
11	"11-out3044"	.99867	753	1	754
11	"11-out3045"	.43846	399	511	910
11	"11-out3046"	.77479	375	109	484
11	"11-out3047"	.41624	164	230	394
11	"11-out3048"	.32591	249	515	764
11	"11-out3049"	.75862	44	14	58
11	"11-out3050"	.73184	131	48	179
11	"11-out3051"	.38834	80	126	206
11	"11-out3052"	.90068	789	87	876
11	"11-out3053"	.99934	1529	1	1530
11	"11-out3054"	.26718	171	469	640
11	"11-out3055"	.34261	677	1299	1976
11	"11-out3056"	.41090	196	281	477
11	"11-out3057"	.36629	163	282	445
11	"11-out3058"	.35447	408	743	1151
11	"11-out3059"	.28133	321	820	1141
11	"11-out3060"	.53648	250	216	466
11	"11-out3061"	.47335	906	1008	1914
11	"11-out3062"	.27231	299	799	1098
11	"11-out3063"	.35059	88	163	251
11	"11-out3064"	.37523	197	328	525
11	"11-out3065"	.77314	668	196	864
11	"11-out3066"	.76490	449	138	587
11	"11-out3067"	.88579	318	41	359
11	"11-out3068"	.21428	21	77	98
11	"11-out3069"	.40202	1032	1535	2567
11	"11-out3070"	.46500	279	321	600
11	"11-out3071"	.28280	610	1547	2157
11	"11-out3072"	.31275	304	668	972
11	"11-out3073"	.93023	200	15	215
11	"11-out3074"	.44472	354	442	796
11	"11-out3075"	.38628	107	170	277
11	"11-out3076"	.80269	358	88	446
11	"11-out3077"	.46590	82	94	176
11	"11-out3078"	.39516	245	375	620
11	"11-out3079"	.37823	219	360	579
11	"11-out3080"	.44615	203	252	455
11	"11-out3081"	.35907	186	332	518
11	"11-out3082"	.73972	108	38	146
11	"11-out3083"	.64301	299	166	465
11	"11-out3084"	.35128	1063	1963	3026
11	"11-out3085"	.34299	71	136	207
11	"11-out3086"	.32688	152	313	465
11	"11-out3087"	.98979	97	1	98
11	"11-out3088"	.99782	458	1	459
11	"11-out3089"	.34615	54	102	156
11	"11-out3090"	.53575	502	435	937
11	"11-out3091"	.23484	62	202	264
11	"11-out3092"	.32432	288	600	888
11	"11-out3093"	.18292	45	201	246
11	"11-out3094"	.44871	140	172	312
11	"11-out3095"	.99649	284	1	285
11	"11-out3096"	.26628	94	259	353
11	"11-out3097"	.56332	943	731	1674
11	"11-out3098"	.36971	586	999	1585
11	"11-out3099"	.73748	972	346	1318
11	"11-out3100"	.99860	718	1	719
11	"11-out3101"	.26791	385	1052	1437
11	"11-out3102"	.54424	818	685	1503
11	"11-out3103"	.88702	212	27	239
11	"11-out3104"	.45435	423	508	931
11	"11-out3105"	.39269	355	549	904
11	"11-out3106"	.97315	435	12	447
11	"11-out3107"	.39000	78	122	200
11	"11-out3108"	.24857	174	526	700
11	"11-out3109"	.39849	795	1200	1995
11	"11-out3110"	.46774	116	132	248
11	"11-out3111"	.46886	384	435	819
11	"11-out3112"	.30803	69	155	224
11	"11-out3113"	.31138	331	732	1063
11	"11-out3114"	.25842	46	132	178
11	"11-out3115"	.41509	330	465	795
11	"11-out3116"	.53238	263	231	494
11	"11-out3117"	.43513	322	418	740
11	"11-out3118"	.75000	186	62	248
11	"11-out3119"	.94273	214	13	227
11	"11-out3120"	.30917	64	143	207
11	"11-out3121"	.99819	1109	2	1111
11	"11-out3122"	.29360	170	409	579
11	"11-out3123"	.37261	351	591	942
11	"11-out3124"	.37627	701	1162	1863
11	"11-out3125"	.50000	324	324	648
11	"11-out3126"	.41090	309	443	752
11	"11-out3127"	.89320	92	11	103
11	"11-out3128"	.63097	277	162	439
11	"11-out3129"	.32947	57	116	173
11	"11-out3130"	.27243	258	689	947
11	"11-out3131"	.49201	154	159	313
11	"11-out3132"	.58041	1126	814	1940
11	"11-out3133"	.37369	321	538	859
11	"11-out3134"	.35325	396	725	1121
11	"11-out3135"	.99367	157	1	158
11	"11-out3136"	.49723	180	182	362
11	"11-out3137"	.39491	342	524	866
11	"11-out3138"	.25426	134	393	527
11	"11-out3139"	.37400	141	236	377
11	"11-out3140"	.99769	867	2	869
11	"11-out3141"	.28101	222	568	790
11	"11-out3142"	.33567	478	946	1424
11	"11-out3143"	.29724	335	792	1127
11	"11-out3144"	.33349	688	1375	2063
11	"11-out3145"	.35085	227	420	647
11	"11-out3146"	.99145	116	1	117
11	"11-out3147"	.99145	116	1	117
11	"11-out3148"	.47368	513	570	1083
11	"11-out3149"	.33520	179	355	534
11	"11-out3150"	.36480	255	444	699
11	"11-out3151"	.35228	254	467	721
11	"11-out3152"	.27247	197	526	723
11	"11-out3153"	.33748	325	638	963
11	"11-out3154"	.19254	31	130	161
11	"11-out3155"	.89010	81	10	91
11	"11-out3156"	.99159	118	1	119
11	"11-out3157"	.99145	116	1	117
11	"11-out3158"	.35616	52	94	146
11	"11-out3159"	.70054	255	109	364
11	"11-out3160"	.99292	2808	20	2828
11	"11-out3161"	.99509	203	1	204
11	"11-out3162"	.17257	180	863	1043
11	"11-out3163"	.41444	918	1297	2215
11	"11-out3164"	.34391	65	124	189
11	"11-out3165"	.97275	714	20	734
11	"11-out3166"	.43785	775	995	1770
11	"11-out3167"	.25049	252	754	1006
11	"11-out3168"	.28487	290	728	1018
11	"11-out3169"	.22114	205	722	927
11	"11-out3170"	.85831	418	69	487
11	"11-out3171"	.99069	213	2	215
11	"11-out3172"	.69163	637	284	921
11	"11-out3173"	.50297	169	167	336
11	"11-out3174"	.47511	210	232	442
11	"11-out3175"	.38915	402	631	1033
11	"11-out3176"	.32837	243	497	740
11	"11-out3177"	.34205	340	654	994
11	"11-out3178"	.27666	332	868	1200
11	"11-out3179"	.39306	68	105	173
11	"11-out3180"	.99672	304	1	305
11	"11-out3181"	.99656	290	1	291
11	"11-out3182"	.88959	701	87	788
11	"11-out3183"	.99980	5206	1	5207
11	"11-out3184"	.49673	76	77	153
11	"11-out3185"	.38413	1797	2881	4678
11	"11-out3186"	.28784	270	668	938
11	"11-out3187"	.67181	1304	637	1941
11	"11-out3188"	.42117	545	749	1294
11	"11-out3189"	.50000	66	66	132
11	"11-out3190"	.73444	838	303	1141
11	"11-out3191"	.25510	325	949	1274
11	"11-out3192"	.36899	476	814	1290
11	"11-out3193"	.51449	426	402	828
11	"11-out3194"	.98809	83	1	84
11	"11-out3195"	.42020	732	1010	1742
11	"11-out3196"	.20058	207	825	1032
11	"11-out3197"	.38818	92	145	237
11	"11-out3198"	.31877	73	156	229
11	"11-out3199"	.41629	373	523	896
11	"11-out3200"	.39054	380	593	973
11	"11-out3201"	.99755	408	1	409
11	"11-out3202"	.31686	109	235	344
11	"11-out3203"	.99897	979	1	980
11	"11-out3204"	.25000	262	786	1048
11	"11-out3205"	.80136	234	58	292
11	"11-out3206"	.22463	31	107	138
11	"11-out3207"	.41228	188	268	456
11	"11-out3208"	.99671	303	1	304
11	"11-out3209"	.36600	687	1190	1877
11	"11-out3210"	.37313	125	210	335
11	"11-out3211"	.45901	84	99	183
11	"11-out3212"	.34607	172	325	497
11	"11-out3213"	.62025	49	30	79
11	"11-out3214"	.99489	195	1	196
11	"11-out3215"	.80317	253	62	315
11	"11-out3216"	.38518	260	415	675
11	"11-out3217"	.61806	301	186	487
11	"11-out3218"	.43366	219	286	505
11	"11-out3219"	.73422	384	139	523
11	"11-out3220"	.73270	233	85	318
11	"11-out3221"	.93377	141	10	151
11	"11-out3222"	.88993	283	35	318
11	"11-out3223"	.38436	118	189	307
11	"11-out3224"	.45129	139	169	308
11	"11-out3225"	.45810	82	97	179
11	"11-out3226"	.97749	304	7	311
11	"11-out3227"	.33953	73	142	215
11	"11-out3228"	.85039	108	19	127
11	"11-out3229"	.99367	157	1	158
11	"11-out3230"	.77096	239	71	310
11	"11-out3231"	.40557	131	192	323
11	"11-out3232"	.75316	238	78	316
11	"11-out3233"	.76524	251	77	328
11	"11-out3234"	.98070	305	6	311
11	"11-out3235"	.98058	303	6	309
11	"11-out3236"	.47115	147	165	312
11	"11-out3237"	.93114	284	21	305
11	"11-out3238"	.96794	302	10	312
11	"11-out3239"	.97444	305	8	313
11	"11-out3240"	.95527	299	14	313
11	"11-out3241"	.58974	184	128	312
11	"11-out3242"	.94871	296	16	312
11	"11-out3243"	.38801	123	194	317
11	"11-out3244"	.50636	159	155	314
11	"11-out3245"	.46153	144	168	312
11	"11-out3246"	.46625	152	174	326
11	"11-out3247"	.50328	153	151	304
11	"11-out3248"	.52215	165	151	316
11	"11-out3249"	.58653	183	129	312
11	"11-out3250"	.95412	312	15	327
11	"11-out3251"	.81150	254	59	313
11	"11-out3252"	.70000	224	96	320
11	"11-out3253"	.96634	201	7	208
11	"11-out3254"	.25567	124	361	485
11	"11-out3255"	.36727	101	174	275
11	"11-out3256"	.27211	283	757	1040
11	"11-out3257"	.35248	871	1600	2471
11	"11-out3258"	.34258	778	1493	2271
11	"11-out3259"	.55434	204	164	368
11	"11-out3260"	.48002	685	742	1427
11	"11-out3261"	.34234	114	219	333
11	"11-out3262"	.39068	470	733	1203
11	"11-out3263"	.62372	184	111	295
11	"11-out3264"	.24919	232	699	931
11	"11-out3265"	.33565	531	1051	1582
11	"11-out3266"	.13924	11	68	79
11	"11-out3267"	.94982	530	28	558
11	"11-out3268"	.29377	401	964	1365
11	"11-out3269"	.22988	80	268	348
11	"11-out3270"	.99386	162	1	163
11	"11-out3271"	.35632	31	56	87
11	"11-out3272"	.95121	156	8	164
11	"11-out3273"	.58448	211	150	361
11	"11-out3274"	.18604	32	140	172
11	"11-out3275"	.40625	143	209	352
11	"11-out3276"	.37553	261	434	695
11	"11-out3277"	.32594	103	213	316
11	"11-out3278"	.99504	201	1	202
11	"11-out3279"	.44798	211	260	471
11	"11-out3280"	.22422	87	301	388
11	"11-out3281"	.33689	126	248	374
11	"11-out3282"	.44444	152	190	342
11	"11-out3283"	.46327	164	190	354
11	"11-out3284"	.11260	42	331	373
11	"11-out3285"	.39446	570	875	1445
11	"11-out3286"	.39538	291	445	736
11	"11-out3287"	.44209	313	395	708
11	"11-out3288"	.43885	323	413	736
11	"11-out3289"	.33460	88	175	263
11	"11-out3290"	.99580	475	2	477
11	"11-out3291"	.50647	430	419	849
11	"11-out3292"	.99868	760	1	761
11	"11-out3293"	.48600	191	202	393
11	"11-out3294"	.28529	194	486	680
11	"11-out3295"	.24012	152	481	633
11	"11-out3296"	.29834	216	508	724
11	"11-out3297"	.33241	242	486	728
11	"11-out3298"	.29729	44	104	148
11	"11-out3299"	.99746	393	1	394
11	"11-out3300"	.21014	29	109	138
11	"11-out3301"	.49489	194	198	392
11	"11-out3302"	.88906	561	70	631
11	"11-out3303"	.54037	348	296	644
11	"11-out3304"	.49738	190	192	382
11	"11-out3305"	.43665	324	418	742
11	"11-out3306"	.42232	280	383	663
11	"11-out3307"	.26954	131	355	486
11	"11-out3308"	.34337	228	436	664
11	"11-out3309"	.36486	108	188	296
11	"11-out3310"	.43145	107	141	248
11	"11-out3311"	.98703	685	9	694
11	"11-out3312"	.99811	530	1	531
11	"11-out3313"	.61261	68	43	111
11	"11-out3314"	.23724	93	299	392
11	"11-out3315"	.34920	154	287	441
11	"11-out3316"	.66438	97	49	146
11	"11-out3317"	.99099	110	1	111
11	"11-out3318"	.38053	43	70	113
11	"11-out3319"	.76842	73	22	95
11	"11-out3320"	.93491	316	22	338
11	"11-out3321"	.28455	35	88	123
11	"11-out3322"	.99373	476	3	479
11	"11-out3323"	.33027	180	365	545
11	"11-out3324"	.62404	327	197	524
11	"11-out3325"	.75296	445	146	591
11	"11-out3326"	.98170	161	3	164
11	"11-out3327"	.98170	161	3	164
11	"11-out3328"	.98780	162	2	164
11	"11-out3329"	.37436	444	742	1186
11	"11-out3330"	.45336	627	756	1383
11	"11-out3331"	.39050	148	231	379
11	"11-out3332"	.32816	127	260	387
11	"11-out3333"	.45652	273	325	598
11	"11-out3334"	.31433	193	421	614
11	"11-out3335"	.86500	173	27	200
11	"11-out3336"	.36947	259	442	701
11	"11-out3337"	.33540	108	214	322
11	"11-out3338"	.61333	230	145	375
11	"11-out3339"	.76923	780	234	1014
11	"11-out3340"	.59011	203	141	344
11	"11-out3341"	.42317	168	229	397
11	"11-out3342"	.28529	196	491	687
11	"11-out3343"	.22311	83	289	372
11	"11-out3344"	.30376	113	259	372
11	"11-out3345"	.99570	232	1	233
11	"11-out3346"	.46128	423	494	917
11	"11-out3347"	.37469	468	781	1249
11	"11-out3348"	.22008	103	365	468
11	"11-out3349"	.55454	122	98	220
11	"11-out3350"	.96078	49	2	51
11	"11-out3351"	.31157	148	327	475
11	"11-out3352"	.87051	921	137	1058
11	"11-out3353"	.50294	342	338	680
11	"11-out3354"	.36933	106	181	287
11	"11-out3355"	.99687	319	1	320
11	"11-out3356"	.98360	60	1	61
11	"11-out3357"	.16666	21	105	126
11	"11-out3358"	.28907	381	937	1318
11	"11-out3359"	.59062	378	262	640
11	"11-out3360"	.45376	319	384	703
11	"11-out3361"	.98275	57	1	58
11	"11-out3362"	.40902	290	419	709
11	"11-out3363"	.99431	175	1	176
11	"11-out3364"	.32569	128	265	393
11	"11-out3365"	.33050	39	79	118
11	"11-out3366"	.52395	175	159	334
11	"11-out3367"	.99593	245	1	246
11	"11-out3368"	.77966	92	26	118
11	"11-out3369"	.28484	47	118	165
11	"11-out3370"	.60924	145	93	238
11	"11-out3371"	.23834	46	147	193
11	"11-out3372"	.48309	100	107	207
11	"11-out3373"	.31515	52	113	165
11	"11-out3374"	.30300	323	743	1066
11	"11-out3375"	.99619	262	1	263
11	"11-out3376"	.99065	106	1	107
11	"11-out3377"	.99408	168	1	169
11	"11-out3378"	.50537	47	46	93
11	"11-out3379"	.59405	60	41	101
11	"11-out3380"	.44230	483	609	1092
11	"11-out3381"	.79178	270	71	341
11	"11-out3382"	.35116	978	1807	2785
11	"11-out3383"	.48387	60	64	124
11	"11-out3384"	.99832	596	1	597
11	"11-out3385"	.48211	337	362	699
11	"11-out3386"	.31615	135	292	427
11	"11-out3387"	.99173	120	1	121
11	"11-out3388"	.99462	185	1	186
11	"11-out3389"	.57327	133	99	232
11	"11-out3390"	.32921	320	652	972
11	"11-out3391"	.19875	32	129	161
11	"11-out3392"	.83536	137	27	164
11	"11-out3393"	.44581	469	583	1052
11	"11-out3394"	.41496	61	86	147
11	"11-out3395"	.28230	201	511	712
11	"11-out3396"	.43989	494	629	1123
11	"11-out3397"	.36057	353	626	979
11	"11-out3398"	.99720	357	1	358
11	"11-out3399"	.33923	115	224	339
11	"11-out3400"	.56502	126	97	223
11	"11-out3401"	.36961	163	278	441
11	"11-out3402"	.26259	172	483	655
11	"11-out3403"	.99635	273	1	274
11	"11-out3404"	.99810	527	1	528
11	"11-out3405"	.28525	89	223	312
11	"11-out3406"	.99433	527	3	530
11	"11-out3407"	.73289	225	82	307
11	"11-out3408"	.56338	80	62	142
11	"11-out3409"	.29967	466	1089	1555
11	"11-out3410"	.40915	599	865	1464
11	"11-out3411"	.76433	613	189	802
11	"11-out3412"	.50628	161	157	318
11	"11-out3413"	.46314	333	386	719
11	"11-out3414"	.98679	523	7	530
11	"11-out3415"	.52434	280	254	534
11	"11-out3416"	.99590	243	1	244
11	"11-out3417"	.99593	245	1	246
11	"11-out3418"	.54918	134	110	244
11	"11-out3419"	.99700	333	1	334
11	"11-out3420"	.97154	239	7	246
11	"11-out3421"	.37258	386	650	1036
11	"11-out3422"	.36440	172	300	472
11	"11-out3423"	.25416	122	358	480
11	"11-out3424"	.37714	835	1379	2214
11	"11-out3425"	.41376	451	639	1090
11	"11-out3426"	.29978	283	661	944
11	"11-out3427"	.33619	313	618	931
11	"11-out3428"	.40919	187	270	457
11	"11-out3429"	.46825	745	846	1591
11	"11-out3430"	.52509	136	123	259
11	"11-out3431"	.37529	316	526	842
11	"11-out3432"	.23924	228	725	953
11	"11-out3433"	.30284	798	1837	2635
11	"11-out3434"	.27747	904	2354	3258
11	"11-out3435"	.37654	305	505	810
11	"11-out3436"	.97615	614	15	629
11	"11-out3437"	.39114	1184	1843	3027
11	"11-out3438"	.38129	159	258	417
11	"11-out3439"	.45920	197	232	429
11	"11-out3440"	.48555	269	285	554
11	"11-out3441"	.77896	363	103	466
11	"11-out3442"	.23404	44	144	188
11	"11-out3443"	.47878	79	86	165
11	"11-out3444"	.31250	50	110	160
11	"11-out3445"	.33962	54	105	159
11	"11-out3446"	.31058	182	404	586
11	"11-out3447"	.39680	323	491	814
11	"11-out3448"	.35897	42	75	117
11	"11-out3449"	.90966	715	71	786
11	"11-out3450"	.37735	100	165	265
11	"11-out3451"	.34121	101	195	296
11	"11-out3452"	.70252	529	224	753
11	"11-out3453"	.35433	135	246	381
11	"11-out3454"	.99890	913	1	914
11	"11-out3455"	.34872	438	818	1256
11	"11-out3456"	.99841	631	1	632
11	"11-out3457"	.51070	310	297	607
11	"11-out3458"	.31708	475	1023	1498
11	"11-out3459"	.32075	153	324	477
11	"11-out3460"	.43091	315	416	731
11	"11-out3461"	.89189	297	36	333
11	"11-out3462"	.28543	147	368	515
11	"11-out3463"	.18993	83	354	437
11	"11-out3464"	.42207	65	89	154
11	"11-out3465"	.37950	137	224	361
11	"11-out3466"	.35563	287	520	807
11	"11-out3467"	.33790	345	676	1021
11	"11-out3468"	.49405	291	298	589
11	"11-out3469"	.60093	256	170	426
11	"11-out3470"	.97542	397	10	407
11	"11-out3471"	.38388	81	130	211
11	"11-out3472"	.88314	393	52	445
11	"11-out3473"	.33033	110	223	333
11	"11-out3474"	.24344	65	202	267
11	"11-out3475"	.37305	144	242	386
11	"11-out3476"	.71497	444	177	621
11	"11-out3477"	.99450	543	3	546
11	"11-out3478"	.32028	90	191	281
11	"11-out3479"	.55672	211	168	379
11	"11-out3480"	.53968	238	203	441
11	"11-out3481"	.31316	414	908	1322
11	"11-out3482"	.56420	145	112	257
11	"11-out3483"	.99856	698	1	699
11	"11-out3484"	.34771	137	257	394
11	"11-out3485"	.41356	378	536	914
11	"11-out3486"	.60137	350	232	582
11	"11-out3487"	.43533	239	310	549
11	"11-out3488"	.29655	43	102	145
11	"11-out3489"	.27335	79	210	289
11	"11-out3490"	.26557	81	224	305
11	"11-out3491"	.71951	236	92	328
11	"11-out3492"	.69000	276	124	400
11	"11-out3493"	.99855	692	1	693
11	"11-out3494"	.99855	692	1	693
11	"11-out3495"	.99834	602	1	603
11	"11-out3496"	.99832	596	1	597
11	"11-out3497"	.99767	429	1	430
11	"11-out3498"	.39254	400	619	1019
11	"11-out3499"	.41942	190	263	453
11	"11-out3500"	.43434	215	280	495
11	"11-out3501"	.21739	20	72	92
11	"11-out3502"	.35000	35	65	100
11	"11-out3503"	.38311	177	285	462
11	"11-out3504"	.34263	135	259	394
11	"11-out3505"	.30909	136	304	440
11	"11-out3506"	.32300	146	306	452
11	"11-out3507"	.99851	674	1	675
11	"11-out3508"	.54400	136	114	250
11	"11-out3509"	.66509	141	71	212
11	"11-out3510"	.99242	131	1	132
11	"11-out3511"	.36990	118	201	319
11	"11-out3512"	.99463	371	2	373
11	"11-out3513"	.47734	158	173	331
11	"11-out3514"	.45802	431	510	941
11	"11-out3515"	.26562	255	705	960
11	"11-out3516"	.58280	183	131	314
11	"11-out3517"	.47800	239	261	500
11	"11-out3518"	.31205	88	194	282
11	"11-out3519"	.89514	461	54	515
11	"11-out3520"	.16944	61	299	360
11	"11-out3521"	.72144	259	100	359
11	"11-out3522"	.33858	129	252	381
11	"11-out3523"	.43236	163	214	377
11	"11-out3524"	.34647	123	232	355
11	"11-out3525"	.54812	205	169	374
11	"11-out3526"	.98369	181	3	184
11	"11-out3527"	.56350	315	244	559
11	"11-out3528"	.69585	302	132	434
11	"11-out3529"	.39861	173	261	434
11	"11-out3530"	.56451	245	189	434
11	"11-out3531"	.77994	280	79	359
11	"11-out3532"	.30508	108	246	354
11	"11-out3533"	.38970	265	415	680
11	"11-out3534"	.99855	692	1	693
11	"11-out3535"	.30590	264	599	863
11	"11-out3536"	.31980	197	419	616
11	"11-out3537"	.45402	316	380	696
11	"11-out3538"	.33057	160	324	484
11	"11-out3539"	.36061	163	289	452
11	"11-out3540"	.27648	107	280	387
11	"11-out3541"	.81450	483	110	593
11	"11-out3542"	.72663	311	117	428
11	"11-out3543"	.34398	140	267	407
11	"11-out3544"	.41577	116	163	279
11	"11-out3545"	.51666	372	348	720
11	"11-out3546"	.99683	315	1	316
11	"11-out3547"	.29710	82	194	276
11	"11-out3548"	.99767	429	1	430
11	"11-out3549"	.39200	343	532	875
11	"11-out3550"	.89820	900	102	1002
11	"11-out3551"	.48116	1073	1157	2230
11	"11-out3552"	.99173	120	1	121
11	"11-out3553"	.39379	165	254	419
11	"11-out3554"	.99750	400	1	401
11	"11-out3555"	.99749	398	1	399
11	"11-out3556"	.48657	145	153	298
11	"11-out3557"	.73267	74	27	101
11	"11-out3558"	.27631	231	605	836
11	"11-out3559"	.22889	225	758	983
11	"11-out3560"	.36842	49	84	133
11	"11-out3561"	.37858	449	737	1186
11	"11-out3562"	.18934	32	137	169
11	"11-out3563"	.26080	350	992	1342
11	"11-out3564"	.28317	271	686	957
11	"11-out3565"	.39280	491	759	1250
11	"11-out3566"	.42402	293	398	691
11	"11-out3567"	.71186	252	102	354
11	"11-out3568"	.52370	232	211	443
11	"11-out3569"	.59615	93	63	156
11	"11-out3570"	.53790	823	707	1530
11	"11-out3571"	.65384	85	45	130
11	"11-out3572"	.43438	288	375	663
11	"11-out3573"	.99264	135	1	136
11	"11-out3574"	.89583	602	70	672
11	"11-out3575"	.49857	175	176	351
11	"11-out3576"	.37611	378	627	1005
11	"11-out3577"	.26822	195	532	727
11	"11-out3578"	.27625	392	1027	1419
11	"11-out3579"	.24339	129	401	530
11	"11-out3580"	.33262	157	315	472
11	"11-out3581"	.36312	195	342	537
11	"11-out3582"	.65168	58	31	89
11	"11-out3583"	.71428	150	60	210
11	"11-out3584"	.37226	1498	2526	4024
11	"11-out3585"	.99137	115	1	116
11	"11-out3586"	.60451	107	70	177
11	"11-out3587"	.29613	1324	3147	4471
11	"11-out3588"	.49790	119	120	239
11	"11-out3589"	.48501	259	275	534
11	"11-out3590"	.31491	171	372	543
11	"11-out3591"	.99890	912	1	913
11	"11-out3592"	.98039	350	7	357
11	"11-out3593"	.20192	42	166	208
11	"11-out3594"	.21731	128	461	589
11	"11-out3595"	.47368	270	300	570
11	"11-out3596"	.99828	583	1	584
11	"11-out3597"	.64473	49	27	76
11	"11-out3598"	.99476	190	1	191
11	"11-out3599"	.99792	481	1	482
11	"11-out3600"	.99464	557	3	560
11	"11-out3601"	.99856	698	1	699
11	"11-out3602"	.99856	697	1	698
11	"11-out3603"	.99489	585	3	588
11	"11-out3604"	.99848	660	1	661
11	"11-out3605"	.98775	242	3	245
11	"11-out3606"	.52873	138	123	261
11	"11-out3607"	.32485	115	239	354
11	"11-out3608"	.44018	195	248	443
11	"11-out3609"	.99591	244	1	245
11	"11-out3610"	.43986	267	340	607
11	"11-out3611"	.22033	65	230	295
11	"11-out3612"	.41477	146	206	352
11	"11-out3613"	.23705	87	280	367
11	"11-out3614"	.18157	69	311	380
11	"11-out3615"	.99450	543	3	546
11	"11-out3616"	.24444	66	204	270
11	"11-out3617"	.39223	313	485	798
11	"11-out3618"	.33638	184	363	547
11	"11-out3619"	.99152	117	1	118
11	"11-out3620"	.38566	113	180	293
11	"11-out3621"	.99646	2258	8	2266
11	"11-out3622"	.37264	158	266	424
11	"11-out3623"	.37349	31	52	83
11	"11-out3624"	.20676	55	211	266
11	"11-out3625"	.36981	98	167	265
11	"11-out3626"	.97247	318	9	327
11	"11-out3627"	.31307	613	1345	1958
11	"11-out3628"	.39312	103	159	262
11	"11-out3629"	.26082	259	734	993
11	"11-out3630"	.40455	426	627	1053
11	"11-out3631"	.12738	20	137	157
11	"11-out3632"	.42857	108	144	252
11	"11-out3633"	.71235	421	170	591
11	"11-out3634"	.78053	377	106	483
11	"11-out3635"	.99668	301	1	302
11	"11-out3636"	.99668	301	1	302
11	"11-out3637"	.12698	64	440	504
11	"11-out3638"	.24634	101	309	410
11	"11-out3639"	.99239	522	4	526
11	"11-out3640"	.27688	103	269	372
11	"11-out3641"	.34380	197	376	573
11	"11-out3642"	.40000	212	318	530
11	"11-out3643"	.80985	115	27	142
11	"11-out3644"	.29577	42	100	142
11	"11-out3645"	.34329	333	637	970
11	"11-out3646"	.99367	157	1	158
11	"11-out3647"	.31904	134	286	420
11	"11-out3648"	.12753	44	301	345
11	"11-out3649"	.26149	91	257	348
11	"11-out3650"	.27485	235	620	855
11	"11-out3651"	.90476	437	46	483
11	"11-out3652"	.86969	574	86	660
11	"11-out3653"	.95504	2528	119	2647
11	"11-out3654"	.24213	77	241	318
11	"11-out3655"	.42857	126	168	294
11	"11-out3656"	.43386	246	321	567
11	"11-out3657"	.21321	71	262	333
11	"11-out3658"	.99820	557	1	558
11	"11-out3659"	.22208	350	1226	1576
11	"11-out3660"	.85984	1092	178	1270
11	"11-out3661"	.88918	337	42	379
11	"11-out3662"	.18276	70	313	383
11	"11-out3663"	.77082	1860	553	2413
11	"11-out3664"	.38345	153	246	399
11	"11-out3665"	.39712	359	545	904
11	"11-out3666"	.97413	113	3	116
11	"11-out3667"	.40667	207	302	509
11	"11-out3668"	.50089	281	280	561
11	"11-out3669"	.41468	209	295	504
11	"11-out3670"	.47660	163	179	342
11	"11-out3671"	.42779	157	210	367
11	"11-out3672"	.59365	412	282	694
11	"11-out3673"	.17741	88	408	496
11	"11-out3674"	.30097	31	72	103
11	"11-out3675"	.22901	161	542	703
11	"11-out3676"	.98484	325	5	330
11	"11-out3677"	.58401	643	458	1101
11	"11-out3678"	.45180	539	654	1193
11	"11-out3679"	.24207	252	789	1041
11	"11-out3680"	.37383	160	268	428
11	"11-out3681"	.44883	193	237	430
11	"11-out3682"	.62025	196	120	316
11	"11-out3683"	.36996	101	172	273
11	"11-out3684"	.31339	220	482	702
11	"11-out3685"	.44972	161	197	358
11	"11-out3686"	.34166	82	158	240
11	"11-out3687"	.34600	91	172	263
11	"11-out3688"	.57715	389	285	674
11	"11-out3689"	.88141	498	67	565
11	"11-out3690"	.36483	1517	2641	4158
11	"11-out3691"	.60451	107	70	177
11	"11-out3692"	.44760	1384	1708	3092
11	"11-out3693"	.40223	144	214	358
11	"11-out3694"	.37313	75	126	201
11	"11-out3695"	.51805	789	734	1523
11	"11-out3696"	.41252	224	319	543
11	"11-out3697"	.33333	55	110	165
11	"11-out3698"	.43125	138	182	320
11	"11-out3699"	.17295	211	1009	1220
11	"11-out3700"	.38663	162	257	419
11	"11-out3701"	.41619	221	310	531
11	"11-out3702"	.46006	144	169	313
11	"11-out3703"	.50819	403	390	793
11	"11-out3704"	.31322	161	353	514
11	"11-out3705"	.48989	97	101	198
11	"11-out3706"	.40384	42	62	104
11	"11-out3707"	.43096	206	272	478
11	"11-out3708"	.35619	348	629	977
11	"11-out3709"	.27083	26	70	96
11	"11-out3710"	.27753	194	505	699
11	"11-out3711"	.99528	422	2	424
11	"11-out3712"	.98984	195	2	197
11	"11-out3713"	.91654	637	58	695
11	"11-out3714"	.32608	240	496	736
11	"11-out3715"	.35784	73	131	204
11	"11-out3716"	.38567	533	849	1382
11	"11-out3717"	.16780	98	486	584
11	"11-out3718"	.24844	40	121	161
11	"11-out3719"	.99576	235	1	236
11	"11-out3720"	.67431	147	71	218
11	"11-out3721"	.13649	49	310	359
11	"11-out3722"	.26560	217	600	817
11	"11-out3723"	.71902	325	127	452
11	"11-out3724"	.27851	337	873	1210
11	"11-out3725"	.40577	267	391	658
11	"11-out3726"	.35418	436	795	1231
11	"11-out3727"	.54867	62	51	113
11	"11-out3728"	.84397	476	88	564
11	"11-out3729"	.44469	201	251	452
11	"11-out3730"	.40133	120	179	299
11	"11-out3731"	.24171	197	618	815
11	"11-out3732"	.37723	338	558	896
11	"11-out3733"	.33875	667	1302	1969
11	"11-out3734"	.53639	140	121	261
11	"11-out3735"	.50750	676	656	1332
11	"11-out3736"	.39951	330	496	826
11	"11-out3737"	.38090	387	629	1016
11	"11-out3738"	.41122	315	451	766
11	"11-out3739"	.36952	422	720	1142
11	"11-out3740"	.37603	91	151	242
11	"11-out3741"	.40511	301	442	743
11	"11-out3742"	.42514	213	288	501
11	"11-out3743"	.92857	325	25	350
11	"11-out3744"	.75850	223	71	294
11	"11-out3745"	.29166	84	204	288
11	"11-out3746"	.55696	308	245	553
11	"11-out3747"	.33891	182	355	537
11	"11-out3748"	.26220	145	408	553
11	"11-out3749"	.28862	170	419	589
11	"11-out3750"	.99438	177	1	178
11	"11-out3751"	.49269	337	347	684
11	"11-out3752"	.99386	162	1	163
11	"11-out3753"	.60301	120	79	199
11	"11-out3754"	.86296	233	37	270
11	"11-out3755"	.75000	270	90	360
11	"11-out3756"	.13383	53	343	396
11	"11-out3757"	.34769	113	212	325
11	"11-out3758"	.99521	208	1	209
11	"11-out3759"	.39487	77	118	195
11	"11-out3760"	.38819	125	197	322
11	"11-out3761"	.36750	276	475	751
11	"11-out3762"	.23966	58	184	242
11	"11-out3763"	.36986	54	92	146
11	"11-out3764"	.28704	215	534	749
11	"11-out3765"	.56485	135	104	239
11	"11-out3766"	.75000	180	60	240
11	"11-out3767"	.29439	63	151	214
11	"11-out3768"	.30088	68	158	226
11	"11-out3769"	.59607	152	103	255
11	"11-out3770"	.26341	54	151	205
11	"11-out3771"	.47417	101	112	213
11	"11-out3772"	.59663	142	96	238
11	"11-out3773"	.35964	82	146	228
11	"11-out3774"	.99736	379	1	380
11	"11-out3775"	.30163	92	213	305
11	"11-out3776"	.98734	78	1	79
11	"11-out3777"	.98734	78	1	79
11	"11-out3778"	.99295	141	1	142
11	"11-out3779"	.35327	124	227	351
11	"11-out3780"	.70093	75	32	107
11	"11-out3781"	.65000	169	91	260
11	"11-out3782"	.37677	266	440	706
11	"11-out3783"	.22744	121	411	532
11	"11-out3784"	.46384	186	215	401
11	"11-out3785"	.26458	127	353	480
11	"11-out3786"	.98936	93	1	94
11	"11-out3787"	.37541	1023	1702	2725
11	"11-out3788"	.47058	32	36	68
11	"11-out3789"	.37803	296	487	783
11	"11-out3790"	.44891	145	178	323
11	"11-out3791"	.28173	91	232	323
11	"11-out3792"	.31119	314	695	1009
11	"11-out3793"	.30690	391	883	1274
11	"11-out3794"	.62051	363	222	585
11	"11-out3795"	.20951	251	947	1198
11	"11-out3796"	.32669	82	169	251
11	"11-out3797"	.98947	94	1	95
11	"11-out3798"	.21428	36	132	168
11	"11-out3799"	.32047	108	229	337
11	"11-out3800"	.18887	146	627	773
11	"11-out3801"	.21224	156	579	735
11	"11-out3802"	.40000	120	180	300
11	"11-out3803"	.27741	86	224	310
11	"11-out3804"	.99706	340	1	341
11	"11-out3805"	.76530	75	23	98
11	"11-out3806"	.43448	63	82	145
11	"11-out3807"	.64948	63	34	97
11	"11-out3808"	.98507	66	1	67
11	"11-out3809"	.37510	446	743	1189
11	"11-out3810"	.35848	727	1301	2028
11	"11-out3811"	.98630	72	1	73
11	"11-out3812"	.33500	201	399	600
11	"11-out3813"	.55725	219	174	393
11	"11-out3814"	.66118	201	103	304
11	"11-out3815"	.29634	227	539	766
11	"11-out3816"	.20821	76	289	365
11	"11-out3817"	.30822	802	1800	2602
11	"11-out3818"	.57737	985	721	1706
11	"11-out3819"	.33333	161	322	483
11	"11-out3820"	.24320	313	974	1287
11	"11-out3821"	.38374	203	326	529
11	"11-out3822"	.42127	198	272	470
11	"11-out3823"	.91515	151	14	165
11	"11-out3824"	.66494	129	65	194
11	"11-out3825"	.98437	63	1	64
11	"11-out3826"	.33333	268	536	804
11	"11-out3827"	.98571	69	1	70
11	"11-out3828"	.40723	439	639	1078
11	"11-out3829"	.86309	145	23	168
11	"11-out3830"	.86904	73	11	84
11	"11-out3831"	.46464	184	212	396
11	"11-out3832"	.21428	117	429	546
11	"11-out3833"	.25814	103	296	399
11	"11-out3834"	.19298	220	920	1140
11	"11-out3835"	.19824	181	732	913
11	"11-out3836"	.30317	258	593	851
11	"11-out3837"	.44540	412	513	925
11	"11-out3838"	.88000	88	12	100
11	"11-out3839"	.41368	254	360	614
11	"11-out3840"	.59112	1012	700	1712
11	"11-out3841"	.68571	48	22	70
11	"11-out3842"	.47940	384	417	801
11	"11-out3843"	.39655	368	560	928
11	"11-out3844"	.97533	791	20	811
11	"11-out3845"	.43404	102	133	235
11	"11-out3846"	.40281	429	636	1065
11	"11-out3847"	.19789	94	381	475
11	"11-out3848"	.28422	191	481	672
11	"11-out3849"	.41481	168	237	405
11	"11-out3850"	.46462	591	681	1272
11	"11-out3851"	.28294	146	370	516
11	"11-out3852"	.30150	60	139	199
11	"11-out3853"	.36889	204	349	553
11	"11-out3854"	.93406	255	18	273
11	"11-out3855"	.79746	126	32	158
11	"11-out3856"	.27603	334	876	1210
11	"11-out3857"	.98717	77	1	78
11	"11-out3858"	.55278	288	233	521
11	"11-out3859"	.98924	92	1	93
11	"11-out3860"	.52435	183	166	349
11	"11-out3861"	.99718	354	1	355
11	"11-out3862"	.45233	223	270	493
11	"11-out3863"	.40288	419	621	1040
11	"11-out3864"	.99894	949	1	950
11	"11-out3865"	.41791	140	195	335
11	"11-out3866"	.39658	372	566	938
11	"11-out3867"	.34607	163	308	471
11	"11-out3868"	.61206	142	90	232
11	"11-out3869"	.42956	369	490	859
11	"11-out3870"	.44407	266	333	599
11	"11-out3871"	.63333	380	220	600
11	"11-out3872"	.35135	260	480	740
11	"11-out3873"	.98936	93	1	94
11	"11-out3874"	.44588	276	343	619
11	"11-out3875"	.48786	402	422	824
11	"11-out3876"	.40543	418	613	1031
11	"11-out3877"	.30873	159	356	515
11	"11-out3878"	.48641	197	208	405
11	"11-out3879"	.35480	358	651	1009
11	"11-out3880"	.37055	594	1009	1603
11	"11-out3881"	.36792	78	134	212
11	"11-out3882"	.45921	152	179	331
11	"11-out3883"	.71597	242	96	338
11	"11-out3884"	.79166	247	65	312
11	"11-out3885"	.26803	327	893	1220
11	"11-out3886"	.78131	736	206	942
11	"11-out3887"	.63451	467	269	736
11	"11-out3888"	.29744	221	522	743
11	"11-out3889"	.63342	724	419	1143
11	"11-out3890"	.33246	128	257	385
11	"11-out3891"	.43205	124	163	287
11	"11-out3892"	.63109	272	159	431
11	"11-out3893"	.36188	507	894	1401
11	"11-out3894"	.45103	175	213	388
11	"11-out3895"	.34143	267	515	782
11	"11-out3896"	.89473	272	32	304
11	"11-out3897"	.55339	342	276	618
11	"11-out3898"	.48109	229	247	476
11	"11-out3899"	.34924	161	300	461
11	"11-out3900"	.39782	183	277	460
11	"11-out3901"	.15882	27	143	170
11	"11-out3902"	.31147	76	168	244
11	"11-out3903"	.27777	110	286	396
11	"11-out3904"	.30913	132	295	427
11	"11-out3905"	.27491	171	451	622
11	"11-out3906"	.06289	20	298	318
11	"11-out3907"	.66322	514	261	775
11	"11-out3908"	.52138	317	291	608
11	"11-out3909"	.57322	137	102	239
11	"11-out3910"	.75609	248	80	328
11	"11-out3911"	.81110	906	211	1117
11	"11-out3912"	.51785	145	135	280
11	"11-out3913"	.40972	413	595	1008
11	"11-out3914"	.27638	254	665	919
11	"11-out3915"	.34312	397	760	1157
11	"11-out3916"	.81258	633	146	779
11	"11-out3917"	.30223	677	1563	2240
11	"11-out3918"	.35604	554	1002	1556
11	"11-out3919"	.39021	295	461	756
11	"11-out3920"	.31085	106	235	341
11	"11-out3921"	.47428	166	184	350
11	"11-out3922"	.71487	173	69	242
11	"11-out3923"	.32661	324	668	992
11	"11-out3924"	.24723	179	545	724
11	"11-out3925"	.98630	72	1	73
11	"11-out3926"	.44551	323	402	725
11	"11-out3927"	.35109	112	207	319
11	"11-out3928"	.97185	656	19	675
11	"11-out3929"	.77455	560	163	723
11	"11-out3930"	.98611	71	1	72
11	"11-out3931"	.44741	268	331	599
11	"11-out3932"	.53359	413	361	774
11	"11-out3933"	.74946	347	116	463
11	"11-out3934"	.96407	322	12	334
11	"11-out3935"	.53048	261	231	492
11	"11-out3936"	.46191	285	332	617
11	"11-out3937"	.36643	107	185	292
11	"11-out3938"	.48360	118	126	244
11	"11-out3939"	.62105	118	72	190
11	"11-out3940"	.80392	82	20	102
11	"11-out3941"	.32280	92	193	285
11	"11-out3942"	.35370	353	645	998
11	"11-out3943"	.99253	133	1	134
11	"11-out3944"	.82089	605	132	737
11	"11-out3945"	.89600	784	91	875
11	"11-out3946"	.33439	105	209	314
11	"11-out3947"	.21472	70	256	326
11	"11-out3948"	.29911	169	396	565
11	"11-out3949"	.22857	104	351	455
11	"11-out3950"	.28247	361	917	1278
11	"11-out3951"	.21086	163	610	773
11	"11-out3952"	.36645	177	306	483
11	"11-out3953"	.33701	244	480	724
11	"11-out3954"	.76737	508	154	662
11	"11-out3955"	.99896	969	1	970
11	"11-out3956"	.70781	516	213	729
11	"11-out3957"	.98936	93	1	94
11	"11-out3958"	.93415	227	16	243
11	"11-out3959"	.85156	436	76	512
11	"11-out3960"	.99494	197	1	198
11	"11-out3961"	.34157	511	985	1496
11	"11-out3962"	.41644	795	1114	1909
11	"11-out3963"	.55794	337	267	604
11	"11-out3964"	.26030	101	287	388
11	"11-out3965"	.99545	219	1	220
11	"11-out3966"	.97132	542	16	558
11	"11-out3967"	.25149	84	250	334
11	"11-out3968"	.98461	64	1	65
11	"11-out3969"	.28706	91	226	317
11	"11-out3970"	.24186	171	536	707
11	"11-out3971"	.99719	356	1	357
11	"11-out3972"	.99371	158	1	159
11	"11-out3973"	.34535	364	690	1054
11	"11-out3974"	.39463	103	158	261
11	"11-out3975"	.26843	91	248	339
11	"11-out3976"	.26289	209	586	795
11	"11-out3977"	.46254	494	574	1068
11	"11-out3978"	.99889	906	1	907
11	"11-out3979"	.99290	140	1	141
11	"11-out3980"	.94326	133	8	141
11	"11-out3981"	.38522	292	466	758
11	"11-out3982"	.41798	79	110	189
11	"11-out3983"	.65359	100	53	153
11	"11-out3984"	.63725	65	37	102
11	"11-out3985"	.59756	49	33	82
11	"11-out3986"	.98863	87	1	88
11	"11-out3987"	.50649	39	38	77
11	"11-out3988"	.51882	124	115	239
11	"11-out3989"	.47490	123	136	259
11	"11-out3990"	.53352	183	160	343
11	"11-out3991"	.55066	288	235	523
11	"11-out3992"	.32727	36	74	110
11	"11-out3993"	.88030	228	31	259
11	"11-out3994"	.55274	131	106	237
11	"11-out3995"	.42765	201	269	470
11	"11-out3996"	.45555	410	490	900
11	"11-out3997"	.36005	256	455	711
11	"11-out3998"	.30653	244	552	796
11	"11-out3999"	.27777	150	390	540
11	"11-out4000"	.60210	401	265	666
11	"11-out4001"	.45007	284	347	631
11	"11-out4002"	.34506	304	577	881
11	"11-out4003"	.96716	648	22	670
11	"11-out4004"	.28884	158	389	547
11	"11-out4005"	.65083	274	147	421
11	"11-out4006"	.36610	108	187	295
11	"11-out4007"	.45363	773	931	1704
11	"11-out4008"	.94581	192	11	203
11	"11-out4009"	.72727	96	36	132
11	"11-out4010"	.23644	157	507	664
11	"11-out4011"	.69196	155	69	224
11	"11-out4012"	.52121	86	79	165
11	"11-out4013"	.52297	239	218	457
11	"11-out4014"	.99489	195	1	196
11	"11-out4015"	.99549	221	1	222
11	"11-out4016"	.60810	135	87	222
11	"11-out4017"	.86666	169	26	195
11	"11-out4018"	.24489	48	148	196
11	"11-out4019"	.45083	188	229	417
11	"11-out4020"	.92857	104	8	112
11	"11-out4021"	.38714	235	372	607
11	"11-out4022"	.27814	42	109	151
11	"11-out4023"	.47337	240	267	507
11	"11-out4024"	.44921	429	526	955
11	"11-out4025"	.46683	190	217	407
11	"11-out4026"	.28113	158	404	562
11	"11-out4027"	.57933	157	114	271
11	"11-out4028"	.51083	165	158	323
11	"11-out4029"	.29642	174	413	587
11	"11-out4030"	.37086	168	285	453
11	"11-out4031"	.59656	278	188	466
11	"11-out4032"	.35820	120	215	335
11	"11-out4033"	.40750	163	237	400
11	"11-out4034"	.33665	304	599	903
11	"11-out4035"	.46252	216	251	467
11	"11-out4036"	.46186	109	127	236
11	"11-out4037"	.20000	36	144	180
11	"11-out4038"	.95323	265	13	278
11	"11-out4039"	.87567	162	23	185
11	"11-out4040"	.35233	68	125	193
11	"11-out4041"	.41798	79	110	189
11	"11-out4042"	.35880	554	990	1544
11	"11-out4043"	.27703	228	595	823
11	"11-out4044"	.17777	32	148	180
11	"11-out4045"	.24965	179	538	717
11	"11-out4046"	.32065	253	536	789
11	"11-out4047"	.60714	289	187	476
11	"11-out4048"	.19083	75	318	393
11	"11-out4049"	.37690	173	286	459
11	"11-out4050"	.30555	143	325	468
11	"11-out4051"	.58085	176	127	303
11	"11-out4052"	.33333	64	128	192
11	"11-out4053"	.35523	173	314	487
11	"11-out4054"	.28031	534	1371	1905
11	"11-out4055"	.37759	273	450	723
11	"11-out4056"	.22428	133	460	593
11	"11-out4057"	.30683	247	558	805
11	"11-out4058"	.61956	57	35	92
11	"11-out4059"	.24676	229	699	928
11	"11-out4060"	.23056	89	297	386
11	"11-out4061"	.45918	180	212	392
11	"11-out4062"	.31606	183	396	579
11	"11-out4063"	.98809	83	1	84
11	"11-out4064"	.54929	78	64	142
11	"11-out4065"	.99559	226	1	227
11	"11-out4066"	.41051	367	527	894
11	"11-out4067"	.63886	812	459	1271
11	"11-out4068"	.99418	171	1	172
11	"11-out4069"	.39099	278	433	711
11	"11-out4070"	.97065	893	27	920
11	"11-out4071"	.51937	67	62	129
11	"11-out4072"	.69298	79	35	114
11	"11-out4073"	.99846	650	1	651
11	"11-out4074"	.24271	100	312	412
11	"11-out4075"	.25390	130	382	512
11	"11-out4076"	.53065	277	245	522
11	"11-out4077"	.91590	599	55	654
11	"11-out4078"	.40782	73	106	179
11	"11-out4079"	.99576	235	1	236
11	"11-out4080"	.99800	499	1	500
11	"11-out4081"	.29900	151	354	505
11	"11-out4082"	.37280	170	286	456
11	"11-out4083"	.29808	234	551	785
11	"11-out4084"	.09500	19	181	200
11	"11-out4085"	.63636	77	44	121
11	"11-out4086"	.32978	62	126	188
11	"11-out4087"	.40070	113	169	282
11	"11-out4088"	.22222	12	42	54
11	"11-out4089"	.26162	180	508	688
11	"11-out4090"	.29325	100	241	341
11	"11-out4091"	.32860	301	615	916
11	"11-out4092"	.46179	278	324	602
11	"11-out4093"	.49295	105	108	213
11	"11-out4094"	.60810	135	87	222
11	"11-out4095"	.43347	101	132	233
11	"11-out4096"	.98245	168	3	171
11	"11-out4097"	.52736	106	95	201
11	"11-out4098"	.40397	183	270	453
11	"11-out4099"	.32019	260	552	812
11	"11-out4100"	.40441	55	81	136
11	"11-out4101"	.18750	117	507	624
11	"11-out4102"	.78947	330	88	418
11	"11-out4103"	.93333	196	14	210
11	"11-out4104"	.44444	84	105	189
11	"11-out4105"	.31756	94	202	296
11	"11-out4106"	.57450	347	257	604
11	"11-out4107"	.45925	310	365	675
11	"11-out4108"	.99047	104	1	105
11	"11-out4109"	.89189	231	28	259
11	"11-out4110"	.87850	94	13	107
11	"11-out4111"	.26239	127	357	484
11	"11-out4112"	.81070	621	145	766
11	"11-out4113"	.39220	322	499	821
11	"11-out4114"	.29889	217	509	726
11	"11-out4115"	.32625	215	444	659
11	"11-out4116"	.66181	364	186	550
11	"11-out4117"	.57504	295	218	513
11	"11-out4118"	.30386	55	126	181
11	"11-out4119"	.99230	129	1	130
11	"11-out4120"	.28215	136	346	482
11	"11-out4121"	.92840	389	30	419
11	"11-out4122"	.67058	171	84	255
11	"11-out4123"	.13095	11	73	84
11	"11-out4124"	.44541	102	127	229
11	"11-out4125"	.78571	198	54	252
11	"11-out4126"	.99315	145	1	146
11	"11-out4127"	.34718	117	220	337
11	"11-out4128"	.39560	216	330	546
11	"11-out4129"	.44481	266	332	598
11	"11-out4130"	.41678	298	417	715
11	"11-out4131"	.99310	144	1	145
11	"11-out4132"	.25832	442	1269	1711
11	"11-out4133"	.27544	230	605	835
11	"11-out4134"	.40083	192	287	479
11	"11-out4135"	.39047	82	128	210
11	"11-out4136"	.40594	82	120	202
11	"11-out4137"	.41935	91	126	217
11	"11-out4138"	.32696	137	282	419
11	"11-out4139"	.24696	61	186	247
11	"11-out4140"	.99616	260	1	261
11	"11-out4141"	.38423	307	492	799
11	"11-out4142"	.57608	477	351	828
11	"11-out4143"	.54307	290	244	534
11	"11-out4144"	.43467	183	238	421
11	"11-out4145"	.44444	76	95	171
11	"11-out4146"	.28487	145	364	509
11	"11-out4147"	.95762	113	5	118
11	"11-out4148"	.99633	272	1	273
11	"11-out4149"	.38725	79	125	204
11	"11-out4150"	.88849	502	63	565
11	"11-out4151"	.17391	44	209	253
11	"11-out4152"	.21910	477	1700	2177
11	"11-out4153"	.19179	187	788	975
11	"11-out4154"	.99797	493	1	494
11	"11-out4155"	.33333	29	58	87
11	"11-out4156"	.97761	393	9	402
11	"11-out4157"	.51968	132	122	254
11	"11-out4158"	.34415	106	202	308
11	"11-out4159"	.44612	236	293	529
11	"11-out4160"	.29654	309	733	1042
11	"11-out4161"	.39243	363	562	925
11	"11-out4162"	.29094	151	368	519
11	"11-out4163"	.28880	534	1315	1849
11	"11-out4164"	.50738	206	200	406
11	"11-out4165"	.29568	288	686	974
11	"11-out4166"	.97556	479	12	491
11	"11-out4167"	.66197	94	48	142
11	"11-out4168"	.39780	181	274	455
11	"11-out4169"	.26650	113	311	424
11	"11-out4170"	.36692	142	245	387
11	"11-out4171"	.23214	91	301	392
11	"11-out4172"	.84586	450	82	532
11	"11-out4173"	.28662	315	784	1099
11	"11-out4174"	.46969	186	210	396
11	"11-out4175"	.13868	19	118	137
11	"11-out4176"	.32530	81	168	249
11	"11-out4177"	.53801	276	237	513
11	"11-out4178"	.40473	1589	2337	3926
11	"11-out4179"	.85531	201	34	235
11	"11-out4180"	.30379	72	165	237
11	"11-out4181"	.25579	276	803	1079
11	"11-out4182"	.42051	82	113	195
11	"11-out4183"	.99591	488	2	490
11	"11-out4184"	.35410	125	228	353
11	"11-out4185"	.99465	186	1	187
11	"11-out4186"	.32674	1587	3270	4857
11	"11-out4187"	.18207	65	292	357
11	"11-out4188"	.97761	393	9	402
11	"11-out4189"	.24379	167	518	685
11	"11-out4190"	.54770	155	128	283
11	"11-out4191"	.48369	89	95	184
11	"11-out4192"	.81747	1048	234	1282
11	"11-out4193"	.56302	67	52	119
11	"11-out4194"	.99137	115	1	116
11	"11-out4195"	.99692	649	2	651
11	"11-out4196"	.32412	176	367	543
11	"11-out4197"	.40485	500	735	1235
11	"11-out4198"	.29302	126	304	430
11	"11-out4199"	.30842	161	361	522
11	"11-out4200"	.51960	1776	1642	3418
11	"11-out4201"	.34640	212	400	612
11	"11-out4202"	.34239	378	726	1104
11	"11-out4203"	.42952	451	599	1050
11	"11-out4204"	.40921	444	641	1085
11	"11-out4205"	.99862	724	1	725
11	"11-out4206"	.92241	107	9	116
11	"11-out4207"	.95555	215	10	225
11	"11-out4208"	.99373	634	4	638
11	"11-out4209"	.47658	173	190	363
11	"11-out4210"	.99797	493	1	494
11	"11-out4211"	.31457	123	268	391
11	"11-out4212"	.86046	148	24	172
11	"11-out4213"	.42272	599	818	1417
11	"11-out4214"	.24326	271	843	1114
11	"11-out4215"	.77297	143	42	185
11	"11-out4216"	.20283	200	786	986
11	"11-out4217"	.39779	253	383	636
11	"11-out4218"	.47031	103	116	219
11	"11-out4219"	.52547	165	149	314
11	"11-out4220"	.45714	96	114	210
11	"11-out4221"	.99719	356	1	357
11	"11-out4222"	.33333	35	70	105
11	"11-out4223"	.93431	697	49	746
11	"11-out4224"	.22265	57	199	256
11	"11-out4225"	.56139	1710	1336	3046
11	"11-out4226"	.98666	74	1	75
11	"11-out4227"	.29721	96	227	323
11	"11-out4228"	.58423	430	306	736
11	"11-out4229"	.50039	629	628	1257
11	"11-out4230"	.85929	513	84	597
11	"11-out4231"	.41666	75	105	180
11	"11-out4232"	.43848	139	178	317
11	"11-out4233"	.30044	67	156	223
11	"11-out4234"	.28615	279	696	975
11	"11-out4235"	.57000	285	215	500
11	"11-out4236"	.56485	270	208	478
11	"11-out4237"	.52247	93	85	178
11	"11-out4238"	.91200	114	11	125
11	"11-out4239"	.34612	550	1039	1589
11	"11-out4240"	.63719	209	119	328
11	"11-out4241"	.26810	137	374	511
11	"11-out4242"	.41398	219	310	529
11	"11-out4243"	.84095	460	87	547
11	"11-out4244"	.33750	54	106	160
11	"11-out4245"	.53653	837	723	1560
11	"11-out4246"	.32142	162	342	504
11	"11-out4247"	.64516	140	77	217
11	"11-out4248"	.34592	174	329	503
11	"11-out4249"	.15048	31	175	206
11	"11-out4250"	.65740	71	37	108
11	"11-out4251"	.33561	98	194	292
11	"11-out4252"	.58656	681	480	1161
11	"11-out4253"	.34340	125	239	364
11	"11-out4254"	.35830	220	394	614
11	"11-out4255"	.34707	101	190	291
11	"11-out4256"	.47816	219	239	458
11	"11-out4257"	.26520	157	435	592
11	"11-out4258"	.99310	144	1	145
11	"11-out4259"	.37203	298	503	801
11	"11-out4260"	.29899	119	279	398
11	"11-out4261"	.17871	136	625	761
11	"11-out4262"	.29818	362	852	1214
11	"11-out4263"	.37810	152	250	402
11	"11-out4264"	.46680	225	257	482
11	"11-out4265"	.45569	72	86	158
11	"11-out4266"	.38434	108	173	281
11	"11-out4267"	.32022	228	484	712
11	"11-out4268"	.99805	512	1	513
11	"11-out4269"	.99310	144	1	145
11	"11-out4270"	.22142	31	109	140
11	"11-out4271"	.54454	489	409	898
11	"11-out4272"	.40997	148	213	361
11	"11-out4273"	.53012	88	78	166
11	"11-out4274"	.29317	202	487	689
11	"11-out4275"	.23151	144	478	622
11	"11-out4276"	.32116	132	279	411
11	"11-out4277"	.74468	70	24	94
11	"11-out4278"	.25272	139	411	550
11	"11-out4279"	.98765	80	1	81
11	"11-out4280"	.34763	81	152	233
11	"11-out4281"	.41362	261	370	631
11	"11-out4282"	.57328	176	131	307
11	"11-out4283"	.71356	284	114	398
11	"11-out4284"	.48606	157	166	323
11	"11-out4285"	.32676	116	239	355
11	"11-out4286"	.47758	277	303	580
11	"11-out4287"	.46524	174	200	374
11	"11-out4288"	.18983	71	303	374
11	"11-out4289"	.21693	82	296	378
11	"11-out4290"	.32111	289	611	900
11	"11-out4291"	.33561	245	485	730
11	"11-out4292"	.99792	481	1	482
11	"11-out4293"	.98867	786	9	795
11	"11-out4294"	.18471	58	256	314
11	"11-out4295"	.87179	102	15	117
11	"11-out4296"	.45682	164	195	359
11	"11-out4297"	.68852	42	19	61
11	"11-out4298"	.36681	84	145	229
11	"11-out4299"	.40467	225	331	556
11	"11-out4300"	.87078	465	69	534
11	"11-out4301"	.58858	196	137	333
11	"11-out4302"	.46290	287	333	620
11	"11-out4303"	.11610	31	236	267
11	"11-out4304"	.32013	97	206	303
11	"11-out4305"	.39784	407	616	1023
11	"11-out4306"	.41145	539	771	1310
11	"11-out4307"	.42480	161	218	379
11	"11-out4308"	.44217	130	164	294
11	"11-out4309"	.57936	73	53	126
11	"11-out4310"	.72549	74	28	102
11	"11-out4311"	.95057	500	26	526
11	"11-out4312"	.60266	1494	985	2479
11	"11-out4313"	.27078	127	342	469
11	"11-out4314"	.43151	482	635	1117
11	"11-out4315"	.25000	50	150	200
11	"11-out4316"	.26823	114	311	425
11	"11-out4317"	.76208	205	64	269
11	"11-out4318"	.97407	263	7	270
11	"11-out4319"	.36802	145	249	394
11	"11-out4320"	.21390	40	147	187
11	"11-out4321"	.35185	171	315	486
11	"11-out4322"	.46093	177	207	384
11	"11-out4323"	.31000	93	207	300
11	"11-out4324"	.35333	53	97	150
11	"11-out4325"	.92988	557	42	599
11	"11-out4326"	.43453	458	596	1054
11	"11-out4327"	.36007	202	359	561
11	"11-out4328"	.29710	257	608	865
11	"11-out4329"	.67861	511	242	753
11	"11-out4330"	.66417	178	90	268
11	"11-out4331"	.53017	246	218	464
11	"11-out4332"	.44943	120	147	267
11	"11-out4333"	.84228	251	47	298
11	"11-out4334"	.38705	293	464	757
11	"11-out4335"	.53433	319	278	597
11	"11-out4336"	.49700	83	84	167
11	"11-out4337"	.62544	349	209	558
11	"11-out4338"	.99230	129	1	130
11	"11-out4339"	.40000	140	210	350
11	"11-out4340"	.99630	270	1	271
11	"11-out4341"	.99152	117	1	118
11	"11-out4342"	.41564	271	381	652
11	"11-out4343"	.71487	173	69	242
11	"11-out4344"	.97368	74	2	76
11	"11-out4345"	.99462	185	1	186
11	"11-out4346"	.65354	83	44	127
11	"11-out4347"	.33571	47	93	140
11	"11-out4348"	.48220	894	960	1854
11	"11-out4349"	.99551	222	1	223
11	"11-out4350"	.67241	2143	1044	3187
11	"11-out4351"	.31451	195	425	620
11	"11-out4352"	.37804	62	102	164
11	"11-out4353"	.59866	179	120	299
11	"11-out4354"	.52569	133	120	253
11	"11-out4355"	.40168	523	779	1302
11	"11-out4356"	.64779	103	56	159
11	"11-out4357"	.14360	55	328	383
11	"11-out4358"	.31223	74	163	237
11	"11-out4359"	.62678	220	131	351
11	"11-out4360"	.59523	175	119	294
11	"11-out4361"	.42424	70	95	165
11	"11-out4362"	.35135	65	120	185
11	"11-out4363"	.54906	526	432	958
11	"11-out4364"	.99509	203	1	204
11	"11-out4365"	.36363	88	154	242
11	"11-out4366"	.39272	108	167	275
11	"11-out4367"	.48930	183	191	374
11	"11-out4368"	.55274	524	424	948
11	"11-out4369"	.48695	56	59	115
11	"11-out4370"	.58585	58	41	99
11	"11-out4371"	.55603	129	103	232
11	"11-out4372"	.36011	121	215	336
11	"11-out4373"	.35734	124	223	347
11	"11-out4374"	.99459	184	1	185
11	"11-out4375"	.26015	205	583	788
11	"11-out4376"	.89684	739	85	824
11	"11-out4377"	.23448	102	333	435
11	"11-out4378"	.34388	163	311	474
11	"11-out4379"	.70539	170	71	241
11	"11-out4380"	.46031	116	136	252
11	"11-out4381"	.28700	254	631	885
11	"11-out4382"	.82722	158	33	191
11	"11-out4383"	.19101	85	360	445
11	"11-out4384"	.96830	275	9	284
11	"11-out4385"	.71070	425	173	598
11	"11-out4386"	.33221	99	199	298
11	"11-out4387"	.48863	86	90	176
11	"11-out4388"	.96212	1524	60	1584
11	"11-out4389"	.99716	352	1	353
11	"11-out4390"	.99551	222	1	223
11	"11-out4391"	.29152	86	209	295
11	"11-out4392"	.34649	667	1258	1925
11	"11-out4393"	.60042	565	376	941
11	"11-out4394"	.56923	185	140	325
11	"11-out4395"	.68782	401	182	583
11	"11-out4396"	.46052	70	82	152
11	"11-out4397"	.31988	111	236	347
11	"11-out4398"	.56802	167	127	294
11	"11-out4399"	.56493	87	67	154
11	"11-out4400"	.98930	185	2	187
11	"11-out4401"	.46484	238	274	512
11	"11-out4402"	.29779	162	382	544
11	"11-out4403"	.41800	209	291	500
11	"11-out4404"	.48361	1181	1261	2442
11	"11-out4405"	.95568	496	23	519
11	"11-out4406"	.99705	339	1	340
11	"11-out4407"	.23946	142	451	593
11	"11-out4408"	.40119	67	100	167
11	"11-out4409"	.36842	42	72	114
11	"11-out4410"	.32664	228	470	698
11	"11-out4411"	.97674	84	2	86
11	"11-out4412"	.99447	180	1	181
11	"11-out4413"	.45401	311	374	685
11	"11-out4414"	.98518	133	2	135
11	"11-out4415"	.23230	105	347	452
11	"11-out4416"	.36443	500	872	1372
11	"11-out4417"	.64981	180	97	277
11	"11-out4418"	.27213	126	337	463
11	"11-out4419"	.48961	165	172	337
11	"11-out4420"	.96960	319	10	329
11	"11-out4421"	.99743	389	1	390
11	"11-out4422"	.44414	334	418	752
11	"11-out4423"	.83750	469	91	560
11	"11-out4424"	.95873	395	17	412
11	"11-out4425"	.31818	126	270	396
11	"11-out4426"	.99751	401	1	402
11	"11-out4427"	.99115	112	1	113
11	"11-out4428"	.44520	130	162	292
11	"11-out4429"	.42962	58	77	135
11	"11-out4430"	.28400	71	179	250
11	"11-out4431"	.99386	162	1	163
11	"11-out4432"	.38378	213	342	555
11	"11-out4433"	.43032	210	278	488
11	"11-out4434"	.54941	517	424	941
11	"11-out4435"	.28571	34	85	119
11	"11-out4436"	.43187	187	246	433
11	"11-out4437"	.94915	280	15	295
11	"11-out4438"	.36627	126	218	344
11	"11-out4439"	.46366	134	155	289
11	"11-out4440"	.29134	229	557	786
11	"11-out4441"	.35492	126	229	355
11	"11-out4442"	.99744	781	2	783
11	"11-out4443"	.29249	74	179	253
11	"11-out4444"	.40071	446	667	1113
11	"11-out4445"	.99644	280	1	281
11	"11-out4446"	.39794	232	351	583
11	"11-out4447"	.19911	45	181	226
11	"11-out4448"	.38983	184	288	472
11	"11-out4449"	.30909	68	152	220
11	"11-out4450"	.53799	177	152	329
11	"11-out4451"	.62463	213	128	341
11	"11-out4452"	.31920	113	241	354
11	"11-out4453"	.41916	280	388	668
11	"11-out4454"	.48757	412	433	845
11	"11-out4455"	.50404	187	184	371
11	"11-out4456"	.57735	153	112	265
11	"11-out4457"	.16504	34	172	206
11	"11-out4458"	.30188	64	148	212
11	"11-out4459"	.42129	637	875	1512
11	"11-out4460"	.43021	1119	1482	2601
11	"11-out4461"	.59003	154	107	261
11	"11-out4462"	.40939	61	88	149
11	"11-out4463"	.38476	399	638	1037
11	"11-out4464"	.17241	20	96	116
11	"11-out4465"	.35846	252	451	703
11	"11-out4466"	.27586	160	420	580
11	"11-out4467"	.52147	340	312	652
11	"11-out4468"	.41071	92	132	224
11	"11-out4469"	.21463	44	161	205
11	"11-out4470"	.43157	287	378	665
11	"11-out4471"	.52760	86	77	163
11	"11-out4472"	.41862	607	843	1450
11	"11-out4473"	.98918	183	2	185
11	"11-out4474"	.19730	44	179	223
11	"11-out4475"	.47378	253	281	534
11	"11-out4476"	.51923	135	125	260
11	"11-out4477"	.22164	43	151	194
11	"11-out4478"	.63496	247	142	389
11	"11-out4479"	.42900	142	189	331
11	"11-out4480"	.55000	55	45	100
11	"11-out4481"	.60323	149	98	247
11	"11-out4482"	.74257	150	52	202
11	"11-out4483"	.18611	67	293	360
11	"11-out4484"	.12698	40	275	315
11	"11-out4485"	.26530	26	72	98
11	"11-out4486"	.25377	84	247	331
11	"11-out4487"	.41333	62	88	150
11	"11-out4488"	.44827	195	240	435
11	"11-out4489"	.87903	327	45	372
11	"11-out4490"	.47291	358	399	757
11	"11-out4491"	.57386	202	150	352
11	"11-out4492"	.29889	217	509	726
11	"11-out4493"	.30072	83	193	276
11	"11-out4494"	.26237	53	149	202
11	"11-out4495"	.76098	277	87	364
11	"11-out4496"	.32738	110	226	336
11	"11-out4497"	.50972	262	252	514
11	"11-out4498"	.46128	566	661	1227
11	"11-out4499"	.40769	106	154	260
11	"11-out4500"	.25858	128	367	495
11	"11-out4501"	.46153	162	189	351
11	"11-out4502"	.31803	97	208	305
11	"11-out4503"	.45019	226	276	502
11	"11-out4504"	.60335	216	142	358
11	"11-out4505"	.69565	96	42	138
11	"11-out4506"	.49840	156	157	313
11	"11-out4507"	.40932	79	114	193
11	"11-out4508"	.35417	623	1136	1759
11	"11-out4509"	.24940	104	313	417
11	"11-out4510"	.35460	150	273	423
11	"11-out4511"	.45072	622	758	1380
11	"11-out4512"	.60313	269	177	446
11	"11-out4513"	.30353	275	631	906
11	"11-out4514"	.47377	280	311	591
11	"11-out4515"	.94924	505	27	532
11	"11-out4516"	.43430	119	155	274
11	"11-out4517"	.37908	58	95	153
11	"11-out4518"	.61256	117	74	191
11	"11-out4519"	.27490	69	182	251
11	"11-out4520"	.40923	390	563	953
11	"11-out4521"	.37804	124	204	328
11	"11-out4522"	.36899	338	578	916
11	"11-out4523"	.35185	95	175	270
11	"11-out4524"	.32594	103	213	316
11	"11-out4525"	.48029	195	211	406
11	"11-out4526"	.99624	265	1	266
11	"11-out4527"	.43750	98	126	224
11	"11-out4528"	.37267	180	303	483
11	"11-out4529"	.60090	265	176	441
11	"11-out4530"	.20149	27	107	134
11	"11-out4531"	.99082	108	1	109
11	"11-out4532"	.38194	165	267	432
11	"11-out4533"	.65469	237	125	362
11	"11-out4534"	.51684	721	674	1395
11	"11-out4535"	.48461	252	268	520
11	"11-out4536"	.38285	134	216	350
11	"11-out4537"	.31596	97	210	307
11	"11-out4538"	.66341	136	69	205
11	"11-out4539"	.46049	169	198	367
11	"11-out4540"	.20168	48	190	238
11	"11-out4541"	.28806	70	173	243
11	"11-out4542"	.21978	40	142	182
11	"11-out4543"	.44541	204	254	458
11	"11-out4544"	.19736	45	183	228
11	"11-out4545"	.36567	98	170	268
11	"11-out4546"	.27124	233	626	859
11	"11-out4547"	.26219	43	121	164
11	"11-out4548"	.40909	81	117	198
11	"11-out4549"	.42299	195	266	461
11	"11-out4550"	.15476	26	142	168
11	"11-out4551"	.48582	257	272	529
11	"11-out4552"	.30323	450	1034	1484
11	"11-out4553"	.86819	303	46	349
11	"11-out4554"	.21014	29	109	138
11	"11-out4555"	.45962	370	435	805
11	"11-out4556"	.24606	125	383	508
11	"11-out4557"	.80434	111	27	138
11	"11-out4558"	.28874	844	2079	2923
11	"11-out4559"	.42233	87	119	206
11	"11-out4560"	.82119	124	27	151
11	"11-out4561"	.54427	670	561	1231
11	"11-out4562"	.47120	270	303	573
11	"11-out4563"	.40177	272	405	677
11	"11-out4564"	.99591	488	2	490
11	"11-out4565"	.88168	1237	166	1403
11	"11-out4566"	.45098	69	84	153
11	"11-out4567"	.83802	119	23	142
11	"11-out4568"	.65346	132	70	202
11	"11-out4569"	.41763	180	251	431
11	"11-out4570"	.33067	207	419	626
11	"11-out4571"	.24084	250	788	1038
11	"11-out4572"	.30181	300	694	994
11	"11-out4573"	.51785	145	135	280
11	"11-out4574"	.28389	134	338	472
11	"11-out4575"	.25510	50	146	196
11	"11-out4576"	.67716	172	82	254
11	"11-out4577"	.21568	88	320	408
11	"11-out4578"	.22176	161	565	726
11	"11-out4579"	.44715	110	136	246
11	"11-out4580"	.30665	567	1282	1849
11	"11-out4581"	.74504	263	90	353
11	"11-out4582"	.98809	83	1	84
11	"11-out4583"	.48538	83	88	171
11	"11-out4584"	.91916	307	27	334
11	"11-out4585"	.28373	82	207	289
11	"11-out4586"	.41897	106	147	253
11	"11-out4587"	.99547	220	1	221
11	"11-out4588"	.92011	334	29	363
11	"11-out4589"	.45746	285	338	623
11	"11-out4590"	.46625	456	522	978
11	"11-out4591"	.61209	172	109	281
11	"11-out4592"	.99724	362	1	363
11	"11-out4593"	.36708	29	50	79
11	"11-out4594"	.52674	128	115	243
11	"11-out4595"	.59729	221	149	370
11	"11-out4596"	.42957	61	81	142
11	"11-out4597"	.24038	125	395	520
11	"11-out4598"	.31772	251	539	790
11	"11-out4599"	.32512	251	521	772
11	"11-out4600"	.35430	321	585	906
11	"11-out4601"	.50741	171	166	337
11	"11-out4602"	.22598	207	709	916
11	"11-out4603"	.44009	180	229	409
11	"11-out4604"	.72119	313	121	434
11	"11-out4605"	.41115	199	285	484
11	"11-out4606"	.33663	102	201	303
11	"11-out4607"	.41433	133	188	321
11	"11-out4608"	.50824	185	179	364
11	"11-out4609"	.23719	125	402	527
11	"11-out4610"	.39274	130	201	331
11	"11-out4611"	.98543	406	6	412
11	"11-out4612"	.17283	28	134	162
11	"11-out4613"	.59278	115	79	194
11	"11-out4614"	.46153	96	112	208
11	"11-out4615"	.31707	182	392	574
11	"11-out4616"	.98561	137	2	139
11	"11-out4617"	.79661	235	60	295
11	"11-out4618"	.32039	289	613	902
11	"11-out4619"	.20286	85	334	419
11	"11-out4620"	.35864	359	642	1001
11	"11-out4621"	.21073	106	397	503
11	"11-out4622"	.23456	38	124	162
11	"11-out4623"	.52238	105	96	201
11	"11-out4624"	.43236	163	214	377
11	"11-out4625"	.27483	83	219	302
11	"11-out4626"	.41773	391	545	936
11	"11-out4627"	.99657	291	1	292
11	"11-out4628"	.73643	190	68	258
11	"11-out4629"	.99663	296	1	297
11	"11-out4630"	.64492	356	196	552
11	"11-out4631"	.54786	475	392	867
11	"11-out4632"	.53333	112	98	210
11	"11-out4633"	.53286	381	334	715
11	"11-out4634"	.99736	379	1	380
11	"11-out4635"	.34358	190	363	553
11	"11-out4636"	.69436	259	114	373
11	"11-out4637"	.80078	410	102	512
11	"11-out4638"	.66153	172	88	260
11	"11-out4639"	.76007	434	137	571
11	"11-out4640"	.44791	43	53	96
11	"11-out4641"	.38144	37	60	97
11	"11-out4642"	.38582	49	78	127
11	"11-out4643"	.55477	157	126	283
11	"11-out4644"	.34688	128	241	369
11	"11-out4645"	.98947	94	1	95
11	"11-out4646"	.31818	21	45	66
11	"11-out4647"	.50251	100	99	199
11	"11-out4648"	.81693	357	80	437
11	"11-out4649"	.25567	169	492	661
11	"11-out4650"	.35416	85	155	240
11	"11-out4651"	.22656	29	99	128
11	"11-out4652"	.29501	77	184	261
11	"11-out4653"	.46546	155	178	333
11	"11-out4654"	.61994	460	282	742
11	"11-out4655"	.19298	33	138	171
11	"11-out4656"	.53617	126	109	235
11	"11-out4657"	.28285	127	322	449
11	"11-out4658"	.34673	207	390	597
11	"11-out4659"	.70984	137	56	193
11	"11-out4660"	.50000	104	104	208
11	"11-out4661"	.34608	181	342	523
11	"11-out4662"	.79133	1862	491	2353
11	"11-out4663"	.51776	1151	1072	2223
11	"11-out4664"	.45969	211	248	459
11	"11-out4665"	.31888	103	220	323
11	"11-out4666"	.30344	132	303	435
11	"11-out4667"	.95312	122	6	128
11	"11-out4668"	.39365	124	191	315
11	"11-out4669"	.36470	62	108	170
11	"11-out4670"	.31710	508	1094	1602
11	"11-out4671"	.31250	200	440	640
11	"11-out4672"	.30707	421	950	1371
11	"11-out4673"	.26666	156	429	585
11	"11-out4674"	.37647	96	159	255
11	"11-out4675"	.37160	178	301	479
11	"11-out4676"	.52727	145	130	275
11	"11-out4677"	.31438	94	205	299
11	"11-out4678"	.28942	312	766	1078
11	"11-out4679"	.99541	217	1	218
11	"11-out4680"	.42857	141	188	329
11	"11-out4681"	.95705	156	7	163
11	"11-out4682"	.29832	125	294	419
11	"11-out4683"	.30040	295	687	982
11	"11-out4684"	.26200	60	169	229
11	"11-out4685"	.21960	121	430	551
11	"11-out4686"	.21960	121	430	551
11	"11-out4687"	.25773	25	72	97
11	"11-out4688"	.51985	144	133	277
11	"11-out4689"	.45959	273	321	594
11	"11-out4690"	.59010	871	605	1476
11	"11-out4691"	.99746	394	1	395
11	"11-out4692"	.43820	117	150	267
11	"11-out4693"	.56189	817	637	1454
11	"11-out4694"	.68396	738	341	1079
11	"11-out4695"	.28082	123	315	438
11	"11-out4696"	.45161	42	51	93
11	"11-out4697"	.37313	100	168	268
11	"11-out4698"	.54963	299	245	544
11	"11-out4699"	.40892	220	318	538
11	"11-out4700"	.21319	181	668	849
11	"11-out4701"	.98352	418	7	425
11	"11-out4702"	.98901	90	1	91
11	"11-out4703"	.54406	426	357	783
11	"11-out4704"	.77718	293	84	377
11	"11-out4705"	.38519	255	407	662
11	"11-out4706"	.24422	74	229	303
11	"11-out4707"	.27906	108	279	387
11	"11-out4708"	.86363	247	39	286
11	"11-out4709"	.37093	342	580	922
11	"11-out4710"	.64670	216	118	334
11	"11-out4711"	.45061	73	89	162
11	"11-out4712"	.99074	107	1	108
11	"11-out4713"	.45299	53	64	117
11	"11-out4714"	.23250	206	680	886
11	"11-out4715"	.50781	65	63	128
11	"11-out4716"	.42634	492	662	1154
11	"11-out4717"	.53582	359	311	670
11	"11-out4718"	.26666	48	132	180
11	"11-out4719"	.34257	210	403	613
11	"11-out4720"	.39894	529	797	1326
11	"11-out4721"	.52951	583	518	1101
11	"11-out4722"	.83070	211	43	254
11	"11-out4723"	.68864	188	85	273
11	"11-out4724"	.58769	191	134	325
11	"11-out4725"	.52500	105	95	200
11	"11-out4726"	.33226	207	416	623
11	"11-out4727"	.56534	186	143	329
11	"11-out4728"	.54048	514	437	951
11	"11-out4729"	.98888	89	1	90
11	"11-out4730"	.99305	143	1	144
11	"11-out4731"	.87797	1216	169	1385
11	"11-out4732"	.93478	86	6	92
11	"11-out4733"	.47916	46	50	96
11	"11-out4734"	.43684	83	107	190
11	"11-out4735"	.29971	107	250	357
11	"11-out4736"	.31612	147	318	465
11	"11-out4737"	.36666	132	228	360
11	"11-out4738"	.57994	214	155	369
11	"11-out4739"	.50000	202	202	404
11	"11-out4740"	.98387	244	4	248
11	"11-out4741"	.49830	147	148	295
11	"11-out4742"	.97783	353	8	361
11	"11-out4743"	.45397	656	789	1445
11	"11-out4744"	.23722	65	209	274
11	"11-out4745"	.98924	92	1	93
11	"11-out4746"	.18902	31	133	164
11	"11-out4747"	.53881	118	101	219
11	"11-out4748"	.41891	155	215	370
11	"11-out4749"	.20338	48	188	236
11	"11-out4750"	.76719	290	88	378
11	"11-out4751"	.99447	360	2	362
11	"11-out4752"	.16793	22	109	131
11	"11-out4753"	.59880	100	67	167
11	"11-out4754"	.99218	127	1	128
11	"11-out4755"	.46203	359	418	777
11	"11-out4756"	.38745	766	1211	1977
11	"11-out4757"	.99344	303	2	305
11	"11-out4758"	.58133	461	332	793
11	"11-out4759"	.28181	186	474	660
11	"11-out4760"	.19072	74	314	388
11	"11-out4761"	.26436	92	256	348
11	"11-out4762"	.32601	401	829	1230
11	"11-out4763"	.29177	117	284	401
11	"11-out4764"	.25490	182	532	714
11	"11-out4765"	.29173	187	454	641
11	"11-out4766"	.45575	103	123	226
11	"11-out4767"	.23063	137	457	594
11	"11-out4768"	.29787	98	231	329
11	"11-out4769"	.42105	168	231	399
11	"11-out4770"	.87762	251	35	286
11	"11-out4771"	.74666	112	38	150
11	"11-out4772"	.56488	74	57	131
11	"11-out4773"	.32017	73	155	228
11	"11-out4774"	.59036	98	68	166
11	"11-out4775"	.31529	134	291	425
11	"11-out4776"	.15676	66	355	421
11	"11-out4777"	.28893	308	758	1066
11	"11-out4778"	.38148	169	274	443
11	"11-out4779"	.26855	123	335	458
11	"11-out4780"	.32124	62	131	193
11	"11-out4781"	.22459	84	290	374
11	"11-out4782"	.33824	826	1616	2442
11	"11-out4783"	.33403	159	317	476
11	"11-out4784"	.36460	447	779	1226
11	"11-out4785"	.31012	147	327	474
11	"11-out4786"	.99841	629	1	630
11	"11-out4787"	.99746	394	1	395
11	"11-out4788"	.98529	67	1	68
11	"11-out4789"	.36390	619	1082	1701
11	"11-out4790"	.72298	368	141	509
11	"11-out4791"	.37373	111	186	297
11	"11-out4792"	.82164	410	89	499
11	"11-out4793"	.24148	78	245	323
11	"11-out4794"	.33497	136	270	406
11	"11-out4795"	.49717	264	267	531
11	"11-out4796"	.30911	200	447	647
11	"11-out4797"	.21578	41	149	190
11	"11-out4798"	.41935	104	144	248
11	"11-out4799"	.99565	229	1	230
11	"11-out4800"	.46808	198	225	423
11	"11-out4801"	.65568	219	115	334
11	"11-out4802"	.99870	774	1	775
11	"11-out4803"	.41815	327	455	782
11	"11-out4804"	.17682	58	270	328
11	"11-out4805"	.39739	122	185	307
11	"11-out4806"	.99655	289	1	290
11	"11-out4807"	.36672	216	373	589
11	"11-out4808"	.21715	157	566	723
11	"11-out4809"	.37435	219	366	585
11	"11-out4810"	.47350	143	159	302
11	"11-out4811"	.32994	130	264	394
11	"11-out4812"	.35392	653	1192	1845
11	"11-out4813"	.60515	423	276	699
11	"11-out4814"	.41701	299	418	717
11	"11-out4815"	.28848	283	698	981
11	"11-out4816"	.56321	98	76	174
11	"11-out4817"	.30994	296	659	955
11	"11-out4818"	.42957	61	81	142
11	"11-out4819"	.96969	32	1	33
11	"11-out4820"	.24129	104	327	431
11	"11-out4821"	.31746	40	86	126
11	"11-out4822"	.07377	9	113	122
11	"11-out4823"	.99621	263	1	264
11	"11-out4824"	.98611	284	4	288
11	"11-out4825"	.85618	256	43	299
11	"11-out4826"	.70952	149	61	210
11	"11-out4827"	.52752	642	575	1217
11	"11-out4828"	.60390	340	223	563
11	"11-out4829"	.46201	444	517	961
11	"11-out4830"	.26436	69	192	261
11	"11-out4831"	.30072	83	193	276
11	"11-out4832"	.99356	772	5	777
11	"11-out4833"	.47533	106	117	223
11	"11-out4834"	.91764	312	28	340
11	"11-out4835"	.75342	110	36	146
11	"11-out4836"	.39106	280	436	716
11	"11-out4837"	.15116	39	219	258
11	"11-out4838"	.86679	436	67	503
11	"11-out4839"	.51754	59	55	114
11	"11-out4840"	.51395	313	296	609
11	"11-out4841"	.90784	729	74	803
11	"11-out4842"	.37816	388	638	1026
11	"11-out4843"	.32755	170	349	519
11	"11-out4844"	.99362	2026	13	2039
11	"11-out4845"	.99358	310	2	312
11	"11-out4846"	.42105	184	253	437
11	"11-out4847"	.99757	411	1	412
11	"11-out4848"	.48054	210	227	437
11	"11-out4849"	.86666	403	62	465
11	"11-out4850"	.67346	132	64	196
11	"11-out4851"	.70114	122	52	174
11	"11-out4852"	.32967	60	122	182
11	"11-out4853"	.67326	68	33	101
11	"11-out4854"	.48578	205	217	422
11	"11-out4855"	.80122	391	97	488
11	"11-out4856"	.89142	1798	219	2017
11	"11-out4857"	.33881	103	201	304
11	"11-out4858"	.99651	286	1	287
11	"11-out4859"	.37026	254	432	686
11	"11-out4860"	.24400	122	378	500
11	"11-out4861"	.38787	192	303	495
11	"11-out4862"	.31620	80	173	253
11	"11-out4863"	.47630	191	210	401
11	"11-out4864"	.17919	31	142	173
11	"11-out4865"	.32236	49	103	152
11	"11-out4866"	.36440	43	75	118
11	"11-out4867"	.37606	44	73	117
11	"11-out4868"	.37037	130	221	351
11	"11-out4869"	.22966	48	161	209
11	"11-out4870"	.56589	73	56	129
11	"11-out4871"	.99494	197	1	198
11	"11-out4872"	.56617	77	59	136
11	"11-out4873"	.24340	120	373	493
11	"11-out4874"	.99019	101	1	102
11	"11-out4875"	.75841	631	201	832
11	"11-out4876"	.43794	247	317	564
11	"11-out4877"	.17919	31	142	173
11	"11-out4878"	.27734	71	185	256
11	"11-out4879"	.38989	216	338	554
11	"11-out4880"	.99539	216	1	217
11	"11-out4881"	.49305	71	73	144
11	"11-out4882"	.85421	334	57	391
11	"11-out4883"	.40600	581	850	1431
11	"11-out4884"	.36439	438	764	1202
11	"11-out4885"	.89514	350	41	391
11	"11-out4886"	.54035	154	131	285
11	"11-out4887"	.55193	271	220	491
11	"11-out4888"	.17484	57	269	326
11	"11-out4889"	.85549	296	50	346
11	"11-out4890"	.99397	165	1	166
11	"11-out4891"	.99814	539	1	540
11	"11-out4892"	.34574	65	123	188
11	"11-out4893"	.54166	52	44	96
11	"11-out4894"	.51817	727	676	1403
11	"11-out4895"	.42124	230	316	546
11	"11-out4896"	.45083	353	430	783
11	"11-out4897"	.47234	632	706	1338
11	"11-out4898"	.34139	240	463	703
11	"11-out4899"	.82822	135	28	163
11	"11-out4900"	.99512	204	1	205
11	"11-out4901"	.36842	140	240	380
11	"11-out4902"	.45585	759	906	1665
11	"11-out4903"	.86250	207	33	240
11	"11-out4904"	.32188	75	158	233
11	"11-out4905"	.36633	74	128	202
11	"11-out4906"	.99393	164	1	165
11	"11-out4907"	.66367	148	75	223
11	"11-out4908"	.99009	100	1	101
11	"11-out4909"	.30314	164	377	541
11	"11-out4910"	.39506	160	245	405
11	"11-out4911"	.98913	91	1	92
11	"11-out4912"	.39516	98	150	248
11	"11-out4913"	.42735	100	134	234
11	"11-out4914"	.39910	89	134	223
11	"11-out4915"	.26589	46	127	173
11	"11-out4916"	.48684	74	78	152
11	"11-out4917"	.40840	136	197	333
11	"11-out4918"	.90127	283	31	314
11	"11-out4919"	.68888	62	28	90
11	"11-out4920"	.43859	25	32	57
11	"11-out4921"	.99805	512	1	513
11	"11-out4922"	.26168	252	711	963
11	"11-out4923"	.29330	149	359	508
11	"11-out4924"	.56329	89	69	158
11	"11-out4925"	.96730	503	17	520
11	"11-out4926"	.99798	496	1	497
11	"11-out4927"	.93103	459	34	493
11	"11-out4928"	.23091	118	393	511
11	"11-out4929"	.40023	347	520	867
11	"11-out4930"	.46640	236	270	506
11	"11-out4931"	.66003	332	171	503
11	"11-out4932"	.42217	198	271	469
11	"11-out4933"	.37719	215	355	570
11	"11-out4934"	.51272	141	134	275
11	"11-out4935"	.98571	69	1	70
11	"11-out4936"	.46564	183	210	393
11	"11-out4937"	.57718	86	63	149
11	"11-out4938"	.17206	154	741	895
11	"11-out4939"	.30524	326	742	1068
11	"11-out4940"	.35353	35	64	99
11	"11-out4941"	.83582	56	11	67
11	"11-out4942"	.41052	39	56	95
11	"11-out4943"	.45070	32	39	71
11	"11-out4944"	.70508	208	87	295
11	"11-out4945"	.31645	50	108	158
11	"11-out4946"	.28501	116	291	407
11	"11-out4947"	.33008	203	412	615
11	"11-out4948"	.66166	397	203	600
11	"11-out4949"	.95879	605	26	631
11	"11-out4950"	.31663	177	382	559
11	"11-out4951"	.38410	174	279	453
11	"11-out4952"	.45427	154	185	339
11	"11-out4953"	.68466	317	146	463
11	"11-out4954"	.19298	66	276	342
11	"11-out4955"	.53006	379	336	715
11	"11-out4956"	.44903	348	427	775
11	"11-out4957"	.48571	204	216	420
11	"11-out4958"	.22255	75	262	337
11	"11-out4959"	.65028	450	242	692
11	"11-out4960"	.75274	137	45	182
11	"11-out4961"	.10626	39	328	367
11	"11-out4962"	.79707	381	97	478
11	"11-out4963"	.83507	400	79	479
11	"11-out4964"	.22105	63	222	285
11	"11-out4965"	.37278	63	106	169
11	"11-out4966"	.75365	618	202	820
11	"11-out4967"	.25388	49	144	193
11	"11-out4968"	.30868	167	374	541
11	"11-out4969"	.22179	116	407	523
11	"11-out4970"	.33750	54	106	160
11	"11-out4971"	.38235	52	84	136
11	"11-out4972"	.98850	86	1	87
11	"11-out4973"	.30434	21	48	69
11	"11-out4974"	.21052	16	60	76
11	"11-out4975"	.99820	557	1	558
11	"11-out4976"	.26872	122	332	454
11	"11-out4977"	.48888	242	253	495
11	"11-out4978"	.32059	302	640	942
11	"11-out4979"	.23378	173	567	740
11	"11-out4980"	.24382	158	490	648
11	"11-out4981"	.25280	45	133	178
11	"11-out4982"	.29569	55	131	186
11	"11-out4983"	.38598	369	587	956
11	"11-out4984"	.35978	467	831	1298
11	"11-out4985"	.27272	42	112	154
11	"11-out4986"	.98571	69	1	70
11	"11-out4987"	.67213	41	20	61
11	"11-out4988"	.52238	35	32	67
11	"11-out4989"	.31891	118	252	370
11	"11-out4990"	.30484	107	244	351
11	"11-out4991"	.61744	531	329	860
11	"11-out4992"	.88951	1586	197	1783
11	"11-out4993"	.84482	539	99	638
11	"11-out4994"	.31615	184	398	582
11	"11-out4995"	.44923	146	179	325
11	"11-out4996"	.24000	72	228	300
11	"11-out4997"	.99734	375	1	376
11	"11-out4998"	.98461	64	1	65
11	"11-out4999"	.99604	755	3	758
11	"11-out5000"	.46994	86	97	183
11	"11-out5001"	.36867	153	262	415
11	"11-out5002"	.08823	9	93	102
11	"11-out5003"	.52845	65	58	123
11	"11-out5004"	.98484	65	1	66
11	"11-out5005"	.25641	20	58	78
11	"11-out5006"	.99358	155	1	156
11	"11-out5007"	.36036	40	71	111
11	"11-out5008"	.99324	147	1	148
11	"11-out5009"	.49367	195	200	395
11	"11-out5010"	.34007	185	359	544
11	"11-out5011"	.91235	406	39	445
11	"11-out5012"	.54769	178	147	325
11	"11-out5013"	.46231	276	321	597
11	"11-out5014"	.27314	59	157	216
11	"11-out5015"	.41538	216	304	520
11	"11-out5016"	.20346	47	184	231
11	"11-out5017"	.49568	747	760	1507
11	"11-out5018"	.49789	237	239	476
11	"11-out5019"	.26330	381	1066	1447
11	"11-out5020"	.24341	157	488	645
11	"11-out5021"	.18918	49	210	259
11	"11-out5022"	.26381	105	293	398
11	"11-out5023"	.32653	32	66	98
11	"11-out5024"	.37242	416	701	1117
11	"11-out5025"	.58282	95	68	163
11	"11-out5026"	.98760	239	3	242
11	"11-out5027"	.42257	161	220	381
11	"11-out5028"	.41988	228	315	543
11	"11-out5029"	.99761	419	1	420
11	"11-out5030"	.28741	169	419	588
11	"11-out5031"	.61428	172	108	280
11	"11-out5032"	.36283	41	72	113
11	"11-out5033"	.36891	273	467	740
11	"11-out5034"	.99865	743	1	744
11	"11-out5035"	.99794	485	1	486
11	"11-out5036"	.99827	578	1	579
11	"11-out5037"	.92284	622	52	674
11	"11-out5038"	.29534	127	303	430
11	"11-out5039"	.28041	401	1029	1430
11	"11-out5040"	.73271	477	174	651
11	"11-out5041"	.56896	198	150	348
11	"11-out5042"	.33756	133	261	394
11	"11-out5043"	.99487	194	1	195
11	"11-out5044"	.99737	380	1	381
11	"11-out5045"	.48189	173	186	359
11	"11-out5046"	.65341	411	218	629
11	"11-out5047"	.40707	46	67	113
11	"11-out5048"	.99386	162	1	163
11	"11-out5049"	.34545	266	504	770
11	"11-out5050"	.31000	124	276	400
11	"11-out5051"	.45231	460	557	1017
11	"11-out5052"	.82269	116	25	141
11	"11-out5053"	.50092	271	270	541
11	"11-out5054"	.99763	421	1	422
11	"11-out5055"	.33492	280	556	836
11	"11-out5056"	.99883	854	1	855
11	"11-out5057"	.99270	136	1	137
11	"11-out5058"	.39117	266	414	680
11	"11-out5059"	.39118	444	691	1135
11	"11-out5060"	.34845	192	359	551
11	"11-out5061"	.61333	138	87	225
11	"11-out5062"	.60436	249	163	412
11	"11-out5063"	.37017	144	245	389
11	"11-out5064"	.91292	346	33	379
11	"11-out5065"	.26122	291	823	1114
11	"11-out5066"	.46461	151	174	325
11	"11-out5067"	.69837	301	130	431
11	"11-out5068"	.50424	178	175	353
11	"11-out5069"	.38285	67	108	175
11	"11-out5070"	.73684	154	55	209
11	"11-out5071"	.56451	105	81	186
11	"11-out5072"	.39759	66	100	166
11	"11-out5073"	.99275	137	1	138
11	"11-out5074"	.41707	254	355	609
11	"11-out5075"	.48175	396	426	822
11	"11-out5076"	.15139	38	213	251
11	"11-out5077"	.30315	144	331	475
11	"11-out5078"	.44473	515	643	1158
11	"11-out5079"	.40551	294	431	725
11	"11-out5080"	.39651	182	277	459
11	"11-out5081"	.47368	117	130	247
11	"11-out5082"	.87896	443	61	504
11	"11-out5083"	.58737	121	85	206
11	"11-out5084"	.99090	327	3	330
11	"11-out5085"	.60421	487	319	806
11	"11-out5086"	.67532	364	175	539
11	"11-out5087"	.92538	1079	87	1166
11	"11-out5088"	.20823	91	346	437
11	"11-out5089"	.31364	361	790	1151
11	"11-out5090"	.33730	198	389	587
11	"11-out5091"	.62739	229	136	365
11	"11-out5092"	.41269	156	222	378
11	"11-out5093"	.33027	252	511	763
11	"11-out5094"	.97878	323	7	330
11	"11-out5095"	.24800	218	661	879
11	"11-out5096"	.30708	156	352	508
11	"11-out5097"	.38414	189	303	492
11	"11-out5098"	.28841	914	2255	3169
11	"11-out5099"	.56848	469	356	825
11	"11-out5100"	.42807	244	326	570
11	"11-out5101"	.31504	155	337	492
11	"11-out5102"	.10642	53	445	498
11	"11-out5103"	.40566	215	315	530
11	"11-out5104"	.97500	195	5	200
11	"11-out5105"	.37096	69	117	186
11	"11-out5106"	.32640	110	227	337
11	"11-out5107"	.19422	74	307	381
11	"11-out5108"	.99180	121	1	122
11	"11-out5109"	.33671	166	327	493
11	"11-out5110"	.49083	455	472	927
11	"11-out5111"	.64210	671	374	1045
11	"11-out5112"	.28821	181	447	628
11	"11-out5113"	.23206	165	546	711
11	"11-out5114"	.81914	154	34	188
11	"11-out5115"	.40760	150	218	368
11	"11-out5116"	.46304	213	247	460
11	"11-out5117"	.71198	309	125	434
11	"11-out5118"	.41000	123	177	300
11	"11-out5119"	.37878	125	205	330
11	"11-out5120"	.97398	337	9	346
11	"11-out5121"	.46153	174	203	377
11	"11-out5122"	.35036	288	534	822
11	"11-out5123"	.74226	144	50	194
11	"11-out5124"	.39943	564	848	1412
11	"11-out5125"	.72677	133	50	183
11	"11-out5126"	.99502	200	1	201
11	"11-out5127"	.75449	1804	587	2391
11	"11-out5128"	.33644	144	284	428
11	"11-out5129"	.23670	89	287	376
11	"11-out5130"	.28103	206	527	733
11	"11-out5131"	.37645	678	1123	1801
11	"11-out5132"	.61656	201	125	326
11	"11-out5133"	.33499	202	401	603
11	"11-out5134"	.48493	177	188	365
11	"11-out5135"	.99803	507	1	508
11	"11-out5136"	.17311	85	406	491
11	"11-out5137"	.43582	163	211	374
11	"11-out5138"	.30975	902	2010	2912
11	"11-out5139"	.89237	597	72	669
11	"11-out5140"	.35942	326	581	907
11	"11-out5141"	.99826	577	1	578
11	"11-out5142"	.91036	518	51	569
11	"11-out5143"	.79190	137	36	173
11	"11-out5144"	.33234	224	450	674
11	"11-out5145"	.86746	144	22	166
11	"11-out5146"	.66253	214	109	323
11	"11-out5147"	.24769	591	1795	2386
11	"11-out5148"	.53225	264	232	496
11	"11-out5149"	.47260	138	154	292
11	"11-out5150"	.40458	106	156	262
11	"11-out5151"	.60951	743	476	1219
11	"11-out5152"	.97192	554	16	570
11	"11-out5153"	.72767	163	61	224
11	"11-out5154"	.98876	88	1	89
11	"11-out5155"	.25855	136	390	526
11	"11-out5156"	.99557	225	1	226
11	"11-out5157"	.58431	149	106	255
11	"11-out5158"	.98353	239	4	243
11	"11-out5159"	.57564	312	230	542
11	"11-out5160"	.29117	99	241	340
11	"11-out5161"	.37421	1379	2306	3685
11	"11-out5162"	.26797	1103	3013	4116
11	"11-out5163"	.31812	1471	3153	4624
11	"11-out5164"	.25419	1181	3465	4646
11	"11-out5165"	.38791	244	385	629
11	"11-out5166"	.55774	1956	1551	3507
11	"11-out5167"	.21630	130	471	601
11	"11-out5168"	.36538	190	330	520
11	"11-out5169"	.22647	77	263	340
11	"11-out5170"	.65842	293	152	445
11	"11-out5171"	.34453	164	312	476
11	"11-out5172"	.72000	234	91	325
11	"11-out5173"	.99612	257	1	258
11	"11-out5174"	.35972	259	461	720
11	"11-out5175"	.30165	200	463	663
11	"11-out5176"	.86093	551	89	640
11	"11-out5177"	.46851	186	211	397
11	"11-out5178"	.50318	158	156	314
11	"11-out5179"	.30538	102	232	334
11	"11-out5180"	.30046	195	454	649
11	"11-out5181"	.47050	319	359	678
11	"11-out5182"	.27297	202	538	740
11	"11-out5183"	.99606	253	1	254
11	"11-out5184"	.65814	206	107	313
11	"11-out5185"	.42250	199	272	471
11	"11-out5186"	.43233	230	302	532
11	"11-out5187"	.37383	120	201	321
11	"11-out5188"	.24299	104	324	428
11	"11-out5189"	.89542	411	48	459
11	"11-out5190"	.51351	114	108	222
11	"11-out5191"	.40478	491	722	1213
11	"11-out5192"	.55632	958	764	1722
11	"11-out5193"	.33517	364	722	1086
11	"11-out5194"	.22701	121	412	533
11	"11-out5195"	.96380	426	16	442
11	"11-out5196"	.28125	63	161	224
11	"11-out5197"	.52114	530	487	1017
11	"11-out5198"	.80815	813	193	1006
11	"11-out5199"	.80000	396	99	495
11	"11-out5200"	.59130	204	141	345
11	"11-out5201"	.99888	1792	2	1794
11	"11-out5202"	.26105	537	1520	2057
11	"11-out5203"	.30963	575	1282	1857
11	"11-out5204"	.94850	350	19	369
11	"11-out5205"	.38356	112	180	292
11	"11-out5206"	.49382	320	328	648
11	"11-out5207"	.32882	170	347	517
11	"11-out5208"	.99331	297	2	299
11	"11-out5209"	.31694	419	903	1322
11	"11-out5210"	.55813	192	152	344
11	"11-out5211"	.87724	293	41	334
11	"11-out5212"	.30769	124	279	403
11	"11-out5213"	.27254	133	355	488
11	"11-out5214"	.35775	166	298	464
11	"11-out5215"	.40761	289	420	709
11	"11-out5216"	.99651	286	1	287
11	"11-out5217"	.24965	179	538	717
11	"11-out5218"	.37984	147	240	387
11	"11-out5219"	.44283	306	385	691
11	"11-out5220"	.09968	32	289	321
11	"11-out5221"	.33698	277	545	822
11	"11-out5222"	.29857	63	148	211
11	"11-out5223"	.41627	440	617	1057
11	"11-out5224"	.29411	115	276	391
11	"11-out5225"	.16009	65	341	406
11	"11-out5226"	.47210	110	123	233
11	"11-out5227"	.32653	48	99	147
11	"11-out5228"	.54838	102	84	186
11	"11-out5229"	.19650	90	368	458
11	"11-out5230"	.99387	649	4	653
11	"11-out5231"	.46794	146	166	312
11	"11-out5232"	.68750	154	70	224
11	"11-out5233"	.23655	66	213	279
11	"11-out5234"	.33371	289	577	866
11	"11-out5235"	.29506	293	700	993
11	"11-out5236"	.69908	992	427	1419
11	"11-out5237"	.99724	362	1	363
11	"11-out5238"	.43354	274	358	632
11	"11-out5239"	.44008	213	271	484
11	"11-out5240"	.50000	104	104	208
11	"11-out5241"	.61756	218	135	353
11	"11-out5242"	.37597	288	478	766
11	"11-out5243"	.17266	72	345	417
11	"11-out5244"	.85990	178	29	207
11	"11-out5245"	.47280	113	126	239
11	"11-out5246"	.26408	75	209	284
11	"11-out5247"	.25480	53	155	208
11	"11-out5248"	.30816	253	568	821
11	"11-out5249"	.99696	329	1	330
11	"11-out5250"	.44181	505	638	1143
11	"11-out5251"	.37527	170	283	453
11	"11-out5252"	.58581	256	181	437
11	"11-out5253"	.37777	187	308	495
11	"11-out5254"	.21355	271	998	1269
11	"11-out5255"	.22123	25	88	113
11	"11-out5256"	.23991	113	358	471
11	"11-out5257"	.21981	142	504	646
11	"11-out5258"	.93220	165	12	177
11	"11-out5259"	.99319	146	1	147
11	"11-out5260"	.61715	295	183	478
11	"11-out5261"	.22550	168	577	745
11	"11-out5262"	.40246	326	484	810
11	"11-out5263"	.97737	216	5	221
11	"11-out5264"	.96296	104	4	108
11	"11-out5265"	.64220	210	117	327
11	"11-out5266"	.34490	159	302	461
11	"11-out5267"	.29577	42	100	142
11	"11-out5268"	.32894	175	357	532
11	"11-out5269"	.98876	88	1	89
11	"11-out5270"	.35116	361	667	1028
11	"11-out5271"	.45954	142	167	309
11	"11-out5272"	.88910	449	56	505
11	"11-out5273"	.37714	132	218	350
11	"11-out5274"	.74678	174	59	233
11	"11-out5275"	.88095	185	25	210
11	"11-out5276"	.96420	404	15	419
11	"11-out5277"	.70204	344	146	490
11	"11-out5278"	.93421	355	25	380
11	"11-out5279"	.63529	108	62	170
11	"11-out5280"	.34156	83	160	243
11	"11-out5281"	.47264	691	771	1462
11	"11-out5282"	.57004	118	89	207
11	"11-out5283"	.38425	83	133	216
11	"11-out5284"	.28358	76	192	268
11	"11-out5285"	.32388	377	787	1164
11	"11-out5286"	.64516	100	55	155
11	"11-out5287"	.48815	103	108	211
11	"11-out5288"	.31891	59	126	185
11	"11-out5289"	.24742	144	438	582
11	"11-out5290"	.51851	56	52	108
11	"11-out5291"	.18338	64	285	349
11	"11-out5292"	.22345	101	351	452
11	"11-out5293"	.98876	88	1	89
11	"11-out5294"	.29861	43	101	144
11	"11-out5295"	.96620	486	17	503
11	"11-out5296"	.76363	714	221	935
11	"11-out5297"	.29249	74	179	253
11	"11-out5298"	.35102	86	159	245
11	"11-out5299"	.40209	345	513	858
11	"11-out5300"	.65349	215	114	329
11	"11-out5301"	.37050	103	175	278
11	"11-out5302"	.36332	105	184	289
11	"11-out5303"	.57286	114	85	199
11	"11-out5304"	.05325	9	160	169
11	"11-out5305"	.12637	23	159	182
11	"11-out5306"	.99193	123	1	124
11	"11-out5307"	.63448	92	53	145
11	"11-out5308"	.29677	46	109	155
11	"11-out5309"	.99931	1467	1	1468
11	"11-out5310"	.33088	90	182	272
11	"11-out5311"	.41631	199	279	478
11	"11-out5312"	.39408	80	123	203
11	"11-out5313"	.51197	1283	1223	2506
11	"11-out5314"	.38181	84	136	220
11	"11-out5315"	.38862	909	1430	2339
11	"11-out5316"	.17215	136	654	790
11	"11-out5317"	.47696	176	193	369
11	"11-out5318"	.34246	75	144	219
11	"11-out5319"	.27409	219	580	799
11	"11-out5320"	.45177	370	449	819
11	"11-out5321"	.34984	219	407	626
11	"11-out5322"	.43539	155	201	356
11	"11-out5323"	.24695	81	247	328
11	"11-out5324"	.34180	121	233	354
11	"11-out5325"	.47756	149	163	312
11	"11-out5326"	.25974	80	228	308
11	"11-out5327"	.37569	68	113	181
11	"11-out5328"	.94531	363	21	384
11	"11-out5329"	.40939	61	88	149
11	"11-out5330"	.91789	436	39	475
11	"11-out5331"	.46283	137	159	296
11	"11-out5332"	.31529	169	367	536
11	"11-out5333"	.32764	96	197	293
11	"11-out5334"	.30678	104	235	339
11	"11-out5335"	.97468	77	2	79
11	"11-out5336"	.40499	211	310	521
11	"11-out5337"	.42010	234	323	557
11	"11-out5338"	.36933	106	181	287
11	"11-out5339"	.75975	253	80	333
11	"11-out5340"	.35381	167	305	472
11	"11-out5341"	.41772	198	276	474
11	"11-out5342"	.31205	44	97	141
11	"11-out5343"	.22388	120	416	536
11	"11-out5344"	.51659	249	233	482
11	"11-out5345"	.21845	116	415	531
11	"11-out5346"	.39763	202	306	508
11	"11-out5347"	.51779	320	298	618
11	"11-out5348"	.99756	410	1	411
11	"11-out5349"	.44785	146	180	326
11	"11-out5350"	.29158	142	345	487
11	"11-out5351"	.20750	260	993	1253
11	"11-out5352"	.37231	156	263	419
11	"11-out5353"	.46212	61	71	132
11	"11-out5354"	.69313	323	143	466
11	"11-out5355"	.67476	361	174	535
11	"11-out5356"	.38888	147	231	378
11	"11-out5357"	.35899	415	741	1156
11	"11-out5358"	.36487	347	604	951
11	"11-out5359"	.57983	138	100	238
11	"11-out5360"	.35582	232	420	652
11	"11-out5361"	.30894	76	170	246
11	"11-out5362"	.23809	60	192	252
11	"11-out5363"	.31622	154	333	487
11	"11-out5364"	.40740	660	960	1620
11	"11-out5365"	.28141	318	812	1130
11	"11-out5366"	.21631	236	855	1091
11	"11-out5367"	.15841	16	85	101
11	"11-out5368"	.99487	194	1	195
11	"11-out5369"	.99526	210	1	211
11	"11-out5370"	.41617	355	498	853
11	"11-out5371"	.36994	64	109	173
11	"11-out5372"	.29251	258	624	882
11	"11-out5373"	.24716	829	2525	3354
11	"11-out5374"	.43946	196	250	446
11	"11-out5375"	.99828	583	1	584
11	"11-out5376"	.99367	157	1	158
11	"11-out5377"	.32539	41	85	126
11	"11-out5378"	.99365	313	2	315
11	"11-out5379"	.38389	367	589	956
11	"11-out5380"	.62432	349	210	559
11	"11-out5381"	.35532	280	508	788
11	"11-out5382"	.38511	119	190	309
11	"11-out5383"	.56825	179	136	315
11	"11-out5384"	.34732	91	171	262
11	"11-out5385"	.81572	664	150	814
11	"11-out5386"	.21676	75	271	346
11	"11-out5387"	.55314	255	206	461
11	"11-out5388"	.19760	99	402	501
11	"11-out5389"	.99679	1245	4	1249
11	"11-out5390"	.26693	67	184	251
11	"11-out5391"	.98888	89	1	90
11	"11-out5392"	.84757	367	66	433
11	"11-out5393"	.51944	414	383	797
11	"11-out5394"	.86363	209	33	242
11	"11-out5395"	.28365	118	298	416
11	"11-out5396"	.25280	45	133	178
11	"11-out5397"	.77163	544	161	705
11	"11-out5398"	.35308	143	262	405
11	"11-out5399"	.54022	141	120	261
11	"11-out5400"	.34096	149	288	437
11	"11-out5401"	.44444	56	70	126
11	"11-out5402"	.85950	208	34	242
11	"11-out5403"	.41039	371	533	904
11	"11-out5404"	.35866	269	481	750
11	"11-out5405"	.40048	982	1470	2452
11	"11-out5406"	.49462	138	141	279
11	"11-out5407"	.58458	273	194	467
11	"11-out5408"	.65825	522	271	793
11	"11-out5409"	.28067	167	428	595
11	"11-out5410"	.51483	347	327	674
11	"11-out5411"	.98360	180	3	183
11	"11-out5412"	.24904	195	588	783
11	"11-out5413"	.98543	203	3	206
11	"11-out5414"	.28735	50	124	174
11	"11-out5415"	.99658	292	1	293
11	"11-out5416"	.20701	59	226	285
11	"11-out5417"	.45561	272	325	597
11	"11-out5418"	.80623	853	205	1058
11	"11-out5419"	.55371	67	54	121
11	"11-out5420"	.98958	95	1	96
11	"11-out5421"	.99206	125	1	126
11	"11-out5422"	.27510	63	166	229
11	"11-out5423"	.38388	243	390	633
11	"11-out5424"	.29573	194	462	656
11	"11-out5425"	.39306	873	1348	2221
11	"11-out5426"	.34014	283	549	832
11	"11-out5427"	.30982	246	548	794
11	"11-out5428"	.36911	306	523	829
11	"11-out5429"	.36000	252	448	700
11	"11-out5430"	.36549	250	434	684
11	"11-out5431"	.34663	469	884	1353
11	"11-out5432"	.34142	394	760	1154
11	"11-out5433"	.99561	227	1	228
11	"11-out5434"	.87128	352	52	404
11	"11-out5435"	.21978	40	142	182
11	"11-out5436"	.23582	79	256	335
11	"11-out5437"	.40765	309	449	758
11	"11-out5438"	.37243	127	214	341
11	"11-out5439"	.51531	488	459	947
11	"11-out5440"	.94117	496	31	527
11	"11-out5441"	.49199	215	222	437
11	"11-out5442"	.99838	1235	2	1237
11	"11-out5443"	.85907	317	52	369
11	"11-out5444"	.85164	310	54	364
11	"11-out5445"	.31132	99	219	318
11	"11-out5446"	.31104	214	474	688
11	"11-out5447"	.71954	254	99	353
11	"11-out5448"	.20158	51	202	253
11	"11-out5449"	.75527	179	58	237
11	"11-out5450"	.40816	60	87	147
11	"11-out5451"	.50819	93	90	183
11	"11-out5452"	.39002	133	208	341
11	"11-out5453"	.45116	97	118	215
11	"11-out5454"	.36015	94	167	261
11	"11-out5455"	.29657	234	555	789
11	"11-out5456"	.33124	422	852	1274
11	"11-out5457"	.31658	126	272	398
11	"11-out5458"	.32134	134	283	417
11	"11-out5459"	.31668	260	561	821
11	"11-out5460"	.32735	219	450	669
11	"11-out5461"	.31095	403	893	1296
11	"11-out5462"	.49003	492	512	1004
11	"11-out5463"	.15101	193	1085	1278
11	"11-out5464"	.39915	190	286	476
11	"11-out5465"	.27126	287	771	1058
11	"11-out5466"	.85604	666	112	778
11	"11-out5467"	.37624	678	1124	1802
11	"11-out5468"	.99601	250	1	251
11	"11-out5469"	.84329	409	76	485
11	"11-out5470"	.49809	262	264	526
11	"11-out5471"	.99808	522	1	523
11	"11-out5472"	.99829	585	1	586
11	"11-out5473"	.57142	56	42	98
11	"11-out5474"	.99408	168	1	169
11	"11-out5475"	.98979	97	1	98
11	"11-out5476"	.54961	144	118	262
11	"11-out5477"	.99949	1981	1	1982
11	"11-out5478"	.55351	181	146	327
11	"11-out5479"	.62880	227	134	361
11	"11-out5480"	.36082	70	124	194
11	"11-out5481"	.41044	55	79	134
11	"11-out5482"	.99462	185	1	186
11	"11-out5483"	.38695	445	705	1150
11	"11-out5484"	.40363	111	164	275
11	"11-out5485"	.42632	353	475	828
11	"11-out5486"	.24120	192	604	796
11	"11-out5487"	.99859	712	1	713
11	"11-out5488"	.44467	1057	1320	2377
11	"11-out5489"	.56184	268	209	477
11	"11-out5490"	.36755	247	425	672
11	"11-out5491"	.29276	178	430	608
11	"11-out5492"	.25179	210	624	834
11	"11-out5493"	.30118	153	355	508
11	"11-out5494"	.18155	124	559	683
11	"11-out5495"	.92567	137	11	148
11	"11-out5496"	.31718	144	310	454
11	"11-out5497"	.31759	74	159	233
11	"11-out5498"	.37500	120	200	320
11	"11-out5499"	.32567	326	675	1001
11	"11-out5500"	.98417	311	5	316
11	"11-out5501"	.47692	124	136	260
11	"11-out5502"	.99929	1426	1	1427
11	"11-out5503"	.98011	493	10	503
11	"11-out5504"	.99290	140	1	141
11	"11-out5505"	.41844	608	845	1453
11	"11-out5506"	.65505	188	99	287
11	"11-out5507"	.97457	115	3	118
11	"11-out5508"	.29326	61	147	208
11	"11-out5509"	.94545	104	6	110
11	"11-out5510"	.36000	261	464	725
11	"11-out5511"	.28187	84	214	298
11	"11-out5512"	.50471	107	105	212
11	"11-out5513"	.33466	168	334	502
11	"11-out5514"	.98837	85	1	86
11	"11-out5515"	.30948	173	386	559
11	"11-out5516"	.44662	159	197	356
11	"11-out5517"	.41280	187	266	453
11	"11-out5518"	.50895	199	192	391
11	"11-out5519"	.62130	315	192	507
11	"11-out5520"	.33583	134	265	399
11	"11-out5521"	.46108	628	734	1362
11	"11-out5522"	.36792	117	201	318
11	"11-out5523"	.38686	159	252	411
11	"11-out5524"	.30788	371	834	1205
11	"11-out5525"	.55952	141	111	252
11	"11-out5526"	.57155	647	485	1132
11	"11-out5527"	.87157	414	61	475
11	"11-out5528"	.99399	331	2	333
11	"11-out5529"	.36326	89	156	245
11	"11-out5530"	.41441	92	130	222
11	"11-out5531"	.40851	288	417	705
11	"11-out5532"	.36896	107	183	290
11	"11-out5533"	.22448	132	456	588
11	"11-out5534"	.39189	232	360	592
11	"11-out5535"	.48275	1120	1200	2320
11	"11-out5536"	.38593	719	1144	1863
11	"11-out5537"	.27284	209	557	766
11	"11-out5538"	.72761	382	143	525
11	"11-out5539"	.99560	453	2	455
11	"11-out5540"	.99656	290	1	291
11	"11-out5541"	.26086	132	374	506
11	"11-out5542"	.22336	65	226	291
11	"11-out5543"	.23177	89	295	384
11	"11-out5544"	.36802	198	340	538
11	"11-out5545"	.99399	331	2	333
11	"11-out5546"	.50782	454	440	894
11	"11-out5547"	.60332	254	167	421
11	"11-out5548"	.41666	290	406	696
11	"11-out5549"	.44751	1053	1300	2353
11	"11-out5550"	.41300	413	587	1000
11	"11-out5551"	.37947	159	260	419
11	"11-out5552"	.28285	99	251	350
11	"11-out5553"	.31046	353	784	1137
11	"11-out5554"	.30653	61	138	199
11	"11-out5555"	.62650	52	31	83
11	"11-out5556"	.35714	45	81	126
11	"11-out5557"	.67750	271	129	400
11	"11-out5558"	.49259	133	137	270
11	"11-out5559"	.99736	379	1	380
11	"11-out5560"	.34298	237	454	691
11	"11-out5561"	.37974	150	245	395
11	"11-out5562"	.32657	161	332	493
11	"11-out5563"	.30869	714	1599	2313
11	"11-out5564"	.36778	306	526	832
11	"11-out5565"	.27828	123	319	442
11	"11-out5566"	.29530	44	105	149
11	"11-out5567"	.40939	61	88	149
11	"11-out5568"	.35862	534	955	1489
11	"11-out5569"	.50230	109	108	217
11	"11-out5570"	.40324	298	441	739
11	"11-out5571"	.41304	209	297	506
11	"11-out5572"	.46592	335	384	719
11	"11-out5573"	.37884	308	505	813
11	"11-out5574"	.42674	300	403	703
11	"11-out5575"	.33768	233	457	690
11	"11-out5576"	.44705	76	94	170
11	"11-out5577"	.37376	265	444	709
11	"11-out5578"	.34427	388	739	1127
11	"11-out5579"	.37184	103	174	277
11	"11-out5580"	.41375	427	605	1032
11	"11-out5581"	.34894	216	403	619
11	"11-out5582"	.85460	241	41	282
11	"11-out5583"	.31303	221	485	706
11	"11-out5584"	.66666	172	86	258
11	"11-out5585"	.38978	145	227	372
11	"11-out5586"	.46537	289	332	621
11	"11-out5587"	.38461	240	384	624
11	"11-out5588"	.15985	43	226	269
11	"11-out5589"	.21399	52	191	243
11	"11-out5590"	.69918	86	37	123
11	"11-out5591"	.57679	169	124	293
11	"11-out5592"	.36734	36	62	98
11	"11-out5593"	.99200	124	1	125
11	"11-out5594"	.60555	109	71	180
11	"11-out5595"	.56637	64	49	113
11	"11-out5596"	.29144	647	1573	2220
11	"11-out5597"	.42883	473	630	1103
11	"11-out5598"	.31611	153	331	484
11	"11-out5599"	.80000	88	22	110
11	"11-out5600"	.26841	215	586	801
11	"11-out5601"	.18471	145	640	785
11	"11-out5602"	.30124	651	1510	2161
11	"11-out5603"	.38109	125	203	328
11	"11-out5604"	.28197	97	247	344
11	"11-out5605"	.33121	104	210	314
11	"11-out5606"	.33461	87	173	260
11	"11-out5607"	.20989	174	655	829
11	"11-out5608"	.54258	172	145	317
11	"11-out5609"	.26785	210	574	784
11	"11-out5610"	.58156	82	59	141
11	"11-out5611"	.29951	561	1312	1873
11	"11-out5612"	.49446	134	137	271
11	"11-out5613"	.24080	144	454	598
11	"11-out5614"	.36734	72	124	196
11	"11-out5615"	.29452	43	103	146
11	"11-out5616"	.86614	110	17	127
11	"11-out5617"	.37795	192	316	508
11	"11-out5618"	.35598	440	796	1236
11	"11-out5619"	.96132	1044	42	1086
11	"11-out5620"	.36051	168	298	466
11	"11-out5621"	.98561	411	6	417
11	"11-out5622"	.45693	191	227	418
11	"11-out5623"	.30358	398	913	1311
11	"11-out5624"	.99137	115	1	116
11	"11-out5625"	.99145	116	1	117
11	"11-out5626"	.99849	665	1	666
11	"11-out5627"	.38788	365	576	941
11	"11-out5628"	.99849	665	1	666
11	"11-out5629"	.46250	74	86	160
11	"11-out5630"	.24528	39	120	159
11	"11-out5631"	.33034	184	373	557
11	"11-out5632"	.99404	167	1	168
11	"11-out5633"	.30498	208	474	682
11	"11-out5634"	.43333	884	1156	2040
11	"11-out5635"	.31578	654	1417	2071
11	"11-out5636"	.46875	225	255	480
11	"11-out5637"	.34279	157	301	458
11	"11-out5638"	.57174	259	194	453
11	"11-out5639"	.43907	209	267	476
11	"11-out5640"	.39583	95	145	240
11	"11-out5641"	.99354	154	1	155
11	"11-out5642"	.57517	482	356	838
11	"11-out5643"	.69855	241	104	345
11	"11-out5644"	.19015	85	362	447
11	"11-out5645"	.36314	203	356	559
11	"11-out5646"	.48469	95	101	196
11	"11-out5647"	.26859	65	177	242
11	"11-out5648"	.36887	128	219	347
11	"11-out5649"	.97435	114	3	117
11	"11-out5650"	.97142	34	1	35
11	"11-out5651"	.42622	104	140	244
11	"11-out5652"	.18357	114	507	621
11	"11-out5653"	.27019	97	262	359
11	"11-out5654"	.28638	122	304	426
11	"11-out5655"	.49779	226	228	454
11	"11-out5656"	.27419	153	405	558
11	"11-out5657"	.27044	86	232	318
11	"11-out5658"	.25664	309	895	1204
11	"11-out5659"	.33949	643	1251	1894
11	"11-out5660"	.41880	98	136	234
11	"11-out5661"	.65094	138	74	212
11	"11-out5662"	.27160	88	236	324
11	"11-out5663"	.82640	457	96	553
11	"11-out5664"	.38157	145	235	380
11	"11-out5665"	.61403	245	154	399
11	"11-out5666"	.64627	243	133	376
11	"11-out5667"	.39558	269	411	680
11	"11-out5668"	.69534	194	85	279
11	"11-out5669"	.23404	242	792	1034
11	"11-out5670"	.99428	174	1	175
11	"11-out5671"	.55133	145	118	263
11	"11-out5672"	.93488	201	14	215
11	"11-out5673"	.45551	599	716	1315
11	"11-out5674"	.33426	120	239	359
11	"11-out5675"	.48409	137	146	283
11	"11-out5676"	.90967	282	28	310
11	"11-out5677"	.21969	261	927	1188
11	"11-out5678"	.99570	232	1	233
11	"11-out5679"	.37464	133	222	355
11	"11-out5680"	.38031	170	277	447
11	"11-out5681"	.41935	65	90	155
11	"11-out5682"	.25295	107	316	423
11	"11-out5683"	.30933	275	614	889
11	"11-out5684"	.48773	358	376	734
11	"11-out5685"	.95959	190	8	198
11	"11-out5686"	.44712	241	298	539
11	"11-out5687"	.47781	140	153	293
11	"11-out5688"	.38189	270	437	707
11	"11-out5689"	.36120	216	382	598
11	"11-out5690"	.34893	82	153	235
11	"11-out5691"	.99428	174	1	175
11	"11-out5692"	.21060	139	521	660
11	"11-out5693"	.18489	120	529	649
11	"11-out5694"	.45490	116	139	255
11	"11-out5695"	.18023	31	141	172
11	"11-out5696"	.35914	218	389	607
11	"11-out5697"	.98709	459	6	465
11	"11-out5698"	.98557	410	6	416
11	"11-out5699"	.45660	242	288	530
11	"11-out5700"	.51428	72	68	140
11	"11-out5701"	.50000	163	163	326
11	"11-out5702"	.99137	115	1	116
11	"11-out5703"	.99090	109	1	110
11	"11-out5704"	.29043	167	408	575
11	"11-out5705"	.38793	45	71	116
11	"11-out5706"	.99850	666	1	667
11	"11-out5707"	.43839	153	196	349
11	"11-out5708"	.63836	203	115	318
11	"11-out5709"	.99425	173	1	174
11	"11-out5710"	.41211	279	398	677
11	"11-out5711"	.62215	410	249	659
11	"11-out5712"	.45014	158	193	351
11	"11-out5713"	.27220	1091	2917	4008
11	"11-out5714"	.97095	468	14	482
11	"11-out5715"	.43410	56	73	129
11	"11-out5716"	.25335	189	557	746
11	"11-out5717"	.55963	61	48	109
11	"11-out5718"	.99798	495	1	496
11	"11-out5719"	.22077	68	240	308
11	"11-out5720"	.99791	478	1	479
11	"11-out5721"	.18713	128	556	684
11	"11-out5722"	.40229	35	52	87
11	"11-out5723"	.99438	177	1	178
11	"11-out5724"	.73684	70	25	95
11	"11-out5725"	.28869	166	409	575
11	"11-out5726"	.41336	198	281	479
11	"11-out5727"	.32602	119	246	365
11	"11-out5728"	.99849	665	1	666
11	"11-out5729"	.97797	444	10	454
11	"11-out5730"	.30635	159	360	519
11	"11-out5731"	.43636	96	124	220
11	"11-out5732"	.43678	228	294	522
11	"11-out5733"	.25287	88	260	348
11	"11-out5734"	.61757	260	161	421
11	"11-out5735"	.98662	664	9	673
11	"11-out5736"	.76383	207	64	271
11	"11-out5737"	.57464	281	208	489
11	"11-out5738"	.99065	106	1	107
11	"11-out5739"	.49900	252	253	505
11	"11-out5740"	.98701	152	2	154
11	"11-out5741"	.88502	331	43	374
11	"11-out5742"	.99707	341	1	342
11	"11-out5743"	.27255	142	379	521
11	"11-out5744"	.35036	240	445	685
11	"11-out5745"	.34536	220	417	637
11	"11-out5746"	.34070	231	447	678
11	"11-out5747"	.27320	156	415	571
11	"11-out5748"	.31196	73	161	234
11	"11-out5749"	.42587	609	821	1430
11	"11-out5750"	.31413	1527	3334	4861
11	"11-out5751"	.68845	3328	1506	4834
11	"11-out5752"	.37030	197	335	532
11	"11-out5753"	.44454	489	611	1100
11	"11-out5754"	.42522	236	319	555
11	"11-out5755"	.31803	381	817	1198
11	"11-out5756"	.23338	144	473	617
11	"11-out5757"	.97619	410	10	420
11	"11-out5758"	.99316	436	3	439
11	"11-out5759"	.61526	403	252	655
11	"11-out5760"	.27972	160	412	572
11	"11-out5761"	.99470	188	1	189
11	"11-out5762"	.46703	340	388	728
11	"11-out5763"	.42396	184	250	434
11	"11-out5764"	.77374	554	162	716
11	"11-out5765"	.98557	410	6	416
11	"11-out5766"	.46647	327	374	701
11	"11-out5767"	.22471	20	69	89
11	"11-out5768"	.40129	435	649	1084
11	"11-out5769"	.35365	174	318	492
11	"11-out5770"	.23164	486	1612	2098
11	"11-out5771"	.45857	155	183	338
11	"11-out5772"	.67065	336	165	501
11	"11-out5773"	.95733	718	32	750
11	"11-out5774"	.61477	233	146	379
11	"11-out5775"	.74099	329	115	444
11	"11-out5776"	.33762	210	412	622
11	"11-out5777"	.76674	309	94	403
11	"11-out5778"	.45856	404	477	881
11	"11-out5779"	.29698	128	303	431
11	"11-out5780"	.99640	277	1	278
11	"11-out5781"	.99645	281	1	282
11	"11-out5782"	.99640	277	1	278
11	"11-out5783"	.93989	172	11	183
11	"11-out5784"	.32127	968	2045	3013
11	"11-out5785"	.32629	711	1468	2179
11	"11-out5786"	.65838	530	275	805
11	"11-out5787"	.36523	290	504	794
11	"11-out5788"	.70048	435	186	621
11	"11-out5789"	.29123	196	477	673
11	"11-out5790"	.44333	133	167	300
11	"11-out5791"	.98561	411	6	417
11	"11-out5792"	.88022	316	43	359
11	"11-out5793"	.99849	665	1	666
11	"11-out5794"	.24390	30	93	123
11	"11-out5795"	.16596	79	397	476
11	"11-out5796"	.31293	317	696	1013
11	"11-out5797"	.31055	459	1019	1478
11	"11-out5798"	.88646	570	73	643
11	"11-out5799"	.99690	322	1	323
11	"11-out5800"	.35435	191	348	539
11	"11-out5801"	.95152	1001	51	1052
11	"11-out5802"	.39811	127	192	319
11	"11-out5803"	.19173	116	489	605
11	"11-out5804"	.40466	104	153	257
11	"11-out5805"	.47184	243	272	515
11	"11-out5806"	.32753	226	464	690
11	"11-out5807"	.20444	46	179	225
11	"11-out5808"	.46122	113	132	245
11	"11-out5809"	.76679	194	59	253
11	"11-out5810"	.76744	198	60	258
11	"11-out5811"	.14814	32	184	216
11	"11-out5812"	.38537	548	874	1422
11	"11-out5813"	.82222	222	48	270
11	"11-out5814"	.31884	242	517	759
11	"11-out5815"	.27500	77	203	280
11	"11-out5816"	.69528	413	181	594
11	"11-out5817"	.28289	43	109	152
11	"11-out5818"	.30845	62	139	201
11	"11-out5819"	.34597	73	138	211
11	"11-out5820"	.33916	155	302	457
11	"11-out5821"	.52272	207	189	396
11	"11-out5822"	.35233	204	375	579
11	"11-out5823"	.50211	237	235	472
11	"11-out5824"	.79377	204	53	257
11	"11-out5825"	.22996	132	442	574
11	"11-out5826"	.99687	319	1	320
11	"11-out5827"	.26869	424	1154	1578
11	"11-out5828"	.42436	303	411	714
11	"11-out5829"	.25346	128	377	505
11	"11-out5830"	.31995	271	576	847
11	"11-out5831"	.27616	95	249	344
11	"11-out5832"	.54770	3783	3124	6907
11	"11-out5833"	.42975	104	138	242
11	"11-out5834"	.37577	242	402	644
11	"11-out5835"	.49549	165	168	333
11	"11-out5836"	.99845	646	1	647
11	"11-out5837"	.27974	174	448	622
11	"11-out5838"	.20175	69	273	342
11	"11-out5839"	.57105	221	166	387
11	"11-out5840"	.29702	30	71	101
11	"11-out5841"	.40754	108	157	265
11	"11-out5842"	.59444	107	73	180
11	"11-out5843"	.76571	134	41	175
11	"11-out5844"	.25659	253	733	986
11	"11-out5845"	.29277	154	372	526
11	"11-out5846"	.32828	390	798	1188
11	"11-out5847"	.30012	241	562	803
11	"11-out5848"	.47513	86	95	181
11	"11-out5849"	.45108	83	101	184
11	"11-out5850"	.44887	360	442	802
11	"11-out5851"	.62711	222	132	354
11	"11-out5852"	.91370	180	17	197
11	"11-out5853"	.97175	172	5	177
11	"11-out5854"	.97147	545	16	561
11	"11-out5855"	.49562	623	634	1257
11	"11-out5856"	.36480	170	296	466
11	"11-out5857"	.34033	162	314	476
11	"11-out5858"	.66666	362	181	543
11	"11-out5859"	.47034	230	259	489
11	"11-out5860"	.49069	448	465	913
11	"11-out5861"	.35604	324	586	910
11	"11-out5862"	.22559	171	587	758
11	"11-out5863"	.45197	240	291	531
11	"11-out5864"	.35364	296	541	837
11	"11-out5865"	.20376	65	254	319
11	"11-out5866"	.48958	917	956	1873
11	"11-out5867"	.41577	116	163	279
11	"11-out5868"	.99948	1943	1	1944
11	"11-out5869"	.37609	129	214	343
11	"11-out5870"	.29569	110	262	372
11	"11-out5871"	.48916	158	165	323
11	"11-out5872"	.98203	164	3	167
11	"11-out5873"	.32044	58	123	181
11	"11-out5874"	.47024	640	721	1361
11	"11-out5875"	.42369	236	321	557
11	"11-out5876"	.42458	76	103	179
11	"11-out5877"	.59677	111	75	186
11	"11-out5878"	.51602	306	287	593
11	"11-out5879"	.58252	240	172	412
11	"11-out5880"	.48856	641	671	1312
11	"11-out5881"	.23369	43	141	184
11	"11-out5882"	.58136	443	319	762
11	"11-out5883"	.46577	381	437	818
11	"11-out5884"	.71631	202	80	282
11	"11-out5885"	.39767	274	415	689
11	"11-out5886"	.41284	360	512	872
11	"11-out5887"	.97350	147	4	151
11	"11-out5888"	.15454	17	93	110
11	"11-out5889"	.36150	723	1277	2000
11	"11-out5890"	.34595	676	1278	1954
11	"11-out5891"	.29650	805	1910	2715
11	"11-out5892"	.39627	1148	1749	2897
11	"11-out5893"	.33333	198	396	594
11	"11-out5894"	.50274	550	544	1094
11	"11-out5895"	.29573	215	512	727
11	"11-out5896"	.56873	211	160	371
11	"11-out5897"	.45549	87	104	191
11	"11-out5898"	.24380	256	794	1050
11	"11-out5899"	.28376	229	578	807
11	"11-out5900"	.39285	33	51	84
11	"11-out5901"	.29721	96	227	323
11	"11-out5902"	.12183	53	382	435
11	"11-out5903"	.28380	170	429	599
11	"11-out5904"	.38303	149	240	389
11	"11-out5905"	.31218	310	683	993
11	"11-out5906"	.25097	129	385	514
11	"11-out5907"	.92050	220	19	239
11	"11-out5908"	.91081	337	33	370
11	"11-out5909"	.29526	106	253	359
11	"11-out5910"	.48768	396	416	812
11	"11-out5911"	.91253	313	30	343
11	"11-out5912"	.25882	88	252	340
11	"11-out5913"	.42099	365	502	867
11	"11-out5914"	.41756	233	325	558
11	"11-out5915"	.60747	65	42	107
11	"11-out5916"	.48752	215	226	441
11	"11-out5917"	.59322	70	48	118
11	"11-out5918"	.45321	775	935	1710
11	"11-out5919"	.28762	862	2135	2997
11	"11-out5920"	.37086	280	475	755
11	"11-out5921"	.35722	1630	2933	4563
11	"11-out5922"	.31203	83	183	266
11	"11-out5923"	.99065	318	3	321
11	"11-out5924"	.21880	114	407	521
11	"11-out5925"	.39226	71	110	181
11	"11-out5926"	.37570	133	221	354
11	"11-out5927"	.58441	180	128	308
11	"11-out5928"	.42370	286	389	675
11	"11-out5929"	.41441	322	455	777
11	"11-out5930"	.33377	507	1012	1519
11	"11-out5931"	.37248	222	374	596
11	"11-out5932"	.27743	407	1060	1467
11	"11-out5933"	.42147	577	792	1369
11	"11-out5934"	.40659	74	108	182
11	"11-out5935"	.39579	885	1351	2236
11	"11-out5936"	.95500	191	9	200
11	"11-out5937"	.99465	186	1	187
11	"11-out5938"	.35706	311	560	871
11	"11-out5939"	.35960	146	260	406
11	"11-out5940"	.31352	401	878	1279
11	"11-out5941"	.80724	557	133	690
11	"11-out5942"	.95366	1523	74	1597
11	"11-out5943"	.64035	584	328	912
11	"11-out5944"	.27720	428	1116	1544
11	"11-out5945"	.29488	248	593	841
11	"11-out5946"	.93036	334	25	359
11	"11-out5947"	.98791	327	4	331
11	"11-out5948"	.26530	52	144	196
11	"11-out5949"	.47549	97	107	204
11	"11-out5950"	.51955	93	86	179
11	"11-out5951"	.73630	363	130	493
11	"11-out5952"	.37878	225	369	594
11	"11-out5953"	.25225	56	166	222
11	"11-out5954"	.98496	262	4	266
11	"11-out5955"	.99723	361	1	362
11	"11-out5956"	.99723	361	1	362
11	"11-out5957"	.37404	147	246	393
11	"11-out5958"	.97808	357	8	365
11	"11-out5959"	.37333	112	188	300
11	"11-out5960"	.36805	318	546	864
11	"11-out5961"	.33511	188	373	561
11	"11-out5962"	.99878	822	1	823
11	"11-out5963"	.32861	116	237	353
11	"11-out5964"	.83480	379	75	454
11	"11-out5965"	.21111	57	213	270
11	"11-out5966"	.18711	61	265	326
11	"11-out5967"	.34819	164	307	471
11	"11-out5968"	.30310	381	876	1257
11	"11-out5969"	.48961	165	172	337
11	"11-out5970"	.51606	257	241	498
11	"11-out5971"	.35643	180	325	505
11	"11-out5972"	.99703	1008	3	1011
11	"11-out5973"	.97590	243	6	249
11	"11-out5974"	.51276	241	229	470
11	"11-out5975"	.73279	362	132	494
11	"11-out5976"	.99621	263	1	264
11	"11-out5977"	.17258	68	326	394
11	"11-out5978"	.21221	198	735	933
11	"11-out5979"	.94389	572	34	606
11	"11-out5980"	.88957	145	18	163
11	"11-out5981"	.36956	119	203	322
11	"11-out5982"	.44536	216	269	485
11	"11-out5983"	.99710	344	1	345
11	"11-out5984"	.38557	123	196	319
11	"11-out5985"	.63047	331	194	525
11	"11-out5986"	.28803	142	351	493
11	"11-out5987"	.38871	255	401	656
11	"11-out5988"	.93508	1599	111	1710
11	"11-out5989"	.26809	263	718	981
11	"11-out5990"	.44364	185	232	417
11	"11-out5991"	.39895	381	574	955
11	"11-out5992"	.30622	128	290	418
11	"11-out5993"	.33653	175	345	520
11	"11-out5994"	.19801	20	81	101
11	"11-out5995"	.42990	184	244	428
11	"11-out5996"	.25379	368	1082	1450
11	"11-out5997"	.99793	483	1	484
11	"11-out5998"	.44343	439	551	990
11	"11-out5999"	.97425	492	13	505
11	"11-out6000"	.33253	139	279	418
11	"11-out6001"	.31111	112	248	360
11	"11-out6002"	.38621	482	766	1248
11	"11-out6003"	.40551	103	151	254
11	"11-out6004"	.20182	199	787	986
11	"11-out6005"	.23905	202	643	845
11	"11-out6006"	.28841	122	301	423
11	"11-out6007"	.31490	131	285	416
11	"11-out6008"	.76165	147	46	193
11	"11-out6009"	.98854	518	6	524
11	"11-out6010"	.99367	157	1	158
11	"11-out6011"	.74698	62	21	83
11	"11-out6012"	.30799	235	528	763
11	"11-out6013"	.68822	298	135	433
11	"11-out6014"	.30612	105	238	343
11	"11-out6015"	.38565	199	317	516
11	"11-out6016"	.99878	822	1	823
11	"11-out6017"	.33748	217	426	643
11	"11-out6018"	.60447	162	106	268
11	"11-out6019"	.44897	198	243	441
11	"11-out6020"	.30412	236	540	776
11	"11-out6021"	.33688	253	498	751
11	"11-out6022"	.34393	119	227	346
11	"11-out6023"	.99207	626	5	631
11	"11-out6024"	.53619	237	205	442
11	"11-out6025"	.28169	40	102	142
11	"11-out6026"	.47940	128	139	267
11	"11-out6027"	.99661	294	1	295
11	"11-out6028"	.81553	168	38	206
11	"11-out6029"	.30674	100	226	326
11	"11-out6030"	.91463	450	42	492
11	"11-out6031"	.33805	310	607	917
11	"11-out6032"	.62962	272	160	432
11	"11-out6033"	.38062	279	454	733
11	"11-out6034"	.42398	251	341	592
11	"11-out6035"	.38433	211	338	549
11	"11-out6036"	.43048	257	340	597
11	"11-out6037"	.36115	251	444	695
11	"11-out6038"	.40053	300	449	749
11	"11-out6039"	.39186	212	329	541
11	"11-out6040"	.26923	98	266	364
11	"11-out6041"	.99145	116	1	117
11	"11-out6042"	.99145	116	1	117
11	"11-out6043"	.09090	14	140	154
11	"11-out6044"	.25963	155	442	597
11	"11-out6045"	.27853	244	632	876
11	"11-out6046"	.27789	254	660	914
11	"11-out6047"	.25324	117	345	462
11	"11-out6048"	.48122	282	304	586
11	"11-out6049"	.36111	26	46	72
11	"11-out6050"	.98550	68	1	69
11	"11-out6051"	.51057	169	162	331
11	"11-out6052"	.30352	465	1067	1532
11	"11-out6053"	.41213	197	281	478
11	"11-out6054"	.26535	108	299	407
11	"11-out6055"	.42207	130	178	308
11	"11-out6056"	.87365	325	47	372
11	"11-out6057"	.44988	193	236	429
11	"11-out6058"	.21703	79	285	364
11	"11-out6059"	.30000	75	175	250
11	"11-out6060"	.31337	157	344	501
11	"11-out6061"	.49450	225	230	455
11	"11-out6062"	.65111	293	157	450
11	"11-out6063"	.25271	186	550	736
11	"11-out6064"	.32688	152	313	465
11	"11-out6065"	.99823	567	1	568
11	"11-out6066"	.99310	144	1	145
11	"11-out6067"	.99310	144	1	145
11	"11-out6068"	.98859	260	3	263
11	"11-out6069"	.99619	262	1	263
11	"11-out6070"	.99239	261	2	263
11	"11-out6071"	.98113	104	2	106
11	"11-out6072"	.98113	104	2	106
11	"11-out6073"	.97058	198	6	204
11	"11-out6074"	.32231	273	574	847
11	"11-out6075"	.98230	111	2	113
11	"11-out6076"	.99047	104	1	105
11	"11-out6077"	.43308	343	449	792
11	"11-out6078"	.46542	175	201	376
11	"11-out6079"	.49890	454	456	910
11	"11-out6080"	.96739	89	3	92
11	"11-out6081"	.28000	56	144	200
11	"11-out6082"	.83710	185	36	221
11	"11-out6083"	.87192	177	26	203
11	"11-out6084"	.45291	101	122	223
11	"11-out6085"	.27906	60	155	215
11	"11-out6086"	.30462	145	331	476
11	"11-out6087"	.46376	96	111	207
11	"11-out6088"	.64471	470	259	729
11	"11-out6089"	.98039	50	1	51
11	"11-out6090"	.98360	420	7	427
11	"11-out6091"	.40117	341	509	850
11	"11-out6092"	.91966	767	67	834
11	"11-out6093"	.68240	159	74	233
11	"11-out6094"	.38069	142	231	373
11	"11-out6095"	.23711	46	148	194
11	"11-out6096"	.79831	570	144	714
11	"11-out6097"	.46153	102	119	221
11	"11-out6098"	.27426	65	172	237
11	"11-out6099"	.42857	93	124	217
11	"11-out6100"	.89201	190	23	213
11	"11-out6101"	.91304	231	22	253
11	"11-out6102"	.27852	227	588	815
11	"11-out6103"	.75910	271	86	357
11	"11-out6104"	.46218	220	256	476
11	"11-out6105"	.21412	94	345	439
11	"11-out6106"	.92366	605	50	655
11	"11-out6107"	.97956	911	19	930
11	"11-out6108"	.49765	106	107	213
11	"11-out6109"	.39482	122	187	309
11	"11-out6110"	.44719	415	513	928
11	"11-out6111"	.15763	32	171	203
11	"11-out6112"	.42578	109	147	256
11	"11-out6113"	.98924	92	1	93
11	"11-out6114"	.39039	130	203	333
11	"11-out6115"	.15740	34	182	216
11	"11-out6116"	.22748	48	163	211
11	"11-out6117"	.36597	71	123	194
11	"11-out6118"	.38812	85	134	219
11	"11-out6119"	.63106	130	76	206
11	"11-out6120"	.24038	50	158	208
11	"11-out6121"	.89370	227	27	254
11	"11-out6122"	.91732	233	21	254
11	"11-out6123"	.91542	184	17	201
11	"11-out6124"	.99497	198	1	199
11	"11-out6125"	.45342	258	311	569
11	"11-out6126"	.42708	82	110	192
11	"11-out6127"	.84469	533	98	631
11	"11-out6128"	.40808	202	293	495
11	"11-out6129"	.43216	567	745	1312
11	"11-out6130"	.28380	212	535	747
11	"11-out6131"	.47887	204	222	426
11	"11-out6132"	.96526	389	14	403
11	"11-out6133"	.35947	110	196	306
11	"11-out6134"	.32371	617	1289	1906
11	"11-out6135"	.36860	209	358	567
11	"11-out6136"	.62135	128	78	206
11	"11-out6137"	.80978	149	35	184
11	"11-out6138"	.24199	68	213	281
11	"11-out6139"	.98879	794	9	803
11	"11-out6140"	.53214	538	473	1011
11	"11-out6141"	.48557	101	107	208
11	"11-out6142"	.38650	126	200	326
11	"11-out6143"	.31152	100	221	321
11	"11-out6144"	.31503	132	287	419
11	"11-out6145"	.32958	352	716	1068
11	"11-out6146"	.32146	361	762	1123
11	"11-out6147"	.39791	191	289	480
11	"11-out6148"	.11635	37	281	318
11	"11-out6149"	.55935	278	219	497
11	"11-out6150"	.99479	191	1	192
11	"11-out6151"	.35140	525	969	1494
11	"11-out6152"	.40953	378	545	923
11	"11-out6153"	.31918	549	1171	1720
11	"11-out6154"	.39215	260	403	663
11	"11-out6155"	.22727	15	51	66
11	"11-out6156"	.99666	598	2	600
11	"11-out6157"	.40983	125	180	305
11	"11-out6158"	.43452	146	190	336
11	"11-out6159"	.35135	117	216	333
11	"11-out6160"	.36235	129	227	356
11	"11-out6161"	.22133	83	292	375
11	"11-out6162"	.46578	177	203	380
11	"11-out6163"	.69637	250	109	359
11	"11-out6164"	.48994	195	203	398
11	"11-out6165"	.24282	127	396	523
11	"11-out6166"	.30496	86	196	282
11	"11-out6167"	.41358	134	190	324
11	"11-out6168"	.27509	74	195	269
11	"11-out6169"	.39116	124	193	317
11	"11-out6170"	.23955	86	273	359
11	"11-out6171"	.40640	165	241	406
11	"11-out6172"	.51984	275	254	529
11	"11-out6173"	.40533	152	223	375
11	"11-out6174"	.29904	125	293	418
11	"11-out6175"	.19350	161	671	832
11	"11-out6176"	.83237	581	117	698
11	"11-out6177"	.91596	545	50	595
11	"11-out6178"	.99747	395	1	396
11	"11-out6179"	.99756	409	1	410
11	"11-out6180"	.25888	51	146	197
11	"11-out6181"	.99274	547	4	551
11	"11-out6182"	.86723	405	62	467
11	"11-out6183"	.44316	347	436	783
11	"11-out6184"	.90661	233	24	257
11	"11-out6185"	.29022	92	225	317
11	"11-out6186"	.99122	113	1	114
11	"11-out6187"	.33430	229	456	685
11	"11-out6188"	.35737	109	196	305
11	"11-out6189"	.80208	154	38	192
11	"11-out6190"	.26252	220	618	838
11	"11-out6191"	.48497	355	377	732
11	"11-out6192"	.17687	26	121	147
11	"11-out6193"	.37373	111	186	297
11	"11-out6194"	.38978	145	227	372
11	"11-out6195"	.18243	27	121	148
11	"11-out6196"	.98601	282	4	286
11	"11-out6197"	.38104	205	333	538
11	"11-out6198"	.41104	67	96	163
11	"11-out6199"	.28705	337	837	1174
11	"11-out6200"	.99130	114	1	115
11	"11-out6201"	.40944	52	75	127
11	"11-out6202"	.42401	226	307	533
11	"11-out6203"	.41379	288	408	696
11	"11-out6204"	.52644	209	188	397
11	"11-out6205"	.31001	226	503	729
11	"11-out6206"	.95744	180	8	188
11	"11-out6207"	.52054	152	140	292
11	"11-out6208"	.52808	94	84	178
11	"11-out6209"	.28906	37	91	128
11	"11-out6210"	.23409	92	301	393
11	"11-out6211"	.21578	82	298	380
11	"11-out6212"	.54729	162	134	296
11	"11-out6213"	.70487	289	121	410
11	"11-out6214"	.30701	175	395	570
11	"11-out6215"	.34638	230	434	664
11	"11-out6216"	.36285	127	223	350
11	"11-out6217"	.60897	95	61	156
11	"11-out6218"	.48172	224	241	465
11	"11-out6219"	.23643	61	197	258
11	"11-out6220"	.99761	419	1	420
11	"11-out6221"	.92934	171	13	184
11	"11-out6222"	.31746	40	86	126
11	"11-out6223"	.37249	130	219	349
11	"11-out6224"	.40189	127	189	316
11	"11-out6225"	.99494	197	1	198
11	"11-out6226"	.32974	92	187	279
11	"11-out6227"	.32225	126	265	391
11	"11-out6228"	.55102	216	176	392
11	"11-out6229"	.35097	126	233	359
11	"11-out6230"	.43750	259	333	592
11	"11-out6231"	.28744	71	176	247
11	"11-out6232"	.99346	152	1	153
11	"11-out6233"	.47916	92	100	192
11	"11-out6234"	.99841	630	1	631
11	"11-out6235"	.99591	244	1	245
11	"11-out6236"	.76595	180	55	235
11	"11-out6237"	.66009	134	69	203
11	"11-out6238"	.55652	128	102	230
11	"11-out6239"	.36377	247	432	679
11	"11-out6240"	.38818	92	145	237
11	"11-out6241"	.65454	144	76	220
11	"11-out6242"	.47460	271	300	571
11	"11-out6243"	.99342	151	1	152
11	"11-out6244"	.99705	339	1	340
11	"11-out6245"	.40530	107	157	264
11	"11-out6246"	.93175	355	26	381
11	"11-out6247"	.17725	53	246	299
11	"11-out6248"	.85287	371	64	435
11	"11-out6249"	.33796	73	143	216
11	"11-out6250"	.79296	203	53	256
11	"11-out6251"	.32958	176	358	534
11	"11-out6252"	.22158	308	1082	1390
11	"11-out6253"	.33155	497	1002	1499
11	"11-out6254"	.23308	31	102	133
11	"11-out6255"	.39842	555	838	1393
11	"11-out6256"	.35479	259	471	730
11	"11-out6257"	.88431	902	118	1020
11	"11-out6258"	.88505	308	40	348
11	"11-out6259"	.28455	35	88	123
11	"11-out6260"	.84967	260	46	306
11	"11-out6261"	.95145	98	5	103
11	"11-out6262"	.53906	69	59	128
11	"11-out6263"	.26299	86	241	327
11	"11-out6264"	.54368	112	94	206
11	"11-out6265"	.50731	104	101	205
11	"11-out6266"	.54368	112	94	206
11	"11-out6267"	.38031	143	233	376
11	"11-out6268"	.28307	199	504	703
11	"11-out6269"	.39124	277	431	708
11	"11-out6270"	.99672	304	1	305
11	"11-out6271"	.47789	227	248	475
11	"11-out6272"	.41310	416	591	1007
11	"11-out6273"	.41359	146	207	353
11	"11-out6274"	.99103	221	2	223
11	"11-out6275"	.74324	110	38	148
11	"11-out6276"	.38904	270	424	694
11	"11-out6277"	.52727	145	130	275
11	"11-out6278"	.29976	128	299	427
11	"11-out6279"	.94478	154	9	163
11	"11-out6280"	.43577	190	246	436
11	"11-out6281"	.28934	171	420	591
11	"11-out6282"	.46332	619	717	1336
11	"11-out6283"	.90094	191	21	212
11	"11-out6284"	.44677	256	317	573
11	"11-out6285"	.27493	215	567	782
11	"11-out6286"	.41322	300	426	726
11	"11-out6287"	.22666	34	116	150
11	"11-out6288"	.99473	189	1	190
11	"11-out6289"	.34634	71	134	205
11	"11-out6290"	.34099	89	172	261
11	"11-out6291"	.85217	98	17	115
11	"11-out6292"	.41496	61	86	147
11	"11-out6293"	.58482	424	301	725
11	"11-out6294"	.95430	355	17	372
11	"11-out6295"	.96698	205	7	212
11	"11-out6296"	.81034	47	11	58
11	"11-out6297"	.99130	114	1	115
11	"11-out6298"	.64824	258	140	398
11	"11-out6299"	.99180	121	1	122
11	"11-out6300"	.99523	209	1	210
11	"11-out6301"	.42439	87	118	205
11	"11-out6302"	.56393	344	266	610
11	"11-out6303"	.39743	124	188	312
11	"11-out6304"	.40639	89	130	219
11	"11-out6305"	.39631	86	131	217
11	"11-out6306"	.99539	216	1	217
11	"11-out6307"	.99310	144	1	145
11	"11-out6308"	.91970	126	11	137
11	"11-out6309"	1.00000	59	0	59
11	"11-out6310"	.99621	263	1	264
11	"11-out6311"	.99588	242	1	243
11	"11-out6312"	.99489	195	1	196
11	"11-out6313"	.44776	60	74	134
11	"11-out6314"	.31098	269	596	865
11	"11-out6315"	.33262	156	313	469
11	"11-out6316"	.99833	599	1	600
11	"11-out6317"	.84773	579	104	683
11	"11-out6318"	.18744	230	997	1227
11	"11-out6319"	.93373	155	11	166
11	"11-out6320"	.46090	560	655	1215
11	"11-out6321"	.40224	179	266	445
11	"11-out6322"	.80608	212	51	263
11	"11-out6323"	.90731	186	19	205
11	"11-out6324"	.53043	61	54	115
11	"11-out6325"	.31564	119	258	377
11	"11-out6326"	.29679	176	417	593
11	"11-out6327"	.29608	53	126	179
11	"11-out6328"	.25297	298	880	1178
11	"11-out6329"	.70103	68	29	97
11	"11-out6330"	.99596	494	2	496
11	"11-out6331"	.40243	132	196	328
11	"11-out6332"	.37435	73	122	195
11	"11-out6333"	.31155	248	548	796
11	"11-out6334"	.16858	44	217	261
11	"11-out6335"	.43750	119	153	272
11	"11-out6336"	.28605	484	1208	1692
11	"11-out6337"	.33497	136	270	406
11	"11-out6338"	.80976	315	74	389
11	"11-out6339"	.98604	212	3	215
11	"11-out6340"	.96276	181	7	188
11	"11-out6341"	.99264	135	1	136
11	"11-out6342"	.25278	68	201	269
11	"11-out6343"	.91588	196	18	214
11	"11-out6344"	.99014	201	2	203
11	"11-out6345"	.98461	128	2	130
11	"11-out6346"	.99789	473	1	474
11	"11-out6347"	.99789	473	1	474
11	"11-out6348"	.99789	475	1	476
11	"11-out6349"	.99789	473	1	474
11	"11-out6350"	.51641	346	324	670
11	"11-out6351"	.68613	1034	473	1507
11	"11-out6352"	.99547	220	1	221
11	"11-out6353"	.99547	220	1	221
11	"11-out6354"	.96875	403	13	416
11	"11-out6355"	.98381	304	5	309
11	"11-out6356"	.58903	827	577	1404
11	"11-out6357"	.24469	196	605	801
11	"11-out6358"	.83035	186	38	224
11	"11-out6359"	.99450	181	1	182
11	"11-out6360"	.20616	194	747	941
11	"11-out6361"	.97101	134	4	138
11	"11-out6362"	.46636	312	357	669
11	"11-out6363"	.98326	470	8	478
11	"11-out6364"	.21327	90	332	422
11	"11-out6365"	.35305	370	678	1048
11	"11-out6366"	.44193	137	173	310
11	"11-out6367"	.99431	175	1	176
11	"11-out6368"	.94626	317	18	335
11	"11-out6369"	.97887	417	9	426
11	"11-out6370"	.38903	717	1126	1843
11	"11-out6371"	.67142	235	115	350
11	"11-out6372"	.52272	138	126	264
11	"11-out6373"	.26016	32	91	123
11	"11-out6374"	.54367	417	350	767
11	"11-out6375"	.49857	175	176	351
11	"11-out6376"	.31808	153	328	481
11	"11-out6377"	.31919	158	337	495
11	"11-out6378"	.37767	159	262	421
11	"11-out6379"	.29214	331	802	1133
11	"11-out6380"	.30503	97	221	318
11	"11-out6381"	.99038	103	1	104
11	"11-out6382"	.38208	209	338	547
11	"11-out6383"	.99047	104	1	105
11	"11-out6384"	.37727	249	411	660
11	"11-out6385"	.58377	331	236	567
11	"11-out6386"	.99736	379	1	380
11	"11-out6387"	.37909	428	701	1129
11	"11-out6388"	.28539	127	318	445
11	"11-out6389"	.32103	87	184	271
11	"11-out6390"	.31974	149	317	466
11	"11-out6391"	.36979	284	484	768
11	"11-out6392"	.12307	48	342	390
11	"11-out6393"	.39768	309	468	777
11	"11-out6394"	.51196	107	102	209
11	"11-out6395"	.40826	316	458	774
11	"11-out6396"	.90211	341	37	378
11	"11-out6397"	.62857	308	182	490
11	"11-out6398"	.99845	646	1	647
11	"11-out6399"	.20975	185	697	882
11	"11-out6400"	.24427	64	198	262
11	"11-out6401"	.99829	1755	3	1758
11	"11-out6402"	.35849	209	374	583
11	"11-out6403"	.51572	82	77	159
11	"11-out6404"	.44987	184	225	409
11	"11-out6405"	.56810	171	130	301
11	"11-out6406"	.86604	653	101	754
11	"11-out6407"	.38509	62	99	161
11	"11-out6408"	.21153	11	41	52
11	"11-out6409"	.42171	202	277	479
11	"11-out6410"	.26776	162	443	605
11	"11-out6411"	.36158	273	482	755
11	"11-out6412"	.42731	194	260	454
11	"11-out6413"	.54418	234	196	430
11	"11-out6414"	.39516	147	225	372
11	"11-out6415"	.57039	393	296	689
11	"11-out6416"	.92729	829	65	894
11	"11-out6417"	.99791	478	1	479
11	"11-out6418"	.39038	276	431	707
11	"11-out6419"	.99803	508	1	509
11	"11-out6420"	.37222	386	651	1037
11	"11-out6421"	.99790	477	1	478
11	"11-out6422"	.82323	163	35	198
11	"11-out6423"	.38418	617	989	1606
11	"11-out6424"	.53439	101	88	189
11	"11-out6425"	.99975	4127	1	4128
11	"11-out6426"	.61138	376	239	615
11	"11-out6427"	.19823	45	182	227
11	"11-out6428"	.68085	64	30	94
11	"11-out6429"	.30849	207	464	671
11	"11-out6430"	.33703	182	358	540
11	"11-out6431"	.26356	34	95	129
11	"11-out6432"	.42950	198	263	461
11	"11-out6433"	.53590	306	265	571
11	"11-out6434"	.35833	129	231	360
11	"11-out6435"	.46075	135	158	293
11	"11-out6436"	.97769	263	6	269
11	"11-out6437"	.98255	338	6	344
11	"11-out6438"	.99719	355	1	356
11	"11-out6439"	.97272	428	12	440
11	"11-out6440"	.29194	87	211	298
11	"11-out6441"	.36708	203	350	553
11	"11-out6442"	.25063	99	296	395
11	"11-out6443"	.99170	598	5	603
11	"11-out6444"	.36514	88	153	241
11	"11-out6445"	.32340	76	159	235
11	"11-out6446"	.27826	320	830	1150
11	"11-out6447"	.39194	370	574	944
11	"11-out6448"	.37070	291	494	785
11	"11-out6449"	.68309	194	90	284
11	"11-out6450"	.53004	344	305	649
11	"11-out6451"	.90725	225	23	248
11	"11-out6452"	.36506	464	807	1271
11	"11-out6453"	.30656	42	95	137
11	"11-out6454"	.24704	188	573	761
11	"11-out6455"	.46919	99	112	211
11	"11-out6456"	.39759	99	150	249
11	"11-out6457"	.37371	364	610	974
11	"11-out6458"	.42803	458	612	1070
11	"11-out6459"	.50957	266	256	522
11	"11-out6460"	.23687	221	712	933
11	"11-out6461"	.54651	94	78	172
11	"11-out6462"	.94329	183	11	194
11	"11-out6463"	.36765	432	743	1175
11	"11-out6464"	.49604	251	255	506
11	"11-out6465"	.28191	106	270	376
11	"11-out6466"	.53170	109	96	205
11	"11-out6467"	.30504	133	303	436
11	"11-out6468"	.59007	226	157	383
11	"11-out6469"	.25615	156	453	609
11	"11-out6470"	1.00000	969	0	969
11	"11-out6471"	1.00000	812	0	812
11	"11-out6472"	1.00000	1459	0	1459
11	"11-out6473"	.26338	182	509	691
11	"11-out6474"	.17241	120	576	696
11	"11-out6475"	.57026	349	263	612
11	"11-out6476"	.31585	271	587	858
11	"11-out6477"	.42105	64	88	152
11	"11-out6478"	.44062	282	358	640
11	"11-out6479"	.84545	93	17	110
11	"11-out6480"	.63295	169	98	267
11	"11-out6481"	.54356	131	110	241
11	"11-out6482"	.99669	302	1	303
11	"11-out6483"	.16742	74	368	442
11	"11-out6484"	.99629	269	1	270
11	"11-out6485"	.44680	126	156	282
11	"11-out6486"	.99829	1755	3	1758
11	"11-out6487"	.47750	138	151	289
11	"11-out6488"	.54872	794	653	1447
11	"11-out6489"	.26535	108	299	407
11	"11-out6490"	.40521	233	342	575
11	"11-out6491"	.57361	187	139	326
11	"11-out6492"	.54616	349	290	639
11	"11-out6493"	.80769	84	20	104
11	"11-out6494"	.46020	133	156	289
11	"11-out6495"	.36758	93	160	253
11	"11-out6496"	.41642	142	199	341
11	"11-out6497"	.99218	127	1	128
11	"11-out6498"	.30215	168	388	556
11	"11-out6499"	.48160	144	155	299
11	"11-out6500"	.31536	310	673	983
11	"11-out6501"	.37506	683	1138	1821
11	"11-out6502"	.38709	156	247	403
11	"11-out6503"	.23230	174	575	749
11	"11-out6504"	.40668	560	817	1377
11	"11-out6505"	.99318	437	3	440
11	"11-out6506"	.99663	296	1	297
11	"11-out6507"	.37084	379	643	1022
11	"11-out6508"	.28194	139	354	493
11	"11-out6509"	.54910	246	202	448
11	"11-out6510"	.24236	135	422	557
11	"11-out6511"	.99749	398	1	399
11	"11-out6512"	.82834	526	109	635
11	"11-out6513"	.99509	203	1	204
11	"11-out6514"	.30594	108	245	353
11	"11-out6515"	.44967	210	257	467
11	"11-out6516"	.75238	158	52	210
11	"11-out6517"	.96402	134	5	139
11	"11-out6518"	.27810	94	244	338
11	"11-out6519"	.36090	96	170	266
11	"11-out6520"	.86837	508	77	585
11	"11-out6521"	.88188	224	30	254
11	"11-out6522"	.27640	301	788	1089
11	"11-out6523"	.34722	150	282	432
11	"11-out6524"	.31785	267	573	840
11	"11-out6525"	.93902	77	5	82
11	"11-out6526"	.19393	64	266	330
11	"11-out6527"	.44327	168	211	379
11	"11-out6528"	.34032	1444	2799	4243
11	"11-out6529"	.96531	501	18	519
11	"11-out6530"	.99488	389	2	391
11	"11-out6531"	.29725	1211	2863	4074
11	"11-out6532"	.94285	165	10	175
11	"11-out6533"	.33544	53	105	158
11	"11-out6534"	.33982	471	915	1386
11	"11-out6535"	.46815	147	167	314
11	"11-out6536"	.51927	458	424	882
11	"11-out6537"	.49206	124	128	252
11	"11-out6538"	.25793	195	561	756
11	"11-out6539"	.42019	129	178	307
11	"11-out6540"	.27722	28	73	101
11	"11-out6541"	.46558	115	132	247
11	"11-out6542"	.42799	211	282	493
11	"11-out6543"	.41078	99	142	241
11	"11-out6544"	.25187	235	698	933
11	"11-out6545"	.52127	245	225	470
11	"11-out6546"	.86528	167	26	193
11	"11-out6547"	.36443	332	579	911
11	"11-out6548"	.38077	1672	2719	4391
11	"11-out6549"	.49604	1255	1275	2530
11	"11-out6550"	.42218	255	349	604
11	"11-out6551"	.53717	224	193	417
11	"11-out6552"	.27733	104	271	375
11	"11-out6553"	.52647	169	152	321
11	"11-out6554"	.41696	118	165	283
11	"11-out6555"	.39682	150	228	378
11	"11-out6556"	.44084	544	690	1234
11	"11-out6557"	.46004	213	250	463
11	"11-out6558"	.58022	311	225	536
11	"11-out6559"	.23166	60	199	259
11	"11-out6560"	.99404	167	1	168
11	"11-out6561"	.99481	192	1	193
11	"11-out6562"	.51219	126	120	246
11	"11-out6563"	.18123	85	384	469
11	"11-out6564"	.37004	168	286	454
11	"11-out6565"	.26754	183	501	684
11	"11-out6566"	.29982	346	808	1154
11	"11-out6567"	.31328	224	491	715
11	"11-out6568"	.12598	32	222	254
11	"11-out6569"	.18864	113	486	599
11	"11-out6570"	.38265	75	121	196
11	"11-out6571"	.61883	138	85	223
11	"11-out6572"	.89230	116	14	130
11	"11-out6573"	.42874	707	942	1649
11	"11-out6574"	.30314	231	531	762
11	"11-out6575"	.76687	125	38	163
11	"11-out6576"	.21585	49	178	227
11	"11-out6577"	.52806	207	185	392
11	"11-out6578"	.40680	1159	1690	2849
11	"11-out6579"	.25247	102	302	404
11	"11-out6580"	.45018	357	436	793
11	"11-out6581"	.43545	280	363	643
11	"11-out6582"	.37008	292	497	789
11	"11-out6583"	.34465	203	386	589
11	"11-out6584"	.36745	280	482	762
11	"11-out6585"	.38157	464	752	1216
11	"11-out6586"	.71775	974	383	1357
11	"11-out6587"	.99280	276	2	278
11	"11-out6588"	.23000	115	385	500
11	"11-out6589"	.98913	91	1	92
11	"11-out6590"	.25333	76	224	300
11	"11-out6591"	.57107	229	172	401
11	"11-out6592"	.39370	50	77	127
11	"11-out6593"	.40821	149	216	365
11	"11-out6594"	.93777	211	14	225
11	"11-out6595"	.20192	21	83	104
11	"11-out6596"	.41401	130	184	314
11	"11-out6597"	.25085	73	218	291
11	"11-out6598"	.99942	1731	1	1732
11	"11-out6599"	.36905	551	942	1493
11	"11-out6600"	.60264	182	120	302
11	"11-out6601"	.39597	59	90	149
11	"11-out6602"	.60810	135	87	222
11	"11-out6603"	.41077	511	733	1244
11	"11-out6604"	.39807	537	812	1349
11	"11-out6605"	.32563	451	934	1385
11	"11-out6606"	.37515	302	503	805
11	"11-out6607"	.51282	320	304	624
11	"11-out6608"	.31116	276	611	887
11	"11-out6609"	.29595	95	226	321
11	"11-out6610"	.30018	166	387	553
11	"11-out6611"	.37828	230	378	608
11	"11-out6612"	.42194	500	685	1185
11	"11-out6613"	.51724	255	238	493
11	"11-out6614"	.77654	629	181	810
11	"11-out6615"	.21818	276	989	1265
11	"11-out6616"	.44491	630	786	1416
11	"11-out6617"	.94441	1767	104	1871
11	"11-out6618"	.99826	577	1	578
11	"11-out6619"	.68020	268	126	394
11	"11-out6620"	.56495	187	144	331
11	"11-out6621"	.59200	74	51	125
11	"11-out6622"	.39540	482	737	1219
11	"11-out6623"	.31772	251	539	790
11	"11-out6624"	.34117	145	280	425
11	"11-out6625"	.39605	442	674	1116
11	"11-out6626"	.37650	125	207	332
11	"11-out6627"	.99905	1055	1	1056
11	"11-out6628"	.84571	148	27	175
11	"11-out6629"	.35191	303	558	861
11	"11-out6630"	.40043	185	277	462
11	"11-out6631"	.49329	515	529	1044
11	"11-out6632"	.30508	216	492	708
11	"11-out6633"	.91401	3933	370	4303
11	"11-out6634"	.69729	129	56	185
11	"11-out6635"	.37323	53	89	142
11	"11-out6636"	.72768	318	119	437
11	"11-out6637"	.27419	119	315	434
11	"11-out6638"	.32578	734	1519	2253
11	"11-out6639"	.36122	177	313	490
11	"11-out6640"	.48626	177	187	364
11	"11-out6641"	.22403	289	1001	1290
11	"11-out6642"	.31482	533	1160	1693
11	"11-out6643"	.33059	362	733	1095
11	"11-out6644"	.39751	448	679	1127
11	"11-out6645"	.99690	322	1	323
11	"11-out6646"	.18360	56	249	305
11	"11-out6647"	.25034	182	545	727
11	"11-out6648"	.41248	304	433	737
11	"11-out6649"	.27506	203	535	738
11	"11-out6650"	.39609	751	1145	1896
11	"11-out6651"	.99333	149	1	150
11	"11-out6652"	.45521	869	1040	1909
11	"11-out6653"	.35778	561	1007	1568
11	"11-out6654"	.99828	1745	3	1748
11	"11-out6655"	.99814	537	1	538
11	"11-out6656"	.99830	1762	3	1765
11	"11-out6657"	.67630	117	56	173
11	"11-out6658"	.99122	113	1	114
11	"11-out6659"	.18571	78	342	420
11	"11-out6660"	.27568	212	557	769
11	"11-out6661"	.81108	1288	300	1588
11	"11-out6662"	.49823	563	567	1130
11	"11-out6663"	.26130	52	147	199
11	"11-out6664"	.29004	67	164	231
11	"11-out6665"	.20419	302	1177	1479
11	"11-out6666"	.40956	514	741	1255
11	"11-out6667"	.30056	214	498	712
11	"11-out6668"	.99873	789	1	790
11	"11-out6669"	.57627	306	225	531
11	"11-out6670"	.32558	42	87	129
11	"11-out6671"	.48852	149	156	305
11	"11-out6672"	.26275	206	578	784
11	"11-out6673"	.34183	67	129	196
11	"11-out6674"	.31540	129	280	409
11	"11-out6675"	.34424	410	781	1191
11	"11-out6676"	.45856	487	575	1062
11	"11-out6677"	.52577	153	138	291
11	"11-out6678"	.31304	427	937	1364
11	"11-out6679"	.99333	298	2	300
11	"11-out6680"	.68164	531	248	779
11	"11-out6681"	.28189	316	805	1121
11	"11-out6682"	.40344	117	173	290
11	"11-out6683"	.40586	166	243	409
11	"11-out6684"	.39591	194	296	490
11	"11-out6685"	.43784	944	1212	2156
11	"11-out6686"	.40828	138	200	338
11	"11-out6687"	.31290	337	740	1077
11	"11-out6688"	.45291	101	122	223
11	"11-out6689"	.24489	48	148	196
11	"11-out6690"	.38100	365	593	958
11	"11-out6691"	.47641	202	222	424
11	"11-out6692"	.26711	519	1424	1943
11	"11-out6693"	.36441	297	518	815
11	"11-out6694"	.67172	487	238	725
11	"11-out6695"	.96699	498	17	515
11	"11-out6696"	.98581	278	4	282
11	"11-out6697"	.40289	139	206	345
11	"11-out6698"	.53703	145	125	270
11	"11-out6699"	.50392	449	442	891
11	"11-out6700"	.20258	141	555	696
11	"11-out6701"	.14911	126	719	845
11	"11-out6702"	.43295	423	554	977
11	"11-out6703"	.40621	340	497	837
11	"11-out6704"	.17954	172	786	958
11	"11-out6705"	.35804	285	511	796
11	"11-out6706"	.34996	533	990	1523
11	"11-out6707"	.48120	320	345	665
11	"11-out6708"	.56470	288	222	510
11	"11-out6709"	.31250	150	330	480
11	"11-out6710"	.30487	150	342	492
11	"11-out6711"	.35521	92	167	259
11	"11-out6712"	.51194	150	143	293
11	"11-out6713"	.37354	161	270	431
11	"11-out6714"	.45614	156	186	342
11	"11-out6715"	.52123	135	124	259
11	"11-out6716"	.41052	195	280	475
11	"11-out6717"	.48678	442	466	908
11	"11-out6718"	.33065	412	834	1246
11	"11-out6719"	.97468	154	4	158
11	"11-out6720"	.58652	566	399	965
11	"11-out6721"	.98773	161	2	163
11	"11-out6722"	.48081	401	433	834
11	"11-out6723"	.33834	270	528	798
11	"11-out6724"	.37349	217	364	581
11	"11-out6725"	.58283	686	491	1177
11	"11-out6726"	.40597	136	199	335
11	"11-out6727"	.50903	169	163	332
11	"11-out6728"	.99242	131	1	132
11	"11-out6729"	.46830	266	302	568
11	"11-out6730"	.42512	247	334	581
11	"11-out6731"	.42600	95	128	223
11	"11-out6732"	.52241	303	277	580
11	"11-out6733"	.26744	46	126	172
11	"11-out6734"	.67647	414	198	612
11	"11-out6735"	.99122	226	2	228
11	"11-out6736"	.22503	142	489	631
11	"11-out6737"	.35057	244	452	696
11	"11-out6738"	.99285	278	2	280
11	"11-out6739"	.98181	162	3	165
11	"11-out6740"	.28455	70	176	246
11	"11-out6741"	.60167	216	143	359
11	"11-out6742"	.54618	136	113	249
11	"11-out6743"	.99465	372	2	374
11	"11-out6744"	.51324	155	147	302
11	"11-out6745"	.22872	86	290	376
11	"11-out6746"	.30471	252	575	827
11	"11-out6747"	.76327	532	165	697
11	"11-out6748"	.66158	217	111	328
11	"11-out6749"	.99376	478	3	481
11	"11-out6750"	.45083	353	430	783
11	"11-out6751"	.32937	305	621	926
11	"11-out6752"	.98717	77	1	78
11	"11-out6753"	.32608	30	62	92
11	"11-out6754"	.58241	53	38	91
11	"11-out6755"	.26501	203	563	766
11	"11-out6756"	.90000	117	13	130
11	"11-out6757"	.98947	94	1	95
11	"11-out6758"	.98181	54	1	55
11	"11-out6759"	.35832	239	428	667
11	"11-out6760"	.98305	58	1	59
11	"11-out6761"	.98591	70	1	71
11	"11-out6762"	.99029	102	1	103
11	"11-out6763"	.99242	131	1	132
11	"11-out6764"	.98823	84	1	85
11	"11-out6765"	.98924	92	1	93
11	"11-out6766"	.27586	144	378	522
11	"11-out6767"	.31578	126	273	399
11	"11-out6768"	.36250	145	255	400
11	"11-out6769"	.94117	192	12	204
11	"11-out6770"	.94036	205	13	218
11	"11-out6771"	.97709	256	6	262
11	"11-out6772"	.30609	397	900	1297
11	"11-out6773"	.92462	368	30	398
11	"11-out6774"	.98863	174	2	176
11	"11-out6775"	.34045	637	1234	1871
11	"11-out6776"	.99029	102	1	103
11	"11-out6777"	.39912	182	274	456
11	"11-out6778"	.42509	332	449	781
11	"11-out6779"	.49019	125	130	255
11	"11-out6780"	.99173	120	1	121
11	"11-out6781"	.50970	210	202	412
11	"11-out6782"	.38161	137	222	359
11	"11-out6783"	.39240	124	192	316
11	"11-out6784"	.41062	340	488	828
11	"11-out6785"	.67108	304	149	453
11	"11-out6786"	.84569	422	77	499
11	"11-out6787"	.87473	405	58	463
11	"11-out6788"	.29220	386	935	1321
11	"11-out6789"	.49275	102	105	207
11	"11-out6790"	.47505	219	242	461
11	"11-out6791"	.95945	71	3	74
11	"11-out6792"	.98214	55	1	56
11	"11-out6793"	.23642	74	239	313
11	"11-out6794"	.31550	118	256	374
11	"11-out6795"	.34485	439	834	1273
11	"11-out6796"	.27969	325	837	1162
11	"11-out6797"	.18152	57	257	314
11	"11-out6798"	.48064	149	161	310
11	"11-out6799"	.33802	120	235	355
11	"11-out6800"	.57092	161	121	282
11	"11-out6801"	.87250	568	83	651
11	"11-out6802"	.45685	90	107	197
11	"11-out6803"	.99741	386	1	387
11	"11-out6804"	.53972	197	168	365
11	"11-out6805"	.34779	553	1037	1590
11	"11-out6806"	.27007	111	300	411
11	"11-out6807"	.55752	819	650	1469
11	"11-out6808"	.36842	182	312	494
11	"11-out6809"	.37121	49	83	132
11	"11-out6810"	.89032	138	17	155
11	"11-out6811"	.58217	294	211	505
11	"11-out6812"	.34736	586	1101	1687
11	"11-out6813"	.58936	831	579	1410
11	"11-out6814"	.42490	331	448	779
11	"11-out6815"	.35507	294	534	828
11	"11-out6816"	.82497	740	157	897
11	"11-out6817"	.37346	152	255	407
11	"11-out6818"	.24242	32	100	132
11	"11-out6819"	.46808	484	550	1034
11	"11-out6820"	.45733	268	318	586
11	"11-out6821"	.26290	433	1214	1647
11	"11-out6822"	.35460	100	182	282
11	"11-out6823"	.42962	232	308	540
11	"11-out6824"	.89285	75	9	84
11	"11-out6825"	.45226	90	109	199
11	"11-out6826"	.41880	147	204	351
11	"11-out6827"	.38157	87	141	228
11	"11-out6828"	.33913	78	152	230
11	"11-out6829"	.26213	297	836	1133
11	"11-out6830"	.55958	1343	1057	2400
11	"11-out6831"	.19911	226	909	1135
11	"11-out6832"	.38235	78	126	204
11	"11-out6833"	.16763	58	288	346
11	"11-out6834"	.88732	126	16	142
11	"11-out6835"	.21167	214	797	1011
11	"11-out6836"	.40349	646	955	1601
11	"11-out6837"	.32348	416	870	1286
11	"11-out6838"	.50793	160	155	315
11	"11-out6839"	.42440	233	316	549
11	"11-out6840"	.37264	158	266	424
11	"11-out6841"	.36178	178	314	492
11	"11-out6842"	.99748	397	1	398
11	"11-out6843"	.22993	106	355	461
11	"11-out6844"	.99369	315	2	317
11	"11-out6845"	.59605	242	164	406
11	"11-out6846"	.55805	322	255	577
11	"11-out6847"	.40932	237	342	579
11	"11-out6848"	.38787	192	303	495
11	"11-out6849"	.13142	23	152	175
11	"11-out6850"	.39457	131	201	332
11	"11-out6851"	.23214	26	86	112
11	"11-out6852"	.35507	49	89	138
11	"11-out6853"	.87577	141	20	161
11	"11-out6854"	.28310	186	471	657
11	"11-out6855"	.38281	294	474	768
11	"11-out6856"	.52149	279	256	535
11	"11-out6857"	.32369	112	234	346
11	"11-out6858"	.18197	103	463	566
11	"11-out6859"	.99696	328	1	329
11	"11-out6860"	.91506	571	53	624
11	"11-out6861"	.86919	412	62	474
11	"11-out6862"	.30283	139	320	459
11	"11-out6863"	.45871	100	118	218
11	"11-out6864"	.22000	33	117	150
11	"11-out6865"	.98684	225	3	228
11	"11-out6866"	.89140	197	24	221
11	"11-out6867"	.20286	85	334	419
11	"11-out6868"	.17350	55	262	317
11	"11-out6869"	.36924	305	521	826
11	"11-out6870"	.59006	190	132	322
11	"11-out6871"	.26560	366	1012	1378
11	"11-out6872"	.41642	578	810	1388
11	"11-out6873"	.28071	393	1007	1400
11	"11-out6874"	.93396	198	14	212
11	"11-out6875"	.97435	114	3	117
11	"11-out6876"	.32835	22	45	67
11	"11-out6877"	.71291	298	120	418
11	"11-out6878"	.42062	718	989	1707
11	"11-out6879"	.37945	746	1220	1966
11	"11-out6880"	.99186	1220	10	1230
11	"11-out6881"	.29246	167	404	571
11	"11-out6882"	.35156	90	166	256
11	"11-out6883"	.59740	92	62	154
11	"11-out6884"	.44094	2296	2911	5207
11	"11-out6885"	.96666	174	6	180
11	"11-out6886"	.52884	165	147	312
11	"11-out6887"	.37190	135	228	363
11	"11-out6888"	.18466	53	234	287
11	"11-out6889"	.74698	248	84	332
11	"11-out6890"	.50592	128	125	253
11	"11-out6891"	.70848	401	165	566
11	"11-out6892"	.13636	24	152	176
11	"11-out6893"	.35380	121	221	342
11	"11-out6894"	.52605	212	191	403
11	"11-out6895"	.35011	292	542	834
11	"11-out6896"	.26729	85	233	318
11	"11-out6897"	.38308	77	124	201
11	"11-out6898"	.99080	431	4	435
11	"11-out6899"	.61376	321	202	523
11	"11-out6900"	.41588	89	125	214
11	"11-out6901"	.99669	302	1	303
11	"11-out6902"	.58940	89	62	151
11	"11-out6903"	.74452	102	35	137
11	"11-out6904"	.36413	134	234	368
11	"11-out6905"	.39948	155	233	388
11	"11-out6906"	.89285	125	15	140
11	"11-out6907"	.50000	58	58	116
11	"11-out6908"	.34108	44	85	129
11	"11-out6909"	.53398	220	192	412
11	"11-out6910"	.32114	123	260	383
11	"11-out6911"	.37455	106	177	283
11	"11-out6912"	.70387	309	130	439
11	"11-out6913"	.61609	268	167	435
11	"11-out6914"	.99791	479	1	480
11	"11-out6915"	.99509	203	1	204
11	"11-out6916"	.48172	224	241	465
11	"11-out6917"	.26061	135	383	518
11	"11-out6918"	.15517	81	441	522
11	"11-out6919"	.23121	80	266	346
11	"11-out6920"	.88654	797	102	899
11	"11-out6921"	.58076	151	109	260
11	"11-out6922"	.46530	114	131	245
11	"11-out6923"	.85084	251	44	295
11	"11-out6924"	.38625	163	259	422
11	"11-out6925"	.57711	232	170	402
11	"11-out6926"	.93830	365	24	389
11	"11-out6927"	.49084	134	139	273
11	"11-out6928"	.84070	190	36	226
11	"11-out6929"	.99122	113	1	114
11	"11-out6930"	.45549	481	575	1056
11	"11-out6931"	.35351	362	662	1024
11	"11-out6932"	.26588	205	566	771
11	"11-out6933"	.75135	139	46	185
11	"11-out6934"	.36997	313	533	846
11	"11-out6935"	.81297	213	49	262
11	"11-out6936"	.53560	361	313	674
11	"11-out6937"	.23936	45	143	188
11	"11-out6938"	.40936	201	290	491
11	"11-out6939"	.98148	53	1	54
11	"11-out6940"	.95934	472	20	492
11	"11-out6941"	.40113	564	842	1406
11	"11-out6942"	.45995	672	789	1461
11	"11-out6943"	.25862	330	946	1276
11	"11-out6944"	.98387	305	5	310
11	"11-out6945"	.33936	732	1425	2157
11	"11-out6946"	.29454	243	582	825
11	"11-out6947"	.21704	135	487	622
11	"11-out6948"	.45108	249	303	552
11	"11-out6949"	.99843	640	1	641
11	"11-out6950"	.38344	227	365	592
11	"11-out6951"	.32250	129	271	400
11	"11-out6952"	.52964	134	119	253
11	"11-out6953"	.53424	117	102	219
11	"11-out6954"	.99733	374	1	375
11	"11-out6955"	.43597	143	185	328
11	"11-out6956"	.98850	86	1	87
11	"11-out6957"	.99680	312	1	313
11	"11-out6958"	.72979	316	117	433
11	"11-out6959"	.99285	278	2	280
11	"11-out6960"	.41888	173	240	413
11	"11-out6961"	.30061	98	228	326
11	"11-out6962"	.48275	196	210	406
11	"11-out6963"	.48396	166	177	343
11	"11-out6964"	.50902	141	136	277
11	"11-out6965"	.48611	245	259	504
11	"11-out6966"	.87444	794	114	908
11	"11-out6967"	.97489	233	6	239
11	"11-out6968"	.37636	207	343	550
11	"11-out6969"	.99099	110	1	111
11	"11-out6970"	.27450	28	74	102
11	"11-out6971"	.60130	92	61	153
11	"11-out6972"	.37379	311	521	832
11	"11-out6973"	.33064	82	166	248
11	"11-out6974"	.96893	655	21	676
11	"11-out6975"	.57812	74	54	128
11	"11-out6976"	.99925	1345	1	1346
11	"11-out6977"	.66968	148	73	221
11	"11-out6978"	.67123	147	72	219
11	"11-out6979"	.49673	152	154	306
11	"11-out6980"	.99545	219	1	220
11	"11-out6981"	.26988	95	257	352
11	"11-out6982"	.64062	164	92	256
11	"11-out6983"	.12500	33	231	264
11	"11-out6984"	.42187	108	148	256
11	"11-out6985"	.96897	406	13	419
11	"11-out6986"	.40609	80	117	197
11	"11-out6987"	.35039	89	165	254
11	"11-out6988"	.37380	117	196	313
11	"11-out6989"	.97472	270	7	277
11	"11-out6990"	.73214	246	90	336
11	"11-out6991"	.38394	177	284	461
11	"11-out6992"	.53392	299	261	560
11	"11-out6993"	.38342	199	320	519
11	"11-out6994"	.99285	139	1	140
11	"11-out6995"	.30861	154	345	499
11	"11-out6996"	.41176	140	200	340
11	"11-out6997"	.99371	316	2	318
11	"11-out6998"	.65614	603	316	919
11	"11-out6999"	.14611	32	187	219
11	"11-out7000"	.80263	366	90	456
11	"11-out7001"	.21981	162	575	737
11	"11-out7002"	.46276	87	101	188
11	"11-out7003"	.47445	130	144	274
11	"11-out7004"	.99324	147	1	148
11	"11-out7005"	.39145	229	356	585
11	"11-out7006"	.56521	143	110	253
11	"11-out7007"	.26315	110	308	418
11	"11-out7008"	.99697	330	1	331
11	"11-out7009"	.27800	67	174	241
11	"11-out7010"	.98913	182	2	184
11	"11-out7011"	.97074	365	11	376
11	"11-out7012"	.27314	59	157	216
11	"11-out7013"	.98122	418	8	426
11	"11-out7014"	.97222	315	9	324
11	"11-out7015"	.42857	270	360	630
11	"11-out7016"	.99790	477	1	478
11	"11-out7017"	.50783	486	471	957
11	"11-out7018"	.99789	473	1	474
11	"11-out7019"	.98044	351	7	358
11	"11-out7020"	.99086	217	2	219
11	"11-out7021"	.31313	248	544	792
11	"11-out7022"	.42845	524	699	1223
11	"11-out7023"	.99425	173	1	174
11	"11-out7024"	.51257	163	155	318
11	"11-out7025"	.37586	109	181	290
11	"11-out7026"	.44333	133	167	300
11	"11-out7027"	.17991	43	196	239
11	"11-out7028"	.22826	63	213	276
11	"11-out7029"	.49075	292	303	595
11	"11-out7030"	.90384	282	30	312
11	"11-out7031"	.99792	482	1	483
11	"11-out7032"	.99791	478	1	479
11	"11-out7033"	.99789	473	1	474
11	"11-out7034"	.99789	475	1	476
11	"11-out7035"	.32460	124	258	382
11	"11-out7036"	.99790	477	1	478
11	"11-out7037"	.99337	150	1	151
11	"11-out7038"	.99547	220	1	221
11	"11-out7039"	.99547	220	1	221
11	"11-out7040"	.99789	474	1	475
11	"11-out7041"	.51801	115	107	222
11	"11-out7042"	.42665	733	985	1718
11	"11-out7043"	.39114	106	165	271
11	"11-out7044"	.48598	104	110	214
11	"11-out7045"	.41642	426	597	1023
11	"11-out7046"	.37299	348	585	933
11	"11-out7047"	.38279	178	287	465
11	"11-out7048"	.48943	278	290	568
11	"11-out7049"	.57364	74	55	129
11	"11-out7050"	.29857	63	148	211
11	"11-out7051"	.22515	213	733	946
11	"11-out7052"	.34887	202	377	579
11	"11-out7053"	.70370	133	56	189
11	"11-out7054"	.99619	262	1	263
11	"11-out7055"	.82339	373	80	453
11	"11-out7056"	.29922	924	2164	3088
11	"11-out7057"	.53636	59	51	110
11	"11-out7058"	.25847	61	175	236
11	"11-out7059"	.54244	262	221	483
11	"11-out7060"	.35087	80	148	228
11	"11-out7061"	.87040	450	67	517
11	"11-out7062"	.29989	281	656	937
11	"11-out7063"	.19088	180	763	943
11	"11-out7064"	.26577	139	384	523
11	"11-out7065"	.24680	116	354	470
11	"11-out7066"	.23745	123	395	518
11	"11-out7067"	.96894	312	10	322
11	"11-out7068"	.21612	134	486	620
11	"11-out7069"	.97186	380	11	391
11	"11-out7070"	.28961	53	130	183
11	"11-out7071"	.99047	104	1	105
11	"11-out7072"	.99047	104	1	105
11	"11-out7073"	.31204	303	668	971
11	"11-out7074"	.32523	241	500	741
11	"11-out7075"	.35047	259	480	739
11	"11-out7076"	.86714	483	74	557
11	"11-out7077"	.36815	74	127	201
11	"11-out7078"	.28968	73	179	252
11	"11-out7079"	.52941	135	120	255
11	"11-out7080"	.33852	87	170	257
11	"11-out7081"	.22751	43	146	189
11	"11-out7082"	.97630	206	5	211
11	"11-out7083"	.99397	165	1	166
11	"11-out7084"	.99397	165	1	166
11	"11-out7085"	.37649	471	780	1251
11	"11-out7086"	.40670	1273	1857	3130
11	"11-out7087"	.99651	286	1	287
11	"11-out7088"	.69377	401	177	578
11	"11-out7089"	.24793	90	273	363
11	"11-out7090"	.30042	140	326	466
11	"11-out7091"	.92744	294	23	317
11	"11-out7092"	.36159	354	625	979
11	"11-out7093"	.96529	306	11	317
11	"11-out7094"	.45176	295	358	653
11	"11-out7095"	.32061	437	926	1363
11	"11-out7096"	.84112	180	34	214
11	"11-out7097"	.43099	178	235	413
11	"11-out7098"	.53092	558	493	1051
11	"11-out7099"	.62087	226	138	364
11	"11-out7100"	.39430	429	659	1088
11	"11-out7101"	.30128	47	109	156
11	"11-out7102"	.95402	498	24	522
11	"11-out7103"	.41078	99	142	241
11	"11-out7104"	.83129	340	69	409
11	"11-out7105"	.28295	337	854	1191
11	"11-out7106"	.51419	163	154	317
11	"11-out7107"	.99047	104	1	105
11	"11-out7108"	.69154	139	62	201
11	"11-out7109"	.25635	887	2573	3460
11	"11-out7110"	.13961	86	530	616
11	"11-out7111"	.95541	150	7	157
11	"11-out7112"	.43799	279	358	637
11	"11-out7113"	.67592	146	70	216
11	"11-out7114"	.30550	366	832	1198
11	"11-out7115"	.32640	157	324	481
11	"11-out7116"	.35108	824	1523	2347
11	"11-out7117"	.40831	501	726	1227
11	"11-out7118"	.70844	260	107	367
11	"11-out7119"	.33054	79	160	239
11	"11-out7120"	.99593	245	1	246
11	"11-out7121"	.55053	207	169	376
11	"11-out7122"	.33431	114	227	341
11	"11-out7123"	.45146	707	859	1566
11	"11-out7124"	.50000	177	177	354
11	"11-out7125"	.45569	576	688	1264
11	"11-out7126"	.99651	286	1	287
11	"11-out7127"	.38188	215	348	563
11	"11-out7128"	.34892	373	696	1069
11	"11-out7129"	.37903	528	865	1393
11	"11-out7130"	.28481	45	113	158
11	"11-out7131"	.51546	250	235	485
11	"11-out7132"	.41996	223	308	531
11	"11-out7133"	.33333	121	242	363
11	"11-out7134"	.39000	78	122	200
11	"11-out7135"	.95041	115	6	121
11	"11-out7136"	.35294	120	220	340
11	"11-out7137"	.45440	583	700	1283
11	"11-out7138"	.45899	347	409	756
11	"11-out7139"	.35732	283	509	792
11	"11-out7140"	.44444	60	75	135
11	"11-out7141"	.78285	274	76	350
11	"11-out7142"	.72388	97	37	134
11	"11-out7143"	.50450	56	55	111
11	"11-out7144"	.31777	354	760	1114
11	"11-out7145"	.28211	112	285	397
11	"11-out7146"	.43031	494	654	1148
11	"11-out7147"	.30664	157	355	512
11	"11-out7148"	.27074	199	536	735
11	"11-out7149"	.22444	101	349	450
11	"11-out7150"	.31924	136	290	426
11	"11-out7151"	.72507	240	91	331
11	"11-out7152"	.42168	595	816	1411
11	"11-out7153"	.40584	125	183	308
11	"11-out7154"	.20074	54	215	269
11	"11-out7155"	.55300	433	350	783
11	"11-out7156"	.33519	300	595	895
11	"11-out7157"	.33908	334	651	985
11	"11-out7158"	.54415	191	160	351
11	"11-out7159"	.33407	151	301	452
11	"11-out7160"	.99438	177	1	178
11	"11-out7161"	.99526	210	1	211
11	"11-out7162"	.60994	319	204	523
11	"11-out7163"	.97280	322	9	331
11	"11-out7164"	.99647	283	1	284
11	"11-out7165"	.88124	1076	145	1221
11	"11-out7166"	.23399	95	311	406
11	"11-out7167"	.77488	327	95	422
11	"11-out7168"	.24547	190	584	774
11	"11-out7169"	.49488	290	296	586
11	"11-out7170"	.25000	65	195	260
11	"11-out7171"	.31939	84	179	263
11	"11-out7172"	.27385	198	525	723
11	"11-out7173"	.77848	492	140	632
11	"11-out7174"	.40422	249	367	616
11	"11-out7175"	.31578	138	299	437
11	"11-out7176"	.35775	332	596	928
11	"11-out7177"	.34146	70	135	205
11	"11-out7178"	.53591	97	84	181
11	"11-out7179"	.24788	117	355	472
11	"11-out7180"	.42424	210	285	495
11	"11-out7181"	.36666	66	114	180
11	"11-out7182"	.30656	42	95	137
11	"11-out7183"	.28362	97	245	342
11	"11-out7184"	.44028	188	239	427
11	"11-out7185"	.32835	66	135	201
11	"11-out7186"	.99809	525	1	526
11	"11-out7187"	.85555	231	39	270
11	"11-out7188"	.55337	197	159	356
11	"11-out7189"	.23255	110	363	473
11	"11-out7190"	.31955	116	247	363
11	"11-out7191"	.49226	191	197	388
11	"11-out7192"	.34210	52	100	152
11	"11-out7193"	.32701	69	142	211
11	"11-out7194"	.29105	218	531	749
11	"11-out7195"	.41959	227	314	541
11	"11-out7196"	.99065	106	1	107
11	"11-out7197"	.70072	96	41	137
11	"11-out7198"	.99065	212	2	214
11	"11-out7199"	.93868	444	29	473
11	"11-out7200"	.99122	226	2	228
11	"11-out7201"	.99122	226	2	228
11	"11-out7202"	.33781	226	443	669
11	"11-out7203"	.47894	91	99	190
11	"11-out7204"	.26458	254	706	960
11	"11-out7205"	.75487	271	88	359
11	"11-out7206"	.50059	422	421	843
11	"11-out7207"	.41112	414	593	1007
11	"11-out7208"	.76981	408	122	530
11	"11-out7209"	.46192	91	106	197
11	"11-out7210"	.76991	87	26	113
11	"11-out7211"	.99596	494	2	496
11	"11-out7212"	.31189	97	214	311
11	"11-out7213"	.99596	494	2	496
11	"11-out7214"	.99596	494	2	496
11	"11-out7215"	.28481	90	226	316
11	"11-out7216"	.99047	104	1	105
11	"11-out7217"	.98260	113	2	115
11	"11-out7218"	.55115	167	136	303
11	"11-out7219"	.35204	69	127	196
11	"11-out7220"	.24626	33	101	134
11	"11-out7221"	.27633	160	419	579
11	"11-out7222"	.38157	464	752	1216
11	"11-out7223"	.37583	112	186	298
11	"11-out7224"	.49056	624	648	1272
11	"11-out7225"	.50828	276	267	543
11	"11-out7226"	.99425	173	1	174
11	"11-out7227"	.82019	333	73	406
11	"11-out7228"	.22765	135	458	593
11	"11-out7229"	.33474	79	157	236
11	"11-out7230"	.28466	232	583	815
11	"11-out7231"	.99652	287	1	288
11	"11-out7232"	.39262	298	461	759
11	"11-out7233"	.43589	510	660	1170
11	"11-out7234"	.51957	146	135	281
11	"11-out7235"	.32725	305	627	932
11	"11-out7236"	.30294	113	260	373
11	"11-out7237"	.42592	46	62	108
11	"11-out7238"	.99596	494	2	496
11	"11-out7239"	.53776	178	153	331
11	"11-out7240"	.53965	592	505	1097
11	"11-out7241"	.95588	455	21	476
11	"11-out7242"	.26633	53	146	199
11	"11-out7243"	.20000	27	108	135
11	"11-out7244"	.38123	191	310	501
11	"11-out7245"	.50563	359	351	710
11	"11-out7246"	.99393	164	1	165
11	"11-out7247"	.99684	316	1	317
11	"11-out7248"	.33771	154	302	456
11	"11-out7249"	.73437	141	51	192
11	"11-out7250"	.65771	98	51	149
11	"11-out7251"	.99363	156	1	157
11	"11-out7252"	.99596	247	1	248
11	"11-out7253"	.98648	146	2	148
11	"11-out7254"	.99371	158	1	159
11	"11-out7255"	.42769	139	186	325
11	"11-out7256"	.59016	180	125	305
11	"11-out7257"	.44194	118	149	267
11	"11-out7258"	.21379	31	114	145
11	"11-out7259"	.45167	229	278	507
11	"11-out7260"	.75531	142	46	188
11	"11-out7261"	.33092	183	370	553
11	"11-out7262"	.36225	167	294	461
11	"11-out7263"	.34246	450	864	1314
11	"11-out7264"	.35531	167	303	470
11	"11-out7265"	.59700	637	430	1067
11	"11-out7266"	.45731	150	178	328
11	"11-out7267"	.62361	338	204	542
11	"11-out7268"	.99337	150	1	151
11	"11-out7269"	.47857	916	998	1914
11	"11-out7270"	.22222	48	168	216
11	"11-out7271"	.91187	238	23	261
11	"11-out7272"	.66400	166	84	250
11	"11-out7273"	.29629	152	361	513
11	"11-out7274"	.67706	304	145	449
11	"11-out7275"	.41290	64	91	155
11	"11-out7276"	.41304	38	54	92
11	"11-out7277"	.96153	375	15	390
11	"11-out7278"	.89436	127	15	142
11	"11-out7279"	.29729	44	104	148
11	"11-out7280"	.44051	137	174	311
11	"11-out7281"	.37881	186	305	491
11	"11-out7282"	.21132	112	418	530
11	"11-out7283"	.62721	212	126	338
11	"11-out7284"	.18725	47	204	251
11	"11-out7285"	.79099	246	65	311
11	"11-out7286"	.40140	399	595	994
11	"11-out7287"	.17351	76	362	438
11	"11-out7288"	.93877	230	15	245
11	"11-out7289"	.67782	749	356	1105
11	"11-out7290"	.75974	117	37	154
11	"11-out7291"	.22435	35	121	156
11	"11-out7292"	.42624	549	739	1288
11	"11-out7293"	.30732	130	293	423
11	"11-out7294"	.38596	88	140	228
11	"11-out7295"	.29934	91	213	304
11	"11-out7296"	.45280	283	342	625
11	"11-out7297"	.56204	77	60	137
11	"11-out7298"	.20512	32	124	156
11	"11-out7299"	.42440	160	217	377
11	"11-out7300"	.25991	59	168	227
11	"11-out7301"	.85416	369	63	432
11	"11-out7302"	.65384	102	54	156
11	"11-out7303"	.38791	533	841	1374
11	"11-out7304"	.62881	371	219	590
11	"11-out7305"	.29708	153	362	515
11	"11-out7306"	.28637	124	309	433
11	"11-out7307"	.61100	655	417	1072
11	"11-out7308"	.78421	149	41	190
11	"11-out7309"	.36036	160	284	444
11	"11-out7310"	.42496	589	797	1386
11	"11-out7311"	.99624	265	1	266
11	"11-out7312"	.78250	313	87	400
11	"11-out7313"	.41525	294	414	708
11	"11-out7314"	.46299	269	312	581
11	"11-out7315"	.32394	161	336	497
11	"11-out7316"	.85714	66	11	77
11	"11-out7317"	.28837	62	153	215
11	"11-out7318"	.58461	38	27	65
11	"11-out7319"	.90196	598	65	663
11	"11-out7320"	.98757	159	2	161
11	"11-out7321"	.99598	248	1	249
11	"11-out7322"	.29689	220	521	741
11	"11-out7323"	.39371	213	328	541
11	"11-out7324"	.38347	311	500	811
11	"11-out7325"	.48059	780	843	1623
11	"11-out7326"	.20258	47	185	232
11	"11-out7327"	.15418	35	192	227
11	"11-out7328"	.11475	28	216	244
11	"11-out7329"	.48379	209	223	432
11	"11-out7330"	.71678	491	194	685
11	"11-out7331"	.48659	236	249	485
11	"11-out7332"	.59756	98	66	164
11	"11-out7333"	.28039	113	290	403
11	"11-out7334"	.25555	46	134	180
11	"11-out7335"	.49397	82	84	166
11	"11-out7336"	.85443	135	23	158
11	"11-out7337"	.99319	146	1	147
11	"11-out7338"	.44904	141	173	314
11	"11-out7339"	.25000	58	174	232
11	"11-out7340"	.28037	120	308	428
11	"11-out7341"	.73856	113	40	153
11	"11-out7342"	.40500	162	238	400
11	"11-out7343"	.46296	200	232	432
11	"11-out7344"	.40646	352	514	866
11	"11-out7345"	.43848	278	356	634
11	"11-out7346"	.40883	148	214	362
11	"11-out7347"	.25287	198	585	783
11	"11-out7348"	.42741	53	71	124
11	"11-out7349"	.05844	9	145	154
11	"11-out7350"	.31155	62	137	199
11	"11-out7351"	.26818	59	161	220
11	"11-out7352"	.47014	126	142	268
11	"11-out7353"	.41342	117	166	283
11	"11-out7354"	.64187	233	130	363
11	"11-out7355"	.45512	142	170	312
11	"11-out7356"	.45092	147	179	326
11	"11-out7357"	.35112	513	948	1461
11	"11-out7358"	.59166	71	49	120
11	"11-out7359"	.08256	9	100	109
11	"11-out7360"	.71556	561	223	784
11	"11-out7361"	.18576	248	1087	1335
11	"11-out7362"	.55158	139	113	252
11	"11-out7363"	.67150	370	181	551
11	"11-out7364"	.99596	494	2	496
11	"11-out7365"	.36908	117	200	317
11	"11-out7366"	.99494	197	1	198
11	"11-out7367"	.47023	158	178	336
11	"11-out7368"	.99047	104	1	105
11	"11-out7369"	.38345	102	164	266
11	"11-out7370"	.26383	329	918	1247
11	"11-out7371"	.42003	260	359	619
11	"11-out7372"	.48849	191	200	391
11	"11-out7373"	.75000	81	27	108
11	"11-out7374"	.34411	117	223	340
11	"11-out7375"	.31111	224	496	720
11	"11-out7376"	.29565	34	81	115
11	"11-out7377"	.41818	69	96	165
11	"11-out7378"	.27258	175	467	642
11	"11-out7379"	.91868	418	37	455
11	"11-out7380"	.99811	529	1	530
11	"11-out7381"	.52554	288	260	548
11	"11-out7382"	.32098	78	165	243
11	"11-out7383"	.10810	20	165	185
11	"11-out7384"	.62812	201	119	320
11	"11-out7385"	.41570	217	305	522
11	"11-out7386"	.99358	465	3	468
11	"11-out7387"	.41617	211	296	507
11	"11-out7388"	.28543	292	731	1023
11	"11-out7389"	.15328	42	232	274
11	"11-out7390"	.79238	229	60	289
11	"11-out7391"	.50720	176	171	347
11	"11-out7392"	.32344	109	228	337
11	"11-out7393"	.38461	120	192	312
11	"11-out7394"	.56292	492	382	874
11	"11-out7395"	.34285	48	92	140
11	"11-out7396"	.99919	1248	1	1249
11	"11-out7397"	.99880	833	1	834
11	"11-out7398"	.99918	1228	1	1229
11	"11-out7399"	.90753	265	27	292
11	"11-out7400"	.33783	100	196	296
11	"11-out7401"	.31827	155	332	487
11	"11-out7402"	.30985	585	1303	1888
11	"11-out7403"	.89108	180	22	202
11	"11-out7404"	.38596	154	245	399
11	"11-out7405"	.30226	120	277	397
11	"11-out7406"	.25355	107	315	422
11	"11-out7407"	.47731	284	311	595
11	"11-out7408"	.31830	120	257	377
11	"11-out7409"	.30660	501	1133	1634
11	"11-out7410"	.49695	163	165	328
11	"11-out7411"	.99721	358	1	359
11	"11-out7412"	.46346	222	257	479
11	"11-out7413"	.49272	237	244	481
11	"11-out7414"	.29719	159	376	535
11	"11-out7415"	.22709	114	388	502
11	"11-out7416"	.47058	392	441	833
11	"11-out7417"	.52554	144	130	274
11	"11-out7418"	.96754	805	27	832
11	"11-out7419"	.28176	224	571	795
11	"11-out7420"	.32104	148	313	461
11	"11-out7421"	.45911	292	344	636
11	"11-out7422"	.21416	127	466	593
11	"11-out7423"	.57500	184	136	320
11	"11-out7424"	.45476	372	446	818
11	"11-out7425"	.92843	480	37	517
11	"11-out7426"	.36631	311	538	849
11	"11-out7427"	.59876	97	65	162
11	"11-out7428"	.98170	161	3	164
11	"11-out7429"	.98170	161	3	164
11	"11-out7430"	.98170	161	3	164
11	"11-out7431"	.98170	161	3	164
11	"11-out7432"	.64719	554	302	856
11	"11-out7433"	.54383	366	307	673
11	"11-out7434"	.40834	225	326	551
11	"11-out7435"	.16111	116	604	720
11	"11-out7436"	.26955	324	878	1202
11	"11-out7437"	.99019	303	3	306
11	"11-out7438"	.98717	77	1	78
11	"11-out7439"	.74698	62	21	83
11	"11-out7440"	.98901	90	1	91
11	"11-out7441"	.41414	41	58	99
11	"11-out7442"	.99152	117	1	118
11	"11-out7443"	.98947	94	1	95
11	"11-out7444"	.34328	23	44	67
11	"11-out7445"	.99259	134	1	135
11	"11-out7446"	.99418	171	1	172
11	"11-out7447"	.99342	151	1	152
11	"11-out7448"	.99019	101	1	102
11	"11-out7449"	.98924	92	1	93
11	"11-out7450"	.76949	671	201	872
11	"11-out7451"	.98529	67	1	68
11	"11-out7452"	.43666	455	587	1042
11	"11-out7453"	.37250	149	251	400
11	"11-out7454"	.36939	280	478	758
11	"11-out7455"	.32571	57	118	175
11	"11-out7456"	.56690	161	123	284
11	"11-out7457"	.53264	155	136	291
11	"11-out7458"	.41566	138	194	332
11	"11-out7459"	.99729	737	2	739
11	"11-out7460"	.46491	318	366	684
11	"11-out7461"	.41071	299	429	728
11	"11-out7462"	.93706	938	63	1001
11	"11-out7463"	.26847	218	594	812
11	"11-out7464"	.35379	317	579	896
11	"11-out7465"	.34828	233	436	669
11	"11-out7466"	.40775	263	382	645
11	"11-out7467"	.40223	216	321	537
11	"11-out7468"	.46975	528	596	1124
11	"11-out7469"	.29552	99	236	335
11	"11-out7470"	.31228	89	196	285
11	"11-out7471"	.49480	143	146	289
11	"11-out7472"	.34420	95	181	276
11	"11-out7473"	.26053	68	193	261
11	"11-out7474"	.48676	515	543	1058
11	"11-out7475"	.28973	443	1086	1529
11	"11-out7476"	.41295	510	725	1235
11	"11-out7477"	.90233	813	88	901
11	"11-out7478"	.98442	569	9	578
11	"11-out7479"	.34100	311	601	912
11	"11-out7480"	.15555	133	722	855
11	"11-out7481"	.62139	151	92	243
11	"11-out7482"	.26592	96	265	361
11	"11-out7483"	.36628	226	391	617
11	"11-out7484"	.28571	58	145	203
11	"11-out7485"	.46774	116	132	248
11	"11-out7486"	.28603	129	322	451
11	"11-out7487"	.90697	234	24	258
11	"11-out7488"	.29177	110	267	377
11	"11-out7489"	.99295	141	1	142
11	"11-out7490"	1.00000	2	0	2
11	"11-out7491"	.33705	181	356	537
11	"11-out7492"	.36383	163	285	448
11	"11-out7493"	.98207	493	9	502
11	"11-out7494"	.27450	42	111	153
11	"11-out7495"	.48255	166	178	344
11	"11-out7496"	.46202	73	85	158
11	"11-out7497"	.99453	182	1	183
11	"11-out7498"	.50253	99	98	197
11	"11-out7499"	.28791	112	277	389
11	"11-out7500"	.94594	70	4	74
11	"11-out7501"	.97923	943	20	963
11	"11-out7502"	.72702	269	101	370
11	"11-out7503"	.40263	153	227	380
11	"11-out7504"	.27133	248	666	914
11	"11-out7505"	.40114	1051	1569	2620
11	"11-out7506"	.48521	443	470	913
11	"11-out7507"	.35350	333	609	942
11	"11-out7508"	.45454	370	444	814
11	"11-out7509"	.33013	344	698	1042
11	"11-out7510"	.32848	226	462	688
11	"11-out7511"	.37549	659	1096	1755
11	"11-out7512"	.30352	129	296	425
11	"11-out7513"	.41732	212	296	508
11	"11-out7514"	.40490	198	291	489
11	"11-out7515"	.91680	551	50	601
11	"11-out7516"	.30961	161	359	520
11	"11-out7517"	.74131	192	67	259
11	"11-out7518"	.32507	105	218	323
11	"11-out7519"	.24187	67	210	277
11	"11-out7520"	.97495	2491	64	2555
11	"11-out7521"	.17787	82	379	461
11	"11-out7522"	.28325	115	291	406
11	"11-out7523"	.52286	503	459	962
11	"11-out7524"	.16909	116	570	686
11	"11-out7525"	.32896	402	820	1222
11	"11-out7526"	.99519	207	1	208
11	"11-out7527"	.99778	451	1	452
11	"11-out7528"	.99678	310	1	311
11	"11-out7529"	.99834	603	1	604
11	"11-out7530"	.99285	139	1	140
11	"11-out7531"	.99453	182	1	183
11	"11-out7532"	.98924	92	1	93
11	"11-out7533"	.99346	152	1	153
11	"11-out7534"	.99386	162	1	163
11	"11-out7535"	.99551	222	1	223
11	"11-out7536"	.99567	230	1	231
11	"11-out7537"	.98734	78	1	79
11	"11-out7538"	.99728	368	1	369
11	"11-out7539"	.99280	138	1	139
11	"11-out7540"	.31861	404	864	1268
11	"11-out7541"	.29061	195	476	671
11	"11-out7542"	.26723	221	606	827
11	"11-out7543"	.68390	357	165	522
11	"11-out7544"	.99745	392	1	393
11	"11-out7545"	.99549	221	1	222
11	"11-out7546"	.52380	77	70	147
11	"11-out7547"	.78212	140	39	179
11	"11-out7548"	.85371	747	128	875
11	"11-out7549"	.37950	411	672	1083
11	"11-out7550"	.39878	197	297	494
11	"11-out7551"	.28141	159	406	565
11	"11-out7552"	.20826	126	479	605
11	"11-out7553"	.38757	524	828	1352
11	"11-out7554"	.74314	1192	412	1604
11	"11-out7555"	.28319	305	772	1077
11	"11-out7556"	.46463	473	545	1018
11	"11-out7557"	.40145	552	823	1375
11	"11-out7558"	.40483	419	616	1035
11	"11-out7559"	.29075	280	683	963
11	"11-out7560"	.27506	299	788	1087
11	"11-out7561"	.38956	418	655	1073
11	"11-out7562"	.25757	221	637	858
11	"11-out7563"	.27231	180	481	661
11	"11-out7564"	.82532	515	109	624
11	"11-out7565"	.27789	132	343	475
11	"11-out7566"	.16475	43	218	261
11	"11-out7567"	.48615	158	167	325
11	"11-out7568"	.99646	282	1	283
11	"11-out7569"	.36231	50	88	138
11	"11-out7570"	.62921	336	198	534
11	"11-out7571"	.78225	97	27	124
11	"11-out7572"	.45962	74	87	161
11	"11-out7573"	.23452	72	235	307
11	"11-out7574"	.36518	172	299	471
11	"11-out7575"	.36526	61	106	167
11	"11-out7576"	.44206	351	443	794
11	"11-out7577"	.54419	825	691	1516
11	"11-out7578"	.99382	322	2	324
11	"11-out7579"	.35314	202	370	572
11	"11-out7580"	.42713	85	114	199
11	"11-out7581"	.98947	94	1	95
11	"11-out7582"	.22000	22	78	100
11	"11-out7583"	.53191	75	66	141
11	"11-out7584"	.19924	106	426	532
11	"11-out7585"	.99545	219	1	220
11	"11-out7586"	.98550	68	1	69
11	"11-out7587"	.26418	135	376	511
11	"11-out7588"	.15609	32	173	205
11	"11-out7589"	.82685	234	49	283
11	"11-out7590"	.49693	1865	1888	3753
11	"11-out7591"	1.00000	156	0	156
11	"11-out7592"	.35332	218	399	617
11	"11-out7593"	.99610	256	1	257
11	"11-out7594"	.26385	119	332	451
11	"11-out7595"	.35909	79	141	220
11	"11-out7596"	.25000	102	306	408
11	"11-out7597"	.39197	127	197	324
11	"11-out7598"	.32211	67	141	208
11	"11-out7599"	.39285	88	136	224
11	"11-out7600"	.99373	317	2	319
11	"11-out7601"	.51917	176	163	339
11	"11-out7602"	.43209	140	184	324
11	"11-out7603"	.61212	101	64	165
11	"11-out7604"	.19711	41	167	208
11	"11-out7605"	.37931	165	270	435
11	"11-out7606"	.31339	110	241	351
11	"11-out7607"	.27947	64	165	229
11	"11-out7608"	.55813	72	57	129
11	"11-out7609"	.38438	256	410	666
11	"11-out7610"	.50972	262	252	514
11	"11-out7611"	.29411	40	96	136
11	"11-out7612"	.26840	113	308	421
11	"11-out7613"	.40740	66	96	162
11	"11-out7614"	.29298	167	403	570
11	"11-out7615"	.32916	79	161	240
11	"11-out7616"	.45045	250	305	555
11	"11-out7617"	.43448	63	82	145
11	"11-out7618"	.55208	159	129	288
11	"11-out7619"	.94088	191	12	203
11	"11-out7620"	.35013	132	245	377
11	"11-out7621"	.39583	133	203	336
11	"11-out7622"	.51282	80	76	156
11	"11-out7623"	.98785	244	3	247
11	"11-out7624"	.61325	111	70	181
11	"11-out7625"	.63474	570	328	898
11	"11-out7626"	.23522	211	686	897
11	"11-out7627"	.28571	98	245	343
11	"11-out7628"	.42807	122	163	285
11	"11-out7629"	.32283	82	172	254
11	"11-out7630"	.38768	107	169	276
11	"11-out7631"	.24040	263	831	1094
11	"11-out7632"	.38802	324	511	835
11	"11-out7633"	.27036	156	421	577
11	"11-out7634"	.37843	193	317	510
11	"11-out7635"	.48190	293	315	608
11	"11-out7636"	.42775	447	598	1045
11	"11-out7637"	.25674	257	744	1001
11	"11-out7638"	.35483	66	120	186
11	"11-out7639"	.79710	495	126	621
11	"11-out7640"	.55424	424	341	765
11	"11-out7641"	.99285	139	1	140
11	"11-out7642"	.42541	77	104	181
11	"11-out7643"	.34381	678	1294	1972
11	"11-out7644"	.99285	139	1	140
11	"11-out7645"	.43623	626	809	1435
11	"11-out7646"	.33258	149	299	448
11	"11-out7647"	.99233	518	4	522
11	"11-out7648"	.22386	257	891	1148
11	"11-out7649"	.99428	174	1	175
11	"11-out7650"	.76943	297	89	386
11	"11-out7651"	.38007	206	336	542
11	"11-out7652"	.99107	111	1	112
11	"11-out7653"	.99082	108	1	109
11	"11-out7654"	.99107	111	1	112
11	"11-out7655"	.99115	112	1	113
11	"11-out7656"	.99107	111	1	112
11	"11-out7657"	.99122	113	1	114
11	"11-out7658"	.99047	104	1	105
11	"11-out7659"	.98214	110	2	112
11	"11-out7660"	.99082	108	1	109
11	"11-out7661"	.98165	107	2	109
11	"11-out7662"	.99159	118	1	119
11	"11-out7663"	.99115	112	1	113
11	"11-out7664"	.99115	112	1	113
11	"11-out7665"	.99122	113	1	114
11	"11-out7666"	.99115	112	1	113
11	"11-out7667"	.99107	111	1	112
11	"11-out7668"	.99122	113	1	114
11	"11-out7669"	.99130	114	1	115
11	"11-out7670"	.99082	108	1	109
11	"11-out7671"	.99193	123	1	124
11	"11-out7672"	.98260	113	2	115
11	"11-out7673"	.99099	110	1	111
11	"11-out7674"	.99130	114	1	115
11	"11-out7675"	.99122	113	1	114
11	"11-out7676"	.99130	114	1	115
11	"11-out7677"	.99099	110	1	111
11	"11-out7678"	.99122	113	1	114
11	"11-out7679"	.99122	113	1	114
11	"11-out7680"	.99122	113	1	114
11	"11-out7681"	.99122	113	1	114
11	"11-out7682"	.99122	113	1	114
11	"11-out7683"	.60576	189	123	312
11	"11-out7684"	.53061	312	276	588
11	"11-out7685"	.37865	259	425	684
11	"11-out7686"	.77813	242	69	311
11	"11-out7687"	.99659	293	1	294
11	"11-out7688"	.92706	483	38	521
11	"11-out7689"	.62801	130	77	207
11	"11-out7690"	.18666	98	427	525
11	"11-out7691"	.60883	193	124	317
11	"11-out7692"	.28483	323	811	1134
11	"11-out7693"	.35388	155	283	438
11	"11-out7694"	.46470	79	91	170
11	"11-out7695"	.27652	86	225	311
11	"11-out7696"	.24952	131	394	525
11	"11-out7697"	.99746	394	1	395
11	"11-out7698"	.21984	113	401	514
11	"11-out7699"	.99719	356	1	357
11	"11-out7700"	.97005	486	15	501
11	"11-out7701"	.66135	166	85	251
11	"11-out7702"	.33214	279	561	840
11	"11-out7703"	1.00000	156	0	156
11	"11-out7704"	.53921	110	94	204
11	"11-out7705"	.42913	218	290	508
11	"11-out7706"	.81290	126	29	155
11	"11-out7707"	.92436	110	9	119
11	"11-out7708"	.96244	205	8	213
11	"11-out7709"	.57586	167	123	290
11	"11-out7710"	.52407	185	168	353
11	"11-out7711"	.99009	100	1	101
11	"11-out7712"	.40769	212	308	520
11	"11-out7713"	.66972	219	108	327
11	"11-out7714"	.41754	119	166	285
11	"11-out7715"	1.00000	156	0	156
11	"11-out7716"	1.00000	156	0	156
11	"11-out7717"	.57894	165	120	285
11	"11-out7718"	.30868	167	374	541
11	"11-out7719"	.59012	275	191	466
11	"11-out7720"	.43761	228	293	521
11	"11-out7721"	.90338	187	20	207
11	"11-out7722"	.47511	105	116	221
11	"11-out7723"	.39692	181	275	456
11	"11-out7724"	.27317	330	878	1208
11	"11-out7725"	.31527	320	695	1015
11	"11-out7726"	.42664	317	426	743
11	"11-out7727"	.28367	219	553	772
11	"11-out7728"	.83812	642	124	766
11	"11-out7729"	.39712	166	252	418
11	"11-out7730"	.27101	245	659	904
11	"11-out7731"	.29767	64	151	215
11	"11-out7732"	.99122	113	1	114
11	"11-out7733"	.29600	37	88	125
11	"11-out7734"	.26288	51	143	194
11	"11-out7735"	.94285	99	6	105
11	"11-out7736"	.44210	168	212	380
11	"11-out7737"	.54448	153	128	281
11	"11-out7738"	.38931	102	160	262
11	"11-out7739"	.39849	106	160	266
11	"11-out7740"	.84474	185	34	219
11	"11-out7741"	.41091	143	205	348
11	"11-out7742"	.37549	95	158	253
11	"11-out7743"	.52012	168	155	323
11	"11-out7744"	.99323	587	4	591
11	"11-out7745"	.99844	641	1	642
11	"11-out7746"	.32964	149	303	452
11	"11-out7747"	.43963	193	246	439
11	"11-out7748"	.45392	867	1043	1910
11	"11-out7749"	.31782	41	88	129
11	"11-out7750"	.28909	61	150	211
11	"11-out7751"	.24692	281	857	1138
11	"11-out7752"	.45098	276	336	612
11	"11-out7753"	.46761	491	559	1050
11	"11-out7754"	.27447	157	415	572
11	"11-out7755"	.99773	440	1	441
11	"11-out7756"	.36686	124	214	338
11	"11-out7757"	.60323	298	196	494
11	"11-out7758"	.52034	422	389	811
11	"11-out7759"	.58015	456	330	786
11	"11-out7760"	.51147	401	383	784
11	"11-out7761"	.23387	116	380	496
11	"11-out7762"	.42635	55	74	129
11	"11-out7763"	.93380	395	28	423
11	"11-out7764"	.46803	205	233	438
11	"11-out7765"	.55625	89	71	160
11	"11-out7766"	.37589	262	435	697
11	"11-out7767"	.27714	97	253	350
11	"11-out7768"	.20202	20	79	99
11	"11-out7769"	.54494	97	81	178
11	"11-out7770"	.46518	147	169	316
11	"11-out7771"	.26589	46	127	173
11	"11-out7772"	.24777	139	422	561
11	"11-out7773"	.44475	161	201	362
11	"11-out7774"	.99574	234	1	235
11	"11-out7775"	.44594	132	164	296
11	"11-out7776"	.74666	224	76	300
11	"11-out7777"	.99740	384	1	385
11	"11-out7778"	.24223	39	122	161
11	"11-out7779"	.26307	161	451	612
11	"11-out7780"	.35265	73	134	207
11	"11-out7781"	.32967	90	183	273
11	"11-out7782"	.38053	86	140	226
11	"11-out7783"	.28971	31	76	107
11	"11-out7784"	.33421	254	506	760
11	"11-out7785"	.36363	100	175	275
11	"11-out7786"	.35636	392	708	1100
11	"11-out7787"	.32579	216	447	663
11	"11-out7788"	.52631	70	63	133
11	"11-out7789"	.43079	277	366	643
11	"11-out7790"	.35569	175	317	492
11	"11-out7791"	.22510	52	179	231
11	"11-out7792"	.38053	86	140	226
11	"11-out7793"	.50214	117	116	233
11	"11-out7794"	.44308	109	137	246
11	"11-out7795"	.55974	89	70	159
11	"11-out7796"	.29180	89	216	305
11	"11-out7797"	.47142	66	74	140
11	"11-out7798"	.42767	272	364	636
11	"11-out7799"	.38208	128	207	335
11	"11-out7800"	.95172	138	7	145
11	"11-out7801"	.40953	627	904	1531
11	"11-out7802"	.36680	179	309	488
11	"11-out7803"	.30818	388	871	1259
11	"11-out7804"	.95918	235	10	245
11	"11-out7805"	.25294	43	127	170
11	"11-out7806"	.54577	155	129	284
11	"11-out7807"	.28846	150	370	520
11	"11-out7808"	.38235	169	273	442
11	"11-out7809"	.99122	113	1	114
11	"11-out7810"	.99122	113	1	114
11	"11-out7811"	.99122	113	1	114
11	"11-out7812"	.99899	992	1	993
11	"11-out7813"	.33870	42	82	124
11	"11-out7814"	.28061	55	141	196
11	"11-out7815"	.48881	153	160	313
11	"11-out7816"	.99295	141	1	142
11	"11-out7817"	.53212	439	386	825
11	"11-out7818"	.27235	67	179	246
11	"11-out7819"	.76666	184	56	240
11	"11-out7820"	.42773	219	293	512
11	"11-out7821"	.79518	66	17	83
11	"11-out7822"	.36926	161	275	436
11	"11-out7823"	.99000	99	1	100
11	"11-out7824"	.38260	44	71	115
11	"11-out7825"	.26760	57	156	213
11	"11-out7826"	.16402	31	158	189
11	"11-out7827"	.30864	75	168	243
11	"11-out7828"	.26591	188	519	707
11	"11-out7829"	.98319	117	2	119
11	"11-out7830"	.59322	70	48	118
11	"11-out7831"	.44531	57	71	128
11	"11-out7832"	.27777	100	260	360
11	"11-out7833"	.92024	150	13	163
11	"11-out7834"	.47058	80	90	170
11	"11-out7835"	.53048	87	77	164
11	"11-out7836"	.32532	149	309	458
11	"11-out7837"	.20129	62	246	308
11	"11-out7838"	.98437	63	1	64
11	"11-out7839"	.41723	368	514	882
11	"11-out7840"	.29784	249	587	836
11	"11-out7841"	.37614	82	136	218
11	"11-out7842"	.52024	167	154	321
11	"11-out7843"	.98884	266	3	269
11	"11-out7844"	.36842	175	300	475
11	"11-out7845"	.39857	112	169	281
11	"11-out7846"	.34170	68	131	199
11	"11-out7847"	.19791	38	154	192
11	"11-out7848"	.40666	122	178	300
11	"11-out7849"	.50000	102	102	204
11	"11-out7850"	.33571	141	279	420
11	"11-out7851"	.22374	49	170	219
11	"11-out7852"	.28488	49	123	172
11	"11-out7853"	.20134	30	119	149
11	"11-out7854"	.19886	105	423	528
11	"11-out7855"	.37828	230	378	608
11	"11-out7856"	.62878	332	196	528
11	"11-out7857"	.89380	202	24	226
11	"11-out7858"	.68292	84	39	123
11	"11-out7859"	.36608	190	329	519
11	"11-out7860"	.98666	74	1	75
11	"11-out7861"	.99350	153	1	154
11	"11-out7862"	.83448	121	24	145
11	"11-out7863"	.25842	276	792	1068
11	"11-out7864"	.36290	90	158	248
11	"11-out7865"	.93355	281	20	301
11	"11-out7866"	.99137	115	1	116
11	"11-out7867"	.31958	62	132	194
11	"11-out7868"	.93911	725	47	772
11	"11-out7869"	.36744	79	136	215
11	"11-out7870"	.44025	339	431	770
11	"11-out7871"	.35606	94	170	264
11	"11-out7872"	.44549	94	117	211
11	"11-out7873"	.31944	69	147	216
11	"11-out7874"	.49189	91	94	185
11	"11-out7875"	.56637	64	49	113
11	"11-out7876"	.70103	204	87	291
11	"11-out7877"	.29207	59	143	202
11	"11-out7878"	.47895	421	458	879
11	"11-out7879"	.30521	123	280	403
11	"11-out7880"	.99543	218	1	219
11	"11-out7881"	.69936	221	95	316
11	"11-out7882"	.99280	138	1	139
11	"11-out7883"	.65470	146	77	223
11	"11-out7884"	.36866	80	137	217
11	"11-out7885"	.41284	45	64	109
11	"11-out7886"	.36576	203	352	555
11	"11-out7887"	.17872	42	193	235
11	"11-out7888"	.59872	94	63	157
11	"11-out7889"	.63497	374	215	589
11	"11-out7890"	.25949	205	585	790
11	"11-out7891"	.63366	128	74	202
11	"11-out7892"	.98095	206	4	210
11	"11-out7893"	.43326	198	259	457
11	"11-out7894"	.34016	83	161	244
11	"11-out7895"	.47318	150	167	317
11	"11-out7896"	.99645	281	1	282
11	"11-out7897"	.22950	42	141	183
11	"11-out7898"	.77857	218	62	280
11	"11-out7899"	.66983	282	139	421
11	"11-out7900"	.26136	46	130	176
11	"11-out7901"	.46570	129	148	277
11	"11-out7902"	.45736	118	140	258
11	"11-out7903"	.99638	276	1	277
11	"11-out7904"	.33760	79	155	234
11	"11-out7905"	.32405	594	1239	1833
11	"11-out7906"	.67219	162	79	241
11	"11-out7907"	.32173	111	234	345
11	"11-out7908"	.35384	161	294	455
11	"11-out7909"	.32971	152	309	461
11	"11-out7910"	.30588	78	177	255
11	"11-out7911"	.44844	187	230	417
11	"11-out7912"	.86486	64	10	74
11	"11-out7913"	.39482	122	187	309
11	"11-out7914"	.98060	354	7	361
11	"11-out7915"	.53921	440	376	816
11	"11-out7916"	.26785	60	164	224
11	"11-out7917"	.82035	137	30	167
11	"11-out7918"	.73103	212	78	290
11	"11-out7919"	.39310	57	88	145
11	"11-out7920"	.39949	944	1419	2363
11	"11-out7921"	.85483	212	36	248
11	"11-out7922"	.58087	413	298	711
11	"11-out7923"	.38152	285	462	747
11	"11-out7924"	.69111	179	80	259
11	"11-out7925"	1.00000	153	0	153
11	"11-out7926"	.40740	176	256	432
11	"11-out7927"	.27272	90	240	330
11	"11-out7928"	.62992	80	47	127
11	"11-out7929"	.97727	43	1	44
11	"11-out7930"	.95419	125	6	131
11	"11-out7931"	.37168	42	71	113
11	"11-out7932"	.48421	230	245	475
11	"11-out7933"	.76666	184	56	240
11	"11-out7934"	.40419	154	227	381
11	"11-out7935"	.57329	438	326	764
11	"11-out7936"	.43412	201	262	463
11	"11-out7937"	.32098	130	275	405
11	"11-out7938"	.65109	209	112	321
11	"11-out7939"	.36500	73	127	200
11	"11-out7940"	.99019	101	1	102
11	"11-out7941"	.30000	162	378	540
11	"11-out7942"	.55555	65	52	117
11	"11-out7943"	.99363	156	1	157
11	"11-out7944"	.62643	109	65	174
11	"11-out7945"	.78082	57	16	73
11	"11-out7946"	.32094	423	895	1318
11	"11-out7947"	.38447	436	698	1134
11	"11-out7948"	.25260	218	645	863
11	"11-out7949"	.36971	498	849	1347
11	"11-out7950"	.54012	424	361	785
11	"11-out7951"	.87719	700	98	798
11	"11-out7952"	.40774	400	581	981
11	"11-out7953"	.37630	397	658	1055
11	"11-out7954"	.91666	341	31	372
11	"11-out7955"	.39396	1397	2149	3546
11	"11-out7956"	.32401	429	895	1324
11	"11-out7957"	.49023	452	470	922
11	"11-out7958"	.99738	381	1	382
11	"11-out7959"	.41428	58	82	140
11	"11-out7960"	.11111	20	160	180
11	"11-out7961"	.99275	137	1	138
11	"11-out7962"	.74485	543	186	729
11	"11-out7963"	.47749	785	859	1644
11	"11-out7964"	.37743	445	734	1179
11	"11-out7965"	.99512	204	1	205
11	"11-out7966"	.99122	113	1	114
11	"11-out7967"	.99074	107	1	108
11	"11-out7968"	.99056	105	1	106
11	"11-out7969"	.99107	111	1	112
11	"11-out7970"	.99107	111	1	112
11	"11-out7971"	.99137	115	1	116
11	"11-out7972"	.99107	111	1	112
11	"11-out7973"	.99090	109	1	110
11	"11-out7974"	.99082	108	1	109
11	"11-out7975"	.99242	131	1	132
11	"11-out7976"	.99115	112	1	113
11	"11-out7977"	.99115	112	1	113
11	"11-out7978"	.99130	114	1	115
11	"11-out7979"	.99107	111	1	112
11	"11-out7980"	.99107	111	1	112
11	"11-out7981"	.99130	114	1	115
11	"11-out7982"	.99107	111	1	112
11	"11-out7983"	.99115	112	1	113
11	"11-out7984"	.99082	108	1	109
11	"11-out7985"	.99130	114	1	115
11	"11-out7986"	.99130	114	1	115
11	"11-out7987"	.99130	114	1	115
11	"11-out7988"	.99130	114	1	115
11	"11-out7989"	.99130	114	1	115
11	"11-out7990"	.99122	113	1	114
11	"11-out7991"	.99099	110	1	111
11	"11-out7992"	.99122	113	1	114
11	"11-out7993"	.99122	113	1	114
11	"11-out7994"	.99122	113	1	114
11	"11-out7995"	.99122	113	1	114
11	"11-out7996"	.99859	713	1	714
11	"11-out7997"	.32370	213	445	658
11	"11-out7998"	.97727	43	1	44
11	"11-out7999"	.53314	193	169	362
11	"11-out8000"	.55300	313	253	566
11	"11-out16001"	.38150	132	214	346
11	"11-out16002"	.47656	122	134	256
11	"11-out16003"	.60320	377	248	625
11	"11-out16004"	.25988	92	262	354
11	"11-out16005"	.27213	166	444	610
11	"11-out16006"	.35170	134	247	381
11	"11-out16007"	.35310	125	229	354
11	"11-out16008"	.98795	82	1	83
11	"11-out16009"	.29577	105	250	355
11	"11-out16010"	.19571	64	263	327
11	"11-out16011"	.81849	239	53	292
11	"11-out16012"	.30615	169	383	552
11	"11-out16013"	.44756	414	511	925
11	"11-out16014"	.99841	631	1	632
11	"11-out16015"	.99841	631	1	632
11	"11-out16016"	.76642	105	32	137
11	"11-out16017"	.79475	364	94	458
11	"11-out16018"	.45560	195	233	428
11	"11-out16019"	.26490	160	444	604
11	"11-out16020"	.90114	392	43	435
11	"11-out16021"	.33863	149	291	440
11	"11-out16022"	.33811	330	646	976
11	"11-out16023"	.91533	400	37	437
11	"11-out16024"	.40243	231	343	574
11	"11-out16025"	.24162	101	317	418
11	"11-out16026"	.52148	182	167	349
11	"11-out16027"	.29953	130	304	434
11	"11-out16028"	.44385	166	208	374
11	"11-out16029"	.53947	246	210	456
11	"11-out16030"	.57505	272	201	473
11	"11-out16031"	.53521	152	132	284
11	"11-out16032"	.41724	242	338	580
11	"11-out16033"	.32190	291	613	904
11	"11-out16034"	.40659	111	162	273
11	"11-out16035"	.86590	226	35	261
11	"11-out16036"	.20000	111	444	555
11	"11-out16037"	.36177	335	591	926
11	"11-out16038"	.47321	106	118	224
11	"11-out16039"	.26133	271	766	1037
11	"11-out16040"	.26930	279	757	1036
11	"11-out16041"	.19339	41	171	212
11	"11-out16042"	.40509	572	840	1412
11	"11-out16043"	.62585	92	55	147
11	"11-out16044"	.33988	121	235	356
11	"11-out16045"	.30555	253	575	828
11	"11-out16046"	.22413	65	225	290
11	"11-out16047"	.99874	794	1	795
11	"11-out16048"	.55172	384	312	696
11	"11-out16049"	.62043	340	208	548
11	"11-out16050"	.99047	104	1	105
11	"11-out16051"	.33815	117	229	346
11	"11-out16052"	.49689	240	243	483
11	"11-out16053"	.24261	115	359	474
11	"11-out16054"	.35578	169	306	475
11	"11-out16055"	.56623	265	203	468
11	"11-out16056"	.69084	400	179	579
11	"11-out16057"	.42184	197	270	467
11	"11-out16058"	.29528	119	284	403
11	"11-out16059"	.28798	127	314	441
11	"11-out16060"	.42764	396	530	926
11	"11-out16061"	.40394	164	242	406
11	"11-out16062"	.73704	782	279	1061
11	"11-out16063"	.81560	345	78	423
11	"11-out16064"	.19630	85	348	433
11	"11-out16065"	.99790	476	1	477
11	"11-out16066"	.48409	350	373	723
11	"11-out16067"	.58176	185	133	318
11	"11-out16068"	.40807	91	132	223
11	"11-out16069"	.33152	61	123	184
11	"11-out16070"	.96604	825	29	854
11	"11-out16071"	.99549	221	1	222
11	"11-out16072"	.32268	192	403	595
11	"11-out16073"	.24928	87	262	349
11	"11-out16074"	.35376	202	369	571
11	"11-out16075"	.69217	398	177	575
11	"11-out16076"	.28368	80	202	282
11	"11-out16077"	.16847	186	918	1104
11	"11-out16078"	.50922	469	452	921
11	"11-out16079"	.22686	201	685	886
11	"11-out16080"	.69330	642	284	926
11	"11-out16081"	.98305	58	1	59
11	"11-out16082"	.98305	58	1	59
11	"11-out16083"	.98305	58	1	59
11	"11-out16084"	.53453	178	155	333
11	"11-out16085"	.27390	169	448	617
11	"11-out16086"	.73333	66	24	90
11	"11-out16087"	.46850	119	135	254
11	"11-out16088"	.20408	90	351	441
11	"11-out16089"	.54195	239	202	441
11	"11-out16090"	.26728	58	159	217
11	"11-out16091"	.57575	95	70	165
11	"11-out16092"	.49107	220	228	448
11	"11-out16093"	.29086	121	295	416
11	"11-out16094"	.54791	223	184	407
11	"11-out16095"	.29376	146	351	497
11	"11-out16096"	.44052	200	254	454
11	"11-out16097"	.29494	356	851	1207
11	"11-out16098"	.33980	245	476	721
11	"11-out16099"	.26614	103	284	387
11	"11-out16100"	.50256	294	291	585
11	"11-out16101"	.35218	218	401	619
11	"11-out16102"	.21563	80	291	371
11	"11-out16103"	.60431	168	110	278
11	"11-out16104"	.58311	221	158	379
11	"11-out16105"	.24711	150	457	607
11	"11-out16106"	.33017	174	353	527
11	"11-out16107"	.36503	238	414	652
11	"11-out16108"	.40683	131	191	322
11	"11-out16109"	.51700	152	142	294
11	"11-out16110"	.39986	597	896	1493
11	"11-out16111"	.38636	153	243	396
11	"11-out16112"	.26605	348	960	1308
11	"11-out16113"	.31775	68	146	214
11	"11-out16114"	.27972	160	412	572
11	"11-out16115"	.99559	226	1	227
11	"11-out16116"	.72018	610	237	847
11	"11-out16117"	.40140	285	425	710
11	"11-out16118"	.32266	121	254	375
11	"11-out16119"	.48428	416	443	859
11	"11-out16120"	.32616	182	376	558
11	"11-out16121"	.40676	373	544	917
11	"11-out16122"	.26511	57	158	215
11	"11-out16123"	.24976	261	784	1045
11	"11-out16124"	.28225	1295	3293	4588
11	"11-out16125"	.25838	1287	3694	4981
11	"11-out16126"	.43380	154	201	355
11	"11-out16127"	.29050	104	254	358
11	"11-out16128"	.33810	118	231	349
11	"11-out16129"	.38106	165	268	433
11	"11-out16130"	.41747	473	660	1133
11	"11-out16131"	.41963	295	408	703
11	"11-out16132"	.33023	391	793	1184
11	"11-out16133"	.23024	102	341	443
11	"11-out16134"	.46417	149	172	321
11	"11-out16135"	.45270	134	162	296
11	"11-out16136"	.47316	335	373	708
11	"11-out16137"	.99642	279	1	280
11	"11-out16138"	.21342	89	328	417
11	"11-out16139"	.33720	29	57	86
11	"11-out16140"	.87135	359	53	412
11	"11-out16141"	.31978	181	385	566
11	"11-out16142"	.34069	957	1852	2809
11	"11-out16143"	.31428	44	96	140
11	"11-out16144"	.36033	218	387	605
11	"11-out16145"	.31738	199	428	627
11	"11-out16146"	.47058	40	45	85
11	"11-out16147"	.75585	774	250	1024
11	"11-out16148"	.30468	39	89	128
11	"11-out16149"	.77272	102	30	132
11	"11-out16150"	.38636	51	81	132
11	"11-out16151"	.24858	44	133	177
11	"11-out16152"	.57777	104	76	180
11	"11-out16153"	.28850	118	291	409
11	"11-out16154"	.27899	89	230	319
11	"11-out16155"	.81179	289	67	356
11	"11-out16156"	.99699	332	1	333
11	"11-out16157"	.31207	137	302	439
11	"11-out16158"	.34054	189	366	555
11	"11-out16159"	.46594	171	196	367
11	"11-out16160"	.90220	286	31	317
11	"11-out16161"	.27601	122	320	442
11	"11-out16162"	.25083	75	224	299
11	"11-out16163"	.48114	421	454	875
11	"11-out16164"	.53818	148	127	275
11	"11-out16165"	.32252	199	418	617
11	"11-out16166"	.30790	113	254	367
11	"11-out16167"	.39267	150	232	382
11	"11-out16168"	.69747	166	72	238
11	"11-out16169"	.29846	117	275	392
11	"11-out16170"	.32466	312	649	961
11	"11-out16171"	.33282	218	437	655
11	"11-out16172"	.46590	41	47	88
11	"11-out16173"	.34529	77	146	223
11	"11-out16174"	.99305	286	2	288
11	"11-out16175"	.37051	196	333	529
11	"11-out16176"	.32476	341	709	1050
11	"11-out16177"	.80724	825	197	1022
11	"11-out16178"	.32692	119	245	364
11	"11-out16179"	.41140	202	289	491
11	"11-out16180"	.44285	124	156	280
11	"11-out16181"	.14903	31	177	208
11	"11-out16182"	.37531	301	501	802
11	"11-out16183"	.48858	107	112	219
11	"11-out16184"	.25837	54	155	209
11	"11-out16185"	.92194	3744	317	4061
11	"11-out16186"	.39635	174	265	439
11	"11-out16187"	.99295	141	1	142
11	"11-out16188"	.23529	64	208	272
11	"11-out16189"	.33846	132	258	390
11	"11-out16190"	.54285	95	80	175
11	"11-out16191"	.98734	78	1	79
11	"11-out16192"	.50067	373	372	745
11	"11-out16193"	.99450	181	1	182
11	"11-out16194"	.99275	137	1	138
11	"11-out16195"	.99242	131	1	132
11	"11-out16196"	.47567	88	97	185
11	"11-out16197"	.77073	158	47	205
11	"11-out16198"	.41117	206	295	501
11	"11-out16199"	.77215	61	18	79
11	"11-out16200"	.37959	93	152	245
11	"11-out16201"	.32448	220	458	678
11	"11-out16202"	.31851	215	460	675
11	"11-out16203"	.61764	42	26	68
11	"11-out16204"	.29473	140	335	475
11	"11-out16205"	.49107	55	57	112
11	"11-out16206"	.40434	279	411	690
11	"11-out16207"	.23192	154	510	664
11	"11-out16208"	.39922	1034	1556	2590
11	"11-out16209"	.40326	321	475	796
11	"11-out16210"	.32317	159	333	492
11	"11-out16211"	.63636	469	268	737
11	"11-out16212"	.37859	290	476	766
11	"11-out16213"	.38265	331	534	865
11	"11-out16214"	.23162	208	690	898
11	"11-out16215"	.22479	194	669	863
11	"11-out16216"	.99328	296	2	298
11	"11-out16217"	.99371	158	1	159
11	"11-out16218"	.74671	227	77	304
11	"11-out16219"	.79310	92	24	116
11	"11-out16220"	.81675	156	35	191
11	"11-out16221"	.78795	327	88	415
11	"11-out16222"	.38630	158	251	409
11	"11-out16223"	.98989	98	1	99
11	"11-out16224"	.34439	353	672	1025
11	"11-out16225"	.25874	148	424	572
11	"11-out16226"	.27797	159	413	572
11	"11-out16227"	.21578	123	447	570
11	"11-out16228"	.72902	417	155	572
11	"11-out16229"	.30673	173	391	564
11	"11-out16230"	.98120	261	5	266
11	"11-out16231"	.99248	264	2	266
11	"11-out16232"	.98496	262	4	266
11	"11-out16233"	.53674	241	208	449
11	"11-out16234"	.36618	301	521	822
11	"11-out16235"	.40270	298	442	740
11	"11-out16236"	.44628	216	268	484
11	"11-out16237"	.17782	93	430	523
11	"11-out16238"	.39121	187	291	478
11	"11-out16239"	.38123	191	310	501
11	"11-out16240"	.37823	278	457	735
11	"11-out16241"	.34782	304	570	874
11	"11-out16242"	.54275	146	123	269
11	"11-out16243"	.38600	171	272	443
11	"11-out16244"	.26233	117	329	446
11	"11-out16245"	.20993	93	350	443
11	"11-out16246"	.27250	109	291	400
11	"11-out16247"	.72162	337	130	467
11	"11-out16248"	.85744	409	68	477
11	"11-out16249"	.44530	289	360	649
11	"11-out16250"	.91825	337	30	367
11	"11-out16251"	.17032	62	302	364
11	"11-out16252"	.49809	131	132	263
11	"11-out16253"	.81659	187	42	229
11	"11-out16254"	.12307	40	285	325
11	"11-out16255"	.48717	152	160	312
11	"11-out16256"	.95744	180	8	188
11	"11-out16257"	.04545	9	189	198
11	"11-out16258"	.99248	132	1	133
11	"11-out16259"	.97058	33	1	34
11	"11-out16260"	.43589	153	198	351
11	"11-out16261"	.63043	116	68	184
11	"11-out16262"	.63333	95	55	150
11	"11-out16263"	.06635	14	197	211
11	"11-out16264"	.40846	473	685	1158
11	"11-out16265"	.76704	135	41	176
11	"11-out16266"	.95238	60	3	63
11	"11-out16267"	.25354	125	368	493
11	"11-out16268"	.92753	256	20	276
11	"11-out16269"	.41951	172	238	410
11	"11-out16270"	.39318	1257	1940	3197
11	"11-out16271"	.79850	107	27	134
11	"11-out16272"	.33333	188	376	564
11	"11-out16273"	.20698	160	613	773
11	"11-out16274"	.30769	76	171	247
11	"11-out16275"	.89662	451	52	503
11	"11-out16276"	.97368	74	2	76
11	"11-out16277"	.99532	213	1	214
11	"11-out16278"	.75609	155	50	205
11	"11-out16279"	.48457	267	284	551
11	"11-out16280"	.99939	1654	1	1655
11	"11-out16281"	.33153	123	248	371
11	"11-out16282"	.48837	147	154	301
11	"11-out16283"	.18811	57	246	303
11	"11-out16284"	.27138	295	792	1087
11	"11-out16285"	.50641	79	77	156
11	"11-out16286"	.99099	110	1	111
11	"11-out16287"	.35076	275	509	784
11	"11-out16288"	.38888	56	88	144
11	"11-out16289"	.29943	421	985	1406
11	"11-out16290"	.18857	33	142	175
11	"11-out16291"	.39249	230	356	586
11	"11-out16292"	.99720	357	1	358
11	"11-out16293"	.99082	108	1	109
11	"11-out16294"	.37747	248	409	657
11	"11-out16295"	.32970	121	246	367
11	"11-out16296"	.57174	518	388	906
11	"11-out16297"	.33380	237	473	710
11	"11-out16298"	.49052	440	457	897
11	"11-out16299"	.39969	263	395	658
11	"11-out16300"	.35427	141	257	398
11	"11-out16301"	.35606	94	170	264
11	"11-out16302"	.31475	638	1389	2027
11	"11-out16303"	.99324	147	1	148
11	"11-out16304"	.28856	275	678	953
11	"11-out16305"	.30128	235	545	780
11	"11-out16306"	.41573	74	104	178
11	"11-out16307"	.29959	367	858	1225
11	"11-out16308"	.36808	625	1073	1698
11	"11-out16309"	.99563	228	1	229
11	"11-out16310"	.43529	185	240	425
11	"11-out16311"	.99771	436	1	437
11	"11-out16312"	.33916	291	567	858
11	"11-out16313"	.39370	50	77	127
11	"11-out16314"	.34969	57	106	163
11	"11-out16315"	.41433	237	335	572
11	"11-out16316"	.77697	756	217	973
11	"11-out16317"	.48080	238	257	495
11	"11-out16318"	.99828	583	1	584
11	"11-out16319"	.99810	526	1	527
11	"11-out16320"	.72681	290	109	399
11	"11-out16321"	.41265	163	232	395
11	"11-out16322"	.56872	120	91	211
11	"11-out16323"	.44680	42	52	94
11	"11-out16324"	.47962	153	166	319
11	"11-out16325"	.54848	345	284	629
11	"11-out16326"	.32911	26	53	79
11	"11-out16327"	.98904	361	4	365
11	"11-out16328"	.98167	375	7	382
11	"11-out16329"	.96819	274	9	283
11	"11-out16330"	.47368	54	60	114
11	"11-out16331"	.45312	58	70	128
11	"11-out16332"	.27102	87	234	321
11	"11-out16333"	.62068	270	165	435
11	"11-out16334"	.39805	205	310	515
11	"11-out16335"	.21022	74	278	352
11	"11-out16336"	.29292	58	140	198
11	"11-out16337"	.85074	114	20	134
11	"11-out16338"	.99561	227	1	228
11	"11-out16339"	.96153	500	20	520
11	"11-out16340"	.45438	518	622	1140
11	"11-out16341"	.55089	276	225	501
11	"11-out16342"	.47675	3609	3961	7570
11	"11-out16343"	.99801	504	1	505
11	"11-out16344"	.44980	345	422	767
11	"11-out16345"	.31607	232	502	734
11	"11-out16346"	.95102	602	31	633
11	"11-out16347"	.83266	418	84	502
11	"11-out16348"	.98245	56	1	57
11	"11-out16349"	.58143	1096	789	1885
11	"11-out16350"	.26788	146	399	545
11	"11-out16351"	.29903	218	511	729
11	"11-out16352"	.12698	32	220	252
11	"11-out16353"	.32307	168	352	520
11	"11-out16354"	.60520	279	182	461
11	"11-out16355"	.40920	160	231	391
11	"11-out16356"	.35831	502	899	1401
11	"11-out16357"	.28976	184	451	635
11	"11-out16358"	.43226	284	373	657
11	"11-out16359"	.46035	540	633	1173
11	"11-out16360"	.31141	180	398	578
11	"11-out16361"	.33261	310	622	932
11	"11-out16362"	.40860	456	660	1116
11	"11-out16363"	.45846	436	515	951
11	"11-out16364"	.30284	351	808	1159
11	"11-out16365"	.29000	58	142	200
11	"11-out16366"	.41875	201	279	480
11	"11-out16367"	.78540	366	100	466
11	"11-out16368"	.31809	529	1134	1663
11	"11-out16369"	.41981	89	123	212
11	"11-out16370"	.41689	306	428	734
11	"11-out16371"	.99280	138	1	139
11	"11-out16372"	.99346	152	1	153
11	"11-out16373"	.99295	141	1	142
11	"11-out16374"	.68292	56	26	82
11	"11-out16375"	.55209	779	632	1411
11	"11-out16376"	.60770	268	173	441
11	"11-out16377"	.25659	146	423	569
11	"11-out16378"	.43005	166	220	386
11	"11-out16379"	.99783	461	1	462
11	"11-out16380"	.57731	448	328	776
11	"11-out16381"	.35478	893	1624	2517
11	"11-out16382"	.41292	377	536	913
11	"11-out16383"	.37362	102	171	273
11	"11-out16384"	.31081	46	102	148
11	"11-out16385"	.65562	99	52	151
11	"11-out16386"	.99411	169	1	170
11	"11-out16387"	.51408	73	69	142
11	"11-out16388"	.93227	234	17	251
11	"11-out16389"	.99644	280	1	281
11	"11-out16390"	.55396	503	405	908
11	"11-out16391"	.99696	329	1	330
11	"11-out16392"	.22068	160	565	725
11	"11-out16393"	.45127	213	259	472
11	"11-out16394"	.98734	78	1	79
11	"11-out16395"	.99367	157	1	158
11	"11-out16396"	.99367	157	1	158
11	"11-out16397"	.99305	143	1	144
11	"11-out16398"	.39593	78	119	197
11	"11-out16399"	.62040	371	227	598
11	"11-out16400"	.99453	182	1	183
11	"11-out16401"	.73255	63	23	86
11	"11-out16402"	.99801	502	1	503
11	"11-out16403"	.98863	87	1	88
11	"11-out16404"	.43646	237	306	543
11	"11-out16405"	.36725	83	143	226
11	"11-out16406"	.32432	108	225	333
11	"11-out16407"	.33834	90	176	266
11	"11-out16408"	.35531	97	176	273
11	"11-out16409"	.37150	133	225	358
11	"11-out16410"	.37164	97	164	261
11	"11-out16411"	.78494	219	60	279
11	"11-out16412"	.25196	64	190	254
11	"11-out16413"	.36021	134	238	372
11	"11-out16414"	.34262	86	165	251
11	"11-out16415"	.38811	111	175	286
11	"11-out16416"	.22459	42	145	187
11	"11-out16417"	.38775	323	510	833
11	"11-out16418"	.29375	188	452	640
11	"11-out16419"	.65446	733	387	1120
11	"11-out16420"	.63573	185	106	291
11	"11-out16421"	.43283	87	114	201
11	"11-out16422"	.92485	320	26	346
11	"11-out16423"	.22222	74	259	333
11	"11-out16424"	.52647	179	161	340
11	"11-out16425"	.27924	339	875	1214
11	"11-out16426"	.98583	1253	18	1271
11	"11-out16427"	.44444	140	175	315
11	"11-out16428"	.29452	86	206	292
11	"11-out16429"	.29615	77	183	260
11	"11-out16430"	.45491	111	133	244
11	"11-out16431"	.38870	344	541	885
11	"11-out16432"	.65522	897	472	1369
11	"11-out16433"	.81879	122	27	149
11	"11-out16434"	.62133	233	142	375
11	"11-out16435"	.25187	67	199	266
11	"11-out16436"	.29635	203	482	685
11	"11-out16437"	.34843	100	187	287
11	"11-out16438"	.20000	35	140	175
11	"11-out16439"	.47599	466	513	979
11	"11-out16440"	.68421	559	258	817
11	"11-out16441"	.47872	405	441	846
11	"11-out16442"	.32985	633	1286	1919
11	"11-out16443"	.57491	330	244	574
11	"11-out16444"	.21875	933	3332	4265
11	"11-out16445"	.49442	133	136	269
11	"11-out16446"	.25163	192	571	763
11	"11-out16447"	.38379	1653	2654	4307
11	"11-out16448"	.33148	1497	3019	4516
11	"11-out16449"	.98930	185	2	187
11	"11-out16450"	.47691	2128	2334	4462
11	"11-out16451"	.16326	96	492	588
11	"11-out16452"	.31067	288	639	927
11	"11-out16453"	.33688	158	311	469
11	"11-out16454"	.21764	74	266	340
11	"11-out16455"	.25977	226	644	870
11	"11-out16456"	.27941	95	245	340
11	"11-out16457"	.25201	219	650	869
11	"11-out16458"	.27407	148	392	540
11	"11-out16459"	.22400	140	485	625
11	"11-out16460"	.36467	159	277	436
11	"11-out16461"	.30434	154	352	506
11	"11-out16462"	.23324	623	2048	2671
11	"11-out16463"	.55373	237	191	428
11	"11-out16464"	.34474	151	287	438
11	"11-out16465"	.39072	177	276	453
11	"11-out16466"	.58139	250	180	430
11	"11-out16467"	.99728	367	1	368
11	"11-out16468"	.31152	281	621	902
11	"11-out16469"	.40904	371	536	907
11	"11-out16470"	.30134	201	466	667
11	"11-out16471"	.45507	466	558	1024
11	"11-out16472"	.51704	273	255	528
11	"11-out16473"	.35843	652	1167	1819
11	"11-out16474"	.54697	425	352	777
11	"11-out16475"	.42134	75	103	178
11	"11-out16476"	.97843	998	22	1020
11	"11-out16477"	.46401	187	216	403
11	"11-out16478"	.34637	239	451	690
11	"11-out16479"	.43579	319	413	732
11	"11-out16480"	.27786	172	447	619
11	"11-out16481"	.59643	368	249	617
11	"11-out16482"	.99796	490	1	491
11	"11-out16483"	.33752	188	369	557
11	"11-out16484"	.48734	77	81	158
11	"11-out16485"	.60625	97	63	160
11	"11-out16486"	.60159	151	100	251
11	"11-out16487"	.46696	106	121	227
11	"11-out16488"	.34243	163	313	476
11	"11-out16489"	.99837	615	1	616
11	"11-out16490"	.14418	31	184	215
11	"11-out16491"	.56363	124	96	220
11	"11-out16492"	.33144	117	236	353
11	"11-out16493"	.45959	182	214	396
11	"11-out16494"	.43825	181	232	413
11	"11-out16495"	.21126	105	392	497
11	"11-out16496"	.73303	324	118	442
11	"11-out16497"	.62998	521	306	827
11	"11-out16498"	.98845	685	8	693
11	"11-out16499"	.39440	155	238	393
11	"11-out16500"	.55348	119	96	215
11	"11-out16501"	.40521	171	251	422
11	"11-out16502"	.23595	42	136	178
11	"11-out16503"	.99038	103	1	104
11	"11-out16504"	.99462	185	1	186
11	"11-out16505"	.99549	221	1	222
11	"11-out16506"	.99591	731	3	734
11	"11-out16507"	.38191	207	335	542
11	"11-out16508"	.32713	264	543	807
11	"11-out16509"	.33709	269	529	798
11	"11-out16510"	.31297	164	360	524
11	"11-out16511"	.40298	108	160	268
11	"11-out16512"	.99750	399	1	400
11	"11-out16513"	.37681	78	129	207
11	"11-out16514"	.37428	131	219	350
11	"11-out16515"	.34017	315	611	926
11	"11-out16516"	.21555	97	353	450
11	"11-out16517"	.60270	267	176	443
11	"11-out16518"	.99180	363	3	366
11	"11-out16519"	.34250	112	215	327
11	"11-out16520"	.29454	81	194	275
11	"11-out16521"	.31060	82	182	264
11	"11-out16522"	.98058	202	4	206
11	"11-out16523"	.33480	1137	2259	3396
11	"11-out16524"	.88082	170	23	193
11	"11-out16525"	.26288	51	143	194
11	"11-out16526"	.35389	218	398	616
11	"11-out16527"	.40816	60	87	147
11	"11-out16528"	.80503	128	31	159
11	"11-out16529"	.53594	82	71	153
11	"11-out16530"	.99484	193	1	194
11	"11-out16531"	.98941	187	2	189
11	"11-out16532"	.99470	188	1	189
11	"11-out16533"	.99470	188	1	189
11	"11-out16534"	.99470	188	1	189
11	"11-out16535"	.99470	188	1	189
11	"11-out16536"	.99470	188	1	189
11	"11-out16537"	.99470	188	1	189
11	"11-out16538"	.98750	158	2	160
11	"11-out16539"	.43763	400	514	914
11	"11-out16540"	.39668	263	400	663
11	"11-out16541"	.51169	372	355	727
11	"11-out16542"	.89662	399	46	445
11	"11-out16543"	.96241	717	28	745
11	"11-out16544"	.99367	157	1	158
11	"11-out16545"	.99356	772	5	777
11	"11-out16546"	.78606	158	43	201
11	"11-out16547"	.20758	93	355	448
11	"11-out16548"	.43950	287	366	653
11	"11-out16549"	.25755	162	467	629
11	"11-out16550"	.34248	212	407	619
11	"11-out16551"	.29477	79	189	268
11	"11-out16552"	.99788	471	1	472
11	"11-out16553"	.36466	291	507	798
11	"11-out16554"	.73563	256	92	348
11	"11-out16555"	.42912	221	294	515
11	"11-out16556"	.20661	200	768	968
11	"11-out16557"	.31615	135	292	427
11	"11-out16558"	.54320	44	37	81
11	"11-out16559"	.99285	139	1	140
11	"11-out16560"	.97297	72	2	74
11	"11-out16561"	.38235	169	273	442
11	"11-out16562"	.99393	164	1	165
11	"11-out16563"	.99668	301	1	302
11	"11-out16564"	.54595	1978	1645	3623
11	"11-out16565"	.99783	461	1	462
11	"11-out16566"	.40069	115	172	287
11	"11-out16567"	.99784	462	1	463
11	"11-out16568"	.39597	295	450	745
11	"11-out16569"	.37988	68	111	179
11	"11-out16570"	.35597	304	550	854
11	"11-out16571"	.52500	189	171	360
11	"11-out16572"	.49712	692	700	1392
11	"11-out16573"	.27947	64	165	229
11	"11-out16574"	.71333	107	43	150
11	"11-out16575"	.35517	309	561	870
11	"11-out16576"	.72916	70	26	96
11	"11-out16577"	.51851	266	247	513
11	"11-out16578"	.99545	219	1	220
11	"11-out16579"	.99479	191	1	192
11	"11-out16580"	.37631	286	474	760
11	"11-out16581"	.58268	377	270	647
11	"11-out16582"	.34837	139	260	399
11	"11-out16583"	.44210	84	106	190
11	"11-out16584"	.27619	29	76	105
11	"11-out16585"	.32916	158	322	480
11	"11-out16586"	.45843	182	215	397
11	"11-out16587"	.93823	319	21	340
11	"11-out16588"	.93103	135	10	145
11	"11-out16589"	.55339	171	138	309
11	"11-out16590"	.42261	213	291	504
11	"11-out16591"	.98529	268	4	272
11	"11-out16592"	.96456	245	9	254
11	"11-out16593"	.96470	246	9	255
11	"11-out16594"	.22315	160	557	717
11	"11-out16595"	.25768	109	314	423
11	"11-out16596"	.99748	397	1	398
11	"11-out16597"	.34570	149	282	431
11	"11-out16598"	.23949	57	181	238
11	"11-out16599"	.47747	106	116	222
11	"11-out16600"	.34251	87	167	254
11	"11-out16601"	.17842	43	198	241
11	"11-out16602"	.17562	98	460	558
11	"11-out16603"	.34005	118	229	347
11	"11-out16604"	.44562	168	209	377
11	"11-out16605"	.32323	64	134	198
11	"11-out16606"	.33984	226	439	665
11	"11-out16607"	.33242	122	245	367
11	"11-out16608"	.99465	372	2	374
11	"11-out16609"	.41920	179	248	427
11	"11-out16610"	.68000	85	40	125
11	"11-out16611"	.41715	282	394	676
11	"11-out16612"	.28689	1287	3199	4486
11	"11-out16613"	.47533	318	351	669
11	"11-out16614"	.44328	383	481	864
11	"11-out16615"	.44866	319	392	711
11	"11-out16616"	.25373	51	150	201
11	"11-out16617"	.38747	198	313	511
11	"11-out16618"	.12000	66	484	550
11	"11-out16619"	.99598	248	1	249
11	"11-out16620"	.38319	187	301	488
11	"11-out16621"	.24289	94	293	387
11	"11-out16622"	.24568	256	786	1042
11	"11-out16623"	.46464	184	212	396
11	"11-out16624"	.18699	69	300	369
11	"11-out16625"	.38461	145	232	377
11	"11-out16626"	.24600	77	236	313
11	"11-out16627"	.41065	131	188	319
11	"11-out16628"	.36749	251	432	683
11	"11-out16629"	.46460	105	121	226
11	"11-out16630"	.36514	264	459	723
11	"11-out16631"	.34472	605	1150	1755
11	"11-out16632"	.46073	176	206	382
11	"11-out16633"	.37381	394	660	1054
11	"11-out16634"	.31477	147	320	467
11	"11-out16635"	.38207	405	655	1060
11	"11-out16636"	.38668	273	433	706
11	"11-out16637"	.36030	285	506	791
11	"11-out16638"	.30512	292	665	957
11	"11-out16639"	.99356	618	4	622
11	"11-out16640"	.43648	323	417	740
11	"11-out16641"	.29079	180	439	619
11	"11-out16642"	.32272	71	149	220
11	"11-out16643"	.27385	132	350	482
11	"11-out16644"	.33529	114	226	340
11	"11-out16645"	.68813	203	92	295
11	"11-out16646"	.62211	135	82	217
11	"11-out16647"	.50233	215	213	428
11	"11-out16648"	.35858	142	254	396
11	"11-out16649"	.81372	166	38	204
11	"11-out16650"	.17647	51	238	289
11	"11-out16651"	.36879	104	178	282
11	"11-out16652"	.95679	310	14	324
11	"11-out16653"	.51928	175	162	337
11	"11-out16654"	.32471	113	235	348
11	"11-out16655"	.81595	266	60	326
11	"11-out16656"	.18103	42	190	232
11	"11-out16657"	.50672	113	110	223
11	"11-out16658"	.71175	442	179	621
11	"11-out16659"	.29460	142	340	482
11	"11-out16660"	.19852	81	327	408
11	"11-out16661"	.94328	316	19	335
11	"11-out16662"	.44701	232	287	519
11	"11-out16663"	.99233	259	2	261
11	"11-out16664"	.75000	201	67	268
11	"11-out16665"	.90391	254	27	281
11	"11-out16666"	.98260	226	4	230
11	"11-out16667"	.23322	73	240	313
11	"11-out16668"	.25308	123	363	486
11	"11-out16669"	.24436	65	201	266
11	"11-out16670"	.69914	244	105	349
11	"11-out16671"	.33239	118	237	355
11	"11-out16672"	.25722	89	257	346
11	"11-out16673"	.22689	81	276	357
11	"11-out16674"	.99805	514	1	515
11	"11-out16675"	.30324	84	193	277
11	"11-out16676"	.30463	92	210	302
11	"11-out16677"	.34807	669	1253	1922
11	"11-out16678"	.37168	252	426	678
11	"11-out16679"	.29815	356	838	1194
11	"11-out16680"	.33240	119	239	358
11	"11-out16681"	.29910	67	157	224
11	"11-out16682"	.15294	39	216	255
11	"11-out16683"	.53807	318	273	591
11	"11-out16684"	.88668	626	80	706
11	"11-out16685"	.38174	92	149	241
11	"11-out16686"	.28274	136	345	481
11	"11-out16687"	.78968	199	53	252
11	"11-out16688"	.98823	168	2	170
11	"11-out16689"	.99492	196	1	197
11	"11-out16690"	.32960	236	480	716
11	"11-out16691"	.92388	619	51	670
11	"11-out16692"	.97058	33	1	34
11	"11-out16693"	.99849	665	1	666
11	"11-out16694"	.55506	378	303	681
11	"11-out16695"	.43181	380	500	880
11	"11-out16696"	.45677	317	377	694
11	"11-out16697"	.32853	228	466	694
11	"11-out16698"	.99128	569	5	574
11	"11-out16699"	.22746	1007	3420	4427
11	"11-out16700"	.33786	1517	2973	4490
11	"11-out16701"	.29213	26	63	89
11	"11-out16702"	.91150	103	10	113
11	"11-out16703"	.41412	340	481	821
11	"11-out16704"	.68041	66	31	97
11	"11-out16705"	.45679	296	352	648
11	"11-out16706"	.23653	101	326	427
11	"11-out16707"	.58161	367	264	631
11	"11-out16708"	.20205	59	233	292
11	"11-out16709"	.61866	232	143	375
11	"11-out16710"	.31940	917	1954	2871
11	"11-out16711"	.99545	219	1	220
11	"11-out16712"	.28571	226	565	791
11	"11-out16713"	.24666	74	226	300
11	"11-out16714"	.56296	152	118	270
11	"11-out16715"	.97841	272	6	278
11	"11-out16716"	.37301	517	869	1386
11	"11-out16717"	.25757	51	147	198
11	"11-out16718"	.24633	387	1184	1571
11	"11-out16719"	.29561	128	305	433
11	"11-out16720"	.31036	473	1051	1524
11	"11-out16721"	.33094	185	374	559
11	"11-out16722"	.40213	902	1341	2243
11	"11-out16723"	.28981	111	272	383
11	"11-out16724"	.12741	33	226	259
11	"11-out16725"	.44512	146	182	328
11	"11-out16726"	.39299	101	156	257
11	"11-out16727"	.34584	129	244	373
11	"11-out16728"	.96078	98	4	102
11	"11-out16729"	.32950	86	175	261
11	"11-out16730"	.40777	1238	1798	3036
11	"11-out16731"	.28733	431	1069	1500
11	"11-out16732"	.21756	109	392	501
11	"11-out16733"	.20329	210	823	1033
11	"11-out16734"	.34802	229	429	658
11	"11-out16735"	.97539	555	14	569
11	"11-out16736"	.51905	286	265	551
11	"11-out16737"	.99082	108	1	109
11	"11-out16738"	.37144	640	1083	1723
11	"11-out16739"	.76397	2269	701	2970
11	"11-out16740"	.63959	126	71	197
11	"11-out16741"	.45878	512	604	1116
11	"11-out16742"	.33775	280	549	829
11	"11-out16743"	.63636	63	36	99
11	"11-out16744"	.51724	150	140	290
11	"11-out16745"	.44761	188	232	420
11	"11-out16746"	.43333	195	255	450
11	"11-out16747"	.39393	169	260	429
11	"11-out16748"	.36932	236	403	639
11	"11-out16749"	.29440	121	290	411
11	"11-out16750"	.53468	185	161	346
11	"11-out16751"	.90391	254	27	281
11	"11-out16752"	.44827	78	96	174
11	"11-out16753"	.19565	63	259	322
11	"11-out16754"	.27895	289	747	1036
11	"11-out16755"	.34156	83	160	243
11	"11-out16756"	.99730	370	1	371
11	"11-out16757"	.26083	331	938	1269
11	"11-out16758"	.24631	217	664	881
11	"11-out16759"	.41691	419	586	1005
11	"11-out16760"	.37789	277	456	733
11	"11-out16761"	.47333	426	474	900
11	"11-out16762"	.99775	445	1	446
11	"11-out16763"	.33928	76	148	224
11	"11-out16764"	.50428	648	637	1285
11	"11-out16765"	.63333	76	44	120
11	"11-out16766"	.27047	218	588	806
11	"11-out16767"	.98717	77	1	78
11	"11-out16768"	.99212	126	1	127
11	"11-out16769"	.26132	150	424	574
11	"11-out16770"	.94771	145	8	153
11	"11-out16771"	.19642	110	450	560
11	"11-out16772"	.29461	1050	2514	3564
11	"11-out16773"	.25351	884	2603	3487
11	"11-out16774"	.32560	1207	2500	3707
11	"11-out16775"	.37254	114	192	306
11	"11-out16776"	.95215	199	10	209
11	"11-out16777"	.61403	35	22	57
11	"11-out16778"	.27142	209	561	770
11	"11-out16779"	.35881	291	520	811
11	"11-out16780"	.39251	493	763	1256
11	"11-out16781"	.87680	669	94	763
11	"11-out16782"	.75738	359	115	474
11	"11-out16783"	.35616	104	188	292
11	"11-out16784"	.56435	171	132	303
11	"11-out16785"	.46408	252	291	543
11	"11-out16786"	.22279	43	150	193
11	"11-out16787"	.25303	146	431	577
11	"11-out16788"	.71724	104	41	145
11	"11-out16789"	.37465	136	227	363
11	"11-out16790"	.22803	218	738	956
11	"11-out16791"	.42748	112	150	262
11	"11-out16792"	.34545	57	108	165
11	"11-out16793"	.54362	81	68	149
11	"11-out16794"	.99019	101	1	102
11	"11-out16795"	.32285	380	797	1177
11	"11-out16796"	.38016	46	75	121
11	"11-out16797"	.99444	179	1	180
11	"11-out16798"	.98648	73	1	74
11	"11-out16799"	.99742	775	2	777
11	"11-out16800"	.99742	775	2	777
11	"11-out16801"	.99809	523	1	524
11	"11-out16802"	.46865	299	339	638
11	"11-out16803"	.17204	64	308	372
11	"11-out16804"	.33793	49	96	145
11	"11-out16805"	.51968	66	61	127
11	"11-out16806"	.32324	299	626	925
11	"11-out16807"	.51727	494	461	955
11	"11-out16808"	.67460	85	41	126
11	"11-out16809"	.29862	413	970	1383
11	"11-out16810"	.39130	72	112	184
11	"11-out16811"	.42007	113	156	269
11	"11-out16812"	.98897	269	3	272
11	"11-out16813"	.98954	284	3	287
11	"11-out16814"	.50714	71	69	140
11	"11-out16815"	.45114	217	264	481
11	"11-out16816"	.31111	56	124	180
11	"11-out16817"	.23365	318	1043	1361
11	"11-out16818"	.51156	1593	1521	3114
11	"11-out16819"	.74089	183	64	247
11	"11-out16820"	.74200	371	129	500
11	"11-out16821"	.62723	668	397	1065
11	"11-out16822"	.29069	50	122	172
11	"11-out16823"	.50319	236	233	469
11	"11-out16824"	.31413	60	131	191
11	"11-out16825"	.43492	137	178	315
11	"11-out16826"	.40212	265	394	659
11	"11-out16827"	.36139	249	440	689
11	"11-out16828"	.99218	127	1	128
11	"11-out16829"	.48359	339	362	701
11	"11-out16830"	.46534	47	54	101
11	"11-out16831"	.57180	219	164	383
11	"11-out16832"	.48275	140	150	290
11	"11-out16833"	.52994	292	259	551
11	"11-out16834"	.45312	116	140	256
11	"11-out16835"	.38417	335	537	872
11	"11-out16836"	.98888	89	1	90
11	"11-out16837"	.99386	162	1	163
11	"11-out16838"	.57475	173	128	301
11	"11-out16839"	.36959	547	933	1480
11	"11-out16840"	.99019	101	1	102
11	"11-out16841"	.38625	163	259	422
11	"11-out16842"	.39038	203	317	520
11	"11-out16843"	.50000	38	38	76
11	"11-out16844"	.38867	103	162	265
11	"11-out16845"	.99310	144	1	145
11	"11-out16846"	.30914	98	219	317
11	"11-out16847"	.34079	137	265	402
11	"11-out16848"	.33333	44	88	132
11	"11-out16849"	.36661	224	387	611
11	"11-out16850"	.98979	485	5	490
11	"11-out16851"	.99591	488	2	490
11	"11-out16852"	.99801	503	1	504
11	"11-out16853"	.93702	491	33	524
11	"11-out16854"	.91159	464	45	509
11	"11-out16855"	.34406	171	326	497
11	"11-out16856"	.63128	113	66	179
11	"11-out16857"	.50724	70	68	138
11	"11-out16858"	.25165	38	113	151
11	"11-out16859"	.34306	47	90	137
11	"11-out16860"	.68707	101	46	147
11	"11-out16861"	.62000	31	19	50
11	"11-out16862"	.30203	193	446	639
11	"11-out16863"	.99470	188	1	189
11	"11-out16864"	.99470	188	1	189
11	"11-out16865"	.99470	188	1	189
11	"11-out16866"	.52205	71	65	136
11	"11-out16867"	.99512	204	1	205
11	"11-out16868"	.60092	259	172	431
11	"11-out16869"	.34070	308	596	904
11	"11-out16870"	.37500	165	275	440
11	"11-out16871"	.44280	120	151	271
11	"11-out16872"	.40615	396	579	975
11	"11-out16873"	.99742	775	2	777
11	"11-out16874"	.46704	163	186	349
11	"11-out16875"	.32093	69	146	215
11	"11-out16876"	.19263	136	570	706
11	"11-out16877"	.48971	119	124	243
11	"11-out16878"	.31438	188	410	598
11	"11-out16879"	.31432	226	493	719
11	"11-out16880"	.34448	175	333	508
11	"11-out16881"	.99378	160	1	161
11	"11-out16882"	.88212	232	31	263
11	"11-out16883"	.95817	252	11	263
11	"11-out16884"	.99811	529	1	530
11	"11-out16885"	.27597	247	648	895
11	"11-out16886"	.32266	252	529	781
11	"11-out16887"	.50840	121	117	238
11	"11-out16888"	.11111	9	72	81
11	"11-out16889"	.98765	80	1	81
11	"11-out16890"	.46296	50	58	108
11	"11-out16891"	.50000	161	161	322
11	"11-out16892"	.19178	42	177	219
11	"11-out16893"	.63235	129	75	204
11	"11-out16894"	.98076	51	1	52
11	"11-out16895"	.99206	125	1	126
11	"11-out16896"	.98437	63	1	64
11	"11-out16897"	.98701	76	1	77
11	"11-out16898"	.98305	58	1	59
11	"11-out16899"	.98181	54	1	55
11	"11-out16900"	.40145	497	741	1238
11	"11-out16901"	.44921	345	423	768
11	"11-out16902"	.40256	314	466	780
11	"11-out16903"	.99555	224	1	225
11	"11-out16904"	.59360	260	178	438
11	"11-out16905"	.98387	61	1	62
11	"11-out16906"	.33377	501	1000	1501
11	"11-out16907"	.99200	124	1	125
11	"11-out16908"	.99805	513	1	514
11	"11-out16909"	.98165	107	2	109
11	"11-out16910"	.94144	209	13	222
11	"11-out16911"	.64948	63	34	97
11	"11-out16912"	.74096	246	86	332
11	"11-out16913"	.99074	107	1	108
11	"11-out16914"	.99074	107	1	108
11	"11-out16915"	.99425	173	1	174
11	"11-out16916"	.29558	261	622	883
11	"11-out16917"	.42382	153	208	361
11	"11-out16918"	.44507	158	197	355
11	"11-out16919"	.80722	67	16	83
11	"11-out16920"	.98765	80	1	81
11	"11-out16921"	.69298	79	35	114
11	"11-out16922"	.38011	130	212	342
11	"11-out16923"	.65714	230	120	350
11	"11-out16924"	.50224	112	111	223
11	"11-out16925"	.99065	106	1	107
11	"11-out16926"	.68141	77	36	113
11	"11-out16927"	.34526	328	622	950
11	"11-out16928"	.36042	235	417	652
11	"11-out16929"	.49789	236	238	474
11	"11-out16930"	.55657	182	145	327
11	"11-out16931"	.43636	120	155	275
11	"11-out16932"	.38084	163	265	428
11	"11-out16933"	.27027	120	324	444
11	"11-out16934"	.30107	28	65	93
11	"11-out16935"	.45833	55	65	120
11	"11-out16936"	.29449	91	218	309
11	"11-out16937"	.47407	128	142	270
11	"11-out16938"	.99709	343	1	344
11	"11-out16939"	.34604	118	223	341
11	"11-out16940"	.24439	207	640	847
11	"11-out16941"	.24800	93	282	375
11	"11-out16942"	.98750	79	1	80
11	"11-out16943"	.26000	78	222	300
11	"11-out16944"	.59278	230	158	388
11	"11-out16945"	.35535	199	361	560
11	"11-out16946"	.89356	361	43	404
11	"11-out16947"	.99523	209	1	210
11	"11-out16948"	.75329	629	206	835
11	"11-out16949"	.42211	84	115	199
11	"11-out16950"	.37664	200	331	531
11	"11-out16951"	.40418	232	342	574
11	"11-out16952"	.35680	76	137	213
11	"11-out16953"	.40404	120	177	297
11	"11-out16954"	.99468	187	1	188
11	"11-out16955"	.92635	239	19	258
11	"11-out16956"	.25441	144	422	566
11	"11-out16957"	.26737	50	137	187
11	"11-out16958"	.33003	167	339	506
11	"11-out16959"	.45270	268	324	592
11	"11-out16960"	.50175	858	852	1710
11	"11-out16961"	.26241	391	1099	1490
11	"11-out16962"	.41509	66	93	159
11	"11-out16963"	.33548	156	309	465
11	"11-out16964"	.27092	123	331	454
11	"11-out16965"	.73977	199	70	269
11	"11-out16966"	.26250	21	59	80
11	"11-out16967"	.62011	222	136	358
11	"11-out16968"	.48449	125	133	258
11	"11-out16969"	.47093	162	182	344
11	"11-out16970"	.99832	595	1	596
11	"11-out16971"	.99317	291	2	293
11	"11-out16972"	.38719	1167	1847	3014
11	"11-out16973"	.48672	165	174	339
11	"11-out16974"	.42000	126	174	300
11	"11-out16975"	.55646	1503	1198	2701
11	"11-out16976"	.25000	22	66	88
11	"11-out16977"	.25781	99	285	384
11	"11-out16978"	.41935	26	36	62
11	"11-out16979"	.98606	283	4	287
11	"11-out16980"	.59006	701	487	1188
11	"11-out16981"	.42622	104	140	244
11	"11-out16982"	.38870	117	184	301
11	"11-out16983"	.51671	170	159	329
11	"11-out16984"	.27850	320	829	1149
11	"11-out16985"	.23437	75	245	320
11	"11-out16986"	.33928	133	259	392
11	"11-out16987"	.45819	285	337	622
11	"11-out16988"	.39631	1076	1639	2715
11	"11-out16989"	.54511	290	242	532
11	"11-out16990"	.99967	3095	1	3096
11	"11-out16991"	.60000	69	46	115
11	"11-out16992"	.37644	422	699	1121
11	"11-out16993"	.46753	144	164	308
11	"11-out16994"	.99019	101	1	102
11	"11-out16995"	.69372	376	166	542
11	"11-out16996"	.87000	87	13	100
11	"11-out16997"	.47796	282	308	590
11	"11-out16998"	.19774	35	142	177
11	"11-out16999"	.99590	243	1	244
11	"11-out17000"	.98765	80	1	81
11	"11-out17001"	.41354	287	407	694
11	"11-out17002"	.32521	187	388	575
11	"11-out17003"	.28762	172	426	598
11	"11-out17004"	.60794	673	434	1107
11	"11-out17005"	.99786	468	1	469
11	"11-out17006"	.43991	205	261	466
11	"11-out17007"	.18691	20	87	107
11	"11-out17008"	.22134	506	1780	2286
11	"11-out17009"	.44592	235	292	527
11	"11-out17010"	.45578	67	80	147
11	"11-out17011"	.37606	44	73	117
11	"11-out17012"	.30912	383	856	1239
11	"11-out17013"	.27422	133	352	485
11	"11-out17014"	.29411	430	1032	1462
11	"11-out17015"	.46268	155	180	335
11	"11-out17016"	.29565	170	405	575
11	"11-out17017"	.53846	266	228	494
11	"11-out17018"	.42111	379	521	900
11	"11-out17019"	.41078	221	317	538
11	"11-out17020"	.78724	1247	337	1584
11	"11-out17021"	.98734	78	1	79
11	"11-out17022"	.91304	504	48	552
11	"11-out17023"	.89538	291	34	325
11	"11-out17024"	.55521	362	290	652
11	"11-out17025"	.53333	192	168	360
11	"11-out17026"	.56741	101	77	178
11	"11-out17027"	.49592	365	371	736
11	"11-out17028"	.47258	431	481	912
11	"11-out17029"	.22743	194	659	853
11	"11-out17030"	.38860	150	236	386
11	"11-out17031"	.32276	509	1068	1577
11	"11-out17032"	.24876	402	1214	1616
11	"11-out17033"	.26947	128	347	475
11	"11-out17034"	.53448	93	81	174
11	"11-out17035"	.16388	59	301	360
11	"11-out17036"	.28254	102	259	361
11	"11-out17037"	.73178	221	81	302
11	"11-out17038"	.47491	142	157	299
11	"11-out17039"	.36393	111	194	305
11	"11-out17040"	.43600	109	141	250
11	"11-out17041"	.49816	136	137	273
11	"11-out17042"	.40118	877	1309	2186
11	"11-out17043"	.81138	1682	391	2073
11	"11-out17044"	.22500	90	310	400
11	"11-out17045"	.91747	378	34	412
11	"11-out17046"	.30723	573	1292	1865
11	"11-out17047"	.25573	468	1362	1830
11	"11-out17048"	.21477	436	1594	2030
11	"11-out17049"	.40132	789	1177	1966
11	"11-out17050"	.30160	564	1306	1870
11	"11-out17051"	.28773	589	1458	2047
11	"11-out17052"	.35420	758	1382	2140
11	"11-out17053"	.33873	711	1388	2099
11	"11-out17054"	.31222	646	1423	2069
11	"11-out17055"	.53642	162	140	302
11	"11-out17056"	.76715	369	112	481
11	"11-out17057"	.27912	115	297	412
11	"11-out17058"	.47379	235	261	496
11	"11-out17059"	.30368	99	227	326
11	"11-out17060"	.24836	76	230	306
11	"11-out17061"	.23867	79	252	331
11	"11-out17062"	.49801	251	253	504
11	"11-out17063"	.28252	152	386	538
11	"11-out17064"	.58833	333	233	566
11	"11-out17065"	.34807	858	1607	2465
11	"11-out17066"	.29765	684	1614	2298
11	"11-out17067"	.99152	117	1	118
11	"11-out17068"	.19773	122	495	617
11	"11-out17069"	.03781	9	229	238
11	"11-out17070"	.32986	507	1030	1537
11	"11-out17071"	.27696	95	248	343
11	"11-out17072"	.25937	83	237	320
11	"11-out17073"	.44428	315	394	709
11	"11-out17074"	.34939	232	432	664
11	"11-out17075"	.99186	122	1	123
11	"11-out17076"	.51538	134	126	260
11	"11-out17077"	.63178	163	95	258
11	"11-out17078"	.97674	168	4	172
11	"11-out17079"	.17241	35	168	203
11	"11-out17080"	.99756	410	1	411
11	"11-out17081"	.39094	190	296	486
11	"11-out17082"	.38114	186	302	488
11	"11-out17083"	.49210	187	193	380
11	"11-out17084"	.47883	181	197	378
11	"11-out17085"	.30022	133	310	443
11	"11-out17086"	.68711	336	153	489
11	"11-out17087"	.97435	76	2	78
11	"11-out17088"	.78048	64	18	82
11	"11-out17089"	.51578	147	138	285
11	"11-out17090"	.35205	94	173	267
11	"11-out17091"	.52876	239	213	452
11	"11-out17092"	.51153	133	127	260
11	"11-out17093"	.57142	48	36	84
11	"11-out17094"	.64130	59	33	92
11	"11-out17095"	.20720	46	176	222
11	"11-out17096"	.30714	86	194	280
11	"11-out17097"	.58426	52	37	89
11	"11-out17098"	.60714	68	44	112
11	"11-out17099"	.09661	20	187	207
11	"11-out17100"	.78048	96	27	123
11	"11-out17101"	.57543	267	197	464
11	"11-out17102"	.33484	148	294	442
11	"11-out17103"	.44897	66	81	147
11	"11-out17104"	.99537	215	1	216
11	"11-out17105"	.99618	261	1	262
11	"11-out17106"	.65163	159	85	244
11	"11-out17107"	.81481	572	130	702
11	"11-out17108"	.51182	238	227	465
11	"11-out17109"	.35120	131	242	373
11	"11-out17110"	.33894	141	275	416
11	"11-out17111"	.57454	158	117	275
11	"11-out17112"	.73412	555	201	756
11	"11-out17113"	.43209	35	46	81
11	"11-out17114"	.24561	14	43	57
11	"11-out17115"	.36939	239	408	647
11	"11-out17116"	.46538	242	278	520
11	"11-out17117"	.41228	141	201	342
11	"11-out17118"	.37926	289	473	762
11	"11-out17119"	.39340	155	239	394
11	"11-out17120"	.34550	265	502	767
11	"11-out17121"	.55056	147	120	267
11	"11-out17122"	.56209	258	201	459
11	"11-out17123"	.42217	217	297	514
11	"11-out17124"	.23298	178	586	764
11	"11-out17125"	.22797	44	149	193
11	"11-out17126"	.99242	131	1	132
11	"11-out17127"	.99563	228	1	229
11	"11-out17128"	.42358	97	132	229
11	"11-out17129"	.99565	229	1	230
11	"11-out17130"	.87123	318	47	365
11	"11-out17131"	.99465	186	1	187
11	"11-out17132"	.99393	164	1	165
11	"11-out17133"	.18562	31	136	167
11	"11-out17134"	.99145	116	1	117
11	"11-out17135"	.31353	132	289	421
11	"11-out17136"	.53092	103	91	194
11	"11-out17137"	.96883	342	11	353
11	"11-out17138"	.29579	218	519	737
11	"11-out17139"	.29707	1412	3341	4753
11	"11-out17140"	.43216	86	113	199
11	"11-out17141"	.18518	35	154	189
11	"11-out17142"	.87909	349	48	397
11	"11-out17143"	.22815	94	318	412
11	"11-out17144"	.57070	113	85	198
11	"11-out17145"	.69838	345	149	494
11	"11-out17146"	.98814	250	3	253
11	"11-out17147"	.90384	235	25	260
11	"11-out17148"	.27529	253	666	919
11	"11-out17149"	.20911	211	798	1009
11	"11-out17150"	.48737	444	467	911
11	"11-out17151"	.16568	28	141	169
11	"11-out17152"	.50000	91	91	182
11	"11-out17153"	.37158	68	115	183
11	"11-out17154"	.23928	296	941	1237
11	"11-out17155"	.52662	89	80	169
11	"11-out17156"	.37291	179	301	480
11	"11-out17157"	.42512	88	119	207
11	"11-out17158"	.99315	145	1	146
11	"11-out17159"	.38684	147	233	380
11	"11-out17160"	.35648	77	139	216
11	"11-out17161"	.28507	128	321	449
11	"11-out17162"	.39482	229	351	580
11	"11-out17163"	.98850	86	1	87
11	"11-out17164"	.42841	383	511	894
11	"11-out17165"	.46059	415	486	901
11	"11-out17166"	.48772	437	459	896
11	"11-out17167"	.24950	502	1510	2012
11	"11-out17168"	.24208	497	1556	2053
11	"11-out17169"	.50168	149	148	297
11	"11-out17170"	.77966	92	26	118
11	"11-out17171"	.41052	78	112	190
11	"11-out17172"	.72164	70	27	97
11	"11-out17173"	.99328	148	1	149
11	"11-out17174"	.35973	436	776	1212
11	"11-out17175"	.83611	801	157	958
11	"11-out17176"	.26978	283	766	1049
11	"11-out17177"	.42218	472	646	1118
11	"11-out17178"	.34934	349	650	999
11	"11-out17179"	.30192	314	726	1040
11	"11-out17180"	.30056	107	249	356
11	"11-out17181"	.68408	890	411	1301
11	"11-out17182"	.33686	413	813	1226
11	"11-out17183"	.09569	20	189	209
11	"11-out17184"	.57738	97	71	168
11	"11-out17185"	.47375	370	411	781
11	"11-out17186"	.35068	256	474	730
11	"11-out17187"	.27052	201	542	743
11	"11-out17188"	.19138	120	507	627
11	"11-out17189"	.93750	285	19	304
11	"11-out17190"	.84899	253	45	298
11	"11-out17191"	.54677	339	281	620
11	"11-out17192"	.99528	422	2	424
11	"11-out17193"	.99528	422	2	424
11	"11-out17194"	.99526	420	2	422
11	"11-out17195"	.99528	422	2	424
11	"11-out17196"	.99528	422	2	424
11	"11-out17197"	.99528	422	2	424
11	"11-out17198"	.55383	859	692	1551
11	"11-out17199"	.66989	1037	511	1548
11	"11-out17200"	.21578	41	149	190
11	"11-out17201"	.99056	105	1	106
11	"11-out17202"	.63656	282	161	443
11	"11-out17203"	.31076	202	448	650
11	"11-out17204"	.31351	58	127	185
11	"11-out17205"	.55835	177	140	317
11	"11-out17206"	.39847	157	237	394
11	"11-out17207"	.22572	86	295	381
11	"11-out17208"	.94010	361	23	384
11	"11-out17209"	.61090	168	107	275
11	"11-out17210"	.54143	294	249	543
11	"11-out17211"	.47093	243	273	516
11	"11-out17212"	.48344	584	624	1208
11	"11-out17213"	.55481	167	134	301
11	"11-out17214"	.38733	208	329	537
11	"11-out17215"	.61191	883	560	1443
11	"11-out17216"	.35188	196	361	557
11	"11-out17217"	.30820	233	523	756
11	"11-out17218"	.51694	61	57	118
11	"11-out17219"	.65909	145	75	220
11	"11-out17220"	.84158	340	64	404
11	"11-out17221"	.31632	62	134	196
11	"11-out17222"	.26928	178	483	661
11	"11-out17223"	.38998	296	463	759
11	"11-out17224"	.34152	514	991	1505
11	"11-out17225"	.47510	706	780	1486
11	"11-out17226"	.28830	175	432	607
11	"11-out17227"	.44375	71	89	160
11	"11-out17228"	.33103	96	194	290
11	"11-out17229"	.38683	94	149	243
11	"11-out17230"	.99248	132	1	133
11	"11-out17231"	.71171	79	32	111
11	"11-out17232"	.34219	103	198	301
11	"11-out17233"	.47371	712	791	1503
11	"11-out17234"	.56800	71	54	125
11	"11-out17235"	.71088	209	85	294
11	"11-out17236"	.52702	195	175	370
11	"11-out17237"	.99512	204	1	205
11	"11-out17238"	.63279	274	159	433
11	"11-out17239"	.92523	99	8	107
11	"11-out17240"	.44021	162	206	368
11	"11-out17241"	.55102	54	44	98
11	"11-out17242"	.67653	297	142	439
11	"11-out17243"	.56382	53	41	94
11	"11-out17244"	.48623	53	56	109
11	"11-out17245"	.43243	48	63	111
11	"11-out17246"	.63865	76	43	119
11	"11-out17247"	.20121	132	524	656
11	"11-out17248"	.22982	131	439	570
11	"11-out17249"	.88421	168	22	190
11	"11-out17250"	.32750	131	269	400
11	"11-out17251"	.31767	115	247	362
11	"11-out17252"	.47440	139	154	293
11	"11-out17253"	.59872	94	63	157
11	"11-out17254"	.33439	105	209	314
11	"11-out17255"	.24452	134	414	548
11	"11-out17256"	.99621	263	1	264
11	"11-out17257"	.92783	90	7	97
11	"11-out17258"	.54237	128	108	236
11	"11-out17259"	.20854	161	611	772
11	"11-out17260"	.99703	673	2	675
11	"11-out17261"	.35294	156	286	442
11	"11-out17262"	.35443	140	255	395
11	"11-out17263"	.31666	38	82	120
11	"11-out17264"	.77777	490	140	630
11	"11-out17265"	.53488	161	140	301
11	"11-out17266"	.56891	194	147	341
11	"11-out17267"	.59854	987	662	1649
11	"11-out17268"	.38550	133	212	345
11	"11-out17269"	.21850	111	397	508
11	"11-out17270"	.32882	146	298	444
11	"11-out17271"	.72000	126	49	175
11	"11-out17272"	.60919	106	68	174
11	"11-out17273"	.42919	391	520	911
11	"11-out17274"	.36678	318	549	867
11	"11-out17275"	.98701	76	1	77
11	"11-out17276"	.99519	207	1	208
11	"11-out17277"	.45622	99	118	217
11	"11-out17278"	.51004	127	122	249
11	"11-out17279"	.33469	82	163	245
11	"11-out17280"	.39268	333	515	848
11	"11-out17281"	.62933	399	235	634
11	"11-out17282"	.32794	203	416	619
11	"11-out17283"	.36120	108	191	299
11	"11-out17284"	.46969	62	70	132
11	"11-out17285"	.94977	624	33	657
11	"11-out17286"	.41467	277	391	668
11	"11-out17287"	.30721	98	221	319
11	"11-out17288"	.40445	127	187	314
11	"11-out17289"	.34064	202	391	593
11	"11-out17290"	.33024	321	651	972
11	"11-out17291"	.35000	91	169	260
11	"11-out17292"	.99539	216	1	217
11	"11-out17293"	.36483	305	531	836
11	"11-out17294"	.73821	141	50	191
11	"11-out17295"	.98648	219	3	222
11	"11-out17296"	.25833	62	178	240
11	"11-out17297"	.27906	60	155	215
11	"11-out17298"	.52272	69	63	132
11	"11-out17299"	.36764	100	172	272
11	"11-out17300"	.29802	121	285	406
11	"11-out17301"	.81395	1890	432	2322
11	"11-out17302"	.39222	222	344	566
11	"11-out17303"	.46583	300	344	644
11	"11-out17304"	.27631	231	605	836
11	"11-out17305"	.42768	343	459	802
11	"11-out17306"	.99526	210	1	211
11	"11-out17307"	.24179	140	439	579
11	"11-out17308"	.47945	70	76	146
11	"11-out17309"	.29722	107	253	360
11	"11-out17310"	.98404	740	12	752
11	"11-out17311"	.98554	341	5	346
11	"11-out17312"	.50304	248	245	493
11	"11-out17313"	.35136	513	947	1460
11	"11-out17314"	.34381	339	647	986
11	"11-out17315"	.88372	304	40	344
11	"11-out17316"	.39721	570	865	1435
11	"11-out17317"	.76521	264	81	345
11	"11-out17318"	.73977	199	70	269
11	"11-out17319"	.99595	246	1	247
11	"11-out17320"	.62320	779	471	1250
11	"11-out17321"	.59386	310	212	522
11	"11-out17322"	.36842	196	336	532
11	"11-out17323"	.38871	124	195	319
11	"11-out17324"	.99378	160	1	161
11	"11-out17325"	.31944	69	147	216
11	"11-out17326"	.88960	556	69	625
11	"11-out17327"	.32938	306	623	929
11	"11-out17328"	.99290	140	1	141
11	"11-out17329"	.40601	54	79	133
11	"11-out17330"	.34375	77	147	224
11	"11-out17331"	.32437	169	352	521
11	"11-out17332"	.37176	187	316	503
11	"11-out17333"	.41897	424	588	1012
11	"11-out17334"	.36580	169	293	462
11	"11-out17335"	.47183	511	572	1083
11	"11-out17336"	.99797	493	1	494
11	"11-out17337"	.83015	435	89	524
11	"11-out17338"	.26394	549	1531	2080
11	"11-out17339"	.99805	514	1	515
11	"11-out17340"	.39446	228	350	578
11	"11-out17341"	.35904	270	482	752
11	"11-out17342"	.29299	138	333	471
11	"11-out17343"	.52473	297	269	566
11	"11-out17344"	.39182	163	253	416
11	"11-out17345"	.95576	497	23	520
11	"11-out17346"	.55882	133	105	238
11	"11-out17347"	.61056	312	199	511
11	"11-out17348"	.47521	163	180	343
11	"11-out17349"	.50000	267	267	534
11	"11-out17350"	.64200	269	150	419
11	"11-out17351"	.34166	41	79	120
11	"11-out17352"	.52300	216	197	413
11	"11-out17353"	.56927	189	143	332
11	"11-out17354"	.81944	295	65	360
11	"11-out17355"	.41891	124	172	296
11	"11-out17356"	.36830	172	295	467
11	"11-out17357"	.99872	781	1	782
11	"11-out17358"	.87019	181	27	208
11	"11-out17359"	.99792	481	1	482
11	"11-out17360"	.29615	531	1262	1793
11	"11-out17361"	.98936	93	1	94
11	"11-out17362"	.32755	170	349	519
11	"11-out17363"	.45698	85	101	186
11	"11-out17364"	.99115	112	1	113
11	"11-out17365"	.32727	126	259	385
11	"11-out17366"	.32986	95	193	288
11	"11-out17367"	.24911	70	211	281
11	"11-out17368"	.99502	200	1	201
11	"11-out17369"	.35524	227	412	639
11	"11-out17370"	.64726	189	103	292
11	"11-out17371"	.38410	58	93	151
11	"11-out17372"	.85443	270	46	316
11	"11-out17373"	.94871	148	8	156
11	"11-out17374"	.89440	144	17	161
11	"11-out17375"	.39298	997	1540	2537
11	"11-out17376"	.67826	78	37	115
11	"11-out17377"	.83333	210	42	252
11	"11-out17378"	.39945	437	657	1094
11	"11-out17379"	.40808	1272	1845	3117
11	"11-out17380"	.69433	184	81	265
11	"11-out17381"	.92608	426	34	460
11	"11-out17382"	.95185	257	13	270
11	"11-out17383"	.48018	618	669	1287
11	"11-out17384"	.35390	172	314	486
11	"11-out17385"	.95973	143	6	149
11	"11-out17386"	.98897	269	3	272
11	"11-out17387"	.37318	1236	2076	3312
11	"11-out17388"	.75119	314	104	418
11	"11-out17389"	.37435	146	244	390
11	"11-out17390"	.53278	65	57	122
11	"11-out17391"	.40476	119	175	294
11	"11-out17392"	.52108	173	159	332
11	"11-out17393"	.72135	277	107	384
11	"11-out17394"	.46300	194	225	419
11	"11-out17395"	.99152	117	1	118
11	"11-out17396"	.40253	159	236	395
11	"11-out17397"	.58791	107	75	182
11	"11-out17398"	.40666	464	677	1141
11	"11-out17399"	.99206	125	1	126
11	"11-out17400"	.29482	148	354	502
11	"11-out17401"	.46887	241	273	514
11	"11-out17402"	.35028	186	345	531
11	"11-out17403"	.32040	157	333	490
11	"11-out17404"	.40952	215	310	525
11	"11-out17405"	.99229	515	4	519
11	"11-out17406"	.98608	496	7	503
11	"11-out17407"	.39514	309	473	782
11	"11-out17408"	.88805	119	15	134
11	"11-out17409"	.64942	113	61	174
11	"11-out17410"	.89140	197	24	221
11	"11-out17411"	.99290	140	1	141
11	"11-out17412"	.46641	125	143	268
11	"11-out17413"	.71604	174	69	243
11	"11-out17414"	.24675	38	116	154
11	"11-out17415"	.98947	94	1	95
11	"11-out17416"	.99107	111	1	112
11	"11-out17417"	.37546	101	168	269
11	"11-out17418"	.20379	43	168	211
11	"11-out17419"	.73285	203	74	277
11	"11-out17420"	.33843	420	821	1241
11	"11-out17421"	.34583	83	157	240
11	"11-out17422"	.66071	259	133	392
11	"11-out17423"	.32444	73	152	225
11	"11-out17424"	.53636	59	51	110
11	"11-out17425"	.28463	263	661	924
11	"11-out17426"	.22767	102	346	448
11	"11-out17427"	.26513	127	352	479
11	"11-out17428"	.35338	141	258	399
11	"11-out17429"	.33002	233	473	706
11	"11-out17430"	.43113	72	95	167
11	"11-out17431"	.41860	36	50	86
11	"11-out17432"	.50187	534	530	1064
11	"11-out17433"	.26595	25	69	94
11	"11-out17434"	.44479	572	714	1286
11	"11-out17435"	.50632	40	39	79
11	"11-out17436"	.57142	48	36	84
11	"11-out17437"	.29094	135	329	464
11	"11-out17438"	.99740	384	1	385
11	"11-out17439"	.98863	87	1	88
11	"11-out17440"	.37079	353	599	952
11	"11-out17441"	.36254	302	531	833
11	"11-out17442"	.40701	116	169	285
11	"11-out17443"	.27994	374	962	1336
11	"11-out17444"	.22150	276	970	1246
11	"11-out17445"	.23821	96	307	403
11	"11-out17446"	.35045	116	215	331
11	"11-out17447"	.99683	315	1	316
11	"11-out17448"	.33141	115	232	347
11	"11-out17449"	.98989	98	1	99
11	"11-out17450"	.38092	651	1058	1709
11	"11-out17451"	.41461	420	593	1013
11	"11-out17452"	.39769	276	418	694
11	"11-out17453"	.27812	450	1168	1618
11	"11-out17454"	.27420	507	1342	1849
11	"11-out17455"	.41785	730	1017	1747
11	"11-out17456"	.47394	564	626	1190
11	"11-out17457"	.54965	321	263	584
11	"11-out17458"	.41782	300	418	718
11	"11-out17459"	.33400	165	329	494
11	"11-out17460"	.29090	1456	3549	5005
11	"11-out17461"	.81000	324	76	400
11	"11-out17462"	.88583	419	54	473
11	"11-out17463"	.37971	161	263	424
11	"11-out17464"	.90740	392	40	432
11	"11-out17465"	.49333	222	228	450
11	"11-out17466"	.98837	425	5	430
11	"11-out17467"	.89893	507	57	564
11	"11-out17468"	.90957	513	51	564
11	"11-out17469"	.68559	809	371	1180
11	"11-out17470"	.59295	303	208	511
11	"11-out17471"	.51017	326	313	639
11	"11-out17472"	.61436	325	204	529
11	"11-out17473"	.59006	380	264	644
11	"11-out17474"	.97515	471	12	483
11	"11-out17475"	.33937	356	693	1049
11	"11-out17476"	.59517	444	302	746
11	"11-out17477"	.35235	247	454	701
11	"11-out17478"	.52339	179	163	342
11	"11-out17479"	.51282	120	114	234
11	"11-out17480"	.41666	155	217	372
11	"11-out17481"	.25000	101	303	404
11	"11-out17482"	.31578	60	130	190
11	"11-out17483"	.39890	146	220	366
11	"11-out17484"	.42786	258	345	603
11	"11-out17485"	.50612	124	121	245
11	"11-out17486"	.99735	377	1	378
11	"11-out17487"	.99735	377	1	378
11	"11-out17488"	.52459	128	116	244
11	"11-out17489"	.30737	75	169	244
11	"11-out17490"	.29620	117	278	395
11	"11-out17491"	.64050	253	142	395
11	"11-out17492"	.34108	44	85	129
11	"11-out17493"	.33759	132	259	391
11	"11-out17494"	.99936	1567	1	1568
11	"11-out17495"	.92168	153	13	166
11	"11-out17496"	.33962	36	70	106
11	"11-out17497"	.40284	170	252	422
11	"11-out17498"	.62141	412	251	663
11	"11-out17499"	.39754	97	147	244
11	"11-out17500"	.45454	190	228	418
11	"11-out17501"	.21169	76	283	359
11	"11-out17502"	.98039	50	1	51
11	"11-out17503"	.34398	140	267	407
11	"11-out17504"	.17897	63	289	352
11	"11-out17505"	.36121	95	168	263
11	"11-out17506"	.31142	109	241	350
11	"11-out17507"	.99844	643	1	644
11	"11-out17508"	.65490	334	176	510
11	"11-out17509"	.26623	123	339	462
11	"11-out17510"	.26078	272	771	1043
11	"11-out17511"	.37065	192	326	518
11	"11-out17512"	.43347	417	545	962
11	"11-out17513"	.55172	64	52	116
11	"11-out17514"	.30751	270	608	878
11	"11-out17515"	.43223	118	155	273
11	"11-out17516"	.32142	108	228	336
11	"11-out17517"	.76044	273	86	359
11	"11-out17518"	.28909	61	150	211
11	"11-out17519"	.34345	328	627	955
11	"11-out17520"	.43128	408	538	946
11	"11-out17521"	.33089	226	457	683
11	"11-out17522"	.31274	162	356	518
11	"11-out17523"	.36384	155	271	426
11	"11-out17524"	.23551	126	409	535
11	"11-out17525"	.51282	40	38	78
11	"11-out17526"	.78947	60	16	76
11	"11-out17527"	.96153	400	16	416
11	"11-out17528"	.44820	437	538	975
11	"11-out17529"	.42471	409	554	963
11	"11-out17530"	.29879	323	758	1081
11	"11-out17531"	.90462	939	99	1038
11	"11-out17532"	.44648	463	574	1037
11	"11-out17533"	.98536	202	3	205
11	"11-out17534"	.93658	192	13	205
11	"11-out17535"	.47250	232	259	491
11	"11-out17536"	.30712	168	379	547
11	"11-out17537"	.31773	129	277	406
11	"11-out17538"	.45209	151	183	334
11	"11-out17539"	.91003	263	26	289
11	"11-out17540"	.99511	814	4	818
11	"11-out17541"	.32230	224	471	695
11	"11-out17542"	.43902	90	115	205
11	"11-out17543"	.72560	119	45	164
11	"11-out17544"	.42857	66	88	154
11	"11-out17545"	.72297	107	41	148
11	"11-out17546"	.31061	319	708	1027
11	"11-out17547"	.99800	500	1	501
11	"11-out17548"	.33559	396	784	1180
11	"11-out17549"	.56852	672	510	1182
11	"11-out17550"	.29511	489	1168	1657
11	"11-out17551"	.32618	532	1099	1631
11	"11-out17552"	.39609	223	340	563
11	"11-out17553"	.38053	301	490	791
11	"11-out17554"	.32214	192	404	596
11	"11-out17555"	.20000	65	260	325
11	"11-out17556"	.44132	425	538	963
11	"11-out17557"	.22126	154	542	696
11	"11-out17558"	.25801	177	509	686
11	"11-out17559"	.41545	516	726	1242
11	"11-out17560"	.50597	677	661	1338
11	"11-out17561"	.88549	348	45	393
11	"11-out17562"	.38367	188	302	490
11	"11-out17563"	.38823	33	52	85
11	"11-out17564"	.35051	34	63	97
11	"11-out17565"	.58139	50	36	86
11	"11-out17566"	.38161	137	222	359
11	"11-out17567"	.27651	206	539	745
11	"11-out17568"	.30841	132	296	428
11	"11-out17569"	.59894	342	229	571
11	"11-out17570"	.40939	122	176	298
11	"11-out17571"	.34774	193	362	555
11	"11-out17572"	.52758	153	137	290
11	"11-out17573"	.99145	116	1	117
11	"11-out17574"	.82608	190	40	230
11	"11-out17575"	.24412	135	418	553
11	"11-out17576"	.43440	149	194	343
11	"11-out17577"	.46449	314	362	676
11	"11-out17578"	.99145	116	1	117
11	"11-out17579"	.99173	120	1	121
11	"11-out17580"	.99166	119	1	120
11	"11-out17581"	.32196	85	179	264
11	"11-out17582"	.37380	157	263	420
11	"11-out17583"	.39110	167	260	427
11	"11-out17584"	.99145	116	1	117
11	"11-out17585"	.19584	113	464	577
11	"11-out17586"	.93656	561	38	599
11	"11-out17587"	.69289	361	160	521
11	"11-out17588"	.35508	185	336	521
11	"11-out17589"	.88521	455	59	514
11	"11-out17590"	.37950	474	775	1249
11	"11-out17591"	.36196	177	312	489
11	"11-out17592"	.30563	103	234	337
11	"11-out17593"	.26623	123	339	462
11	"11-out17594"	.99166	595	5	600
11	"11-out17595"	.60946	309	198	507
11	"11-out17596"	.33495	206	409	615
11	"11-out17597"	.35236	290	533	823
11	"11-out17598"	.33283	222	445	667
11	"11-out17599"	.55480	248	199	447
11	"11-out17600"	.27327	135	359	494
11	"11-out17601"	.44516	138	172	310
11	"11-out17602"	.23223	268	886	1154
11	"11-out17603"	.31725	125	269	394
11	"11-out17604"	.70689	492	204	696
11	"11-out17605"	.42379	317	431	748
11	"11-out17606"	.34605	408	771	1179
11	"11-out17607"	.36752	430	740	1170
11	"11-out17608"	.59077	205	142	347
11	"11-out17609"	.34138	763	1472	2235
11	"11-out17610"	.55764	445	353	798
11	"11-out17611"	.32523	348	722	1070
11	"11-out17612"	.45481	468	561	1029
11	"11-out17613"	.30961	161	359	520
11	"11-out17614"	.37000	444	756	1200
11	"11-out17615"	.99621	263	1	264
11	"11-out17616"	.62938	287	169	456
11	"11-out17617"	.92198	520	44	564
11	"11-out17618"	.68068	356	167	523
11	"11-out17619"	.87259	363	53	416
11	"11-out17620"	.42415	892	1211	2103
11	"11-out17621"	.62777	339	201	540
11	"11-out17622"	.61072	353	225	578
11	"11-out17623"	.98507	462	7	469
11	"11-out17624"	.22047	56	198	254
11	"11-out17625"	.50162	154	153	307
11	"11-out17626"	.44956	205	251	456
11	"11-out17627"	.29603	254	604	858
11	"11-out17628"	.36842	189	324	513
11	"11-out17629"	.42400	212	288	500
11	"11-out17630"	.31620	560	1211	1771
11	"11-out17631"	.77667	393	113	506
11	"11-out17632"	.30710	519	1171	1690
11	"11-out17633"	.30048	125	291	416
11	"11-out17634"	.53601	253	219	472
11	"11-out17635"	.99521	208	1	209
11	"11-out17636"	.39937	127	191	318
11	"11-out17637"	.41841	459	638	1097
11	"11-out17638"	.29586	308	733	1041
11	"11-out17639"	.99512	204	1	205
11	"11-out17640"	.99504	201	1	202
11	"11-out17641"	.44349	259	325	584
11	"11-out17642"	.48913	225	235	460
11	"11-out17643"	.36676	128	221	349
11	"11-out17644"	.31042	140	311	451
11	"11-out17645"	.32329	161	337	498
11	"11-out17646"	.62318	301	182	483
11	"11-out17647"	.99224	128	1	129
11	"11-out17648"	.29914	35	82	117
11	"11-out17649"	.34866	758	1416	2174
11	"11-out17650"	.21698	46	166	212
11	"11-out17651"	.63888	92	52	144
11	"11-out17652"	.31500	63	137	200
11	"11-out17653"	.31871	436	932	1368
11	"11-out17654"	.43283	116	152	268
11	"11-out17655"	.52054	76	70	146
11	"11-out17656"	.36058	172	305	477
11	"11-out17657"	.99663	296	1	297
11	"11-out17658"	.77521	269	78	347
11	"11-out17659"	.99820	555	1	556
11	"11-out17660"	.44850	405	498	903
11	"11-out17661"	.74289	627	217	844
11	"11-out17662"	.33110	99	200	299
11	"11-out17663"	.33221	99	199	298
11	"11-out17664"	.41388	322	456	778
11	"11-out17665"	.44708	207	256	463
11	"11-out17666"	.39893	75	113	188
11	"11-out17667"	.42718	44	59	103
11	"11-out17668"	.37305	216	363	579
11	"11-out17669"	.37659	383	634	1017
11	"11-out17670"	.29048	287	701	988
11	"11-out17671"	.46680	464	530	994
11	"11-out17672"	.32278	255	535	790
11	"11-out17673"	.35432	287	523	810
11	"11-out17674"	.79725	987	251	1238
11	"11-out17675"	.44171	72	91	163
11	"11-out17676"	.39134	443	689	1132
11	"11-out17677"	.61043	503	321	824
11	"11-out17678"	.42803	113	151	264
11	"11-out17679"	.59076	371	257	628
11	"11-out17680"	.27368	52	138	190
11	"11-out17681"	.38996	544	851	1395
11	"11-out17682"	.34141	366	706	1072
11	"11-out17683"	.50086	289	288	577
11	"11-out17684"	.29179	569	1381	1950
11	"11-out17685"	.52439	677	614	1291
11	"11-out17686"	.99745	785	2	787
11	"11-out17687"	.88427	1597	209	1806
11	"11-out17688"	.40891	523	756	1279
11	"11-out17689"	.64525	462	254	716
11	"11-out17690"	.57264	268	200	468
11	"11-out17691"	.43750	203	261	464
11	"11-out17692"	.39675	171	260	431
11	"11-out17693"	.48956	305	318	623
11	"11-out17694"	.99526	631	3	634
11	"11-out17695"	.60267	270	178	448
11	"11-out17696"	.73981	472	166	638
11	"11-out17697"	.64246	354	197	551
11	"11-out17698"	.52307	272	248	520
11	"11-out17699"	.54205	290	245	535
11	"11-out17700"	.41055	140	201	341
11	"11-out17701"	.65764	413	215	628
11	"11-out17702"	.54868	293	241	534
11	"11-out17703"	.35855	109	195	304
11	"11-out17704"	.27254	136	363	499
11	"11-out17705"	.27795	87	226	313
11	"11-out17706"	.31985	87	185	272
11	"11-out17707"	.41020	217	312	529
11	"11-out17708"	.68093	175	82	257
11	"11-out17709"	.30733	134	302	436
11	"11-out17710"	.99307	287	2	289
11	"11-out17711"	.31766	277	595	872
11	"11-out17712"	.19597	78	320	398
11	"11-out17713"	.20286	85	334	419
11	"11-out17714"	.44366	378	474	852
11	"11-out17715"	.32481	343	713	1056
11	"11-out17716"	.35928	480	856	1336
11	"11-out17717"	.29080	449	1095	1544
11	"11-out17718"	.73589	1148	412	1560
11	"11-out17719"	.42239	694	949	1643
11	"11-out17720"	.66323	193	98	291
11	"11-out17721"	.96587	283	10	293
11	"11-out17722"	.25611	356	1034	1390
11	"11-out17723"	.26713	152	417	569
11	"11-out17724"	.79446	402	104	506
11	"11-out17725"	.44191	194	245	439
11	"11-out17726"	.83265	617	124	741
11	"11-out17727"	.30136	88	204	292
11	"11-out17728"	.35714	130	234	364
11	"11-out17729"	.44225	337	425	762
11	"11-out17730"	.99159	118	1	119
11	"11-out17731"	.48788	282	296	578
11	"11-out17732"	.32632	326	673	999
11	"11-out17733"	.99152	117	1	118
11	"11-out17734"	.99159	118	1	119
11	"11-out17735"	.17363	54	257	311
11	"11-out17736"	.38709	144	228	372
11	"11-out17737"	.19125	70	296	366
11	"11-out17738"	.41752	81	113	194
11	"11-out17739"	.25194	97	288	385
11	"11-out17740"	.77294	320	94	414
11	"11-out17741"	.80745	130	31	161
11	"11-out17742"	.51121	114	109	223
11	"11-out17743"	.99818	549	1	550
11	"11-out17744"	.45788	299	354	653
11	"11-out17745"	.62179	97	59	156
11	"11-out17746"	.41982	521	720	1241
11	"11-out17747"	.99567	230	1	231
11	"11-out17748"	.21600	27	98	125
11	"11-out17749"	.64634	159	87	246
11	"11-out17750"	.61273	481	304	785
11	"11-out17751"	.43243	64	84	148
11	"11-out17752"	.99099	330	3	333
11	"11-out17753"	.40000	126	189	315
11	"11-out17754"	.99346	152	1	153
11	"11-out17755"	.60143	335	222	557
11	"11-out17756"	.22395	43	149	192
11	"11-out17757"	.35357	99	181	280
11	"11-out17758"	.73239	104	38	142
11	"11-out17759"	.31325	78	171	249
11	"11-out17760"	.23703	32	103	135
11	"11-out17761"	.61475	150	94	244
11	"11-out17762"	.42574	129	174	303
11	"11-out17763"	.37773	397	654	1051
11	"11-out17764"	.28282	336	852	1188
11	"11-out17765"	.38832	306	482	788
11	"11-out17766"	.39469	446	684	1130
11	"11-out17767"	.34541	181	343	524
11	"11-out17768"	.44325	207	260	467
11	"11-out17769"	.43538	219	284	503
11	"11-out17770"	.35211	150	276	426
11	"11-out17771"	.39583	190	290	480
11	"11-out17772"	.27442	132	349	481
11	"11-out17773"	.44751	81	100	181
11	"11-out17774"	.31460	196	427	623
11	"11-out17775"	.32286	144	302	446
11	"11-out17776"	.93506	144	10	154
11	"11-out17777"	.44399	218	273	491
11	"11-out17778"	.33059	1850	3746	5596
11	"11-out17779"	.38750	31	49	80
11	"11-out17780"	.99393	164	1	165
11	"11-out17781"	.24861	45	136	181
11	"11-out17782"	.20630	72	277	349
11	"11-out17783"	.45781	586	694	1280
11	"11-out17784"	.81443	79	18	97
11	"11-out17785"	.62857	88	52	140
11	"11-out17786"	.99512	204	1	205
11	"11-out17787"	.53658	242	209	451
11	"11-out17788"	.99572	233	1	234
11	"11-out17789"	.81751	224	50	274
11	"11-out17790"	.90782	325	33	358
11	"11-out17791"	.29729	55	130	185
11	"11-out17792"	.28686	107	266	373
11	"11-out17793"	.96646	2104	73	2177
11	"11-out17794"	.99731	372	1	373
11	"11-out17795"	.61764	273	169	442
11	"11-out17796"	.84266	316	59	375
11	"11-out17797"	.21658	141	510	651
11	"11-out17798"	.44833	269	331	600
11	"11-out17799"	.25534	215	627	842
11	"11-out17800"	.29392	358	860	1218
11	"11-out17801"	.44330	1126	1414	2540
11	"11-out17802"	.30048	311	724	1035
11	"11-out17803"	.73126	849	312	1161
11	"11-out17804"	.60389	93	61	154
11	"11-out17805"	.30555	352	800	1152
11	"11-out17806"	.36164	379	669	1048
11	"11-out17807"	.57971	80	58	138
11	"11-out17808"	.99600	249	1	250
11	"11-out17809"	.46465	447	515	962
11	"11-out17810"	.45721	187	222	409
11	"11-out17811"	.59536	231	157	388
11	"11-out17812"	.99145	116	1	117
11	"11-out17813"	.99152	117	1	118
11	"11-out17814"	.55154	107	87	194
11	"11-out17815"	.99333	149	1	150
11	"11-out17816"	.62727	69	41	110
11	"11-out17817"	.99145	116	1	117
11	"11-out17818"	.99285	139	1	140
11	"11-out17819"	.24848	41	124	165
11	"11-out17820"	.34523	319	605	924
11	"11-out17821"	.80168	190	47	237
11	"11-out17822"	.35114	230	425	655
11	"11-out17823"	.45763	1037	1229	2266
11	"11-out17824"	.87983	864	118	982
11	"11-out17825"	.39805	82	124	206
11	"11-out17826"	.42100	429	590	1019
11	"11-out17827"	.21008	25	94	119
11	"11-out17828"	.71551	83	33	116
11	"11-out17829"	.77533	176	51	227
11	"11-out17830"	.44933	102	125	227
11	"11-out17831"	.70563	513	214	727
11	"11-out17832"	.85664	496	83	579
11	"11-out17833"	.27173	50	134	184
11	"11-out17834"	.33980	175	340	515
11	"11-out17835"	.28534	444	1112	1556
11	"11-out17836"	.42049	238	328	566
11	"11-out17837"	.58778	77	54	131
11	"11-out17838"	.48920	68	71	139
11	"11-out17839"	.90000	144	16	160
11	"11-out17840"	.28571	188	470	658
11	"11-out17841"	.79231	763	200	963
11	"11-out17842"	.34445	351	668	1019
11	"11-out17843"	.39702	374	568	942
11	"11-out17844"	.24882	265	800	1065
11	"11-out17845"	.36270	778	1367	2145
11	"11-out17846"	.42757	307	411	718
11	"11-out17847"	.96097	197	8	205
11	"11-out17848"	.78929	472	126	598
11	"11-out17849"	.32832	153	313	466
11	"11-out17850"	.17757	19	88	107
11	"11-out17851"	.54716	87	72	159
11	"11-out17852"	.37979	109	178	287
11	"11-out17853"	.27622	266	697	963
11	"11-out17854"	.60483	900	588	1488
11	"11-out17855"	.36634	577	998	1575
11	"11-out17856"	.57317	47	35	82
11	"11-out17857"	.99859	711	1	712
11	"11-out17858"	.32960	206	419	625
11	"11-out17859"	.35405	205	374	579
11	"11-out17860"	.23130	300	997	1297
11	"11-out17861"	.24312	336	1046	1382
11	"11-out17862"	.39259	53	82	135
11	"11-out17863"	.48356	103	110	213
11	"11-out17864"	.35299	425	779	1204
11	"11-out17865"	.29041	636	1554	2190
11	"11-out17866"	.77777	455	130	585
11	"11-out17867"	.44944	449	550	999
11	"11-out17868"	.81767	148	33	181
11	"11-out17869"	.27309	68	181	249
11	"11-out17870"	.22368	68	236	304
11	"11-out17871"	.41880	147	204	351
11	"11-out17872"	.34841	770	1440	2210
11	"11-out17873"	.99765	426	1	427
11	"11-out17874"	.52016	245	226	471
11	"11-out17875"	.43436	546	711	1257
11	"11-out17876"	.69261	347	154	501
11	"11-out17877"	.86897	451	68	519
11	"11-out17878"	.42577	304	410	714
11	"11-out17879"	.34308	422	808	1230
11	"11-out17880"	.43621	212	274	486
11	"11-out17881"	.24423	159	492	651
11	"11-out17882"	.18750	39	169	208
11	"11-out17883"	.24414	386	1195	1581
11	"11-out17884"	.37948	148	242	390
11	"11-out17885"	.32352	110	230	340
11	"11-out17886"	.32506	367	762	1129
11	"11-out17887"	.50451	391	384	775
11	"11-out17888"	.98618	714	10	724
11	"11-out17889"	.78003	500	141	641
11	"11-out17890"	.71770	300	118	418
11	"11-out17891"	.33545	158	313	471
11	"11-out17892"	.99159	118	1	119
11	"11-out17893"	.99145	116	1	117
11	"11-out17894"	.99145	116	1	117
11	"11-out17895"	.39202	118	183	301
11	"11-out17896"	.99145	116	1	117
11	"11-out17897"	.50000	165	165	330
11	"11-out17898"	.39273	227	351	578
11	"11-out17899"	.33548	52	103	155
11	"11-out17900"	.45161	112	136	248
11	"11-out17901"	.66572	235	118	353
11	"11-out17902"	.82400	103	22	125
11	"11-out17903"	.90225	120	13	133
11	"11-out17904"	.67802	398	189	587
11	"11-out17905"	.73236	353	129	482
11	"11-out17906"	.54779	149	123	272
11	"11-out17907"	.36643	631	1091	1722
11	"11-out17908"	.43644	309	399	708
11	"11-out17909"	.33750	135	265	400
11	"11-out17910"	.68227	204	95	299
11	"11-out17911"	.39209	238	369	607
11	"11-out17912"	.53650	169	146	315
11	"11-out17913"	.27631	63	165	228
11	"11-out17914"	.99470	188	1	189
11	"11-out17915"	.93121	176	13	189
11	"11-out17916"	.99470	188	1	189
11	"11-out17917"	.36363	68	119	187
11	"11-out17918"	.56228	334	260	594
11	"11-out17919"	.97500	195	5	200
11	"11-out17920"	.99489	195	1	196
11	"11-out17921"	.99441	178	1	179
11	"11-out17922"	.63502	301	173	474
11	"11-out17923"	.16666	24	120	144
11	"11-out17924"	.38206	311	503	814
11	"11-out17925"	.17190	235	1132	1367
11	"11-out17926"	.98387	122	2	124
11	"11-out17927"	.29656	371	880	1251
11	"11-out17928"	1.00000	384	0	384
11	"11-out17929"	.38993	62	97	159
11	"11-out17930"	1.00000	106	0	106
11	"11-out17931"	.88732	189	24	213
11	"11-out17932"	.90884	339	34	373
11	"11-out17933"	.31561	285	618	903
11	"11-out17934"	.30729	59	133	192
11	"11-out17935"	.29940	400	936	1336
11	"11-out17936"	.78894	942	252	1194
11	"11-out17937"	.42260	172	235	407
11	"11-out17938"	.98742	471	6	477
11	"11-out17939"	.40121	331	494	825
11	"11-out17940"	.47712	73	80	153
11	"11-out17941"	.38888	70	110	180
11	"11-out17942"	.34074	184	356	540
11	"11-out17943"	.21276	90	333	423
11	"11-out17944"	.26767	159	435	594
11	"11-out17945"	.73437	282	102	384
11	"11-out17946"	.48582	120	127	247
11	"11-out17947"	.47848	189	206	395
11	"11-out17948"	.99305	143	1	144
11	"11-out17949"	.43392	243	317	560
11	"11-out17950"	.29500	59	141	200
11	"11-out17951"	.44245	296	373	669
11	"11-out17952"	.54276	165	139	304
11	"11-out17953"	.99074	107	1	108
11	"11-out17954"	.29871	210	493	703
11	"11-out17955"	.34020	66	128	194
11	"11-out17956"	.33031	73	148	221
11	"11-out17957"	.26548	60	166	226
11	"11-out17958"	.99145	116	1	117
11	"11-out17959"	.99145	116	1	117
11	"11-out17960"	.41025	128	184	312
11	"11-out17961"	.99861	723	1	724
11	"11-out17962"	.44219	153	193	346
11	"11-out17963"	.73877	181	64	245
11	"11-out17964"	.64705	99	54	153
11	"11-out17965"	.35813	568	1018	1586
11	"11-out17966"	.23684	63	203	266
11	"11-out17967"	.33870	210	410	620
11	"11-out17968"	.44000	55	70	125
11	"11-out17969"	1.00000	326	0	326
11	"11-out17970"	.89253	299	36	335
11	"11-out17971"	.31645	50	108	158
11	"11-out17972"	.99390	163	1	164
11	"11-out17973"	.99056	105	1	106
11	"11-out17974"	.99470	376	2	378
11	"11-out17975"	.18302	110	491	601
11	"11-out17976"	.31428	132	288	420
11	"11-out17977"	.73420	674	244	918
11	"11-out17978"	.34774	177	332	509
11	"11-out17979"	.31154	143	316	459
11	"11-out17980"	.45454	45	54	99
11	"11-out17981"	.30555	44	100	144
11	"11-out17982"	.35714	195	351	546
11	"11-out17983"	.42723	273	366	639
11	"11-out17984"	.33163	130	262	392
11	"11-out17985"	.59654	207	140	347
11	"11-out17986"	.41313	302	429	731
11	"11-out17987"	.53166	319	281	600
11	"11-out17988"	.35517	309	561	870
11	"11-out17989"	.99701	334	1	335
11	"11-out17990"	.26842	102	278	380
11	"11-out17991"	.38847	472	743	1215
11	"11-out17992"	.63765	315	179	494
11	"11-out17993"	.35127	124	229	353
11	"11-out17994"	.66272	224	114	338
11	"11-out17995"	.67821	274	130	404
11	"11-out17996"	.36336	121	212	333
11	"11-out17997"	.67932	483	228	711
11	"11-out17998"	.44954	196	240	436
11	"11-out17999"	.50196	256	254	510
11	"11-out18000"	.21186	200	744	944
11	"11-out18001"	.50686	443	431	874
11	"11-out18002"	.33226	104	209	313
11	"11-out18003"	.72154	298	115	413
11	"11-out18004"	.74456	274	94	368
11	"11-out18005"	.12857	9	61	70
11	"11-out18006"	.94763	561	31	592
11	"11-out18007"	.75000	480	160	640
11	"11-out18008"	.29801	135	318	453
11	"11-out18009"	.35820	24	43	67
11	"11-out18010"	.17543	80	376	456
11	"11-out18011"	.21875	112	400	512
11	"11-out18012"	.71496	1204	480	1684
11	"11-out18013"	.45508	152	182	334
11	"11-out18014"	.49246	98	101	199
11	"11-out18015"	.28804	53	131	184
11	"11-out18016"	.32402	58	121	179
11	"11-out18017"	.42718	88	118	206
11	"11-out18018"	.25988	46	131	177
11	"11-out18019"	.70305	161	68	229
11	"11-out18020"	.32385	148	309	457
11	"11-out18021"	.75147	127	42	169
11	"11-out18022"	.83253	174	35	209
11	"11-out18023"	.35897	168	300	468
11	"11-out18024"	.99808	520	1	521
11	"11-out18025"	.41952	159	220	379
11	"11-out18026"	.13274	60	392	452
11	"11-out18027"	.99820	555	1	556
11	"11-out18028"	.21043	121	454	575
11	"11-out18029"	.68433	297	137	434
11	"11-out18030"	.21731	118	425	543
11	"11-out18031"	.31641	106	229	335
11	"11-out18032"	.86595	1137	176	1313
11	"11-out18033"	.41620	149	209	358
11	"11-out18034"	.27777	190	494	684
11	"11-out18035"	.47500	76	84	160
11	"11-out18036"	.24793	60	182	242
11	"11-out18037"	.41129	102	146	248
11	"11-out18038"	.50881	952	919	1871
11	"11-out18039"	.99705	338	1	339
11	"11-out18040"	.31391	194	424	618
11	"11-out18041"	.63888	368	208	576
11	"11-out18042"	.54620	662	550	1212
11	"11-out18043"	.47528	250	276	526
11	"11-out18044"	.53170	369	325	694
11	"11-out18045"	.99849	665	1	666
11	"11-out18046"	.22014	59	209	268
11	"11-out18047"	.32976	154	313	467
11	"11-out18048"	.49712	173	175	348
11	"11-out18049"	.16000	12	63	75
11	"11-out18050"	.27889	111	287	398
11	"11-out18051"	.26969	89	241	330
11	"11-out18052"	.44251	458	577	1035
11	"11-out18053"	.33126	107	216	323
11	"11-out18054"	.35660	189	341	530
11	"11-out18055"	.36294	143	251	394
11	"11-out18056"	.23809	20	64	84
11	"11-out18057"	.46290	156	181	337
11	"11-out18058"	.99082	108	1	109
11	"11-out18059"	.99850	667	1	668
11	"11-out18060"	.32161	485	1023	1508
11	"11-out18061"	.43155	186	245	431
11	"11-out18062"	.28571	88	220	308
11	"11-out18063"	.94375	151	9	160
11	"11-out18064"	.39659	163	248	411
11	"11-out18065"	.47306	281	313	594
11	"11-out18066"	.26781	124	339	463
11	"11-out18067"	.26182	83	234	317
11	"11-out18068"	.29862	152	357	509
11	"11-out18069"	.99497	198	1	199
11	"11-out18070"	.40182	88	131	219
11	"11-out18071"	.39634	130	198	328
11	"11-out18072"	.58024	94	68	162
11	"11-out18073"	.05806	9	146	155
11	"11-out18074"	.39378	76	117	193
11	"11-out18075"	.25423	45	132	177
11	"11-out18076"	.46842	267	303	570
11	"11-out18077"	.36900	100	171	271
11	"11-out18078"	.54972	304	249	553
11	"11-out18079"	.45557	241	288	529
11	"11-out18080"	.33085	89	180	269
11	"11-out18081"	.37500	57	95	152
11	"11-out18082"	.43233	246	323	569
11	"11-out18083"	.29378	52	125	177
11	"11-out18084"	.22727	40	136	176
11	"11-out18085"	.29368	158	380	538
11	"11-out18086"	.46783	80	91	171
11	"11-out18087"	.45220	123	149	272
11	"11-out18088"	.85867	480	79	559
11	"11-out18089"	.99728	368	1	369
11	"11-out18090"	.20945	62	234	296
11	"11-out18091"	.79119	485	128	613
11	"11-out18092"	.34012	217	421	638
11	"11-out18093"	.25641	100	290	390
11	"11-out18094"	.64837	319	173	492
11	"11-out18095"	.99561	227	1	228
11	"11-out18096"	.99242	131	1	132
11	"11-out18097"	.94708	179	10	189
11	"11-out18098"	.99470	188	1	189
11	"11-out18099"	.99470	188	1	189
11	"11-out18100"	.33497	136	270	406
11	"11-out18101"	.51807	86	80	166
11	"11-out18102"	.99500	199	1	200
11	"11-out18103"	.35033	158	293	451
11	"11-out18104"	.42434	129	175	304
11	"11-out18105"	.53402	361	315	676
11	"11-out18106"	.44615	87	108	195
11	"11-out18107"	.76111	137	43	180
11	"11-out18108"	.40000	142	213	355
11	"11-out18109"	.95535	321	15	336
11	"11-out18110"	.51583	114	107	221
11	"11-out18111"	.41379	120	170	290
11	"11-out18112"	.68699	169	77	246
11	"11-out18113"	.23559	139	451	590
11	"11-out18114"	.36492	335	583	918
11	"11-out18115"	.93596	190	13	203
11	"11-out18116"	.34811	212	397	609
11	"11-out18117"	.91111	205	20	225
11	"11-out18118"	.38888	406	638	1044
11	"11-out18119"	.38117	656	1065	1721
11	"11-out18120"	.42152	188	258	446
11	"11-out18121"	.47540	406	448	854
11	"11-out18122"	.47239	77	86	163
11	"11-out18123"	.99305	143	1	144
11	"11-out18124"	.12841	47	319	366
11	"11-out18125"	.32884	122	249	371
11	"11-out18126"	.39080	204	318	522
11	"11-out18127"	.31931	243	518	761
11	"11-out18128"	.54391	161	135	296
11	"11-out18129"	.62711	111	66	177
11	"11-out18130"	.74358	290	100	390
11	"11-out18131"	.19463	174	720	894
11	"11-out18132"	.66666	80	40	120
11	"11-out18133"	.73627	1650	591	2241
11	"11-out18134"	.44927	62	76	138
11	"11-out18135"	.24582	103	316	419
11	"11-out18136"	.48723	229	241	470
11	"11-out18137"	.99803	507	1	508
11	"11-out18138"	.57471	350	259	609
11	"11-out18139"	.38329	312	502	814
11	"11-out18140"	.55555	45	36	81
11	"11-out18141"	.22950	70	235	305
11	"11-out18142"	.44155	204	258	462
11	"11-out18143"	.21928	116	413	529
11	"11-out18144"	.30272	178	410	588
11	"11-out18145"	.23051	210	701	911
11	"11-out18146"	.75581	715	231	946
11	"11-out18147"	.29325	261	629	890
11	"11-out18148"	.28279	263	667	930
11	"11-out18149"	.31026	130	289	419
11	"11-out18150"	.34254	124	238	362
11	"11-out18151"	.24354	151	469	620
11	"11-out18152"	.48511	163	173	336
11	"11-out18153"	.58146	182	131	313
11	"11-out18154"	.99152	117	1	118
11	"11-out18155"	.27643	149	390	539
11	"11-out18156"	.36231	125	220	345
11	"11-out18157"	.99824	568	1	569
11	"11-out18158"	.75714	212	68	280
11	"11-out18159"	.36390	242	423	665
11	"11-out18160"	.99539	216	1	217
11	"11-out18161"	.33532	56	111	167
11	"11-out18162"	.88842	215	27	242
11	"11-out18163"	.47566	215	237	452
11	"11-out18164"	.50091	274	273	547
11	"11-out18165"	.37735	20	33	53
11	"11-out18166"	1.00000	106	0	106
11	"11-out18167"	.42017	429	592	1021
11	"11-out18168"	.40663	98	143	241
11	"11-out18169"	.26106	118	334	452
11	"11-out18170"	.32317	53	111	164
11	"11-out18171"	.32613	136	281	417
11	"11-out18172"	.43801	106	136	242
11	"11-out18173"	.36023	241	428	669
11	"11-out18174"	.57731	168	123	291
11	"11-out18175"	.34712	193	363	556
11	"11-out18176"	.32142	198	418	616
11	"11-out18177"	.34782	192	360	552
11	"11-out18178"	.28598	151	377	528
11	"11-out18179"	.31132	66	146	212
11	"11-out18180"	.43250	157	206	363
11	"11-out18181"	.82871	479	99	578
11	"11-out18182"	.33333	225	450	675
11	"11-out18183"	.32121	106	224	330
11	"11-out18184"	.29389	77	185	262
11	"11-out18185"	.22368	119	413	532
11	"11-out18186"	.22616	204	698	902
11	"11-out18187"	.27205	111	297	408
11	"11-out18188"	.14697	148	859	1007
11	"11-out18189"	.21046	185	694	879
11	"11-out18190"	.26223	209	588	797
11	"11-out18191"	.30880	193	432	625
11	"11-out18192"	.37742	331	546	877
11	"11-out18193"	.97010	357	11	368
11	"11-out18194"	.20892	192	727	919
11	"11-out18195"	.38436	349	559	908
11	"11-out18196"	.38284	366	590	956
11	"11-out18197"	.48387	105	112	217
11	"11-out18198"	.33673	330	650	980
11	"11-out18199"	.86745	589	90	679
11	"11-out18200"	.36801	994	1707	2701
11	"11-out18201"	.70639	243	101	344
11	"11-out18202"	.44583	214	266	480
11	"11-out18203"	.36904	124	212	336
11	"11-out18204"	.38597	655	1042	1697
11	"11-out18205"	.44407	667	835	1502
11	"11-out18206"	.14393	38	226	264
11	"11-out18207"	.28440	248	624	872
11	"11-out18208"	.31309	196	430	626
11	"11-out18209"	.23730	215	691	906
11	"11-out18210"	.49603	500	508	1008
11	"11-out18211"	.40540	60	88	148
11	"11-out18212"	.99658	292	1	293
11	"11-out18213"	.21830	93	333	426
11	"11-out18214"	.81951	168	37	205
11	"11-out18215"	.50972	131	126	257
11	"11-out18216"	.36693	182	314	496
11	"11-out18217"	.41732	212	296	508
11	"11-out18218"	.70867	343	141	484
11	"11-out18219"	.99581	238	1	239
11	"11-out18220"	.32758	76	156	232
11	"11-out18221"	.32951	115	234	349
11	"11-out18222"	.60583	166	108	274
11	"11-out18223"	.34379	219	418	637
11	"11-out18224"	.95045	211	11	222
11	"11-out18225"	.39393	104	160	264
11	"11-out18226"	.95412	208	10	218
11	"11-out18227"	.99262	942	7	949
11	"11-out18228"	.33554	202	400	602
11	"11-out18229"	.37897	274	449	723
11	"11-out18230"	.22875	35	118	153
11	"11-out18231"	.37402	144	241	385
11	"11-out18232"	.40973	202	291	493
11	"11-out18233"	.99694	326	1	327
11	"11-out18234"	.38666	116	184	300
11	"11-out18235"	.32870	142	290	432
11	"11-out18236"	.54545	114	95	209
11	"11-out18237"	.66060	218	112	330
11	"11-out18238"	.27839	201	521	722
11	"11-out18239"	.59756	98	66	164
11	"11-out18240"	.20689	96	368	464
11	"11-out18241"	.32504	196	407	603
11	"11-out18242"	.31561	190	412	602
11	"11-out18243"	.34079	198	383	581
11	"11-out18244"	.39123	250	389	639
11	"11-out18245"	.42212	187	256	443
11	"11-out18246"	.45652	273	325	598
11	"11-out18247"	.45522	61	73	134
11	"11-out18248"	.83792	274	53	327
11	"11-out18249"	.51006	76	73	149
11	"11-out18250"	.34210	65	125	190
11	"11-out18251"	.11229	21	166	187
11	"11-out18252"	.28030	111	285	396
11	"11-out18253"	.37799	79	130	209
11	"11-out18254"	.99881	840	1	841
11	"11-out18255"	.49551	221	225	446
11	"11-out18256"	.90877	259	26	285
11	"11-out18257"	.46160	559	652	1211
11	"11-out18258"	.30313	271	623	894
11	"11-out18259"	.47457	168	186	354
11	"11-out18260"	.98017	989	20	1009
11	"11-out18261"	.36851	213	365	578
11	"11-out18262"	.33634	186	367	553
11	"11-out18263"	.45426	149	179	328
11	"11-out18264"	.99065	106	1	107
11	"11-out18265"	.38284	482	777	1259
11	"11-out18266"	.51690	214	200	414
11	"11-out18267"	.25199	695	2063	2758
11	"11-out18268"	.23137	618	2053	2671
11	"11-out18269"	.11458	44	340	384
11	"11-out18270"	.33333	45	90	135
11	"11-out18271"	.75457	618	201	819
11	"11-out18272"	.43552	179	232	411
11	"11-out18273"	.65560	158	83	241
11	"11-out18274"	.35864	170	304	474
11	"11-out18275"	.28806	70	173	243
11	"11-out18276"	.39568	55	84	139
11	"11-out18277"	.93887	937	61	998
11	"11-out18278"	.36486	27	47	74
11	"11-out18279"	.99876	809	1	810
11	"11-out18280"	.45904	269	317	586
11	"11-out18281"	.99099	110	1	111
11	"11-out18282"	.43666	131	169	300
11	"11-out18283"	.50980	78	75	153
11	"11-out18284"	.99447	180	1	181
11	"11-out18285"	.94594	385	22	407
11	"11-out18286"	.35021	560	1039	1599
11	"11-out18287"	.42776	678	907	1585
11	"11-out18288"	.41935	91	126	217
11	"11-out18289"	.27312	248	660	908
11	"11-out18290"	.29445	260	623	883
11	"11-out18291"	.36762	218	375	593
11	"11-out18292"	.29983	358	836	1194
11	"11-out18293"	.99590	243	1	244
11	"11-out18294"	.47764	235	257	492
11	"11-out18295"	.30281	86	198	284
11	"11-out18296"	.56250	63	49	112
11	"11-out18297"	.31840	64	137	201
11	"11-out18298"	.58333	140	100	240
11	"11-out18299"	.50819	341	330	671
11	"11-out18300"	.29310	765	1845	2610
11	"11-out18301"	.20298	326	1280	1606
11	"11-out18302"	.24236	381	1191	1572
11	"11-out18303"	.99915	1180	1	1181
11	"11-out18304"	.38957	538	843	1381
11	"11-out18305"	.38186	320	518	838
11	"11-out18306"	.49268	101	104	205
11	"11-out18307"	.41908	246	341	587
11	"11-out18308"	.47596	198	218	416
11	"11-out18309"	.40386	439	648	1087
11	"11-out18310"	.36988	199	339	538
11	"11-out18311"	.52302	159	145	304
11	"11-out18312"	.77804	326	93	419
11	"11-out18313"	.37842	235	386	621
11	"11-out18314"	.20418	39	152	191
11	"11-out18315"	.92878	626	48	674
11	"11-out18316"	.68128	466	218	684
11	"11-out18317"	.46260	167	194	361
11	"11-out18318"	.73590	248	89	337
11	"11-out18319"	.81305	274	63	337
11	"11-out18320"	.28915	120	295	415
11	"11-out18321"	.27644	115	301	416
11	"11-out18322"	.27725	117	305	422
11	"11-out18323"	.59277	246	169	415
11	"11-out18324"	.24161	108	339	447
11	"11-out18325"	.30919	158	353	511
11	"11-out18326"	.38424	161	258	419
11	"11-out18327"	.34054	126	244	370
11	"11-out18328"	.31428	121	264	385
11	"11-out18329"	.39915	190	286	476
11	"11-out18330"	.38113	101	164	265
11	"11-out18331"	.26724	62	170	232
11	"11-out18332"	.24766	106	322	428
11	"11-out18333"	.27207	114	305	419
11	"11-out18334"	.29515	67	160	227
11	"11-out18335"	.37777	102	168	270
11	"11-out18336"	.35356	134	245	379
11	"11-out18337"	.31538	123	267	390
11	"11-out18338"	.48936	115	120	235
11	"11-out18339"	.75985	212	67	279
11	"11-out18340"	.41134	174	249	423
11	"11-out18341"	.66917	89	44	133
11	"11-out18342"	.30177	102	236	338
11	"11-out18343"	.17099	79	383	462
11	"11-out18344"	.64285	54	30	84
11	"11-out18345"	.59692	194	131	325
11	"11-out18346"	.42585	112	151	263
11	"11-out18347"	.52631	140	126	266
11	"11-out18348"	.38576	103	164	267
11	"11-out18349"	.20238	34	134	168
11	"11-out18350"	.36645	177	306	483
11	"11-out18351"	.19282	129	540	669
11	"11-out18352"	.99324	147	1	148
11	"11-out18353"	.94758	470	26	496
11	"11-out18354"	.40725	202	294	496
11	"11-out18355"	.96916	220	7	227
11	"11-out18356"	.99551	222	1	223
11	"11-out18357"	.59740	414	279	693
11	"11-out18358"	.60215	56	37	93
11	"11-out18359"	.56792	347	264	611
11	"11-out18360"	.51630	95	89	184
11	"11-out18361"	.29343	76	183	259
11	"11-out18362"	.22310	56	195	251
11	"11-out18363"	.31604	384	831	1215
11	"11-out18364"	.32563	310	642	952
11	"11-out18365"	.39488	340	521	861
11	"11-out18366"	.27695	280	731	1011
11	"11-out18367"	.99824	569	1	570
11	"11-out18368"	.09523	18	171	189
11	"11-out18369"	.28099	68	174	242
11	"11-out18370"	.32968	211	429	640
11	"11-out18371"	.45918	225	265	490
11	"11-out18372"	.32582	217	449	666
11	"11-out18373"	.27855	139	360	499
11	"11-out18374"	.24731	138	420	558
11	"11-out18375"	.52024	167	154	321
11	"11-out18376"	.35211	150	276	426
11	"11-out18377"	.28888	143	352	495
11	"11-out18378"	.36000	207	368	575
11	"11-out18379"	.18637	93	406	499
11	"11-out18380"	.33827	114	223	337
11	"11-out18381"	.37099	197	334	531
11	"11-out18382"	.99839	621	1	622
11	"11-out18383"	.38106	495	804	1299
11	"11-out18384"	.59550	371	252	623
11	"11-out18385"	.20400	51	199	250
11	"11-out18386"	.34042	112	217	329
11	"11-out18387"	.23629	250	808	1058
11	"11-out18388"	.99889	908	1	909
11	"11-out18389"	.99825	573	1	574
11	"11-out18390"	.51073	333	319	652
11	"11-out18391"	.45258	377	456	833
11	"11-out18392"	.27817	116	301	417
11	"11-out18393"	.99090	109	1	110
11	"11-out18394"	.98319	117	2	119
11	"11-out18395"	1.00000	353	0	353
11	"11-out18396"	1.00000	340	0	340
11	"11-out18397"	1.00000	377	0	377
11	"11-out18398"	1.00000	453	0	453
11	"11-out18399"	1.00000	106	0	106
11	"11-out18400"	.31263	146	321	467
11	"11-out18401"	.40575	127	186	313
11	"11-out18402"	.37365	173	290	463
11	"11-out18403"	.37070	205	348	553
11	"11-out18404"	.19649	56	229	285
11	"11-out18405"	.88000	132	18	150
11	"11-out18406"	.98901	90	1	91
11	"11-out18407"	.35393	126	230	356
11	"11-out18408"	.47923	150	163	313
11	"11-out18409"	.14836	77	442	519
11	"11-out18410"	.26996	142	384	526
11	"11-out18411"	.36718	47	81	128
11	"11-out18412"	.19145	112	473	585
11	"11-out18413"	.38424	161	258	419
11	"11-out18414"	.43258	77	101	178
11	"11-out18415"	.98717	77	1	78
11	"11-out18416"	.33561	49	97	146
11	"11-out18417"	.30930	412	920	1332
11	"11-out18418"	.53888	97	83	180
11	"11-out18419"	.35025	69	128	197
11	"11-out18420"	.70792	143	59	202
11	"11-out18421"	.22085	36	127	163
11	"11-out18422"	.46210	250	291	541
11	"11-out18423"	.85714	474	79	553
11	"11-out18424"	.46482	185	213	398
11	"11-out18425"	.36774	57	98	155
11	"11-out18426"	.32804	62	127	189
11	"11-out18427"	.36565	230	399	629
11	"11-out18428"	.90534	220	23	243
11	"11-out18429"	.41742	230	321	551
11	"11-out18430"	.27450	42	111	153
11	"11-out18431"	.84713	133	24	157
11	"11-out18432"	.28415	208	524	732
11	"11-out18433"	.91880	215	19	234
11	"11-out18434"	.44814	121	149	270
11	"11-out18435"	.32394	161	336	497
11	"11-out18436"	.99541	217	1	218
11	"11-out18437"	.39241	352	545	897
11	"11-out18438"	.34210	52	100	152
11	"11-out18439"	.46037	122	143	265
11	"11-out18440"	.39638	241	367	608
11	"11-out18441"	.30286	169	389	558
11	"11-out18442"	.33113	201	406	607
11	"11-out18443"	.27651	146	382	528
11	"11-out18444"	.24571	129	396	525
11	"11-out18445"	.50000	270	270	540
11	"11-out18446"	.26053	501	1422	1923
11	"11-out18447"	.21658	47	170	217
11	"11-out18448"	.35567	69	125	194
11	"11-out18449"	.34581	674	1275	1949
11	"11-out18450"	.94151	982	61	1043
11	"11-out18451"	.40972	177	255	432
11	"11-out18452"	.36413	67	117	184
11	"11-out18453"	.96846	215	7	222
11	"11-out18454"	.96846	215	7	222
11	"11-out18455"	.99590	243	1	244
11	"11-out18456"	.57142	120	90	210
11	"11-out18457"	.41136	485	694	1179
11	"11-out18458"	.57455	551	408	959
11	"11-out18459"	.99583	239	1	240
11	"11-out18460"	.99262	942	7	949
11	"11-out18461"	.35691	222	400	622
11	"11-out18462"	.27083	195	525	720
11	"11-out18463"	.99806	515	1	516
11	"11-out18464"	.46415	887	1024	1911
11	"11-out18465"	.34801	158	296	454
11	"11-out18466"	.99329	593	4	597
11	"11-out18467"	.87834	361	50	411
11	"11-out18468"	.58267	148	106	254
11	"11-out18469"	.50121	207	206	413
11	"11-out18470"	.34567	168	318	486
11	"11-out18471"	.35504	736	1337	2073
11	"11-out18472"	.32436	217	452	669
11	"11-out18473"	.38121	207	336	543
11	"11-out18474"	.40983	200	288	488
11	"11-out18475"	.34217	129	248	377
11	"11-out18476"	.41365	321	455	776
11	"11-out18477"	.37899	736	1206	1942
11	"11-out18478"	.43596	480	621	1101
11	"11-out18479"	.32900	152	310	462
11	"11-out18480"	.39393	52	80	132
11	"11-out18481"	.22834	87	294	381
11	"11-out18482"	.99156	705	6	711
11	"11-out18483"	.66666	56	28	84
11	"11-out18484"	.55555	125	100	225
11	"11-out18485"	.95412	208	10	218
11	"11-out18486"	.41260	203	289	492
11	"11-out18487"	.35787	384	689	1073
11	"11-out18488"	.44497	93	116	209
11	"11-out18489"	.48000	156	169	325
11	"11-out18490"	.31764	81	174	255
11	"11-out18491"	.26252	131	368	499
11	"11-out18492"	.26098	190	538	728
11	"11-out18493"	.24545	297	913	1210
11	"11-out18494"	.39350	194	299	493
11	"11-out18495"	.27040	275	742	1017
11	"11-out18496"	.26991	61	165	226
11	"11-out18497"	.44728	280	346	626
11	"11-out18498"	.37142	221	374	595
11	"11-out18499"	.28865	56	138	194
11	"11-out18500"	.95576	497	23	520
11	"11-out18501"	.24672	113	345	458
11	"11-out18502"	.30152	158	366	524
11	"11-out18503"	.28143	47	120	167
11	"11-out18504"	.38262	207	334	541
11	"11-out18505"	.25740	139	401	540
11	"11-out18506"	.33451	188	374	562
11	"11-out18507"	.26513	127	352	479
11	"11-out18508"	.96418	350	13	363
11	"11-out18509"	.28352	74	187	261
11	"11-out18510"	.35617	317	573	890
11	"11-out18511"	.29383	124	298	422
11	"11-out18512"	.36027	722	1282	2004
11	"11-out18513"	.46475	211	243	454
11	"11-out18514"	.30232	143	330	473
11	"11-out18515"	.28947	88	216	304
11	"11-out18516"	.57571	422	311	733
11	"11-out18517"	.98969	96	1	97
11	"11-out18518"	.99056	105	1	106
11	"11-out18519"	.33634	223	440	663
11	"11-out18520"	.23809	55	176	231
11	"11-out18521"	.22636	79	270	349
11	"11-out18522"	.30524	326	742	1068
11	"11-out18523"	.42000	105	145	250
11	"11-out18524"	.79907	346	87	433
11	"11-out18525"	.27222	98	262	360
11	"11-out18526"	.26146	114	322	436
11	"11-out18527"	.27466	103	272	375
11	"11-out18528"	.27990	117	301	418
11	"11-out18529"	.84526	366	67	433
11	"11-out18530"	.35436	438	798	1236
11	"11-out18531"	.28795	55	136	191
11	"11-out18532"	.22380	47	163	210
11	"11-out18533"	.45547	179	214	393
11	"11-out18534"	.32590	117	242	359
11	"11-out18535"	.72807	83	31	114
11	"11-out18536"	.50450	392	385	777
11	"11-out18537"	.36557	189	328	517
11	"11-out18538"	.86294	170	27	197
11	"11-out18539"	.42331	69	94	163
11	"11-out18540"	.29166	98	238	336
11	"11-out18541"	.15151	20	112	132
11	"11-out18542"	.23285	163	537	700
11	"11-out18543"	.26785	165	451	616
11	"11-out18544"	.99264	135	1	136
11	"11-out18545"	.99718	354	1	355
11	"11-out18546"	.27906	48	124	172
11	"11-out18547"	.27599	146	383	529
11	"11-out18548"	.92452	98	8	106
11	"11-out18549"	.97619	123	3	126
11	"11-out18550"	.78491	281	77	358
11	"11-out18551"	.99132	343	3	346
11	"11-out18552"	.99408	336	2	338
11	"11-out18553"	.99447	360	2	362
11	"11-out18554"	.36919	175	299	474
11	"11-out18555"	.97560	40	1	41
11	"11-out18556"	.95833	23	1	24
11	"11-out18557"	.96296	26	1	27
11	"11-out18558"	.26148	165	466	631
11	"11-out18559"	.50764	365	354	719
11	"11-out18560"	.23409	92	301	393
11	"11-out18561"	.98563	343	5	348
11	"11-out18562"	.25441	72	211	283
11	"11-out18563"	.30993	287	639	926
11	"11-out18564"	.35384	92	168	260
11	"11-out18565"	.32094	95	201	296
11	"11-out18566"	.51524	169	159	328
11	"11-out18567"	.33093	184	372	556
11	"11-out18568"	.43236	179	235	414
11	"11-out18569"	.28282	28	71	99
11	"11-out18570"	.46259	303	352	655
11	"11-out18571"	.15859	190	1008	1198
11	"11-out18572"	.99719	355	1	356
11	"11-out18573"	.75438	43	14	57
11	"11-out18574"	.32967	60	122	182
11	"11-out18575"	.68627	35	16	51
11	"11-out18576"	.99471	1130	6	1136
11	"11-out18577"	.45787	125	148	273
11	"11-out18578"	.44025	140	178	318
11	"11-out18579"	.62085	262	160	422
11	"11-out18580"	.45333	136	164	300
11	"11-out18581"	.99145	116	1	117
11	"11-out18582"	.99145	116	1	117
11	"11-out18583"	.99145	116	1	117
11	"11-out18584"	.36154	252	445	697
11	"11-out18585"	.53551	196	170	366
11	"11-out18586"	.45754	291	345	636
11	"11-out18587"	.96551	392	14	406
11	"11-out18588"	.29314	124	299	423
11	"11-out18589"	.99555	224	1	225
11	"11-out18590"	.99541	217	1	218
11	"11-out18591"	.27650	193	505	698
11	"11-out18592"	1.00000	330	0	330
11	"11-out18593"	1.00000	327	0	327
11	"11-out18594"	1.00000	106	0	106
11	"11-out18595"	.42144	397	545	942
11	"11-out18596"	.85992	221	36	257
11	"11-out18597"	.28918	107	263	370
11	"11-out18598"	.36199	80	141	221
11	"11-out18599"	.99585	240	1	241
11	"11-out18600"	.96396	214	8	222
11	"11-out18601"	.99418	171	1	172
11	"11-out18602"	.46275	205	238	443
11	"11-out18603"	.36405	320	559	879
11	"11-out18604"	.27137	200	537	737
11	"11-out18605"	.43846	57	73	130
11	"11-out18606"	.37692	49	81	130
11	"11-out18607"	.38281	49	79	128
11	"11-out18608"	.36434	47	82	129
11	"11-out18609"	.32307	42	88	130
11	"11-out18610"	.99130	114	1	115
11	"11-out18611"	.26612	99	273	372
11	"11-out18612"	.95312	122	6	128
11	"11-out18613"	.71428	90	36	126
11	"11-out18614"	.71428	90	36	126
11	"11-out18615"	.74603	94	32	126
11	"11-out18616"	.71428	90	36	126
11	"11-out18617"	.71428	90	36	126
11	"11-out18618"	.73809	93	33	126
11	"11-out18619"	.73015	92	34	126
11	"11-out18620"	.25735	35	101	136
11	"11-out18621"	.46323	63	73	136
11	"11-out18622"	.33823	46	90	136
11	"11-out18623"	.75862	220	70	290
11	"11-out18624"	.38519	458	731	1189
11	"11-out18625"	.30810	114	256	370
11	"11-out18626"	.74094	266	93	359
11	"11-out18627"	.33152	122	246	368
11	"11-out18628"	.38780	159	251	410
11	"11-out18629"	.99295	141	1	142
11	"11-out18630"	.98591	140	2	142
11	"11-out18631"	.99539	216	1	217
11	"11-out18632"	.38202	170	275	445
11	"11-out18633"	.43252	125	164	289
11	"11-out18634"	.31963	389	828	1217
11	"11-out18635"	.17714	62	288	350
11	"11-out18636"	.37556	83	138	221
11	"11-out18637"	.81740	385	86	471
11	"11-out18638"	.33333	140	280	420
11	"11-out18639"	.24960	158	475	633
11	"11-out18640"	.99541	217	1	218
11	"11-out18641"	.99264	135	1	136
11	"11-out18642"	.45219	175	212	387
11	"11-out18643"	.40119	201	300	501
11	"11-out18644"	.30145	186	431	617
11	"11-out18645"	.38155	182	295	477
11	"11-out18646"	.30643	338	765	1103
11	"11-out18647"	.40000	96	144	240
11	"11-out18648"	.99606	253	1	254
11	"11-out18649"	.87272	384	56	440
11	"11-out18650"	.39381	280	431	711
11	"11-out18651"	.21395	46	169	215
11	"11-out18652"	.29577	63	150	213
11	"11-out18653"	.26027	57	162	219
11	"11-out18654"	.25490	65	190	255
11	"11-out18655"	.98969	96	1	97
11	"11-out18656"	.29846	117	275	392
11	"11-out18657"	.29007	38	93	131
11	"11-out18658"	.35384	46	84	130
11	"11-out18659"	.27692	36	94	130
11	"11-out18660"	.38281	49	79	128
11	"11-out18661"	.20769	27	103	130
11	"11-out18662"	.31468	45	98	143
11	"11-out18663"	.46456	59	68	127
11	"11-out18664"	.95854	185	8	193
11	"11-out18665"	.95121	156	8	164
11	"11-out18666"	.75396	95	31	126
11	"11-out18667"	.73809	93	33	126
11	"11-out18668"	.73015	92	34	126
11	"11-out18669"	.72222	91	35	126
11	"11-out18670"	.63397	459	265	724
11	"11-out18671"	.92350	2632	218	2850
11	"11-out18672"	.96428	27	1	28
11	"11-out18673"	.99763	422	1	423
11	"11-out18674"	.99099	330	3	333
11	"11-out18675"	.99750	400	1	401
11	"11-out18676"	.26420	93	259	352
11	"11-out18677"	.99152	117	1	118
11	"11-out18678"	.51757	162	151	313
11	"11-out18679"	.99145	116	1	117
11	"11-out18680"	.37731	163	269	432
11	"11-out18681"	.52747	144	129	273
11	"11-out18682"	.99130	114	1	115
11	"11-out18683"	.33333	57	114	171
11	"11-out18684"	.99578	236	1	237
11	"11-out18685"	.47257	112	125	237
11	"11-out18686"	.07377	9	113	122
11	"11-out18687"	.94491	446	26	472
11	"11-out18688"	.35602	136	246	382
11	"11-out18689"	.47145	223	250	473
11	"11-out18690"	.32203	38	80	118
11	"11-out18691"	.35905	121	216	337
11	"11-out18692"	.52537	176	159	335
11	"11-out18693"	.37500	195	325	520
11	"11-out18694"	.81927	272	60	332
11	"11-out18695"	.80597	216	52	268
11	"11-out18696"	.12538	41	286	327
11	"11-out18697"	.60142	169	112	281
11	"11-out18698"	.50287	876	866	1742
11	"11-out18699"	.41868	121	168	289
11	"11-out18700"	.52439	129	117	246
11	"11-out18701"	.11067	28	225	253
11	"11-out18702"	.36341	149	261	410
11	"11-out18703"	.44964	125	153	278
11	"11-out18704"	.30219	275	635	910
11	"11-out18705"	.33096	233	471	704
11	"11-out18706"	.45017	131	160	291
11	"11-out18707"	.47976	166	180	346
11	"11-out18708"	.36014	291	517	808
11	"11-out18709"	.54975	221	181	402
11	"11-out18710"	.22515	179	616	795
11	"11-out18711"	.46065	363	425	788
11	"11-out18712"	.23240	175	578	753
11	"11-out18713"	.36968	278	474	752
11	"11-out18714"	.41005	155	223	378
11	"11-out18715"	.55937	391	308	699
11	"11-out18716"	.34693	238	448	686
11	"11-out18717"	.42738	671	899	1570
11	"11-out18718"	.41323	743	1055	1798
11	"11-out18719"	.29182	382	927	1309
11	"11-out18720"	.28097	737	1886	2623
11	"11-out18721"	.36385	151	264	415
11	"11-out18722"	.41880	98	136	234
11	"11-out18723"	.26461	86	239	325
11	"11-out18724"	.43042	133	176	309
11	"11-out18725"	.18263	61	273	334
11	"11-out18726"	.47337	240	267	507
11	"11-out18727"	.16155	58	301	359
11	"11-out18728"	.13649	49	310	359
11	"11-out18729"	.99152	117	1	118
11	"11-out18730"	.99186	122	1	123
11	"11-out18731"	.99200	124	1	125
11	"11-out18732"	.43682	121	156	277
11	"11-out18733"	.34970	178	331	509
11	"11-out18734"	.43478	130	169	299
11	"11-out18735"	.31513	127	276	403
11	"11-out18736"	.32644	79	163	242
11	"11-out18737"	.22815	94	318	412
11	"11-out18738"	.99145	116	1	117
11	"11-out18739"	.30639	91	206	297
11	"11-out18740"	.54244	262	221	483
11	"11-out18741"	.99236	130	1	131
11	"11-out18742"	.40800	204	296	500
11	"11-out18743"	.36144	300	530	830
11	"11-out18744"	.97222	35	1	36
11	"11-out18745"	.21628	85	308	393
11	"11-out18746"	.99130	228	2	230
11	"11-out18747"	.32624	46	95	141
11	"11-out18748"	.99305	143	1	144
11	"11-out18749"	.24277	84	262	346
11	"11-out18750"	.45418	114	137	251
11	"11-out18751"	.27975	409	1053	1462
11	"11-out18752"	.84090	74	14	88
11	"11-out18753"	.44199	301	380	681
11	"11-out18754"	.40186	215	320	535
11	"11-out18755"	.31751	87	187	274
11	"11-out18756"	.57108	1193	896	2089
11	"11-out18757"	.99470	188	1	189
11	"11-out18758"	.40243	99	147	246
11	"11-out18759"	.47154	116	130	246
11	"11-out18760"	.47288	218	243	461
11	"11-out18761"	.34518	330	626	956
11	"11-out18762"	.20181	89	352	441
11	"11-out18763"	.20731	85	325	410
11	"11-out18764"	.26306	146	409	555
11	"11-out18765"	.46052	35	41	76
11	"11-out18766"	.95833	23	1	24
11	"11-out18767"	.95833	23	1	24
11	"11-out18768"	.68190	358	167	525
11	"11-out18769"	.18452	31	137	168
11	"11-out18770"	.20846	64	243	307
11	"11-out18771"	.70202	589	250	839
11	"11-out18772"	.32926	54	110	164
11	"11-out18773"	.99705	338	1	339
11	"11-out18774"	.41474	90	127	217
11	"11-out18775"	.84814	229	41	270
11	"11-out18776"	.61363	216	136	352
11	"11-out18777"	.28656	96	239	335
11	"11-out18778"	.58146	182	131	313
11	"11-out18779"	.26638	126	347	473
11	"11-out18780"	.99145	116	1	117
11	"11-out18781"	.46626	311	356	667
11	"11-out18782"	.99130	114	1	115
11	"11-out18783"	.52851	139	124	263
11	"11-out18784"	.37311	1632	2742	4374
11	"11-out18785"	.24657	144	440	584
11	"11-out18786"	.99145	116	1	117
11	"11-out18787"	.24627	182	557	739
11	"11-out18788"	.71757	343	135	478
11	"11-out18789"	.42307	110	150	260
11	"11-out18790"	.33767	389	763	1152
11	"11-out18791"	.48585	395	418	813
11	"11-out18792"	.45794	343	406	749
11	"11-out18793"	.67542	437	210	647
11	"11-out18794"	.45500	182	218	400
11	"11-out18795"	.99152	117	1	118
11	"11-out18796"	.27126	118	317	435
11	"11-out18797"	.99152	117	1	118
11	"11-out18798"	.94219	4825	296	5121
11	"11-out18799"	.99145	116	1	117
11	"11-out18800"	.99137	115	1	116
11	"11-out18801"	.28131	128	327	455
11	"11-out18802"	.99159	118	1	119
11	"11-out18803"	.29709	235	556	791
11	"11-out18804"	.99145	116	1	117
11	"11-out18805"	.35156	45	83	128
11	"11-out18806"	.51079	142	136	278
11	"11-out18807"	.46250	74	86	160
11	"11-out18808"	.35504	338	614	952
11	"11-out18809"	.33180	145	292	437
11	"11-out18810"	.59354	92	63	155
11	"11-out18811"	.42382	217	295	512
11	"11-out18812"	.38369	160	257	417
11	"11-out18813"	.72477	237	90	327
11	"11-out18814"	.99519	207	1	208
11	"11-out18815"	.99519	207	1	208
11	"11-out18816"	.99519	207	1	208
11	"11-out18817"	.95085	503	26	529
11	"11-out18818"	.31970	172	366	538
11	"11-out18819"	.33955	182	354	536
11	"11-out18820"	.44571	78	97	175
11	"11-out18821"	.65730	234	122	356
11	"11-out18822"	.21649	63	228	291
11	"11-out18823"	.40150	320	477	797
11	"11-out18824"	.38017	349	569	918
11	"11-out18825"	.39350	109	168	277
11	"11-out18826"	.55500	111	89	200
11	"11-out18827"	.22680	22	75	97
11	"11-out18828"	.29436	209	501	710
11	"11-out18829"	.26962	79	214	293
11	"11-out18830"	.40345	397	587	984
11	"11-out18831"	.40185	346	515	861
11	"11-out18832"	.84554	750	137	887
11	"11-out18833"	.35879	357	638	995
11	"11-out18834"	.86585	355	55	410
11	"11-out18835"	.43820	156	200	356
11	"11-out18836"	.35372	133	243	376
11	"11-out18837"	.95348	123	6	129
11	"11-out18838"	.39325	35	54	89
11	"11-out18839"	.53608	156	135	291
11	"11-out18840"	.60071	167	111	278
11	"11-out18841"	.32342	185	387	572
11	"11-out18842"	.60800	304	196	500
11	"11-out18843"	.46719	178	203	381
11	"11-out18844"	.36629	263	455	718
11	"11-out18845"	.90285	316	34	350
11	"11-out18846"	.41342	308	437	745
11	"11-out18847"	.21957	166	590	756
11	"11-out18848"	.35055	251	465	716
11	"11-out18849"	.32278	204	428	632
11	"11-out18850"	.57023	272	205	477
11	"11-out18851"	.31868	87	186	273
11	"11-out18852"	.40438	129	190	319
11	"11-out18853"	.21823	79	283	362
11	"11-out18854"	.99519	207	1	208
11	"11-out18855"	.25429	74	217	291
11	"11-out18856"	.50290	173	171	344
11	"11-out18857"	.33563	146	289	435
11	"11-out18858"	.42094	205	282	487
11	"11-out18859"	.68644	324	148	472
11	"11-out18860"	.25141	89	265	354
11	"11-out18861"	.35526	108	196	304
11	"11-out18862"	.50967	316	304	620
11	"11-out18863"	.25213	207	614	821
11	"11-out18864"	.21418	154	565	719
11	"11-out18865"	.49761	418	422	840
11	"11-out18866"	.35433	405	738	1143
11	"11-out18867"	.32462	174	362	536
11	"11-out18868"	.64728	334	182	516
11	"11-out18869"	.98113	52	1	53
11	"11-out18870"	.41726	58	81	139
11	"11-out18871"	.96428	27	1	28
11	"11-out18872"	.61864	219	135	354
11	"11-out18873"	.38000	209	341	550
11	"11-out18874"	.39554	284	434	718
11	"11-out18875"	.26985	231	625	856
11	"11-out18876"	.98039	300	6	306
11	"11-out18877"	.31797	69	148	217
11	"11-out18878"	.53818	444	381	825
11	"11-out18879"	.54794	40	33	73
11	"11-out18880"	.97694	339	8	347
11	"11-out18881"	.94088	382	24	406
11	"11-out18882"	.99145	116	1	117
11	"11-out18883"	.99145	116	1	117
11	"11-out18884"	.22058	75	265	340
11	"11-out18885"	.99145	116	1	117
11	"11-out18886"	.58964	148	103	251
11	"11-out18887"	.89705	244	28	272
11	"11-out18888"	.99115	112	1	113
11	"11-out18889"	.13675	16	101	117
11	"11-out18890"	.35123	85	157	242
11	"11-out18891"	.39734	329	499	828
11	"11-out18892"	.58687	152	107	259
11	"11-out18893"	.99145	116	1	117
11	"11-out18894"	.52213	637	583	1220
11	"11-out18895"	.82020	479	105	584
11	"11-out18896"	.38741	234	370	604
11	"11-out18897"	.43847	196	251	447
11	"11-out18898"	.38144	74	120	194
11	"11-out18899"	.99509	203	1	204
11	"11-out18900"	.33132	440	888	1328
11	"11-out18901"	.62288	147	89	236
11	"11-out18902"	.28206	508	1293	1801
11	"11-out18903"	.22222	64	224	288
11	"11-out18904"	.38028	162	264	426
11	"11-out18905"	.37884	197	323	520
11	"11-out18906"	.34035	97	188	285
11	"11-out18907"	.33333	99	198	297
11	"11-out18908"	.99820	557	1	558
11	"11-out18909"	.25179	246	731	977
11	"11-out18910"	.36000	117	208	325
11	"11-out18911"	.50361	209	206	415
11	"11-out18912"	.95833	23	1	24
11	"11-out18913"	.36055	362	642	1004
11	"11-out18914"	.25210	180	534	714
11	"11-out18915"	.29126	30	73	103
11	"11-out18916"	.37600	47	78	125
11	"11-out18917"	.99159	118	1	119
11	"11-out18918"	.99159	118	1	119
11	"11-out18919"	.99137	115	1	116
11	"11-out18920"	.99145	116	1	117
11	"11-out18921"	.31175	130	287	417
11	"11-out18922"	.21929	75	267	342
11	"11-out18923"	.55304	245	198	443
11	"11-out18924"	.31902	275	587	862
11	"11-out18925"	.36254	182	320	502
11	"11-out18926"	.99145	116	1	117
11	"11-out18927"	.99145	116	1	117
11	"11-out18928"	.46984	374	422	796
11	"11-out18929"	.44961	116	142	258
11	"11-out18930"	.25090	69	206	275
11	"11-out18931"	.32841	89	182	271
11	"11-out18932"	.37083	89	151	240
11	"11-out18933"	.53215	720	633	1353
11	"11-out18934"	.99468	187	1	188
11	"11-out18935"	.35714	190	342	532
11	"11-out18936"	.23841	72	230	302
11	"11-out18937"	.87313	117	17	134
11	"11-out18938"	.25000	53	159	212
11	"11-out18939"	.71785	201	79	280
11	"11-out18940"	.99145	116	1	117
11	"11-out18941"	.30576	329	747	1076
11	"11-out18942"	.99145	116	1	117
11	"11-out18943"	.31598	85	184	269
11	"11-out18944"	.99145	116	1	117
11	"11-out18945"	.41231	221	315	536
11	"11-out18946"	.74375	238	82	320
11	"11-out18947"	.19574	46	189	235
11	"11-out18948"	.76153	99	31	130
11	"11-out18949"	.27492	273	720	993
11	"11-out18950"	.63856	553	313	866
11	"11-out18951"	.85605	785	132	917
11	"11-out18952"	.30537	193	439	632
11	"11-out18953"	.50617	82	80	162
11	"11-out18954"	.57446	162	120	282
11	"11-out18955"	.36619	104	180	284
11	"11-out18956"	.32295	197	413	610
11	"11-out18957"	.20603	41	158	199
11	"11-out18958"	.29818	164	386	550
11	"11-out18959"	.53298	202	177	379
11	"11-out18960"	.31858	144	308	452
11	"11-out18961"	.76237	308	96	404
11	"11-out18962"	.43023	111	147	258
11	"11-out18963"	.99305	143	1	144
11	"11-out18964"	.46563	271	311	582
11	"11-out18965"	.33104	579	1170	1749
11	"11-out18966"	.87912	80	11	91
11	"11-out18967"	.64423	67	37	104
11	"11-out18968"	.57692	45	33	78
11	"11-out18969"	.97457	460	12	472
11	"11-out18970"	.42666	32	43	75
11	"11-out18971"	.37245	238	401	639
11	"11-out18972"	.95795	319	14	333
11	"11-out18973"	.94962	509	27	536
11	"11-out18974"	.31611	153	331	484
11	"11-out18975"	.36956	102	174	276
11	"11-out18976"	.99026	407	4	411
11	"11-out18977"	.91129	226	22	248
11	"11-out18978"	.88961	137	17	154
11	"11-out18979"	.45102	221	269	490
11	"11-out18980"	.39211	189	293	482
11	"11-out18981"	.27403	57	151	208
11	"11-out18982"	.49275	102	105	207
11	"11-out18983"	.89230	174	21	195
11	"11-out18984"	.46634	97	111	208
11	"11-out18985"	.49833	299	301	600
11	"11-out18986"	.73809	124	44	168
11	"11-out18987"	.99115	112	1	113
11	"11-out18988"	.97050	329	10	339
11	"11-out18989"	.40880	511	739	1250
11	"11-out18990"	1.00000	107	0	107
11	"11-out18991"	.87383	187	27	214
11	"11-out18992"	.38810	1018	1605	2623
11	"11-out18993"	.42675	134	180	314
11	"11-out18994"	.42138	134	184	318
11	"11-out18995"	.99324	147	1	148
11	"11-out18996"	.40122	262	391	653
11	"11-out18997"	.70229	92	39	131
11	"11-out18998"	.52268	288	263	551
11	"11-out18999"	.99555	224	1	225
11	"11-out19000"	.35564	186	337	523
11	"11-out19001"	.54017	121	103	224
11	"11-out19002"	.23544	372	1208	1580
11	"11-out19003"	.66589	287	144	431
11	"11-out19004"	.49016	274	285	559
11	"11-out19005"	.46228	239	278	517
11	"11-out19006"	.99236	130	1	131
11	"11-out19007"	.46721	57	65	122
11	"11-out19008"	.23846	31	99	130
11	"11-out19009"	.49170	504	521	1025
11	"11-out19010"	.38135	180	292	472
11	"11-out19011"	.99200	124	1	125
11	"11-out19012"	.99242	131	1	132
11	"11-out19013"	.99248	132	1	133
11	"11-out19014"	.99470	188	1	189
11	"11-out19015"	.99470	188	1	189
11	"11-out19016"	.99470	188	1	189
11	"11-out19017"	.99468	187	1	188
11	"11-out19018"	.99470	188	1	189
11	"11-out19019"	.38932	197	309	506
11	"11-out19020"	.83333	110	22	132
11	"11-out19021"	.45405	84	101	185
11	"11-out19022"	.44623	83	103	186
11	"11-out19023"	.32265	141	296	437
11	"11-out19024"	.32671	181	373	554
11	"11-out19025"	.39160	168	261	429
11	"11-out19026"	.71299	554	223	777
11	"11-out19027"	.30793	97	218	315
11	"11-out19028"	.99784	462	1	463
11	"11-out19029"	.34589	101	191	292
11	"11-out19030"	.22397	170	589	759
11	"11-out19031"	.99000	99	1	100
11	"11-out19032"	.47487	293	324	617
11	"11-out19033"	.99836	610	1	611
11	"11-out19034"	.35185	247	455	702
11	"11-out19035"	.97235	211	6	217
11	"11-out19036"	.18965	22	94	116
11	"11-out19037"	.37022	194	330	524
11	"11-out19038"	1.00000	428	0	428
11	"11-out19039"	1.00000	106	0	106
11	"11-out19040"	.31973	196	417	613
11	"11-out19041"	.98936	93	1	94
11	"11-out19042"	.85041	307	54	361
11	"11-out19043"	.98529	402	6	408
11	"11-out19044"	.25328	135	398	533
11	"11-out19045"	.99145	116	1	117
11	"11-out19046"	.37914	240	393	633
11	"11-out19047"	.84878	174	31	205
11	"11-out19048"	.33516	61	121	182
11	"11-out19049"	.26666	40	110	150
11	"11-out19050"	.61764	105	65	170
11	"11-out19051"	.23023	428	1431	1859
11	"11-out19052"	.98529	67	1	68
11	"11-out19053"	.20507	97	376	473
11	"11-out19054"	.91176	62	6	68
11	"11-out19055"	.24778	112	340	452
11	"11-out19056"	.33333	155	310	465
11	"11-out19057"	.99421	172	1	173
11	"11-out19058"	.25894	181	518	699
11	"11-out19059"	.35294	276	506	782
11	"11-out19060"	.31950	231	492	723
11	"11-out19061"	.29800	149	351	500
11	"11-out19062"	.22292	35	122	157
11	"11-out19063"	.33942	223	434	657
11	"11-out19064"	.57627	136	100	236
11	"11-out19065"	.56384	340	263	603
11	"11-out19066"	.35182	260	479	739
11	"11-out19067"	.68530	956	439	1395
11	"11-out19068"	.30416	146	334	480
11	"11-out19069"	.90151	476	52	528
11	"11-out19070"	.93188	342	25	367
11	"11-out19071"	.30968	179	399	578
11	"11-out19072"	.74264	101	35	136
11	"11-out19073"	.26713	113	310	423
11	"11-out19074"	.22941	78	262	340
11	"11-out19075"	.53623	37	32	69
11	"11-out19076"	.67123	49	24	73
11	"11-out19077"	.35254	159	292	451
11	"11-out19078"	1.00000	17	0	17
11	"11-out19079"	.65147	243	130	373
11	"11-out19080"	.38903	291	457	748
11	"11-out19081"	.26365	222	620	842
11	"11-out19082"	.60757	353	228	581
11	"11-out19083"	.44316	347	436	783
11	"11-out19084"	.45466	672	806	1478
11	"11-out19085"	.99137	115	1	116
11	"11-out19086"	.99145	116	1	117
11	"11-out19087"	.35303	699	1281	1980
11	"11-out19088"	.89861	195	22	217
11	"11-out19089"	.33245	126	253	379
11	"11-out19090"	.39798	158	239	397
11	"11-out19091"	.47261	302	337	639
11	"11-out19092"	.56134	334	261	595
11	"11-out19093"	.35042	41	76	117
11	"11-out19094"	.98104	621	12	633
11	"11-out19095"	.48000	120	130	250
11	"11-out19096"	.24429	107	331	438
11	"11-out19097"	.33789	222	435	657
11	"11-out19098"	.40471	189	278	467
11	"11-out19099"	.16715	114	568	682
11	"11-out19100"	.99824	568	1	569
11	"11-out19101"	.40000	154	231	385
11	"11-out19102"	.71276	134	54	188
11	"11-out19103"	.99137	115	1	116
11	"11-out19104"	.28700	190	472	662
11	"11-out19105"	.84026	384	73	457
11	"11-out19106"	.91222	291	28	319
11	"11-out19107"	.71142	249	101	350
11	"11-out19108"	.30349	217	498	715
11	"11-out19109"	.34242	226	434	660
11	"11-out19110"	.43086	134	177	311
11	"11-out19111"	.99612	257	1	258
11	"11-out19112"	.87068	404	60	464
11	"11-out19113"	.26286	792	2221	3013
11	"11-out19114"	.29162	303	736	1039
11	"11-out19115"	.29780	637	1502	2139
11	"11-out19116"	.58441	765	544	1309
11	"11-out19117"	.99723	1805	5	1810
11	"11-out19118"	.87626	432	61	493
11	"11-out19119"	.24437	152	470	622
11	"11-out19120"	.35949	142	253	395
11	"11-out19121"	.98648	73	1	74
11	"11-out19122"	.99766	428	1	429
11	"11-out19123"	.99849	665	1	666
11	"11-out19124"	.42365	197	268	465
11	"11-out19125"	.39612	307	468	775
11	"11-out19126"	.56594	442	339	781
11	"11-out19127"	.39400	184	283	467
11	"11-out19128"	.37053	166	282	448
11	"11-out19129"	.99895	960	1	961
11	"11-out19130"	.19161	96	405	501
11	"11-out19131"	.99849	665	1	666
11	"11-out19132"	.23880	64	204	268
11	"11-out19133"	.27539	122	321	443
11	"11-out19134"	.56108	248	194	442
11	"11-out19135"	.42023	353	487	840
11	"11-out19136"	.76625	495	151	646
11	"11-out19137"	.44793	228	281	509
11	"11-out19138"	.33085	311	629	940
11	"11-out19139"	.13235	9	59	68
11	"11-out19140"	.88034	103	14	117
11	"11-out19141"	.18953	105	449	554
11	"11-out19142"	.88739	528	67	595
11	"11-out19143"	.24090	106	334	440
11	"11-out19144"	.27215	172	460	632
11	"11-out19145"	.18776	89	385	474
11	"11-out19146"	.28169	20	51	71
11	"11-out19147"	.99768	431	1	432
11	"11-out19148"	.99808	521	1	522
11	"11-out19149"	.99818	549	1	550
11	"11-out19150"	.31699	97	209	306
11	"11-out19151"	.47198	219	245	464
11	"11-out19152"	.52727	319	286	605
11	"11-out19153"	.99806	517	1	518
11	"11-out19154"	.99145	116	1	117
11	"11-out19155"	.46351	216	250	466
11	"11-out19156"	.73941	227	80	307
11	"11-out19157"	.45845	160	189	349
11	"11-out19158"	.43883	287	367	654
11	"11-out19159"	.35897	42	75	117
11	"11-out19160"	.97872	46	1	47
11	"11-out19161"	.99889	906	1	907
11	"11-out19162"	.91558	141	13	154
11	"11-out19163"	.31645	350	756	1106
11	"11-out19164"	.66489	250	126	376
11	"11-out19165"	.27870	216	559	775
11	"11-out19166"	.25306	62	183	245
11	"11-out19167"	.28671	41	102	143
11	"11-out19168"	.38288	170	274	444
11	"11-out19169"	.77615	371	107	478
11	"11-out19170"	.96296	182	7	189
11	"11-out19171"	.48979	168	175	343
11	"11-out19172"	.33190	155	312	467
11	"11-out19173"	.69635	172	75	247
11	"11-out19174"	.35167	147	271	418
11	"11-out19175"	.22427	109	377	486
11	"11-out19176"	.40037	215	322	537
11	"11-out19177"	.98750	79	1	80
11	"11-out19178"	.99280	138	1	139
11	"11-out19179"	.38265	150	242	392
11	"11-out19180"	.30567	140	318	458
11	"11-out19181"	.38666	29	46	75
11	"11-out19182"	.97292	575	16	591
11	"11-out19183"	.44676	214	265	479
11	"11-out19184"	.97648	623	15	638
11	"11-out19185"	.93162	109	8	117
11	"11-out19186"	.63636	231	132	363
11	"11-out19187"	.23577	116	376	492
11	"11-out19188"	.45454	230	276	506
11	"11-out19189"	.34471	313	595	908
11	"11-out19190"	.52681	167	150	317
11	"11-out19191"	.99719	355	1	356
11	"11-out19192"	.31443	122	266	388
11	"11-out19193"	.54676	567	470	1037
11	"11-out19194"	.99644	5041	18	5059
11	"11-out19195"	.24549	218	670	888
11	"11-out19196"	.72619	305	115	420
11	"11-out19197"	.51917	379	351	730
11	"11-out19198"	.43462	236	307	543
11	"11-out19199"	.17123	25	121	146
11	"11-out19200"	.35198	302	556	858
11	"11-out19201"	.23160	85	282	367
11	"11-out19202"	.97814	716	16	732
11	"11-out19203"	.38181	126	204	330
11	"11-out19204"	.52057	253	233	486
11	"11-out19205"	.39775	177	268	445
11	"11-out19206"	.31869	196	419	615
11	"11-out19207"	.99295	141	1	142
11	"11-out19208"	.99743	389	1	390
11	"11-out19209"	.46038	308	361	669
11	"11-out19210"	.86269	333	53	386
11	"11-out19211"	.23950	291	924	1215
11	"11-out19212"	.09597	31	292	323
11	"11-out19213"	.21750	82	295	377
11	"11-out19214"	.14285	9	54	63
11	"11-out19215"	.30835	107	240	347
11	"11-out19216"	.26814	1511	4124	5635
11	"11-out19217"	.54807	285	235	520
11	"11-out19218"	.65306	256	136	392
11	"11-out19219"	.98924	92	1	93
11	"11-out19220"	.37762	108	178	286
11	"11-out19221"	.29314	231	557	788
11	"11-out19222"	.51304	118	112	230
11	"11-out19223"	.96547	755	27	782
11	"11-out19224"	.67127	486	238	724
11	"11-out19225"	.46000	115	135	250
11	"11-out19226"	.46762	260	296	556
11	"11-out19227"	.53716	542	467	1009
11	"11-out19228"	.24761	104	316	420
11	"11-out19229"	.40677	144	210	354
11	"11-out19230"	.85344	297	51	348
11	"11-out19231"	.40196	164	244	408
11	"11-out19232"	.32903	153	312	465
11	"11-out19233"	.95833	23	1	24
11	"11-out19234"	.78888	71	19	90
11	"11-out19235"	.43681	318	410	728
11	"11-out19236"	.34941	210	391	601
11	"11-out19237"	.28040	166	426	592
11	"11-out19238"	.25993	85	242	327
11	"11-out19239"	.33550	103	204	307
11	"11-out19240"	.99568	461	2	463
11	"11-out19241"	.72695	205	77	282
11	"11-out19242"	.59020	265	184	449
11	"11-out19243"	.54587	119	99	218
11	"11-out19244"	.40000	156	234	390
11	"11-out19245"	.87654	142	20	162
11	"11-out19246"	.27439	45	119	164
11	"11-out19247"	.85135	63	11	74
11	"11-out19248"	.46382	109	126	235
11	"11-out19249"	.23876	85	271	356
11	"11-out19250"	.44289	159	200	359
11	"11-out19251"	.40674	181	264	445
11	"11-out19252"	.83208	446	90	536
11	"11-out19253"	.42479	209	283	492
11	"11-out19254"	.17647	9	42	51
11	"11-out19255"	.51538	134	126	260
11	"11-out19256"	.37200	93	157	250
11	"11-out19257"	.99145	116	1	117
11	"11-out19258"	.28985	160	392	552
11	"11-out19259"	.99159	118	1	119
11	"11-out19260"	.38148	103	167	270
11	"11-out19261"	.59451	195	133	328
11	"11-out19262"	.99145	116	1	117
11	"11-out19263"	.46453	131	151	282
11	"11-out19264"	.99130	114	1	115
11	"11-out19265"	.32721	196	403	599
11	"11-out19266"	.49763	210	212	422
11	"11-out19267"	.46540	296	340	636
11	"11-out19268"	.48615	158	167	325
11	"11-out19269"	.21206	116	431	547
11	"11-out19270"	.99275	137	1	138
11	"11-out19271"	.37539	119	198	317
11	"11-out19272"	.26574	135	373	508
11	"11-out19273"	.53753	179	154	333
11	"11-out19274"	.83661	297	58	355
11	"11-out19275"	.29607	151	359	510
11	"11-out19276"	.14583	42	246	288
11	"11-out19277"	.63343	216	125	341
11	"11-out19278"	.42804	232	310	542
11	"11-out19279"	.38611	139	221	360
11	"11-out19280"	.89010	81	10	91
11	"11-out19281"	.30814	208	467	675
11	"11-out19282"	.39358	270	416	686
11	"11-out19283"	.98542	338	5	343
11	"11-out19284"	.39035	178	278	456
11	"11-out19285"	.51851	70	65	135
11	"11-out19286"	.45901	224	264	488
11	"11-out19287"	.45938	164	193	357
11	"11-out19288"	.95833	23	1	24
11	"11-out19289"	.91666	22	2	24
11	"11-out19290"	.95833	23	1	24
11	"11-out19291"	.84848	84	15	99
11	"11-out19292"	.97113	572	17	589
11	"11-out19293"	.86516	539	84	623
11	"11-out19294"	.47101	65	73	138
11	"11-out19295"	.83261	194	39	233
11	"11-out19296"	.69822	236	102	338
11	"11-out19297"	.99145	116	1	117
11	"11-out19298"	.99152	117	1	118
11	"11-out19299"	.35714	80	144	224
11	"11-out19300"	.25958	149	425	574
11	"11-out19301"	.20720	46	176	222
11	"11-out19302"	.42314	234	319	553
11	"11-out19303"	.74107	249	87	336
11	"11-out19304"	.99145	116	1	117
11	"11-out19305"	.45402	158	190	348
11	"11-out19306"	.51219	735	700	1435
11	"11-out19307"	.93364	197	14	211
11	"11-out19308"	.27067	108	291	399
11	"11-out19309"	.38740	320	506	826
11	"11-out19310"	.99295	141	1	142
11	"11-out19311"	.23030	76	254	330
11	"11-out19312"	.99801	503	1	504
11	"11-out19313"	.22962	31	104	135
11	"11-out19314"	.51481	139	131	270
11	"11-out19315"	.62244	61	37	98
11	"11-out19316"	.42711	126	169	295
11	"11-out19317"	.42972	159	211	370
11	"11-out19318"	.44915	159	195	354
11	"11-out19319"	.36069	145	257	402
11	"11-out19320"	.95833	23	1	24
11	"11-out19321"	.87500	21	3	24
11	"11-out19322"	.34589	101	191	292
11	"11-out19323"	.99317	291	2	293
11	"11-out19324"	.99317	291	2	293
11	"11-out19325"	.32594	103	213	316
11	"11-out19326"	.48439	745	793	1538
11	"11-out19327"	.27955	324	835	1159
11	"11-out19328"	.38336	212	341	553
11	"11-out19329"	.20338	72	282	354
11	"11-out19330"	.51142	358	342	700
11	"11-out19331"	.99913	1157	1	1158
11	"11-out19332"	.66086	76	39	115
11	"11-out19333"	.53907	407	348	755
11	"11-out19334"	.32291	31	65	96
11	"11-out19335"	.17557	23	108	131
11	"11-out19336"	.41314	176	250	426
11	"11-out19337"	.28521	81	203	284
11	"11-out19338"	.99159	118	1	119
11	"11-out19339"	.99159	118	1	119
11	"11-out19340"	.45375	157	189	346
11	"11-out19341"	.98275	57	1	58
11	"11-out19342"	.99145	116	1	117
11	"11-out19343"	.99152	117	1	118
11	"11-out19344"	.27345	102	271	373
11	"11-out19345"	.31250	95	209	304
11	"11-out19346"	.92000	92	8	100
11	"11-out19347"	.34349	124	237	361
11	"11-out19348"	.70000	63	27	90
11	"11-out19349"	.28904	161	396	557
11	"11-out19350"	.36813	275	472	747
11	"11-out19351"	.26954	100	271	371
11	"11-out19352"	.87309	344	50	394
11	"11-out19353"	.93352	323	23	346
11	"11-out19354"	.59067	114	79	193
11	"11-out19355"	.35678	71	128	199
11	"11-out19356"	.99551	222	1	223
11	"11-out19357"	.49820	139	140	279
11	"11-out19358"	.99700	333	1	334
11	"11-out19359"	.36550	178	309	487
11	"11-out19360"	.76153	297	93	390
11	"11-out19361"	.78003	500	141	641
11	"11-out19362"	.56162	360	281	641
11	"11-out19363"	.86842	66	10	76
11	"11-out19364"	.42722	226	303	529
11	"11-out19365"	.23053	77	257	334
11	"11-out19366"	.99099	330	3	333
11	"11-out19367"	.99317	291	2	293
11	"11-out19368"	.99317	291	2	293
11	"11-out19369"	.65033	292	157	449
11	"11-out19370"	.50578	175	171	346
11	"11-out19371"	.42612	199	268	467
11	"11-out19372"	.74881	474	159	633
11	"11-out19373"	.99721	358	1	359
11	"11-out19374"	.19895	38	153	191
11	"11-out19375"	.52849	102	91	193
11	"11-out19376"	.39971	283	425	708
11	"11-out19377"	.99521	416	2	418
11	"11-out19378"	.32947	114	232	346
11	"11-out19379"	.92982	318	24	342
11	"11-out19380"	.90886	369	37	406
11	"11-out19381"	.36241	216	380	596
11	"11-out19382"	.95833	23	1	24
11	"11-out19383"	.78750	63	17	80
11	"11-out19384"	.28417	79	199	278
11	"11-out19385"	.33928	95	185	280
11	"11-out19386"	.99152	117	1	118
11	"11-out19387"	.99145	116	1	117
11	"11-out19388"	.37254	95	160	255
11	"11-out19389"	.45105	235	286	521
11	"11-out19390"	.27627	255	668	923
11	"11-out19391"	.26938	66	179	245
11	"11-out19392"	.35271	364	668	1032
11	"11-out19393"	.33315	607	1215	1822
11	"11-out19394"	.26392	308	859	1167
11	"11-out19395"	.32415	259	540	799
11	"11-out19396"	.26441	211	587	798
11	"11-out19397"	.39364	409	630	1039
11	"11-out19398"	.39137	517	804	1321
11	"11-out19399"	.33333	61	122	183
11	"11-out19400"	.37854	374	614	988
11	"11-out19401"	.31759	296	636	932
11	"11-out19402"	.33271	179	359	538
11	"11-out19403"	.37104	82	139	221
11	"11-out19404"	.45199	193	234	427
11	"11-out19405"	.52671	207	186	393
11	"11-out19406"	.33944	185	360	545
11	"11-out19407"	.26427	125	348	473
11	"11-out19408"	.34180	928	1787	2715
11	"11-out19409"	.46487	2283	2628	4911
11	"11-out19410"	.33881	1876	3661	5537
11	"11-out19411"	.91703	420	38	458
11	"11-out19412"	.33117	409	826	1235
11	"11-out19413"	.29017	195	477	672
11	"11-out19414"	.28900	213	524	737
11	"11-out19415"	.29870	115	270	385
11	"11-out19416"	.88135	468	63	531
11	"11-out19417"	.99375	159	1	160
11	"11-out19418"	.37956	52	85	137
11	"11-out19419"	.87654	71	10	81
11	"11-out19420"	.79761	67	17	84
11	"11-out19421"	.90476	57	6	63
11	"11-out19422"	.96808	273	9	282
11	"11-out19423"	.91764	234	21	255
11	"11-out19424"	.95475	211	10	221
11	"11-out19425"	.98974	193	2	195
11	"11-out19426"	.99004	199	2	201
11	"11-out19427"	.99504	201	1	202
11	"11-out19428"	.99358	155	1	156
11	"11-out19429"	.96078	245	10	255
11	"11-out19430"	.97175	172	5	177
11	"11-out19431"	.77083	74	22	96
11	"11-out19432"	.89285	100	12	112
11	"11-out19433"	.98837	170	2	172
11	"11-out19434"	.96938	95	3	98
11	"11-out19435"	.98979	97	1	98
11	"11-out19436"	.98529	134	2	136
11	"11-out19437"	.88717	173	22	195
11	"11-out19438"	.95180	158	8	166
11	"11-out19439"	.98342	178	3	181
11	"11-out19440"	.98536	202	3	205
11	"11-out19441"	.98571	207	3	210
11	"11-out19442"	.98378	182	3	185
11	"11-out19443"	.98095	206	4	210
11	"11-out19444"	.91366	254	24	278
11	"11-out19445"	.99156	235	2	237
11	"11-out19446"	.95348	123	6	129
11	"11-out19447"	.99393	164	1	165
11	"11-out19448"	.99465	186	1	187
11	"11-out19449"	.99408	168	1	169
11	"11-out19450"	.94366	67	4	71
11	"11-out19451"	.83870	52	10	62
11	"11-out19452"	.92233	95	8	103
11	"11-out19453"	.80800	202	48	250
11	"11-out19454"	.98275	171	3	174
11	"11-out19455"	.97484	155	4	159
11	"11-out19456"	.98051	151	3	154
11	"11-out19457"	.95625	153	7	160
11	"11-out19458"	.97633	165	4	169
11	"11-out19459"	.99371	158	1	159
11	"11-out19460"	.28329	134	339	473
11	"11-out19461"	.49417	509	521	1030
11	"11-out19462"	.53125	68	60	128
11	"11-out19463"	.95906	164	7	171
11	"11-out19464"	.70549	321	134	455
11	"11-out19465"	.93763	421	28	449
11	"11-out19466"	.90350	412	44	456
11	"11-out19467"	.87829	433	60	493
11	"11-out19468"	.24829	182	551	733
11	"11-out19469"	.98158	906	17	923
11	"11-out19470"	.36736	349	601	950
11	"11-out19471"	.27178	131	351	482
11	"11-out19472"	.27392	292	774	1066
11	"11-out19473"	.56585	232	178	410
11	"11-out19474"	.92574	374	30	404
11	"11-out19475"	.51470	70	66	136
11	"11-out19476"	.98113	52	1	53
11	"11-out19477"	.99236	130	1	131
11	"11-out19478"	.99802	1011	2	1013
11	"11-out19479"	.84615	66	12	78
11	"11-out19480"	.92951	211	16	227
11	"11-out19481"	.27402	308	816	1124
11	"11-out19482"	.99216	380	3	383
11	"11-out19483"	.30462	145	331	476
11	"11-out19484"	.58679	311	219	530
11	"11-out19485"	.66452	311	157	468
11	"11-out19486"	.99880	836	1	837
11	"11-out19487"	.51120	251	240	491
11	"11-out19488"	.30515	491	1118	1609
11	"11-out19489"	.40545	714	1047	1761
11	"11-out19490"	.25984	310	883	1193
11	"11-out19491"	.38793	611	964	1575
11	"11-out19492"	.60000	252	168	420
11	"11-out19493"	.84227	267	50	317
11	"11-out19494"	.90054	661	73	734
11	"11-out19495"	.30530	345	785	1130
11	"11-out19496"	.55725	146	116	262
11	"11-out19497"	.96813	395	13	408
11	"11-out19498"	.47202	329	368	697
11	"11-out19499"	.33268	341	684	1025
11	"11-out19500"	.45795	599	709	1308
11	"11-out19501"	.26611	128	353	481
11	"11-out19502"	.93220	110	8	118
11	"11-out19503"	.91525	108	10	118
11	"11-out19504"	.48344	73	78	151
11	"11-out19505"	.29069	250	610	860
11	"11-out19506"	.53068	147	130	277
11	"11-out19507"	.24568	57	175	232
11	"11-out19508"	.51641	236	221	457
11	"11-out19509"	.29107	225	548	773
11	"11-out19510"	.24293	43	134	177
11	"11-out19511"	.31309	232	509	741
11	"11-out19512"	.33457	985	1959	2944
11	"11-out19513"	.30249	255	588	843
11	"11-out19514"	.30510	227	517	744
11	"11-out19515"	.36815	215	369	584
11	"11-out19516"	.27227	55	147	202
11	"11-out19517"	.33007	304	617	921
11	"11-out19518"	.50653	349	340	689
11	"11-out19519"	.33561	49	97	146
11	"11-out19520"	.35632	31	56	87
11	"11-out19521"	.60060	197	131	328
11	"11-out19522"	.32871	95	194	289
11	"11-out19523"	.98936	93	1	94
11	"11-out19524"	.72235	1254	482	1736
11	"11-out19525"	.42192	508	696	1204
11	"11-out19526"	.71830	153	60	213
11	"11-out19527"	.42004	683	943	1626
11	"11-out19528"	.10526	20	170	190
11	"11-out19529"	.40703	81	118	199
11	"11-out19530"	.35897	70	125	195
11	"11-out19531"	.72864	145	54	199
11	"11-out19532"	.82589	185	39	224
11	"11-out19533"	.21243	41	152	193
11	"11-out19534"	.33333	66	132	198
11	"11-out19535"	.38969	189	296	485
11	"11-out19536"	.25382	83	244	327
11	"11-out19537"	.41104	67	96	163
11	"11-out19538"	.57714	101	74	175
11	"11-out19539"	.27731	33	86	119
11	"11-out19540"	.51481	278	262	540
11	"11-out19541"	.41073	704	1010	1714
11	"11-out19542"	.44566	406	505	911
11	"11-out19543"	.77017	563	168	731
11	"11-out19544"	.75226	249	82	331
11	"11-out19545"	.47800	239	261	500
11	"11-out19546"	.44979	224	274	498
11	"11-out19547"	.27513	104	274	378
11	"11-out19548"	.31516	133	289	422
11	"11-out19549"	.28835	109	269	378
11	"11-out19550"	.25161	78	232	310
11	"11-out19551"	.99696	328	1	329
11	"11-out19552"	.21013	112	421	533
11	"11-out19553"	.40812	231	335	566
11	"11-out19554"	.38176	381	617	998
11	"11-out19555"	.86236	896	143	1039
11	"11-out19556"	.48241	192	206	398
11	"11-out19557"	.28571	88	220	308
11	"11-out19558"	.47222	85	95	180
11	"11-out19559"	.99047	104	1	105
11	"11-out19560"	.99694	326	1	327
11	"11-out19561"	.30769	44	99	143
11	"11-out19562"	.27413	142	376	518
11	"11-out19563"	.35258	116	213	329
11	"11-out19564"	.99603	251	1	252
11	"11-out19565"	.31329	99	217	316
11	"11-out19566"	.18762	94	407	501
11	"11-out19567"	.29433	78	187	265
11	"11-out19568"	.23130	133	442	575
11	"11-out19569"	.30615	169	383	552
11	"11-out19570"	.32905	154	314	468
11	"11-out19571"	.29032	63	154	217
11	"11-out19572"	.43604	75	97	172
11	"11-out19573"	.48535	381	404	785
11	"11-out19574"	.70539	170	71	241
11	"11-out19575"	.38993	124	194	318
11	"11-out19576"	.33591	130	257	387
11	"11-out19577"	.33691	94	185	279
11	"11-out19578"	.25357	124	365	489
11	"11-out19579"	.21904	115	410	525
11	"11-out19580"	.35967	669	1191	1860
11	"11-out19581"	.72246	164	63	227
11	"11-out19582"	.46786	728	828	1556
11	"11-out19583"	.22468	162	559	721
11	"11-out19584"	.94206	439	27	466
11	"11-out19585"	.95377	392	19	411
11	"11-out19586"	.23328	164	539	703
11	"11-out19587"	.56457	153	118	271
11	"11-out19588"	.29281	53	128	181
11	"11-out19589"	.28433	147	370	517
11	"11-out19590"	.46491	901	1037	1938
11	"11-out19591"	.53768	214	184	398
11	"11-out19592"	.28384	130	328	458
11	"11-out19593"	.99173	120	1	121
11	"11-out19594"	.99230	129	1	130
11	"11-out19595"	.28730	129	320	449
11	"11-out19596"	.61341	192	121	313
11	"11-out19597"	.87782	194	27	221
11	"11-out19598"	.59390	117	80	197
11	"11-out19599"	.56476	109	84	193
11	"11-out19600"	.48979	48	50	98
11	"11-out19601"	.99770	434	1	435
11	"11-out19602"	.25373	425	1250	1675
11	"11-out19603"	.20426	335	1305	1640
11	"11-out19604"	.49829	292	294	586
11	"11-out19605"	.89878	222	25	247
11	"11-out19606"	.81818	207	46	253
11	"11-out19607"	.39986	575	863	1438
11	"11-out19608"	.27239	149	398	547
11	"11-out19609"	.76859	93	28	121
11	"11-out19610"	.59512	122	83	205
11	"11-out19611"	.70982	159	65	224
11	"11-out19612"	.29720	85	201	286
11	"11-out19613"	.40661	344	502	846
11	"11-out19614"	.33651	493	972	1465
11	"11-out19615"	.31294	133	292	425
11	"11-out19616"	.22881	81	273	354
11	"11-out19617"	.35474	116	211	327
11	"11-out19618"	.30000	102	238	340
11	"11-out19619"	.99390	163	1	164
11	"11-out19620"	.99692	324	1	325
11	"11-out19621"	.99528	211	1	212
11	"11-out19622"	.51606	273	256	529
11	"11-out19623"	.43653	141	182	323
11	"11-out19624"	.52115	234	215	449
11	"11-out19625"	.45038	118	144	262
11	"11-out19626"	.31137	260	575	835
11	"11-out19627"	.45662	1858	2211	4069
11	"11-out19628"	.46428	65	75	140
11	"11-out19629"	.98795	82	1	83
11	"11-out19630"	.98148	53	1	54
11	"11-out19631"	.99324	147	1	148
11	"11-out19632"	.53750	86	74	160
11	"11-out19633"	.35038	315	584	899
11	"11-out19634"	.39221	131	203	334
11	"11-out19635"	.94174	291	18	309
11	"11-out19636"	.29942	262	613	875
11	"11-out19637"	.59688	422	285	707
11	"11-out19638"	.42338	315	429	744
11	"11-out19639"	.40784	208	302	510
11	"11-out19640"	.58695	54	38	92
11	"11-out19641"	.17796	84	388	472
11	"11-out19642"	.44444	160	200	360
11	"11-out19643"	.23575	240	778	1018
11	"11-out19644"	.42636	469	631	1100
11	"11-out19645"	.27047	360	971	1331
11	"11-out19646"	.98936	93	1	94
11	"11-out19647"	.50000	89	89	178
11	"11-out19648"	.46513	487	560	1047
11	"11-out19649"	.75816	116	37	153
11	"11-out19650"	.35587	100	181	281
11	"11-out19651"	.53631	96	83	179
11	"11-out19652"	.26775	49	134	183
11	"11-out19653"	.50310	81	80	161
11	"11-out19654"	.33714	59	116	175
11	"11-out19655"	.99173	120	1	121
11	"11-out19656"	.38866	569	895	1464
11	"11-out19657"	.36852	548	939	1487
11	"11-out19658"	.76247	1268	395	1663
11	"11-out19659"	.39005	651	1018	1669
11	"11-out19660"	.33469	573	1139	1712
11	"11-out19661"	.36261	611	1074	1685
11	"11-out19662"	.99942	1743	1	1744
11	"11-out19663"	.99942	1743	1	1744
11	"11-out19664"	.31621	474	1025	1499
11	"11-out19665"	.23346	240	788	1028
11	"11-out19666"	.21687	221	798	1019
11	"11-out19667"	.27441	621	1642	2263
11	"11-out19668"	.41648	389	545	934
11	"11-out19669"	.56899	400	303	703
11	"11-out19670"	.34348	203	388	591
11	"11-out19671"	.39181	268	416	684
11	"11-out19672"	.49731	278	281	559
11	"11-out19673"	.26415	28	78	106
11	"11-out19674"	.75675	56	18	74
11	"11-out19675"	.68000	85	40	125
11	"11-out19676"	.35930	83	148	231
11	"11-out19677"	.38088	259	421	680
11	"11-out19678"	.42303	764	1042	1806
11	"11-out19679"	.51308	647	614	1261
11	"11-out19680"	.38288	528	851	1379
11	"11-out19681"	.36798	308	529	837
11	"11-out19682"	.30542	591	1344	1935
11	"11-out19683"	.36535	966	1678	2644
11	"11-out19684"	.26291	290	813	1103
11	"11-out19685"	.31157	296	654	950
11	"11-out19686"	.34611	379	716	1095
11	"11-out19687"	.37696	455	752	1207
11	"11-out19688"	.28210	134	341	475
11	"11-out19689"	.99627	1071	4	1075
11	"11-out19690"	.35135	52	96	148
11	"11-out19691"	.43067	146	193	339
11	"11-out19692"	.54901	196	161	357
11	"11-out19693"	.90322	364	39	403
11	"11-out19694"	.88662	305	39	344
11	"11-out19695"	.33039	1012	2051	3063
11	"11-out19696"	.39272	216	334	550
11	"11-out19697"	.35425	254	463	717
11	"11-out19698"	.30230	276	637	913
11	"11-out19699"	.22460	115	397	512
11	"11-out19700"	.19796	117	474	591
11	"11-out19701"	.26086	150	425	575
11	"11-out19702"	.88554	147	19	166
11	"11-out19703"	.50259	97	96	193
11	"11-out19704"	.50602	84	82	166
11	"11-out19705"	.37680	523	865	1388
11	"11-out19706"	.28232	238	605	843
11	"11-out19707"	.25669	115	333	448
11	"11-out19708"	.99782	459	1	460
11	"11-out19709"	.26624	209	576	785
11	"11-out19710"	.21782	154	553	707
11	"11-out19711"	.18236	122	547	669
11	"11-out19712"	.67567	150	72	222
11	"11-out19713"	.69306	70	31	101
11	"11-out19714"	.28285	127	322	449
11	"11-out19715"	.44155	578	731	1309
11	"11-out19716"	.54480	152	127	279
11	"11-out19717"	.26455	318	884	1202
11	"11-out19718"	.39220	302	468	770
11	"11-out19719"	.27509	148	390	538
11	"11-out19720"	.99145	116	1	117
11	"11-out19721"	.40800	51	74	125
11	"11-out19722"	.86065	105	17	122
11	"11-out19723"	.57098	185	139	324
11	"11-out19724"	.16389	69	352	421
11	"11-out19725"	.45642	199	237	436
11	"11-out19726"	.21527	124	452	576
11	"11-out19727"	.67783	688	327	1015
11	"11-out19728"	.28170	422	1076	1498
11	"11-out19729"	.31755	161	346	507
11	"11-out19730"	.40207	503	748	1251
11	"11-out19731"	.41903	339	470	809
11	"11-out19732"	.52777	76	68	144
11	"11-out19733"	.26250	42	118	160
11	"11-out19734"	.77697	108	31	139
11	"11-out19735"	.49848	164	165	329
11	"11-out19736"	.44374	422	529	951
11	"11-out19737"	.42322	328	447	775
11	"11-out19738"	.21851	118	422	540
11	"11-out19739"	.42629	321	432	753
11	"11-out19740"	.39285	66	102	168
11	"11-out19741"	.43956	80	102	182
11	"11-out19742"	.45683	127	151	278
11	"11-out19743"	.48137	349	376	725
11	"11-out19744"	.97593	1257	31	1288
11	"11-out19745"	.30836	317	711	1028
11	"11-out19746"	.97593	1257	31	1288
11	"11-out19747"	.42507	556	752	1308
11	"11-out19748"	.30321	396	910	1306
11	"11-out19749"	.44774	1041	1284	2325
11	"11-out19750"	.49681	78	79	157
11	"11-out19751"	.33748	461	905	1366
11	"11-out19752"	.34788	510	956	1466
11	"11-out19753"	.84899	253	45	298
11	"11-out19754"	.98214	55	1	56
11	"11-out19755"	.53921	110	94	204
11	"11-out19756"	.27304	154	410	564
11	"11-out19757"	.62264	99	60	159
11	"11-out19758"	.41213	326	465	791
11	"11-out19759"	.45235	864	1046	1910
11	"11-out19760"	.37572	455	756	1211
11	"11-out19761"	.59390	1480	1012	2492
11	"11-out19762"	.26344	245	685	930
11	"11-out19763"	.35069	559	1035	1594
11	"11-out19764"	.99779	453	1	454
11	"11-out19765"	.35731	437	786	1223
11	"11-out19766"	.27614	338	886	1224
11	"11-out19767"	.31230	302	665	967
11	"11-out19768"	.32946	227	462	689
11	"11-out19769"	.34355	280	535	815
11	"11-out19770"	.98750	79	1	80
11	"11-out19771"	.56619	201	154	355
11	"11-out19772"	.86149	311	50	361
11	"11-out19773"	.34627	107	202	309
11	"11-out19774"	.41938	528	731	1259
11	"11-out19775"	.28937	237	582	819
11	"11-out19776"	.35007	230	427	657
11	"11-out19777"	.35714	265	477	742
11	"11-out19778"	.20129	31	123	154
11	"11-out19779"	.66942	81	40	121
11	"11-out19780"	.41098	187	268	455
11	"11-out19781"	.56250	63	49	112
11	"11-out19782"	.21888	51	182	233
11	"11-out19783"	.68235	58	27	85
11	"11-out19784"	.46500	93	107	200
11	"11-out19785"	.66666	122	61	183
11	"11-out19786"	.34343	68	130	198
11	"11-out19787"	.47524	96	106	202
11	"11-out19788"	.46391	90	104	194
11	"11-out19789"	.97904	327	7	334
11	"11-out19790"	.26155	198	559	757
11	"11-out19791"	.26568	72	199	271
11	"11-out19792"	.36019	447	794	1241
11	"11-out19793"	.38230	471	761	1232
11	"11-out19794"	.33367	328	655	983
11	"11-out19795"	.68275	99	46	145
11	"11-out19796"	.35329	118	216	334
11	"11-out19797"	.43034	139	184	323
11	"11-out19798"	.27675	181	473	654
11	"11-out19799"	.97910	328	7	335
11	"11-out19800"	.29820	365	859	1224
11	"11-out19801"	.51385	204	193	397
11	"11-out19802"	.45706	165	196	361
11	"11-out19803"	.22222	84	294	378
11	"11-out19804"	.26993	88	238	326
11	"11-out19805"	.23655	88	284	372
11	"11-out19806"	.48000	84	91	175
11	"11-out19807"	.24936	98	295	393
11	"11-out19808"	.35755	123	221	344
11	"11-out19809"	.22513	86	296	382
11	"11-out19810"	.58684	223	157	380
11	"11-out19811"	.39083	145	226	371
11	"11-out19812"	.83369	381	76	457
11	"11-out19813"	.51111	46	44	90
11	"11-out19814"	.27069	121	326	447
11	"11-out19815"	.71884	248	97	345
11	"11-out19816"	.41166	466	666	1132
11	"11-out19817"	.28896	343	844	1187
11	"11-out19818"	.61765	1630	1009	2639
11	"11-out19819"	.99871	779	1	780
11	"11-out19820"	.42479	209	283	492
11	"11-out19821"	.38948	252	395	647
11	"11-out19822"	.77642	191	55	246
11	"11-out19823"	.50000	127	127	254
11	"11-out19824"	.32278	153	321	474
11	"11-out19825"	.32207	124	261	385
11	"11-out19826"	.37154	551	932	1483
11	"11-out19827"	.57480	73	54	127
11	"11-out19828"	.51060	1107	1061	2168
11	"11-out19829"	.25600	32	93	125
11	"11-out19830"	.36056	256	454	710
11	"11-out19831"	.37288	176	296	472
11	"11-out19832"	.39195	341	529	870
11	"11-out19833"	.29109	170	414	584
11	"11-out19834"	.46808	220	250	470
11	"11-out19835"	.43875	240	307	547
11	"11-out19836"	.47396	446	495	941
11	"11-out19837"	.71509	1255	500	1755
11	"11-out19838"	.49779	226	228	454
11	"11-out19839"	.30453	215	491	706
11	"11-out19840"	.98000	98	2	100
11	"11-out19841"	.41827	627	872	1499
11	"11-out19842"	.26718	381	1045	1426
11	"11-out19843"	.36151	124	219	343
11	"11-out19844"	.66653	1749	875	2624
11	"11-out19845"	.38617	229	364	593
11	"11-out19846"	.61538	104	65	169
11	"11-out19847"	.53046	148	131	279
11	"11-out19848"	.45279	235	284	519
11	"11-out19849"	.29230	171	414	585
11	"11-out19850"	.22904	153	515	668
11	"11-out19851"	.83333	125	25	150
11	"11-out19852"	.84000	63	12	75
11	"11-out19853"	.91250	73	7	80
11	"11-out19854"	.98113	104	2	106
11	"11-out19855"	.63768	44	25	69
11	"11-out19856"	.95200	119	6	125
11	"11-out19857"	.77477	86	25	111
11	"11-out19858"	.67500	81	39	120
11	"11-out19859"	.99099	110	1	111
11	"11-out19860"	.32666	147	303	450
11	"11-out19861"	.35939	239	426	665
11	"11-out19862"	.60722	252	163	415
11	"11-out19863"	.33530	227	450	677
11	"11-out19864"	.99717	353	1	354
11	"11-out19865"	.98743	393	5	398
11	"11-out19866"	.64159	145	81	226
11	"11-out19867"	.34934	80	149	229
11	"11-out19868"	.26966	96	260	356
11	"11-out19869"	.42895	160	213	373
11	"11-out19870"	.94920	299	16	315
11	"11-out19871"	.73125	117	43	160
11	"11-out19872"	.32515	53	110	163
11	"11-out19873"	.77981	255	72	327
11	"11-out19874"	.14973	28	159	187
11	"11-out19875"	.99543	218	1	219
11	"11-out19876"	.72689	173	65	238
11	"11-out19877"	.32229	185	389	574
11	"11-out19878"	.29983	355	829	1184
11	"11-out19879"	.43867	93	119	212
11	"11-out19880"	.47619	190	209	399
11	"11-out19881"	.21649	147	532	679
11	"11-out19882"	.18867	20	86	106
11	"11-out19883"	.37569	272	452	724
11	"11-out19884"	.20189	149	589	738
11	"11-out19885"	.39675	171	260	431
11	"11-out19886"	.98958	95	1	96
11	"11-out19887"	.29499	395	944	1339
11	"11-out19888"	.34285	492	943	1435
11	"11-out19889"	.20458	232	902	1134
11	"11-out19890"	.38487	453	724	1177
11	"11-out19891"	.49894	237	238	475
11	"11-out19892"	.16860	203	1001	1204
11	"11-out19893"	.39322	464	716	1180
11	"11-out19894"	.47797	586	640	1226
11	"11-out19895"	.33612	402	794	1196
11	"11-out19896"	.25905	322	921	1243
11	"11-out19897"	.90322	252	27	279
11	"11-out19898"	.63380	90	52	142
11	"11-out19899"	.38095	328	533	861
11	"11-out19900"	.32631	31	64	95
11	"11-out19901"	.33111	149	301	450
11	"11-out19902"	.38402	447	717	1164
11	"11-out19903"	.55673	157	125	282
11	"11-out19904"	.20754	77	294	371
11	"11-out19905"	.34477	231	439	670
11	"11-out19906"	.33526	347	688	1035
11	"11-out19907"	.18556	54	237	291
11	"11-out19908"	.41484	95	134	229
11	"11-out19909"	.84444	190	35	225
11	"11-out19910"	.47570	470	518	988
11	"11-out19911"	.91262	94	9	103
11	"11-out19912"	.44342	337	423	760
11	"11-out19913"	.26583	214	591	805
11	"11-out19914"	.41841	100	139	239
11	"11-out19915"	.28508	65	163	228
11	"11-out19916"	.29257	67	162	229
11	"11-out19917"	.99065	212	2	214
11	"11-out19918"	.26482	67	186	253
11	"11-out19919"	.99557	225	1	226
11	"11-out19920"	.32024	155	329	484
11	"11-out19921"	.21621	104	377	481
11	"11-out19922"	.50344	146	144	290
11	"11-out19923"	.48258	97	104	201
11	"11-out19924"	.47486	170	188	358
11	"11-out19925"	.38317	164	264	428
11	"11-out19926"	.34200	184	354	538
11	"11-out19927"	.26074	273	774	1047
11	"11-out19928"	.98529	67	1	68
11	"11-out19929"	.41379	96	136	232
11	"11-out19930"	.45705	612	727	1339
11	"11-out19931"	.40751	141	205	346
11	"11-out19932"	.42372	175	238	413
11	"11-out19933"	.37768	176	290	466
11	"11-out19934"	.99319	146	1	147
11	"11-out19935"	.37651	93	154	247
11	"11-out19936"	.95978	358	15	373
11	"11-out19937"	.29228	489	1184	1673
11	"11-out19938"	.44311	74	93	167
11	"11-out19939"	.34838	108	202	310
11	"11-out19940"	.99047	104	1	105
11	"11-out19941"	.09876	8	73	81
11	"11-out19942"	.10843	9	74	83
11	"11-out19943"	.52248	732	669	1401
11	"11-out19944"	.42257	483	660	1143
11	"11-out19945"	.34545	209	396	605
11	"11-out19946"	.33611	242	478	720
11	"11-out19947"	.46131	477	557	1034
11	"11-out19948"	.32252	179	376	555
11	"11-out19949"	.17845	53	244	297
11	"11-out19950"	.83063	461	94	555
11	"11-out19951"	.28451	676	1700	2376
11	"11-out19952"	.35826	206	369	575
11	"11-out19953"	.35906	200	357	557
11	"11-out19954"	.91578	261	24	285
11	"11-out19955"	.46575	136	156	292
11	"11-out19956"	.31772	95	204	299
11	"11-out19957"	.49756	204	206	410
11	"11-out19958"	.60483	150	98	248
11	"11-out19959"	.47126	41	46	87
11	"11-out19960"	.44512	73	91	164
11	"11-out19961"	.29393	97	233	330
11	"11-out19962"	.45276	139	168	307
11	"11-out19963"	.41397	154	218	372
11	"11-out19964"	.32000	64	136	200
11	"11-out19965"	.50533	710	695	1405
11	"11-out19966"	.32980	343	697	1040
11	"11-out19967"	.26510	272	754	1026
11	"11-out19968"	.37743	388	640	1028
11	"11-out19969"	.15317	212	1172	1384
11	"11-out19970"	.30897	279	624	903
11	"11-out19971"	.26063	196	556	752
11	"11-out19972"	.47005	785	885	1670
11	"11-out19973"	.39349	665	1025	1690
11	"11-out19974"	.40804	690	1001	1691
11	"11-out19975"	.30903	568	1270	1838
11	"11-out19976"	.48710	850	895	1745
11	"11-out19977"	.32875	551	1125	1676
11	"11-out19978"	.22725	722	2455	3177
11	"11-out19979"	.34072	891	1724	2615
11	"11-out19980"	.99603	251	1	252
11	"11-out19981"	.19617	82	336	418
11	"11-out19982"	.45215	241	292	533
11	"11-out19983"	.46189	200	233	433
11	"11-out19984"	.78636	173	47	220
11	"11-out19985"	.99393	164	1	165
11	"11-out19986"	.34013	200	388	588
11	"11-out19987"	.46101	136	159	295
11	"11-out19988"	.49222	95	98	193
11	"11-out19989"	.30694	159	359	518
11	"11-out19990"	.17610	56	262	318
11	"11-out19991"	.80612	237	57	294
11	"11-out19992"	.74093	143	50	193
11	"11-out19993"	.53697	167	144	311
11	"11-out19994"	.38725	79	125	204
11	"11-out19995"	.30693	62	140	202
11	"11-out19996"	.34913	81	151	232
11	"11-out19997"	.32488	205	426	631
11	"11-out19998"	.27252	124	331	455
11	"11-out19999"	.48850	170	178	348
11	"11-out20000"	.41269	364	518	882
11	"11-out20001"	.32901	127	259	386
11	"11-out20002"	.14858	63	361	424
11	"11-out20003"	.35214	156	287	443
11	"11-out20004"	.38352	135	217	352
11	"11-out20005"	.42512	176	238	414
11	"11-out20006"	.44665	247	306	553
11	"11-out20007"	.53246	41	36	77
11	"11-out20008"	.48404	182	194	376
11	"11-out20009"	.81159	56	13	69
11	"11-out20010"	.36515	394	685	1079
11	"11-out20011"	.99473	189	1	190
11	"11-out20012"	.41841	100	139	239
11	"11-out20013"	.62376	63	38	101
11	"11-out20014"	.45812	93	110	203
11	"11-out20015"	.79629	86	22	108
11	"11-out20016"	.37007	47	80	127
11	"11-out20017"	.53524	987	857	1844
11	"11-out20018"	.67146	233	114	347
11	"11-out20019"	.97461	1267	33	1300
11	"11-out20020"	.37919	452	740	1192
11	"11-out20021"	.46906	652	738	1390
11	"11-out20022"	.92901	602	46	648
11	"11-out20023"	.38030	197	321	518
11	"11-out20024"	.34008	168	326	494
11	"11-out20025"	.86428	121	19	140
11	"11-out20026"	.29015	56	137	193
11	"11-out20027"	.34408	715	1363	2078
11	"11-out20028"	.44378	75	94	169
11	"11-out20029"	.99206	125	1	126
11	"11-out20030"	.99180	121	1	122
11	"11-out20031"	.27175	228	611	839
11	"11-out20032"	.57575	532	392	924
11	"11-out20033"	.26415	28	78	106
11	"11-out20034"	.48338	291	311	602
11	"11-out20035"	.22531	397	1365	1762
11	"11-out20036"	.71924	684	267	951
11	"11-out20037"	.51690	214	200	414
11	"11-out20038"	.99212	126	1	127
11	"11-out20039"	.65755	409	213	622
11	"11-out20040"	.54285	133	112	245
11	"11-out20041"	.56488	74	57	131
11	"11-out20042"	.25301	42	124	166
11	"11-out20043"	.33483	149	296	445
11	"11-out20044"	.99397	165	1	166
11	"11-out20045"	.99628	268	1	269
11	"11-out20046"	.88732	63	8	71
11	"11-out20047"	.99684	316	1	317
11	"11-out20048"	.22758	33	112	145
11	"11-out20049"	.26523	148	410	558
11	"11-out20050"	.33276	194	389	583
11	"11-out20051"	.42144	228	313	541
11	"11-out20052"	.98924	92	1	93
11	"11-out20053"	.61512	732	458	1190
11	"11-out20054"	.39548	140	214	354
11	"11-out20055"	.38176	360	583	943
11	"11-out20056"	.99854	686	1	687
11	"11-out20057"	.41809	342	476	818
11	"11-out20058"	.25737	192	554	746
11	"11-out20059"	.22439	195	674	869
11	"11-out20060"	.31578	72	156	228
11	"11-out20061"	.37704	92	152	244
11	"11-out20062"	.16858	44	217	261
11	"11-out20063"	.38862	82	129	211
11	"11-out20064"	.37391	86	144	230
11	"11-out20065"	.38636	85	135	220
11	"11-out20066"	.93636	206	14	220
11	"11-out20067"	.24000	54	171	225
11	"11-out20068"	.19760	33	134	167
11	"11-out20069"	.82157	198	43	241
11	"11-out20070"	.43644	103	133	236
11	"11-out20071"	.64062	451	253	704
11	"11-out20072"	.47178	301	337	638
11	"11-out20073"	.64432	125	69	194
11	"11-out20074"	.35542	118	214	332
11	"11-out20075"	.51474	192	181	373
11	"11-out20076"	.29200	438	1062	1500
11	"11-out20077"	.91500	506	47	553
11	"11-out20078"	.44549	282	351	633
11	"11-out20079"	.30973	70	156	226
11	"11-out20080"	.99703	336	1	337
11	"11-out20081"	.47933	58	63	121
11	"11-out20082"	.26172	374	1055	1429
11	"11-out20083"	.19751	238	967	1205
11	"11-out20084"	.28021	313	804	1117
11	"11-out20085"	.91103	1536	150	1686
11	"11-out20086"	.40832	363	526	889
11	"11-out20087"	.37491	535	892	1427
11	"11-out20088"	.26699	326	895	1221
11	"11-out20089"	.47905	629	684	1313
11	"11-out20090"	.38340	342	550	892
11	"11-out20091"	.26097	107	303	410
11	"11-out20092"	.57734	209	153	362
11	"11-out20093"	.26388	171	477	648
11	"11-out20094"	.29251	43	104	147
11	"11-out20095"	.40155	206	307	513
11	"11-out20096"	.28187	168	428	596
11	"11-out20097"	.51661	311	291	602
11	"11-out20098"	.32126	577	1219	1796
11	"11-out20099"	.99390	326	2	328
11	"11-out20100"	.29129	97	236	333
11	"11-out20101"	.99115	336	3	339
11	"11-out20102"	.98470	322	5	327
11	"11-out20103"	.41798	423	589	1012
11	"11-out20104"	.36426	314	548	862
11	"11-out20105"	.56887	223	169	392
11	"11-out20106"	.23673	232	748	980
11	"11-out20107"	.27777	205	533	738
11	"11-out20108"	.38405	318	510	828
11	"11-out20109"	.40166	337	502	839
11	"11-out20110"	.43506	335	435	770
11	"11-out20111"	.39869	244	368	612
11	"11-out20112"	.41458	665	939	1604
11	"11-out20113"	.38142	571	926	1497
11	"11-out20114"	.37799	663	1091	1754
11	"11-out20115"	.94097	542	34	576
11	"11-out20116"	.35201	402	740	1142
11	"11-out20117"	.43847	563	721	1284
11	"11-out20118"	.22021	61	216	277
11	"11-out20119"	.29520	80	191	271
11	"11-out20120"	.36886	353	604	957
11	"11-out20121"	.99193	123	1	124
11	"11-out20122"	.37827	101	166	267
11	"11-out20123"	.45000	45	55	100
11	"11-out20124"	.65671	264	138	402
11	"11-out20125"	.27150	101	271	372
11	"11-out20126"	.40364	155	229	384
11	"11-out20127"	.44887	180	221	401
11	"11-out20128"	.41057	163	234	397
11	"11-out20129"	.31346	284	622	906
11	"11-out20130"	.33788	322	631	953
11	"11-out20131"	.21927	91	324	415
11	"11-out20132"	.39334	201	310	511
11	"11-out20133"	.28431	58	146	204
11	"11-out20134"	.25629	224	650	874
11	"11-out20135"	.89667	781	90	871
11	"11-out20136"	.37559	157	261	418
11	"11-out20137"	.25000	97	291	388
11	"11-out20138"	.39209	129	200	329
11	"11-out20139"	.99456	183	1	184
11	"11-out20140"	.82631	157	33	190
11	"11-out20141"	.44125	169	214	383
11	"11-out20142"	.36158	64	113	177
11	"11-out20143"	.48571	102	108	210
11	"11-out20144"	.29755	219	517	736
11	"11-out20145"	.31034	261	580	841
11	"11-out20146"	.28434	89	224	313
11	"11-out20147"	.44173	163	206	369
11	"11-out20148"	.58333	98	70	168
11	"11-out20149"	.98876	88	1	89
11	"11-out20150"	.37914	80	131	211
11	"11-out20151"	.19266	63	264	327
11	"11-out20152"	.97674	42	1	43
11	"11-out20153"	.99082	108	1	109
11	"11-out20154"	.99082	108	1	109
11	"11-out20155"	.97435	38	1	39
11	"11-out20156"	.97674	42	1	43
11	"11-out20157"	.92890	196	15	211
11	"11-out20158"	.29615	77	183	260
11	"11-out20159"	.84200	437	82	519
11	"11-out20160"	.31961	233	496	729
11	"11-out20161"	.42279	230	314	544
11	"11-out20162"	.42813	140	187	327
11	"11-out20163"	.30612	135	306	441
11	"11-out20164"	.94577	436	25	461
11	"11-out20165"	.50579	393	384	777
11	"11-out20166"	.26250	126	354	480
11	"11-out20167"	.56569	155	119	274
11	"11-out20168"	.78160	204	57	261
11	"11-out20169"	.87564	169	24	193
11	"11-out20170"	.32165	202	426	628
11	"11-out20171"	.58095	61	44	105
11	"11-out20172"	.30666	253	572	825
11	"11-out20173"	.51273	161	153	314
11	"11-out20174"	.46919	99	112	211
11	"11-out20175"	.42044	473	652	1125
11	"11-out20176"	.56737	240	183	423
11	"11-out20177"	.48792	202	212	414
11	"11-out20178"	.53079	181	160	341
11	"11-out20179"	.25970	107	305	412
11	"11-out20180"	.42489	99	134	233
11	"11-out20181"	.39330	94	145	239
11	"11-out20182"	.45591	1391	1660	3051
11	"11-out20183"	.97142	238	7	245
11	"11-out20184"	.35135	91	168	259
11	"11-out20185"	.32444	146	304	450
11	"11-out20186"	.99535	429	2	431
11	"11-out20187"	.49048	232	241	473
11	"11-out20188"	.78378	87	24	111
11	"11-out20189"	.93650	59	4	63
11	"11-out20190"	.86111	62	10	72
11	"11-out20191"	.89622	95	11	106
11	"11-out20192"	.56962	45	34	79
11	"11-out20193"	.87500	112	16	128
11	"11-out20194"	.80314	306	75	381
11	"11-out20195"	.35413	210	383	593
11	"11-out20196"	.21904	391	1394	1785
11	"11-out20197"	.28883	238	586	824
11	"11-out20198"	.99797	493	1	494
11	"11-out20199"	.98611	142	2	144
11	"11-out20200"	.43540	182	236	418
11	"11-out20201"	.45462	1047	1256	2303
11	"11-out20202"	.20202	20	79	99
11	"11-out20203"	.45173	234	284	518
11	"11-out20204"	.41818	46	64	110
11	"11-out20205"	.31693	58	125	183
11	"11-out20206"	.34000	34	66	100
11	"11-out20207"	.34331	172	329	501
11	"11-out20208"	.99715	350	1	351
11	"11-out20209"	.10050	20	179	199
11	"11-out20210"	.31865	246	526	772
11	"11-out20211"	.42676	169	227	396
11	"11-out20212"	.69465	91	40	131
11	"11-out20213"	.99698	331	1	332
11	"11-out20214"	.38731	232	367	599
11	"11-out20215"	.34782	144	270	414
11	"11-out20216"	.39952	167	251	418
11	"11-out20217"	.43551	493	639	1132
11	"11-out20218"	.26960	275	745	1020
11	"11-out20219"	.33722	347	682	1029
11	"11-out20220"	.41461	505	713	1218
11	"11-out20221"	.72277	219	84	303
11	"11-out20222"	.36694	131	226	357
11	"11-out20223"	.29508	360	860	1220
11	"11-out20224"	.25517	74	216	290
11	"11-out20225"	.26994	335	906	1241
11	"11-out20226"	.29488	271	648	919
11	"11-out20227"	.69000	69	31	100
11	"11-out20228"	.31782	82	176	258
11	"11-out20229"	.42424	504	684	1188
11	"11-out20230"	.84698	1024	185	1209
11	"11-out20231"	.99500	199	1	200
11	"11-out20232"	.38530	346	552	898
11	"11-out20233"	.67741	63	30	93
11	"11-out20234"	.20529	31	120	151
11	"11-out20235"	.45291	101	122	223
11	"11-out20236"	.51282	120	114	234
11	"11-out20237"	.48437	62	66	128
11	"11-out20238"	.99074	107	1	108
11	"11-out20239"	.43333	65	85	150
11	"11-out20240"	.35974	168	299	467
11	"11-out20241"	.49242	65	67	132
11	"11-out20242"	.99319	146	1	147
11	"11-out20243"	.99539	216	1	217
11	"11-out20244"	.39039	130	203	333
11	"11-out20245"	.49180	60	62	122
11	"11-out20246"	.45517	66	79	145
11	"11-out20247"	.41454	114	161	275
11	"11-out20248"	.27642	34	89	123
11	"11-out20249"	.16949	40	196	236
11	"11-out20250"	.48253	152	163	315
11	"11-out20251"	.45205	132	160	292
11	"11-out20252"	.63478	73	42	115
11	"11-out20253"	.52564	41	37	78
11	"11-out20254"	.36027	682	1211	1893
11	"11-out20255"	.90316	457	49	506
11	"11-out20256"	.99853	682	1	683
11	"11-out20257"	.32381	658	1374	2032
11	"11-out20258"	.26493	448	1243	1691
11	"11-out20259"	.32098	338	715	1053
11	"11-out20260"	.42830	460	614	1074
11	"11-out20261"	.99775	445	1	446
11	"11-out20262"	.99775	445	1	446
11	"11-out20263"	.99264	135	1	136
11	"11-out20264"	.99750	399	1	400
11	"11-out20265"	.36089	467	827	1294
11	"11-out20266"	.42768	1307	1749	3056
11	"11-out20267"	.24000	78	247	325
11	"11-out20268"	.44252	77	97	174
11	"11-out20269"	.34554	66	125	191
11	"11-out20270"	.37878	25	41	66
11	"11-out20271"	.57236	87	65	152
11	"11-out20272"	.56697	182	139	321
11	"11-out20273"	.38030	224	365	589
11	"11-out20274"	.59808	125	84	209
11	"11-out20275"	.39271	97	150	247
11	"11-out20276"	.31072	284	630	914
11	"11-out20277"	.35772	88	158	246
11	"11-out20278"	.98091	257	5	262
11	"11-out20279"	.71370	177	71	248
11	"11-out20280"	.94117	48	3	51
11	"11-out20281"	.99378	160	1	161
11	"11-out20282"	.36116	199	352	551
11	"11-out20283"	.97101	67	2	69
11	"11-out20284"	.96797	665	22	687
11	"11-out20285"	.92592	100	8	108
11	"11-out20286"	.35928	60	107	167
11	"11-out20287"	.22494	202	696	898
11	"11-out20288"	.50232	108	107	215
11	"11-out20289"	.38647	80	127	207
11	"11-out20290"	.28196	86	219	305
11	"11-out20291"	.28125	63	161	224
11	"11-out20292"	.33482	75	149	224
11	"11-out20293"	.37442	82	137	219
11	"11-out20294"	.86818	191	29	220
11	"11-out20295"	.25684	75	217	292
11	"11-out20296"	.90454	199	21	220
11	"11-out20297"	.45933	96	113	209
11	"11-out20298"	.28899	63	155	218
11	"11-out20299"	.65402	138	73	211
11	"11-out20300"	.61751	134	83	217
11	"11-out20301"	.50819	310	300	610
11	"11-out20302"	.26585	109	301	410
11	"11-out20303"	.35372	370	676	1046
11	"11-out20304"	.36595	258	447	705
11	"11-out20305"	.76753	383	116	499
11	"11-out20306"	.72909	218	81	299
11	"11-out20307"	.35528	356	646	1002
11	"11-out20308"	.73059	320	118	438
11	"11-out20309"	.55627	173	138	311
11	"11-out20310"	.29206	335	812	1147
11	"11-out20311"	.34469	91	173	264
11	"11-out20312"	.28461	74	186	260
11	"11-out20313"	.29411	50	120	170
11	"11-out20314"	.83756	165	32	197
11	"11-out20315"	.99767	430	1	431
11	"11-out20316"	.50810	94	91	185
11	"11-out20317"	.33510	126	250	376
11	"11-out20318"	.31818	126	270	396
11	"11-out20319"	.99622	264	1	265
11	"11-out20320"	.99371	158	1	159
11	"11-out20321"	.99507	202	1	203
11	"11-out20322"	.79740	307	78	385
11	"11-out20323"	.28855	58	143	201
11	"11-out20324"	.28297	118	299	417
11	"11-out20325"	.26605	116	320	436
11	"11-out20326"	.24705	105	320	425
11	"11-out20327"	.63505	529	304	833
11	"11-out20328"	.71280	206	83	289
11	"11-out20329"	.49528	473	482	955
11	"11-out20330"	.99300	142	1	143
11	"11-out20331"	.46621	138	158	296
11	"11-out20332"	.99746	394	1	395
11	"11-out20333"	.99575	704	3	707
11	"11-out20334"	.99746	394	1	395
11	"11-out20335"	.35379	98	179	277
11	"11-out20336"	.42434	488	662	1150
11	"11-out20337"	.41836	41	57	98
11	"11-out20338"	.29035	268	655	923
11	"11-out20339"	.53110	333	294	627
11	"11-out20340"	.72807	498	186	684
11	"11-out20341"	.31616	178	385	563
11	"11-out20342"	.42156	129	177	306
11	"11-out20343"	.38383	38	61	99
11	"11-out20344"	.39634	260	396	656
11	"11-out20345"	.55555	55	44	99
11	"11-out20346"	.66780	195	97	292
11	"11-out20347"	.30000	123	287	410
11	"11-out20348"	.39923	210	316	526
11	"11-out20349"	.32394	115	240	355
11	"11-out20350"	.72423	260	99	359
11	"11-out20351"	.51955	372	344	716
11	"11-out20352"	.98684	75	1	76
11	"11-out20353"	.85156	1222	213	1435
11	"11-out20354"	.65191	442	236	678
11	"11-out20355"	.60353	239	157	396
11	"11-out20356"	.65873	83	43	126
11	"11-out20357"	.99200	124	1	125
11	"11-out20358"	.42237	838	1146	1984
11	"11-out20359"	.45704	266	316	582
11	"11-out20360"	.30279	238	548	786
11	"11-out20361"	.99521	208	1	209
11	"11-out20362"	.28476	43	108	151
11	"11-out20363"	.43963	193	246	439
11	"11-out20364"	.64953	139	75	214
11	"11-out20365"	.38321	274	441	715
11	"11-out20366"	.99572	233	1	234
11	"11-out20367"	.99502	200	1	201
11	"11-out20368"	.88554	441	57	498
11	"11-out20369"	.99746	394	1	395
11	"11-out20370"	.95973	429	18	447
11	"11-out20371"	.99640	277	1	278
11	"11-out20372"	.73228	186	68	254
11	"11-out20373"	.98913	91	1	92
11	"11-out20374"	.99905	1062	1	1063
11	"11-out20375"	.47107	114	128	242
11	"11-out20376"	.66808	157	78	235
11	"11-out20377"	.99735	377	1	378
11	"11-out20378"	.57015	321	242	563
11	"11-out20379"	.99009	100	1	101
11	"11-out20380"	.71731	203	80	283
11	"11-out20381"	.35814	409	733	1142
11	"11-out20382"	.48059	161	174	335
11	"11-out20383"	.72340	68	26	94
11	"11-out20384"	.97826	90	2	92
11	"11-out20385"	.50132	189	188	377
11	"11-out20386"	.53117	443	391	834
11	"11-out20387"	.49418	170	174	344
11	"11-out20388"	.45125	162	197	359
11	"11-out20389"	.38652	109	173	282
11	"11-out20390"	.55892	166	131	297
11	"11-out20391"	.40088	182	272	454
11	"11-out20392"	.45970	348	409	757
11	"11-out20393"	.49235	161	166	327
11	"11-out20394"	.41543	140	197	337
11	"11-out20395"	.39104	131	204	335
11	"11-out20396"	.92384	461	38	499
11	"11-out20397"	.41486	134	189	323
11	"11-out20398"	.98823	84	1	85
11	"11-out20399"	.79637	395	101	496
11	"11-out20400"	.99815	540	1	541
11	"11-out20401"	.31650	326	704	1030
11	"11-out20402"	.43678	38	49	87
11	"11-out20403"	.33846	44	86	130
11	"11-out20404"	.55160	155	126	281
11	"11-out20405"	.42268	205	280	485
11	"11-out20406"	.98515	929	14	943
11	"11-out20407"	.48964	402	419	821
11	"11-out20408"	.55902	161	127	288
11	"11-out20409"	.55932	99	78	177
11	"11-out20410"	.40697	70	102	172
11	"11-out20411"	.91061	489	48	537
11	"11-out20412"	.35699	176	317	493
12	"12-out1"	.98117	417	8	425
12	"12-out2"	.99845	648	1	649
12	"12-out3"	.36127	125	221	346
12	"12-out4"	.45480	161	193	354
12	"12-out5"	.44814	121	149	270
12	"12-out6"	.39940	135	203	338
12	"12-out7"	.82077	632	138	770
12	"12-out8"	.38253	241	389	630
12	"12-out9"	.43048	161	213	374
12	"12-out10"	.38925	761	1194	1955
12	"12-out11"	.98501	789	12	801
12	"12-out12"	.33050	1090	2208	3298
12	"12-out13"	.29594	343	816	1159
12	"12-out14"	.33480	380	755	1135
12	"12-out15"	.88407	816	107	923
12	"12-out16"	.88374	821	108	929
12	"12-out17"	.31181	314	693	1007
12	"12-out18"	.26906	254	690	944
12	"12-out19"	.86143	802	129	931
12	"12-out20"	.88197	822	110	932
12	"12-out21"	.34855	542	1013	1555
12	"12-out22"	.43895	151	193	344
12	"12-out23"	.21200	53	197	250
12	"12-out24"	.44959	223	273	496
12	"12-out25"	.54904	431	354	785
12	"12-out26"	.77307	201	59	260
12	"12-out27"	.84370	637	118	755
12	"12-out28"	.34778	337	632	969
12	"12-out29"	.34959	129	240	369
12	"12-out30"	.25909	527	1507	2034
12	"12-out31"	.41979	492	680	1172
12	"12-out32"	.36033	129	229	358
12	"12-out33"	.99652	287	1	288
12	"12-out34"	.99709	343	1	344
12	"12-out35"	.76096	347	109	456
12	"12-out36"	.69300	614	272	886
12	"12-out37"	.75878	648	206	854
12	"12-out38"	.44871	385	473	858
12	"12-out39"	.31378	107	234	341
12	"12-out40"	.48623	212	224	436
12	"12-out41"	.18131	66	298	364
12	"12-out42"	.42118	171	235	406
12	"12-out43"	.74100	412	144	556
12	"12-out44"	.43544	199	258	457
12	"12-out45"	.80547	265	64	329
12	"12-out46"	.91240	802	77	879
12	"12-out47"	.20856	112	425	537
12	"12-out48"	.65989	520	268	788
12	"12-out49"	.29699	79	187	266
12	"12-out50"	.73744	323	115	438
12	"12-out51"	.79729	295	75	370
12	"12-out52"	.99682	314	1	315
12	"12-out53"	.36585	225	390	615
12	"12-out54"	.27743	182	474	656
12	"12-out55"	.38191	283	458	741
12	"12-out56"	.61477	391	245	636
12	"12-out57"	.38962	323	506	829
12	"12-out58"	.60165	290	192	482
12	"12-out59"	.47831	386	421	807
12	"12-out60"	.38955	291	456	747
12	"12-out61"	.48630	142	150	292
12	"12-out62"	.39166	188	292	480
12	"12-out63"	.35400	314	573	887
12	"12-out64"	.37022	920	1565	2485
12	"12-out65"	.31929	379	808	1187
12	"12-out66"	.23871	201	641	842
12	"12-out67"	.42182	375	514	889
12	"12-out68"	.30804	134	301	435
12	"12-out69"	.51920	419	388	807
12	"12-out70"	.31540	516	1120	1636
12	"12-out71"	.86024	357	58	415
12	"12-out72"	.25958	237	676	913
12	"12-out73"	.56764	193	147	340
12	"12-out74"	.58593	75	53	128
12	"12-out75"	.32605	194	401	595
12	"12-out76"	.88594	668	86	754
12	"12-out77"	.51133	519	496	1015
12	"12-out78"	.30423	244	558	802
12	"12-out79"	.30846	616	1381	1997
12	"12-out80"	.46094	602	704	1306
12	"12-out81"	.31672	604	1303	1907
12	"12-out82"	.61704	688	427	1115
12	"12-out83"	.21831	317	1135	1452
12	"12-out84"	.99836	611	1	612
12	"12-out85"	.38202	34	55	89
12	"12-out86"	.37966	549	897	1446
12	"12-out87"	.42656	395	531	926
12	"12-out88"	.36764	50	86	136
12	"12-out89"	.21942	61	217	278
12	"12-out90"	.27160	154	413	567
12	"12-out91"	.99763	422	1	423
12	"12-out92"	.99888	896	1	897
12	"12-out93"	.52981	231	205	436
12	"12-out94"	.66111	119	61	180
12	"12-out95"	.99705	338	1	339
12	"12-out96"	.54966	249	204	453
12	"12-out97"	.39053	132	206	338
12	"12-out98"	.56880	959	727	1686
12	"12-out99"	.95737	292	13	305
12	"12-out100"	.40823	218	316	534
12	"12-out101"	.41911	228	316	544
12	"12-out102"	.35623	140	253	393
12	"12-out103"	.40608	227	332	559
12	"12-out104"	.99164	356	3	359
12	"12-out105"	.37037	70	119	189
12	"12-out106"	.28077	333	853	1186
12	"12-out107"	.56426	180	139	319
12	"12-out108"	.82096	188	41	229
12	"12-out109"	.99567	230	1	231
12	"12-out110"	.33778	253	496	749
12	"12-out111"	.45471	246	295	541
12	"12-out112"	.54225	77	65	142
12	"12-out113"	.32142	54	114	168
12	"12-out114"	.96969	160	5	165
12	"12-out115"	.96756	358	12	370
12	"12-out116"	.22613	405	1386	1791
12	"12-out117"	.34690	213	401	614
12	"12-out118"	.99897	975	1	976
12	"12-out119"	.43071	230	304	534
12	"12-out120"	.30252	72	166	238
12	"12-out121"	.99804	1023	2	1025
12	"12-out122"	.24940	104	313	417
12	"12-out123"	.44607	91	113	204
12	"12-out124"	.62337	240	145	385
12	"12-out125"	.33236	115	231	346
12	"12-out126"	.40521	171	251	422
12	"12-out127"	.31935	99	211	310
12	"12-out128"	.37965	489	799	1288
12	"12-out129"	.85729	799	133	932
12	"12-out130"	.27087	146	393	539
12	"12-out131"	.17344	162	772	934
12	"12-out132"	.90295	856	92	948
12	"12-out133"	.55233	591	479	1070
12	"12-out134"	.88292	822	109	931
12	"12-out135"	.42047	193	266	459
12	"12-out136"	.88412	824	108	932
12	"12-out137"	.90000	855	95	950
12	"12-out138"	.90526	860	90	950
12	"12-out139"	.36679	95	164	259
12	"12-out140"	.96000	336	14	350
12	"12-out141"	.71759	310	122	432
12	"12-out142"	.34869	1793	3349	5142
12	"12-out143"	.76628	200	61	261
12	"12-out144"	.62903	39	23	62
12	"12-out145"	.19153	86	363	449
12	"12-out146"	.99065	106	1	107
12	"12-out147"	.30053	559	1301	1860
12	"12-out148"	.59400	218	149	367
12	"12-out149"	.28961	678	1663	2341
12	"12-out150"	.38303	149	240	389
12	"12-out151"	.53301	113	99	212
12	"12-out152"	.32477	253	526	779
12	"12-out153"	.65979	320	165	485
12	"12-out154"	.37799	268	441	709
12	"12-out155"	.38469	362	579	941
12	"12-out156"	.36722	419	722	1141
12	"12-out157"	.45643	220	262	482
12	"12-out158"	.17555	79	371	450
12	"12-out159"	.34347	926	1770	2696
12	"12-out160"	.37535	131	218	349
12	"12-out161"	.57428	201	149	350
12	"12-out162"	.99593	245	1	246
12	"12-out163"	.47812	153	167	320
12	"12-out164"	.98684	75	1	76
12	"12-out165"	.36625	330	571	901
12	"12-out166"	.25617	114	331	445
12	"12-out167"	.46996	266	300	566
12	"12-out168"	.39730	265	402	667
12	"12-out169"	.77853	573	163	736
12	"12-out170"	.88235	90	12	102
12	"12-out171"	.70212	198	84	282
12	"12-out172"	.44631	424	526	950
12	"12-out173"	.38392	215	345	560
12	"12-out174"	.30297	153	352	505
12	"12-out175"	.47608	219	241	460
12	"12-out176"	.40347	395	584	979
12	"12-out177"	.36030	423	751	1174
12	"12-out178"	.22556	60	206	266
12	"12-out179"	.20512	64	248	312
12	"12-out180"	.97297	36	1	37
12	"12-out181"	.53023	491	435	926
12	"12-out182"	.38230	216	349	565
12	"12-out183"	.30833	111	249	360
12	"12-out184"	.44856	266	327	593
12	"12-out185"	.27000	27	73	100
12	"12-out186"	.99328	148	1	149
12	"12-out187"	.78037	167	47	214
12	"12-out188"	.39820	133	201	334
12	"12-out189"	.33439	105	209	314
12	"12-out190"	.32122	115	243	358
12	"12-out191"	.31833	460	985	1445
12	"12-out192"	.31712	424	913	1337
12	"12-out193"	.80620	1610	387	1997
12	"12-out194"	.39878	262	395	657
12	"12-out195"	.35472	691	1257	1948
12	"12-out196"	.48437	62	66	128
12	"12-out197"	.59692	194	131	325
12	"12-out198"	.28472	82	206	288
12	"12-out199"	.39611	917	1398	2315
12	"12-out200"	.35494	104	189	293
12	"12-out201"	.66896	97	48	145
12	"12-out202"	.32103	87	184	271
12	"12-out203"	.25882	110	315	425
12	"12-out204"	.48994	195	203	398
12	"12-out205"	.96588	1076	38	1114
12	"12-out206"	.99532	213	1	214
12	"12-out207"	.42415	151	205	356
12	"12-out208"	.46875	165	187	352
12	"12-out209"	.27683	98	256	354
12	"12-out210"	.62982	245	144	389
12	"12-out211"	.99766	427	1	428
12	"12-out212"	.99903	1034	1	1035
12	"12-out213"	.35458	178	324	502
12	"12-out214"	.34460	163	310	473
12	"12-out215"	.44837	456	561	1017
12	"12-out216"	.99641	278	1	279
12	"12-out217"	.99641	278	1	279
12	"12-out218"	.97029	196	6	202
12	"12-out219"	.99285	139	1	140
12	"12-out220"	.99630	270	1	271
12	"12-out221"	.22133	139	489	628
12	"12-out222"	.45454	210	252	462
12	"12-out223"	.96565	478	17	495
12	"12-out224"	.47478	113	125	238
12	"12-out225"	.51888	316	293	609
12	"12-out226"	.77333	290	85	375
12	"12-out227"	.92116	222	19	241
12	"12-out228"	.33055	198	401	599
12	"12-out229"	.21733	178	641	819
12	"12-out230"	.37039	673	1144	1817
12	"12-out231"	.97196	312	9	321
12	"12-out232"	.62222	196	119	315
12	"12-out233"	.96308	287	11	298
12	"12-out234"	.90251	287	31	318
12	"12-out235"	.96507	304	11	315
12	"12-out236"	.95527	299	14	313
12	"12-out237"	.99680	312	1	313
12	"12-out238"	.33333	108	216	324
12	"12-out239"	.95031	306	16	322
12	"12-out240"	.57366	183	136	319
12	"12-out241"	.98697	303	4	307
12	"12-out242"	.71521	221	88	309
12	"12-out243"	.91585	283	26	309
12	"12-out244"	.97315	290	8	298
12	"12-out245"	.99695	327	1	328
12	"12-out246"	.48874	152	159	311
12	"12-out247"	.57278	181	135	316
12	"12-out248"	.50322	156	154	310
12	"12-out249"	.49691	161	163	324
12	"12-out250"	.50828	184	178	362
12	"12-out251"	.99032	307	3	310
12	"12-out252"	.99680	312	1	313
12	"12-out253"	.98717	308	4	312
12	"12-out254"	.99679	311	1	312
12	"12-out255"	.99358	310	2	312
12	"12-out256"	.97115	303	9	312
12	"12-out257"	.99358	310	2	312
12	"12-out258"	.99038	309	3	312
12	"12-out259"	.97935	332	7	339
12	"12-out260"	.99013	301	3	304
12	"12-out261"	.45261	277	335	612
12	"12-out262"	.46245	117	136	253
12	"12-out263"	.36000	90	160	250
12	"12-out264"	.99725	363	1	364
12	"12-out265"	.99725	363	1	364
12	"12-out266"	.31454	106	231	337
12	"12-out267"	.31000	217	483	700
12	"12-out268"	.79887	568	143	711
12	"12-out269"	.64441	444	245	689
12	"12-out270"	.55516	156	125	281
12	"12-out271"	.37698	95	157	252
12	"12-out272"	.99007	399	4	403
12	"12-out273"	.35816	125	224	349
12	"12-out274"	.67073	220	108	328
12	"12-out275"	.84732	111	20	131
12	"12-out276"	.97152	580	17	597
12	"12-out277"	.70420	619	260	879
12	"12-out278"	.41095	270	387	657
12	"12-out279"	.54463	421	352	773
12	"12-out280"	.55347	207	167	374
12	"12-out281"	.97995	1320	27	1347
12	"12-out282"	.99925	1339	1	1340
12	"12-out283"	.37307	388	652	1040
12	"12-out284"	.29898	354	830	1184
12	"12-out285"	.52357	211	192	403
12	"12-out286"	.30000	129	301	430
12	"12-out287"	.46703	340	388	728
12	"12-out288"	.38066	437	711	1148
12	"12-out289"	.88482	822	107	929
12	"12-out290"	.88299	815	108	923
12	"12-out291"	.88494	823	107	930
12	"12-out292"	.23468	226	737	963
12	"12-out293"	.68376	640	296	936
12	"12-out294"	.32012	396	841	1237
12	"12-out295"	.89114	835	102	937
12	"12-out296"	.86736	824	126	950
12	"12-out297"	.34297	83	159	242
12	"12-out298"	.33922	211	411	622
12	"12-out299"	.56786	205	156	361
12	"12-out300"	.99438	177	1	178
12	"12-out301"	.25000	34	102	136
12	"12-out302"	.27327	135	359	494
12	"12-out303"	.37362	102	171	273
12	"12-out304"	.51392	203	192	395
12	"12-out305"	.27292	128	341	469
12	"12-out306"	.34405	321	612	933
12	"12-out307"	.96000	120	5	125
12	"12-out308"	.99476	190	1	191
12	"12-out309"	.31716	170	366	536
12	"12-out310"	.74273	179	62	241
12	"12-out311"	.51404	366	346	712
12	"12-out312"	.42398	343	466	809
12	"12-out313"	.44874	499	613	1112
12	"12-out314"	.41375	343	486	829
12	"12-out315"	.38192	338	547	885
12	"12-out316"	.25675	95	275	370
12	"12-out317"	.22666	34	116	150
12	"12-out318"	.39810	84	127	211
12	"12-out319"	.44180	186	235	421
12	"12-out320"	.98019	495	10	505
12	"12-out321"	.41908	101	140	241
12	"12-out322"	.27272	111	296	407
12	"12-out323"	.34848	115	215	330
12	"12-out324"	.52516	313	283	596
12	"12-out325"	.99494	394	2	396
12	"12-out326"	.27777	45	117	162
12	"12-out327"	.25641	80	232	312
12	"12-out328"	.42125	107	147	254
12	"12-out329"	.98711	383	5	388
12	"12-out330"	.35492	252	458	710
12	"12-out331"	.33762	131	257	388
12	"12-out332"	.42974	367	487	854
12	"12-out333"	.80740	109	26	135
12	"12-out334"	.56361	412	319	731
12	"12-out335"	.35763	103	185	288
12	"12-out336"	.22641	84	287	371
12	"12-out337"	.99245	789	6	795
12	"12-out338"	.98740	784	10	794
12	"12-out339"	.98364	782	13	795
12	"12-out340"	.88342	826	109	935
12	"12-out341"	.98422	936	15	951
12	"12-out342"	.99182	728	6	734
12	"12-out343"	.33573	979	1937	2916
12	"12-out344"	.89757	850	97	947
12	"12-out345"	.89263	848	102	950
12	"12-out346"	.88412	824	108	932
12	"12-out347"	.88461	828	108	936
12	"12-out348"	.45542	189	226	415
12	"12-out349"	.42196	292	400	692
12	"12-out350"	.31211	667	1470	2137
12	"12-out351"	.32475	164	341	505
12	"12-out352"	.26896	78	212	290
12	"12-out353"	.39832	143	216	359
12	"12-out354"	.61290	532	336	868
12	"12-out355"	.16748	102	507	609
12	"12-out356"	.40373	216	319	535
12	"12-out357"	.36105	165	292	457
12	"12-out358"	.99581	238	1	239
12	"12-out359"	.36820	271	465	736
12	"12-out360"	.41714	365	510	875
12	"12-out361"	.44534	383	477	860
12	"12-out362"	.24657	144	440	584
12	"12-out363"	.27559	140	368	508
12	"12-out364"	.40909	144	208	352
12	"12-out365"	.27045	119	321	440
12	"12-out366"	.47619	40	44	84
12	"12-out367"	.33081	175	354	529
12	"12-out368"	.26315	35	98	133
12	"12-out369"	.73498	208	75	283
12	"12-out370"	.99786	468	1	469
12	"12-out371"	.91428	128	12	140
12	"12-out372"	.33110	940	1899	2839
12	"12-out373"	.99884	865	1	866
12	"12-out374"	.57411	825	612	1437
12	"12-out375"	.59497	379	258	637
12	"12-out376"	.34231	724	1391	2115
12	"12-out377"	.88461	207	27	234
12	"12-out378"	.70980	181	74	255
12	"12-out379"	.59386	155	106	261
12	"12-out380"	.80368	262	64	326
12	"12-out381"	.48466	158	168	326
12	"12-out382"	.59210	225	155	380
12	"12-out383"	.50583	130	127	257
12	"12-out384"	.33928	133	259	392
12	"12-out385"	.25083	75	224	299
12	"12-out386"	.35125	98	181	279
12	"12-out387"	.35826	91	163	254
12	"12-out388"	.23846	31	99	130
12	"12-out389"	.50574	176	172	348
12	"12-out390"	.46884	158	179	337
12	"12-out391"	.97260	71	2	73
12	"12-out392"	.44444	36	45	81
12	"12-out393"	.34502	118	224	342
12	"12-out394"	.52487	211	191	402
12	"12-out395"	.99725	363	1	364
12	"12-out396"	.57438	305	226	531
12	"12-out397"	.39359	209	322	531
12	"12-out398"	.36413	201	351	552
12	"12-out399"	.30684	444	1003	1447
12	"12-out400"	.98863	87	1	88
12	"12-out401"	.45481	156	187	343
12	"12-out402"	.31308	134	294	428
12	"12-out403"	.45714	144	171	315
12	"12-out404"	.38480	309	494	803
12	"12-out405"	.31015	339	754	1093
12	"12-out406"	.33101	238	481	719
12	"12-out407"	.33246	128	257	385
12	"12-out408"	.71578	68	27	95
12	"12-out409"	.40803	264	383	647
12	"12-out410"	.48297	780	835	1615
12	"12-out411"	.62637	57	34	91
12	"12-out412"	.62886	61	36	97
12	"12-out413"	.37662	87	144	231
12	"12-out414"	.99107	111	1	112
12	"12-out415"	.99145	116	1	117
12	"12-out416"	.43272	788	1033	1821
12	"12-out417"	.55704	332	264	596
12	"12-out418"	.33229	107	215	322
12	"12-out419"	.83783	124	24	148
12	"12-out420"	.37407	453	758	1211
12	"12-out421"	.49614	193	196	389
12	"12-out422"	.99280	138	1	139
12	"12-out423"	.26744	46	126	172
12	"12-out424"	.60030	392	261	653
12	"12-out425"	.64615	210	115	325
12	"12-out426"	.66487	248	125	373
12	"12-out427"	.74608	238	81	319
12	"12-out428"	.85269	301	52	353
12	"12-out429"	.31372	80	175	255
12	"12-out430"	.35807	1264	2266	3530
12	"12-out431"	.70397	1365	574	1939
12	"12-out432"	.78184	1516	423	1939
12	"12-out433"	.47400	766	850	1616
12	"12-out434"	.31543	423	918	1341
12	"12-out435"	.35204	897	1651	2548
12	"12-out436"	.37662	58	96	154
12	"12-out437"	.99935	1561	1	1562
12	"12-out438"	.27448	199	526	725
12	"12-out439"	.59763	101	68	169
12	"12-out440"	.47552	136	150	286
12	"12-out441"	.32651	431	889	1320
12	"12-out442"	.84419	829	153	982
12	"12-out443"	.26203	185	521	706
12	"12-out444"	.99686	636	2	638
12	"12-out445"	.99762	420	1	421
12	"12-out446"	.99768	863	2	865
12	"12-out447"	.99701	668	2	670
12	"12-out448"	.37642	198	328	526
12	"12-out449"	.25240	184	545	729
12	"12-out450"	.16248	110	567	677
12	"12-out451"	.46393	3094	3575	6669
12	"12-out452"	.47222	51	57	108
12	"12-out453"	.34912	280	522	802
12	"12-out454"	.99922	1287	1	1288
12	"12-out455"	.40796	164	238	402
12	"12-out456"	.48108	178	192	370
12	"12-out457"	.13218	46	302	348
12	"12-out458"	.25000	83	249	332
12	"12-out459"	.77243	241	71	312
12	"12-out460"	.99679	311	1	312
12	"12-out461"	.97133	305	9	314
12	"12-out462"	.99071	320	3	323
12	"12-out463"	.99416	341	2	343
12	"12-out464"	.73717	230	82	312
12	"12-out465"	.97756	305	7	312
12	"12-out466"	.46388	167	193	360
12	"12-out467"	.89067	277	34	311
12	"12-out468"	.89337	310	37	347
12	"12-out469"	.47588	148	163	311
12	"12-out470"	.56363	186	144	330
12	"12-out471"	.94968	302	16	318
12	"12-out472"	.79421	247	64	311
12	"12-out473"	.63305	226	131	357
12	"12-out474"	.95833	299	13	312
12	"12-out475"	.49842	158	159	317
12	"12-out476"	.96794	302	10	312
12	"12-out477"	.45000	144	176	320
12	"12-out478"	.97402	300	8	308
12	"12-out479"	.50606	167	163	330
12	"12-out480"	.99053	314	3	317
12	"12-out481"	.45954	142	167	309
12	"12-out482"	.82594	261	55	316
12	"12-out483"	.96518	305	11	316
12	"12-out484"	.89423	279	33	312
12	"12-out485"	.57391	198	147	345
12	"12-out486"	.94230	294	18	312
12	"12-out487"	.93269	291	21	312
12	"12-out488"	.97756	305	7	312
12	"12-out489"	.96829	336	11	347
12	"12-out490"	.46623	145	166	311
12	"12-out491"	.94551	295	17	312
12	"12-out492"	.70846	226	93	319
12	"12-out493"	.49593	183	186	369
12	"12-out494"	.93390	325	23	348
12	"12-out495"	.57142	176	132	308
12	"12-out496"	.95129	293	15	308
12	"12-out497"	.99687	319	1	320
12	"12-out498"	.97169	309	9	318
12	"12-out499"	.99425	346	2	348
12	"12-out500"	.98996	296	3	299
12	"12-out501"	.73178	221	81	302
12	"12-out502"	.98159	320	6	326
12	"12-out503"	.64193	199	111	310
12	"12-out504"	.97734	302	7	309
12	"12-out505"	.65806	204	106	310
12	"12-out506"	.88853	279	35	314
12	"12-out507"	.68471	215	99	314
12	"12-out508"	.62500	195	117	312
12	"12-out509"	.99044	311	3	314
12	"12-out510"	.96264	335	13	348
12	"12-out511"	.94230	294	18	312
12	"12-out512"	.99680	312	1	313
12	"12-out513"	.97151	307	9	316
12	"12-out514"	.77272	238	70	308
12	"12-out515"	.98713	307	4	311
12	"12-out516"	.46349	146	169	315
12	"12-out517"	.98407	309	5	314
12	"12-out518"	.58598	184	130	314
12	"12-out519"	.59235	186	128	314
12	"12-out520"	.88178	276	37	313
12	"12-out521"	.97770	307	7	314
12	"12-out522"	.77388	243	71	314
12	"12-out523"	.60828	191	123	314
12	"12-out524"	.78504	252	69	321
12	"12-out525"	.76323	245	76	321
12	"12-out526"	.91205	280	27	307
12	"12-out527"	.89710	279	32	311
12	"12-out528"	.64262	196	109	305
12	"12-out529"	.64951	202	109	311
12	"12-out530"	.48765	158	166	324
12	"12-out531"	.92944	303	23	326
12	"12-out532"	.98235	334	6	340
12	"12-out533"	.42765	133	178	311
12	"12-out534"	.91666	286	26	312
12	"12-out535"	.99358	310	2	312
12	"12-out536"	.99352	307	2	309
12	"12-out537"	.99711	346	1	347
12	"12-out538"	.57099	189	142	331
12	"12-out539"	.48076	150	162	312
12	"12-out540"	.48264	153	164	317
12	"12-out541"	.36538	114	198	312
12	"12-out542"	.84952	271	48	319
12	"12-out543"	.92233	285	24	309
12	"12-out544"	.96153	300	12	312
12	"12-out545"	.97749	304	7	311
12	"12-out546"	.97435	304	8	312
12	"12-out547"	.97741	303	7	310
12	"12-out548"	.97749	304	7	311
12	"12-out549"	.88607	280	36	316
12	"12-out550"	.51940	174	161	335
12	"12-out551"	.54838	170	140	310
12	"12-out552"	.80254	252	62	314
12	"12-out553"	.50169	148	147	295
12	"12-out554"	.81891	303	67	370
12	"12-out555"	.18499	143	630	773
12	"12-out556"	.35176	159	293	452
12	"12-out557"	.24489	96	296	392
12	"12-out558"	.44496	283	353	636
12	"12-out559"	.36248	315	554	869
12	"12-out560"	.35610	318	575	893
12	"12-out561"	.41810	194	270	464
12	"12-out562"	.99074	107	1	108
12	"12-out563"	.45479	845	1013	1858
12	"12-out564"	.31701	123	265	388
12	"12-out565"	.35073	504	933	1437
12	"12-out566"	.98678	2315	31	2346
12	"12-out567"	.41304	76	108	184
12	"12-out568"	.21568	154	560	714
12	"12-out569"	.36552	405	703	1108
12	"12-out570"	.45183	835	1013	1848
12	"12-out571"	.67998	1413	665	2078
12	"12-out572"	.50617	123	120	243
12	"12-out573"	.46374	275	318	593
12	"12-out574"	.19211	39	164	203
12	"12-out575"	.42923	279	371	650
12	"12-out576"	.72467	279	106	385
12	"12-out577"	.54471	201	168	369
12	"12-out578"	.30154	117	271	388
12	"12-out579"	.94628	229	13	242
12	"12-out580"	.99725	363	1	364
12	"12-out581"	.59618	344	233	577
12	"12-out582"	.73139	226	83	309
12	"12-out583"	.82524	255	54	309
12	"12-out584"	.99678	310	1	311
12	"12-out585"	.98219	331	6	337
12	"12-out586"	.63258	198	115	313
12	"12-out587"	.51267	182	173	355
12	"12-out588"	.65527	211	111	322
12	"12-out589"	.49840	156	157	313
12	"12-out590"	.56645	179	137	316
12	"12-out591"	.55016	170	139	309
12	"12-out592"	.98387	305	5	310
12	"12-out593"	.98387	305	5	310
12	"12-out594"	.49038	153	159	312
12	"12-out595"	.96474	301	11	312
12	"12-out596"	.38125	122	198	320
12	"12-out597"	.46178	145	169	314
12	"12-out598"	.42675	134	180	314
12	"12-out599"	.70793	223	92	315
12	"12-out600"	.81619	262	59	321
12	"12-out601"	.85852	267	44	311
12	"12-out602"	.94426	288	17	305
12	"12-out603"	.97039	295	9	304
12	"12-out604"	.99361	311	2	313
12	"12-out605"	.94230	294	18	312
12	"12-out606"	.60983	186	119	305
12	"12-out607"	.56105	170	133	303
12	"12-out608"	.48148	156	168	324
12	"12-out609"	.99676	308	1	309
12	"12-out610"	.96496	303	11	314
12	"12-out611"	.57281	177	132	309
12	"12-out612"	.35937	115	205	320
12	"12-out613"	.54140	170	144	314
12	"12-out614"	.97256	319	9	328
12	"12-out615"	.99050	313	3	316
12	"12-out616"	.45171	145	176	321
12	"12-out617"	.50322	156	154	310
12	"12-out618"	.50458	165	162	327
12	"12-out619"	.91540	303	28	331
12	"12-out620"	.98713	307	4	311
12	"12-out621"	.48051	148	160	308
12	"12-out622"	.58017	199	144	343
12	"12-out623"	.61661	193	120	313
12	"12-out624"	.43504	144	187	331
12	"12-out625"	.53993	169	144	313
12	"12-out626"	.82758	264	55	319
12	"12-out627"	.97115	303	9	312
12	"12-out628"	.97444	305	8	313
12	"12-out629"	.50809	157	152	309
12	"12-out630"	.71704	223	88	311
12	"12-out631"	.58766	181	127	308
12	"12-out632"	.59163	184	127	311
12	"12-out633"	.96507	304	11	315
12	"12-out634"	.52564	164	148	312
12	"12-out635"	.39554	142	217	359
12	"12-out636"	.76375	236	73	309
12	"12-out637"	.90614	280	29	309
12	"12-out638"	.68471	215	99	314
12	"12-out639"	.52293	171	156	327
12	"12-out640"	.78360	239	66	305
12	"12-out641"	.60828	191	123	314
12	"12-out642"	.44094	112	142	254
12	"12-out643"	.34262	295	566	861
12	"12-out644"	.63787	192	109	301
12	"12-out645"	.99019	101	1	102
12	"12-out646"	.22893	125	421	546
12	"12-out647"	.42937	307	408	715
12	"12-out648"	.46374	307	355	662
12	"12-out649"	.50144	174	173	347
12	"12-out650"	.36310	435	763	1198
12	"12-out651"	.33806	238	466	704
12	"12-out652"	.48269	265	284	549
12	"12-out653"	.47104	366	411	777
12	"12-out654"	.35401	251	458	709
12	"12-out655"	.30919	111	248	359
12	"12-out656"	.30139	151	350	501
12	"12-out657"	.99567	230	1	231
12	"12-out658"	.91897	930	82	1012
12	"12-out659"	.35011	313	581	894
12	"12-out660"	.40285	141	209	350
12	"12-out661"	.41458	432	610	1042
12	"12-out662"	.43641	326	421	747
12	"12-out663"	.37716	479	791	1270
12	"12-out664"	.71102	187	76	263
12	"12-out665"	.36732	371	639	1010
12	"12-out666"	.74169	402	140	542
12	"12-out667"	.49778	337	340	677
12	"12-out668"	.90233	4943	535	5478
12	"12-out669"	.41015	210	302	512
12	"12-out670"	.54323	245	206	451
12	"12-out671"	.98152	14239	268	14507
12	"12-out672"	.86890	3904	589	4493
12	"12-out673"	.33436	216	430	646
12	"12-out674"	.99988	8383	1	8384
12	"12-out675"	.83107	1043	212	1255
12	"12-out676"	.80212	454	112	566
12	"12-out677"	.99943	1772	1	1773
12	"12-out678"	.73392	3801	1378	5179
12	"12-out679"	.98985	2147	22	2169
12	"12-out680"	.99310	5615	39	5654
12	"12-out681"	.75066	283	94	377
12	"12-out682"	.73563	192	69	261
12	"12-out683"	.45555	41	49	90
12	"12-out684"	.52998	274	243	517
12	"12-out685"	.20733	113	432	545
12	"12-out686"	.27380	69	183	252
12	"12-out687"	.58531	295	209	504
12	"12-out688"	.85020	420	74	494
12	"12-out689"	.39240	62	96	158
12	"12-out690"	.77653	139	40	179
12	"12-out691"	.41843	59	82	141
12	"12-out692"	.44347	153	192	345
12	"12-out693"	.98969	96	1	97
12	"12-out694"	.30813	318	714	1032
12	"12-out695"	.34408	288	549	837
12	"12-out696"	.97977	533	11	544
12	"12-out697"	.31791	110	236	346
12	"12-out698"	.86135	497	80	577
12	"12-out699"	.83100	595	121	716
12	"12-out700"	.77408	233	68	301
12	"12-out701"	.71181	247	100	347
12	"12-out702"	.93396	297	21	318
12	"12-out703"	.86708	274	42	316
12	"12-out704"	.71732	236	93	329
12	"12-out705"	.99678	310	1	311
12	"12-out706"	.49838	154	155	309
12	"12-out707"	.26973	41	111	152
12	"12-out708"	.33453	279	555	834
12	"12-out709"	.99684	316	1	317
12	"12-out710"	.38719	127	201	328
12	"12-out711"	.58119	408	294	702
12	"12-out712"	.42708	82	110	192
12	"12-out713"	.98360	60	1	61
12	"12-out714"	.58715	128	90	218
12	"12-out715"	.47346	116	129	245
12	"12-out716"	.40909	108	156	264
12	"12-out717"	.41050	750	1077	1827
12	"12-out718"	.42699	386	518	904
12	"12-out719"	.60960	203	130	333
12	"12-out720"	.47538	367	405	772
12	"12-out721"	.47919	357	388	745
12	"12-out722"	.32743	37	76	113
12	"12-out723"	.56170	132	103	235
12	"12-out724"	.59803	1159	779	1938
12	"12-out725"	.46043	896	1050	1946
12	"12-out726"	.29980	617	1441	2058
12	"12-out727"	.32459	669	1392	2061
12	"12-out728"	.40894	384	555	939
12	"12-out729"	.23353	78	256	334
12	"12-out730"	.99401	166	1	167
12	"12-out731"	.29247	105	254	359
12	"12-out732"	.93750	15	1	16
12	"12-out733"	.32876	48	98	146
12	"12-out734"	.61444	953	598	1551
12	"12-out735"	.99653	288	1	289
12	"12-out736"	.30226	467	1078	1545
12	"12-out737"	.98757	318	4	322
12	"12-out738"	.98757	318	4	322
12	"12-out739"	.25250	101	299	400
12	"12-out740"	.49685	158	160	318
12	"12-out741"	.49681	156	158	314
12	"12-out742"	.68370	214	99	313
12	"12-out743"	.43827	142	182	324
12	"12-out744"	.96166	301	12	313
12	"12-out745"	.99090	327	3	330
12	"12-out746"	.65605	206	108	314
12	"12-out747"	.92923	302	23	325
12	"12-out748"	.99692	324	1	325
12	"12-out749"	.98709	306	4	310
12	"12-out750"	.49840	156	157	313
12	"12-out751"	.55591	174	139	313
12	"12-out752"	.99684	316	1	317
12	"12-out753"	.43848	139	178	317
12	"12-out754"	.95569	302	14	316
12	"12-out755"	.94230	294	18	312
12	"12-out756"	.95192	297	15	312
12	"12-out757"	.93569	291	20	311
12	"12-out758"	.96794	302	10	312
12	"12-out759"	.94551	295	17	312
12	"12-out760"	.97530	316	8	324
12	"12-out761"	.97798	311	7	318
12	"12-out762"	.94920	299	16	315
12	"12-out763"	.96794	302	10	312
12	"12-out764"	.89841	283	32	315
12	"12-out765"	.82222	259	56	315
12	"12-out766"	.46623	145	166	311
12	"12-out767"	.95638	307	14	321
12	"12-out768"	.99365	313	2	315
12	"12-out769"	.98095	309	6	315
12	"12-out770"	.79611	246	63	309
12	"12-out771"	.92880	287	22	309
12	"12-out772"	.99029	306	3	309
12	"12-out773"	.60126	190	126	316
12	"12-out774"	.69677	216	94	310
12	"12-out775"	.73289	225	82	307
12	"12-out776"	.39308	125	193	318
12	"12-out777"	.95176	296	15	311
12	"12-out778"	.96825	305	10	315
12	"12-out779"	.40894	128	185	313
12	"12-out780"	.97756	305	7	312
12	"12-out781"	.94426	288	17	305
12	"12-out782"	.48874	152	159	311
12	"12-out783"	.96507	304	11	315
12	"12-out784"	.54179	175	148	323
12	"12-out785"	.43225	134	176	310
12	"12-out786"	.51746	163	152	315
12	"12-out787"	.94462	290	17	307
12	"12-out788"	.97719	300	7	307
12	"12-out789"	.97763	306	7	313
12	"12-out790"	.65372	202	107	309
12	"12-out791"	.91082	286	28	314
12	"12-out792"	.98722	309	4	313
12	"12-out793"	.99076	322	3	325
12	"12-out794"	.98701	304	4	308
12	"12-out795"	.57371	179	133	312
12	"12-out796"	.99025	305	3	308
12	"12-out797"	.93247	290	21	311
12	"12-out798"	.96463	300	11	311
12	"12-out799"	.94920	299	16	315
12	"12-out800"	.61290	190	120	310
12	"12-out801"	.97142	306	9	315
12	"12-out802"	.61490	198	124	322
12	"12-out803"	.71587	257	102	359
12	"12-out804"	.99679	311	1	312
12	"12-out805"	.99363	312	2	314
12	"12-out806"	.25000	81	243	324
12	"12-out807"	.54574	173	144	317
12	"12-out808"	.52365	166	151	317
12	"12-out809"	.31269	101	222	323
12	"12-out810"	.45846	149	176	325
12	"12-out811"	.95483	296	14	310
12	"12-out812"	.95145	294	15	309
12	"12-out813"	.84687	271	49	320
12	"12-out814"	.97222	315	9	324
12	"12-out815"	.69325	226	100	326
12	"12-out816"	.96485	302	11	313
12	"12-out817"	.80645	250	60	310
12	"12-out818"	.57324	180	134	314
12	"12-out819"	.97976	339	7	346
12	"12-out820"	.90675	282	29	311
12	"12-out821"	.97115	303	9	312
12	"12-out822"	.98076	306	6	312
12	"12-out823"	.95806	297	13	310
12	"12-out824"	.88888	280	35	315
12	"12-out825"	.45454	145	174	319
12	"12-out826"	.45602	140	167	307
12	"12-out827"	.77115	246	73	319
12	"12-out828"	.99619	262	1	263
12	"12-out829"	.74516	231	79	310
12	"12-out830"	.76065	232	73	305
12	"12-out831"	.17647	27	126	153
12	"12-out832"	.37254	57	96	153
12	"12-out833"	.50830	153	148	301
12	"12-out834"	.41350	98	139	237
12	"12-out835"	.99534	214	1	215
12	"12-out836"	.33568	143	283	426
12	"12-out837"	.40734	233	339	572
12	"12-out838"	.38112	210	341	551
12	"12-out839"	.26324	159	445	604
12	"12-out840"	.68646	208	95	303
12	"12-out841"	.30794	186	418	604
12	"12-out842"	.94285	330	20	350
12	"12-out843"	.42519	216	292	508
12	"12-out844"	.36560	676	1173	1849
12	"12-out845"	.33807	404	791	1195
12	"12-out846"	.35068	229	424	653
12	"12-out847"	.38325	238	383	621
12	"12-out848"	.37424	247	413	660
12	"12-out849"	.58370	265	189	454
12	"12-out850"	.29799	208	490	698
12	"12-out851"	.44180	186	235	421
12	"12-out852"	.18814	73	315	388
12	"12-out853"	.45653	625	744	1369
12	"12-out854"	.18414	79	350	429
12	"12-out855"	.91201	425	41	466
12	"12-out856"	.49890	457	459	916
12	"12-out857"	.99717	707	2	709
12	"12-out858"	.39086	77	120	197
12	"12-out859"	.99969	3322	1	3323
12	"12-out860"	.99919	1236	1	1237
12	"12-out861"	.75668	4360	1402	5762
12	"12-out862"	.51086	1246	1193	2439
12	"12-out863"	.22443	79	273	352
12	"12-out864"	.40441	110	162	272
12	"12-out865"	.45705	298	354	652
12	"12-out866"	.38827	106	167	273
12	"12-out867"	.50000	262	262	524
12	"12-out868"	.40520	389	571	960
12	"12-out869"	.37656	180	298	478
12	"12-out870"	.43986	256	326	582
12	"12-out871"	.86769	282	43	325
12	"12-out872"	.23041	50	167	217
12	"12-out873"	.41883	129	179	308
12	"12-out874"	.98989	98	1	99
12	"12-out875"	.53626	451	390	841
12	"12-out876"	.51223	314	299	613
12	"12-out877"	.31192	34	75	109
12	"12-out878"	.30620	158	358	516
12	"12-out879"	.87500	350	50	400
12	"12-out880"	.47468	150	166	316
12	"12-out881"	.97315	290	8	298
12	"12-out882"	.93333	294	21	315
12	"12-out883"	.97826	270	6	276
12	"12-out884"	.73162	229	84	313
12	"12-out885"	.38333	207	333	540
12	"12-out886"	.57507	180	133	313
12	"12-out887"	.99079	323	3	326
12	"12-out888"	.49450	585	598	1183
12	"12-out889"	.57352	117	87	204
12	"12-out890"	.71904	302	118	420
12	"12-out891"	.48556	185	196	381
12	"12-out892"	.35820	144	258	402
12	"12-out893"	.25123	102	304	406
12	"12-out894"	.28039	143	367	510
12	"12-out895"	.79335	215	56	271
12	"12-out896"	.65944	213	110	323
12	"12-out897"	.36000	270	480	750
12	"12-out898"	.48693	205	216	421
12	"12-out899"	.35681	157	283	440
12	"12-out900"	.36196	59	104	163
12	"12-out901"	.99082	108	1	109
12	"12-out902"	.61073	91	58	149
12	"12-out903"	.99186	122	1	123
12	"12-out904"	.99481	192	1	193
12	"12-out905"	.24858	88	266	354
12	"12-out906"	.37634	140	232	372
12	"12-out907"	.25789	98	282	380
12	"12-out908"	.46551	162	186	348
12	"12-out909"	.79177	308	81	389
12	"12-out910"	.55905	1065	840	1905
12	"12-out911"	.26858	112	305	417
12	"12-out912"	.35703	231	416	647
12	"12-out913"	.40522	62	91	153
12	"12-out914"	.43508	248	322	570
12	"12-out915"	.32348	219	458	677
12	"12-out916"	.46219	269	313	582
12	"12-out917"	.36140	588	1039	1627
12	"12-out918"	.40136	531	792	1323
12	"12-out919"	.42063	53	73	126
12	"12-out920"	.47959	47	51	98
12	"12-out921"	.35526	81	147	228
12	"12-out922"	.99441	356	2	358
12	"12-out923"	.44932	133	163	296
12	"12-out924"	.49239	971	1001	1972
12	"12-out925"	.99817	1095	2	1097
12	"12-out926"	.74368	1442	497	1939
12	"12-out927"	.45805	273	323	596
12	"12-out928"	.34829	737	1379	2116
12	"12-out929"	.31513	531	1154	1685
12	"12-out930"	.42647	232	312	544
12	"12-out931"	.45901	280	330	610
12	"12-out932"	.37196	690	1165	1855
12	"12-out933"	.34782	104	195	299
12	"12-out934"	.44696	118	146	264
12	"12-out935"	.27579	139	365	504
12	"12-out936"	.92795	541	42	583
12	"12-out937"	.61152	244	155	399
12	"12-out938"	.99530	212	1	213
12	"12-out939"	.39205	158	245	403
12	"12-out940"	.99663	296	1	297
12	"12-out941"	.26388	57	159	216
12	"12-out942"	.81818	72	16	88
12	"12-out943"	.29245	62	150	212
12	"12-out944"	.18055	39	177	216
12	"12-out945"	.28044	76	195	271
12	"12-out946"	.36401	174	304	478
12	"12-out947"	.92366	363	30	393
12	"12-out948"	.21739	35	126	161
12	"12-out949"	.92739	281	22	303
12	"12-out950"	.98717	308	4	312
12	"12-out951"	.99678	310	1	311
12	"12-out952"	.56562	181	139	320
12	"12-out953"	.78525	245	67	312
12	"12-out954"	.54952	172	141	313
12	"12-out955"	.99079	323	3	326
12	"12-out956"	.70930	610	250	860
12	"12-out957"	.32696	137	282	419
12	"12-out958"	.78034	270	76	346
12	"12-out959"	.88000	110	15	125
12	"12-out960"	.39350	109	168	277
12	"12-out961"	.41477	73	103	176
12	"12-out962"	.24680	58	177	235
12	"12-out963"	.16860	29	143	172
12	"12-out964"	.33250	133	267	400
12	"12-out965"	.29006	429	1050	1479
12	"12-out966"	.34985	120	223	343
12	"12-out967"	.92857	299	23	322
12	"12-out968"	.90606	299	31	330
12	"12-out969"	.99487	194	1	195
12	"12-out970"	.24820	69	209	278
12	"12-out971"	.45085	422	514	936
12	"12-out972"	.38897	529	831	1360
12	"12-out973"	.98214	55	1	56
12	"12-out974"	.68627	140	64	204
12	"12-out975"	.41440	305	431	736
12	"12-out976"	.36533	274	476	750
12	"12-out977"	.24750	99	301	400
12	"12-out978"	.37147	763	1291	2054
12	"12-out979"	.40723	90	131	221
12	"12-out980"	.26552	389	1076	1465
12	"12-out981"	.85981	184	30	214
12	"12-out982"	.98780	81	1	82
12	"12-out983"	.45957	108	127	235
12	"12-out984"	.45937	147	173	320
12	"12-out985"	.35123	85	157	242
12	"12-out986"	.34261	123	236	359
12	"12-out987"	.49320	508	522	1030
12	"12-out988"	.28093	84	215	299
12	"12-out989"	.38625	253	402	655
12	"12-out990"	.98778	485	6	491
12	"12-out991"	.23118	43	143	186
12	"12-out992"	.31305	175	384	559
12	"12-out993"	.32844	112	229	341
12	"12-out994"	.66071	333	171	504
12	"12-out995"	.28095	177	453	630
12	"12-out996"	.62377	383	231	614
12	"12-out997"	.55263	63	51	114
12	"12-out998"	.51908	68	63	131
12	"12-out999"	.99860	714	1	715
12	"12-out1000"	.74157	198	69	267
12	"12-out1001"	.97959	48	1	49
12	"12-out1002"	.99630	270	1	271
12	"12-out1003"	.98360	60	1	61
12	"12-out1004"	.57279	299	223	522
12	"12-out1005"	.99082	108	1	109
12	"12-out1006"	.28037	30	77	107
12	"12-out1007"	.27692	108	282	390
12	"12-out1008"	.50279	90	89	179
12	"12-out1009"	.28033	201	516	717
12	"12-out1010"	.58474	69	49	118
12	"12-out1011"	.38674	140	222	362
12	"12-out1012"	.34521	213	404	617
12	"12-out1013"	.39072	295	460	755
12	"12-out1014"	.22137	29	102	131
12	"12-out1015"	.31089	97	215	312
12	"12-out1016"	.45714	160	190	350
12	"12-out1017"	.52664	168	151	319
12	"12-out1018"	.40869	141	204	345
12	"12-out1019"	.32602	119	246	365
12	"12-out1020"	.41916	140	194	334
12	"12-out1021"	.29063	304	742	1046
12	"12-out1022"	.99747	395	1	396
12	"12-out1023"	.94166	791	49	840
12	"12-out1024"	.34361	78	149	227
12	"12-out1025"	.24126	152	478	630
12	"12-out1026"	.38202	102	165	267
12	"12-out1027"	.38815	59	93	152
12	"12-out1028"	.39156	520	808	1328
12	"12-out1029"	.27913	321	829	1150
12	"12-out1030"	.30422	108	247	355
12	"12-out1031"	.44329	129	162	291
12	"12-out1032"	.87428	153	22	175
12	"12-out1033"	.67682	111	53	164
12	"12-out1034"	.98648	73	1	74
12	"12-out1035"	.48907	403	421	824
12	"12-out1036"	.27408	128	339	467
12	"12-out1037"	.35235	389	715	1104
12	"12-out1038"	.87058	74	11	85
12	"12-out1039"	.38168	942	1526	2468
12	"12-out1040"	.32635	312	644	956
12	"12-out1041"	.97674	84	2	86
12	"12-out1042"	.32727	162	333	495
12	"12-out1043"	.38582	490	780	1270
12	"12-out1044"	.41584	126	177	303
12	"12-out1045"	.33911	176	343	519
12	"12-out1046"	.35524	281	510	791
12	"12-out1047"	.39550	176	269	445
12	"12-out1048"	.21308	101	373	474
12	"12-out1049"	.26136	46	130	176
12	"12-out1050"	.79054	117	31	148
12	"12-out1051"	.63184	127	74	201
12	"12-out1052"	.52208	130	119	249
12	"12-out1053"	.99782	459	1	460
12	"12-out1054"	.34167	232	447	679
12	"12-out1055"	.38147	140	227	367
12	"12-out1056"	.99711	346	1	347
12	"12-out1057"	.37478	220	367	587
12	"12-out1058"	.45220	369	447	816
12	"12-out1059"	.45955	250	294	544
12	"12-out1060"	.32807	187	383	570
12	"12-out1061"	.34421	253	482	735
12	"12-out1062"	.33254	141	283	424
12	"12-out1063"	.34134	142	274	416
12	"12-out1064"	.42603	216	291	507
12	"12-out1065"	.96969	32	1	33
12	"12-out1066"	.99551	222	1	223
12	"12-out1067"	.48040	478	517	995
12	"12-out1068"	.34090	120	232	352
12	"12-out1069"	.59440	85	58	143
12	"12-out1070"	.99130	114	1	115
12	"12-out1071"	.42048	156	215	371
12	"12-out1072"	.38000	209	341	550
12	"12-out1073"	.54260	121	102	223
12	"12-out1074"	.52613	906	816	1722
12	"12-out1075"	.51260	122	116	238
12	"12-out1076"	.38844	242	381	623
12	"12-out1077"	.61000	305	195	500
12	"12-out1078"	.43933	105	134	239
12	"12-out1079"	.37670	579	958	1537
12	"12-out1080"	.64418	554	306	860
12	"12-out1081"	.34689	179	337	516
12	"12-out1082"	.51879	69	64	133
12	"12-out1083"	.44171	144	182	326
12	"12-out1084"	.64420	239	132	371
12	"12-out1085"	.99186	122	1	123
12	"12-out1086"	.99145	116	1	117
12	"12-out1087"	.99145	116	1	117
12	"12-out1088"	.24251	170	531	701
12	"12-out1089"	.44082	298	378	676
12	"12-out1090"	.78333	329	91	420
12	"12-out1091"	.94594	140	8	148
12	"12-out1092"	.41433	474	670	1144
12	"12-out1093"	.78231	115	32	147
12	"12-out1094"	.53571	555	481	1036
12	"12-out1095"	.30856	191	428	619
12	"12-out1096"	.81081	330	77	407
12	"12-out1097"	.99681	313	1	314
12	"12-out1098"	.78620	114	31	145
12	"12-out1099"	.47267	346	386	732
12	"12-out1100"	.94318	166	10	176
12	"12-out1101"	.77138	496	147	643
12	"12-out1102"	.40337	382	565	947
12	"12-out1103"	.35333	106	194	300
12	"12-out1104"	.60472	794	519	1313
12	"12-out1105"	.27777	60	156	216
12	"12-out1106"	.59352	568	389	957
12	"12-out1107"	.37317	256	430	686
12	"12-out1108"	.45090	349	425	774
12	"12-out1109"	.29838	148	348	496
12	"12-out1110"	.28703	155	385	540
12	"12-out1111"	.31048	77	171	248
12	"12-out1112"	.99624	265	1	266
12	"12-out1113"	.38709	108	171	279
12	"12-out1114"	.97674	84	2	86
12	"12-out1115"	.29287	333	804	1137
12	"12-out1116"	.56153	292	228	520
12	"12-out1117"	.52916	254	226	480
12	"12-out1118"	.30018	160	373	533
12	"12-out1119"	.39411	134	206	340
12	"12-out1120"	.52427	54	49	103
12	"12-out1121"	.47493	341	377	718
12	"12-out1122"	.44396	206	258	464
12	"12-out1123"	.41111	148	212	360
12	"12-out1124"	.35890	131	234	365
12	"12-out1125"	.39444	142	218	360
12	"12-out1126"	.64848	321	174	495
12	"12-out1127"	.98066	355	7	362
12	"12-out1128"	.43816	496	636	1132
12	"12-out1129"	.37032	317	539	856
12	"12-out1130"	.78580	1229	335	1564
12	"12-out1131"	.34443	600	1142	1742
12	"12-out1132"	.79513	229	59	288
12	"12-out1133"	.24071	149	470	619
12	"12-out1134"	.93700	119	8	127
12	"12-out1135"	.99680	624	2	626
12	"12-out1136"	.96473	383	14	397
12	"12-out1137"	.21940	52	185	237
12	"12-out1138"	.70125	392	167	559
12	"12-out1139"	.45200	226	274	500
12	"12-out1140"	.26646	174	479	653
12	"12-out1141"	.43140	893	1177	2070
12	"12-out1142"	.45419	238	286	524
12	"12-out1143"	.97230	316	9	325
12	"12-out1144"	.41009	130	187	317
12	"12-out1145"	.33965	197	383	580
12	"12-out1146"	.96129	298	12	310
12	"12-out1147"	.47129	156	175	331
12	"12-out1148"	.70858	231	95	326
12	"12-out1149"	.73737	292	104	396
12	"12-out1150"	.69565	240	105	345
12	"12-out1151"	.99079	323	3	326
12	"12-out1152"	.58024	188	136	324
12	"12-out1153"	.68729	211	96	307
12	"12-out1154"	.65677	354	185	539
12	"12-out1155"	.34381	175	334	509
12	"12-out1156"	.72910	253	94	347
12	"12-out1157"	.91509	291	27	318
12	"12-out1158"	.43589	136	176	312
12	"12-out1159"	.57928	179	130	309
12	"12-out1160"	.88382	388	51	439
12	"12-out1161"	.41512	719	1013	1732
12	"12-out1162"	.39158	670	1041	1711
12	"12-out1163"	.49065	105	109	214
12	"12-out1164"	.98131	893	17	910
12	"12-out1165"	.84643	1389	252	1641
12	"12-out1166"	.44377	588	737	1325
12	"12-out1167"	.39072	531	828	1359
12	"12-out1168"	.35807	82	147	229
12	"12-out1169"	.40654	87	127	214
12	"12-out1170"	.74683	118	40	158
12	"12-out1171"	.46875	120	136	256
12	"12-out1172"	.71735	401	158	559
12	"12-out1173"	.84000	231	44	275
12	"12-out1174"	.39378	76	117	193
12	"12-out1175"	.46666	161	184	345
12	"12-out1176"	.39313	447	690	1137
12	"12-out1177"	.38802	175	276	451
12	"12-out1178"	.42276	52	71	123
12	"12-out1179"	.73117	5826	2142	7968
12	"12-out1180"	.44672	847	1049	1896
12	"12-out1181"	.41928	200	277	477
12	"12-out1182"	.52439	43	39	82
12	"12-out1183"	.99824	569	1	570
12	"12-out1184"	.98387	61	1	62
12	"12-out1185"	.73362	168	61	229
12	"12-out1186"	.41269	26	37	63
12	"12-out1187"	.32575	86	178	264
12	"12-out1188"	.66176	45	23	68
12	"12-out1189"	.92935	421	32	453
12	"12-out1190"	.31034	126	280	406
12	"12-out1191"	.99681	313	1	314
12	"12-out1192"	.88025	272	37	309
12	"12-out1193"	.45454	95	114	209
12	"12-out1194"	.87565	1000	142	1142
12	"12-out1195"	.31521	58	126	184
12	"12-out1196"	.45278	398	481	879
12	"12-out1197"	.48493	161	171	332
12	"12-out1198"	.75073	512	170	682
12	"12-out1199"	.31542	276	599	875
12	"12-out1200"	.18412	58	257	315
12	"12-out1201"	.99776	446	1	447
12	"12-out1202"	.45415	213	256	469
12	"12-out1203"	.99636	274	1	275
12	"12-out1204"	.99576	235	1	236
12	"12-out1205"	.99212	126	1	127
12	"12-out1206"	.31906	82	175	257
12	"12-out1207"	.77619	163	47	210
12	"12-out1208"	.51923	162	150	312
12	"12-out1209"	.21524	48	175	223
12	"12-out1210"	.30035	85	198	283
12	"12-out1211"	.99544	874	4	878
12	"12-out1212"	.99544	874	4	878
12	"12-out1213"	.99503	802	4	806
12	"12-out1214"	.99544	874	4	878
12	"12-out1215"	.99470	752	4	756
12	"12-out1216"	.99460	737	4	741
12	"12-out1217"	.30797	166	373	539
12	"12-out1218"	.38679	205	325	530
12	"12-out1219"	.64736	123	67	190
12	"12-out1220"	.37320	156	262	418
12	"12-out1221"	.45853	188	222	410
12	"12-out1222"	.47674	164	180	344
12	"12-out1223"	.41959	334	462	796
12	"12-out1224"	.31143	256	566	822
12	"12-out1225"	.32896	276	563	839
12	"12-out1226"	.37081	343	582	925
12	"12-out1227"	.39532	457	699	1156
12	"12-out1228"	.46711	689	786	1475
12	"12-out1229"	.46153	642	749	1391
12	"12-out1230"	.29805	428	1008	1436
12	"12-out1231"	.33047	578	1171	1749
12	"12-out1232"	.99685	317	1	318
12	"12-out1233"	.27733	558	1454	2012
12	"12-out1234"	.29569	618	1472	2090
12	"12-out1235"	.98571	69	1	70
12	"12-out1236"	.53398	330	288	618
12	"12-out1237"	.36407	225	393	618
12	"12-out1238"	.99543	218	1	219
12	"12-out1239"	.71703	261	103	364
12	"12-out1240"	.31615	135	292	427
12	"12-out1241"	.70322	327	138	465
12	"12-out1242"	.39521	281	430	711
12	"12-out1243"	.99704	337	1	338
12	"12-out1244"	.17241	45	216	261
12	"12-out1245"	.75342	605	198	803
12	"12-out1246"	.42439	87	118	205
12	"12-out1247"	.35215	106	195	301
12	"12-out1248"	.59010	668	464	1132
12	"12-out1249"	.33110	99	200	299
12	"12-out1250"	.99706	340	1	341
12	"12-out1251"	.41440	351	496	847
12	"12-out1252"	.99919	1248	1	1249
12	"12-out1253"	.99460	737	4	741
12	"12-out1254"	.40114	351	524	875
12	"12-out1255"	.28419	160	403	563
12	"12-out1256"	.52406	98	89	187
12	"12-out1257"	.48000	444	481	925
12	"12-out1258"	.33235	113	227	340
12	"12-out1259"	.48506	1380	1465	2845
12	"12-out1260"	.41944	289	400	689
12	"12-out1261"	.56806	338	257	595
12	"12-out1262"	.32094	406	859	1265
12	"12-out1263"	.24254	122	381	503
12	"12-out1264"	.60178	337	223	560
12	"12-out1265"	.22433	118	408	526
12	"12-out1266"	.28780	59	146	205
12	"12-out1267"	.74568	173	59	232
12	"12-out1268"	.94285	231	14	245
12	"12-out1269"	.23746	90	289	379
12	"12-out1270"	.95700	690	31	721
12	"12-out1271"	.97952	287	6	293
12	"12-out1272"	.96680	466	16	482
12	"12-out1273"	.98969	480	5	485
12	"12-out1274"	.26654	149	410	559
12	"12-out1275"	.84210	144	27	171
12	"12-out1276"	.86046	148	24	172
12	"12-out1277"	.58628	248	175	423
12	"12-out1278"	.40681	358	522	880
12	"12-out1279"	.37137	205	347	552
12	"12-out1280"	.71474	446	178	624
12	"12-out1281"	.91360	423	40	463
12	"12-out1282"	.48366	148	158	306
12	"12-out1283"	.52427	108	98	206
12	"12-out1284"	.98360	60	1	61
12	"12-out1285"	.94594	140	8	148
12	"12-out1286"	.39166	94	146	240
12	"12-out1287"	.28054	62	159	221
12	"12-out1288"	.46268	155	180	335
12	"12-out1289"	.31719	393	846	1239
12	"12-out1290"	.73366	146	53	199
12	"12-out1291"	.65951	246	127	373
12	"12-out1292"	.46086	159	186	345
12	"12-out1293"	.79908	175	44	219
12	"12-out1294"	.44675	172	213	385
12	"12-out1295"	.33185	300	604	904
12	"12-out1296"	.46571	163	187	350
12	"12-out1297"	.58982	197	137	334
12	"12-out1298"	.36242	191	336	527
12	"12-out1299"	.29394	301	723	1024
12	"12-out1300"	.36659	540	933	1473
12	"12-out1301"	.35231	365	671	1036
12	"12-out1302"	.41133	225	322	547
12	"12-out1303"	.30512	119	271	390
12	"12-out1304"	.49586	60	61	121
12	"12-out1305"	.32107	358	757	1115
12	"12-out1306"	.67881	708	335	1043
12	"12-out1307"	.82107	413	90	503
12	"12-out1308"	.25614	375	1089	1464
12	"12-out1309"	.27425	407	1077	1484
12	"12-out1310"	.49553	611	622	1233
12	"12-out1311"	.58832	786	550	1336
12	"12-out1312"	.48294	453	485	938
12	"12-out1313"	.74698	62	21	83
12	"12-out1314"	.42345	130	177	307
12	"12-out1315"	.82437	230	49	279
12	"12-out1316"	.38110	117	190	307
12	"12-out1317"	.44841	113	139	252
12	"12-out1318"	.35785	107	192	299
12	"12-out1319"	.23529	36	117	153
12	"12-out1320"	.44444	36	45	81
12	"12-out1321"	.42651	148	199	347
12	"12-out1322"	.54484	407	340	747
12	"12-out1323"	.88541	255	33	288
12	"12-out1324"	.99500	199	1	200
12	"12-out1325"	.39021	670	1047	1717
12	"12-out1326"	.24074	52	164	216
12	"12-out1327"	.76521	352	108	460
12	"12-out1328"	.28680	187	465	652
12	"12-out1329"	.28414	285	718	1003
12	"12-out1330"	.37407	710	1188	1898
12	"12-out1331"	.62156	317	193	510
12	"12-out1332"	.70700	222	92	314
12	"12-out1333"	.98392	306	5	311
12	"12-out1334"	.38054	180	293	473
12	"12-out1335"	.92405	292	24	316
12	"12-out1336"	.65193	236	126	362
12	"12-out1337"	.75862	242	77	319
12	"12-out1338"	.51779	160	149	309
12	"12-out1339"	.41967	128	177	305
12	"12-out1340"	.95151	314	16	330
12	"12-out1341"	.97452	306	8	314
12	"12-out1342"	.95145	294	15	309
12	"12-out1343"	.97170	996	29	1025
12	"12-out1344"	.60937	195	125	320
12	"12-out1345"	.99787	470	1	471
12	"12-out1346"	.40975	84	121	205
12	"12-out1347"	.99352	307	2	309
12	"12-out1348"	.95569	302	14	316
12	"12-out1349"	.94920	299	16	315
12	"12-out1350"	.80813	278	66	344
12	"12-out1351"	.47756	149	163	312
12	"12-out1352"	.41346	129	183	312
12	"12-out1353"	.48148	156	168	324
12	"12-out1354"	.42187	135	185	320
12	"12-out1355"	.44236	142	179	321
12	"12-out1356"	.28145	85	217	302
12	"12-out1357"	.53797	170	146	316
12	"12-out1358"	.22539	71	244	315
12	"12-out1359"	.47318	150	167	317
12	"12-out1360"	.55451	178	143	321
12	"12-out1361"	.48717	152	160	312
12	"12-out1362"	.50464	163	160	323
12	"12-out1363"	.39171	123	191	314
12	"12-out1364"	.41791	140	195	335
12	"12-out1365"	.78864	250	67	317
12	"12-out1366"	.99691	323	1	324
12	"12-out1367"	.99714	349	1	350
12	"12-out1368"	.75562	235	76	311
12	"12-out1369"	.98726	310	4	314
12	"12-out1370"	.98726	310	4	314
12	"12-out1371"	.99696	328	1	329
12	"12-out1372"	.99686	318	1	319
12	"12-out1373"	.98107	311	6	317
12	"12-out1374"	.39687	127	193	320
12	"12-out1375"	.60124	193	128	321
12	"12-out1376"	.73765	239	85	324
12	"12-out1377"	.19314	62	259	321
12	"12-out1378"	.99792	482	1	483
12	"12-out1379"	.60907	349	224	573
12	"12-out1380"	.47485	727	804	1531
12	"12-out1381"	.47230	162	181	343
12	"12-out1382"	.51315	117	111	228
12	"12-out1383"	.99470	188	1	189
12	"12-out1384"	.82627	585	123	708
12	"12-out1385"	.36480	85	148	233
12	"12-out1386"	.45312	493	595	1088
12	"12-out1387"	.86948	453	68	521
12	"12-out1388"	.28644	167	416	583
12	"12-out1389"	.78103	346	97	443
12	"12-out1390"	.31868	58	124	182
12	"12-out1391"	.99411	169	1	170
12	"12-out1392"	.99411	169	1	170
12	"12-out1393"	.45161	112	136	248
12	"12-out1394"	.13043	60	400	460
12	"12-out1395"	.56765	172	131	303
12	"12-out1396"	.85245	52	9	61
12	"12-out1397"	.98360	60	1	61
12	"12-out1398"	.98360	60	1	61
12	"12-out1399"	.98360	60	1	61
12	"12-out1400"	.98360	60	1	61
12	"12-out1401"	.95081	58	3	61
12	"12-out1402"	.98360	60	1	61
12	"12-out1403"	.62337	96	58	154
12	"12-out1404"	.42895	323	430	753
12	"12-out1405"	.75265	213	70	283
12	"12-out1406"	.51958	199	184	383
12	"12-out1407"	.46811	301	342	643
12	"12-out1408"	.41293	249	354	603
12	"12-out1409"	.51473	227	214	441
12	"12-out1410"	.81047	325	76	401
12	"12-out1411"	.69372	188	83	271
12	"12-out1412"	.30092	65	151	216
12	"12-out1413"	.47016	197	222	419
12	"12-out1414"	.26720	66	181	247
12	"12-out1415"	.25000	60	180	240
12	"12-out1416"	.99264	135	1	136
12	"12-out1417"	.32621	168	347	515
12	"12-out1418"	.58598	184	130	314
12	"12-out1419"	.85213	340	59	399
12	"12-out1420"	.33281	212	425	637
12	"12-out1421"	.69375	111	49	160
12	"12-out1422"	.33096	140	283	423
12	"12-out1423"	.53797	170	146	316
12	"12-out1424"	.92767	295	23	318
12	"12-out1425"	.39563	127	194	321
12	"12-out1426"	.99270	136	1	137
12	"12-out1427"	.47239	154	172	326
12	"12-out1428"	.14965	44	250	294
12	"12-out1429"	.33210	361	726	1087
12	"12-out1430"	.55639	222	177	399
12	"12-out1431"	.38701	149	236	385
12	"12-out1432"	.41804	278	387	665
12	"12-out1433"	.32469	213	443	656
12	"12-out1434"	.47255	353	394	747
12	"12-out1435"	.42475	175	237	412
12	"12-out1436"	.31325	52	114	166
12	"12-out1437"	.71841	1342	526	1868
12	"12-out1438"	.85329	285	49	334
12	"12-out1439"	.36014	918	1631	2549
12	"12-out1440"	.99451	544	3	547
12	"12-out1441"	.38888	224	352	576
12	"12-out1442"	.35627	88	159	247
12	"12-out1443"	.32879	169	345	514
12	"12-out1444"	.31434	480	1047	1527
12	"12-out1445"	.35147	465	858	1323
12	"12-out1446"	.51914	122	113	235
12	"12-out1447"	.35589	531	961	1492
12	"12-out1448"	.99159	118	1	119
12	"12-out1449"	.22916	55	185	240
12	"12-out1450"	.43576	407	527	934
12	"12-out1451"	.38674	140	222	362
12	"12-out1452"	.26343	152	425	577
12	"12-out1453"	.63139	185	108	293
12	"12-out1454"	.46762	65	74	139
12	"12-out1455"	.52582	112	101	213
12	"12-out1456"	.37065	192	326	518
12	"12-out1457"	.31063	73	162	235
12	"12-out1458"	.30638	72	163	235
12	"12-out1459"	.65517	76	40	116
12	"12-out1460"	.45833	99	117	216
12	"12-out1461"	.78217	79	22	101
12	"12-out1462"	.43654	86	111	197
12	"12-out1463"	.41976	361	499	860
12	"12-out1464"	.31584	301	652	953
12	"12-out1465"	.52589	132	119	251
12	"12-out1466"	.80851	456	108	564
12	"12-out1467"	.32418	248	517	765
12	"12-out1468"	.52279	172	157	329
12	"12-out1469"	.48672	55	58	113
12	"12-out1470"	.50273	368	364	732
12	"12-out1471"	.52406	697	633	1330
12	"12-out1472"	.42566	272	367	639
12	"12-out1473"	.61268	367	232	599
12	"12-out1474"	.65991	163	84	247
12	"12-out1475"	.68825	170	77	247
12	"12-out1476"	.47099	203	228	431
12	"12-out1477"	.32481	89	185	274
12	"12-out1478"	.45945	289	340	629
12	"12-out1479"	.40634	256	374	630
12	"12-out1480"	.37784	133	219	352
12	"12-out1481"	.35625	57	103	160
12	"12-out1482"	.24104	148	466	614
12	"12-out1483"	.36619	208	360	568
12	"12-out1484"	.73809	310	110	420
12	"12-out1485"	.30010	277	646	923
12	"12-out1486"	.51501	343	323	666
12	"12-out1487"	.37246	92	155	247
12	"12-out1488"	.85784	175	29	204
12	"12-out1489"	.32894	100	204	304
12	"12-out1490"	.77553	577	167	744
12	"12-out1491"	.54285	551	464	1015
12	"12-out1492"	.65952	277	143	420
12	"12-out1493"	.99918	1221	1	1222
12	"12-out1494"	.55125	441	359	800
12	"12-out1495"	.48255	249	267	516
12	"12-out1496"	.65661	283	148	431
12	"12-out1497"	.50094	265	264	529
12	"12-out1498"	.46569	224	257	481
12	"12-out1499"	.27659	104	272	376
12	"12-out1500"	.31734	86	185	271
12	"12-out1501"	.43235	866	1137	2003
12	"12-out1502"	.99232	388	3	391
12	"12-out1503"	.77027	228	68	296
12	"12-out1504"	.35887	178	318	496
12	"12-out1505"	.86933	326	49	375
12	"12-out1506"	.55767	643	510	1153
12	"12-out1507"	.99648	1134	4	1138
12	"12-out1508"	.63576	96	55	151
12	"12-out1509"	.29733	380	898	1278
12	"12-out1510"	.35214	181	333	514
12	"12-out1511"	.99056	105	1	106
12	"12-out1512"	.81144	241	56	297
12	"12-out1513"	.99659	293	1	294
12	"12-out1514"	.99619	1046	4	1050
12	"12-out1515"	.99648	1134	4	1138
12	"12-out1516"	.99646	1129	4	1133
12	"12-out1517"	.99058	421	4	425
12	"12-out1518"	.99758	413	1	414
12	"12-out1519"	.99074	428	4	432
12	"12-out1520"	.99766	428	1	429
12	"12-out1521"	.32548	152	315	467
12	"12-out1522"	.31985	182	387	569
12	"12-out1523"	.35000	147	273	420
12	"12-out1524"	.75280	67	22	89
12	"12-out1525"	.99655	289	1	290
12	"12-out1526"	.44791	215	265	480
12	"12-out1527"	.56809	146	111	257
12	"12-out1528"	.41956	193	267	460
12	"12-out1529"	.37479	226	377	603
12	"12-out1530"	.24608	110	337	447
12	"12-out1531"	.52926	217	193	410
12	"12-out1532"	.76237	308	96	404
12	"12-out1533"	.99303	285	2	287
12	"12-out1534"	.42407	553	751	1304
12	"12-out1535"	.48398	136	145	281
12	"12-out1536"	.66497	131	66	197
12	"12-out1537"	.43060	121	160	281
12	"12-out1538"	.52058	177	163	340
12	"12-out1539"	.99425	173	1	174
12	"12-out1540"	.32223	213	448	661
12	"12-out1541"	.95027	172	9	181
12	"12-out1542"	.96341	158	6	164
12	"12-out1543"	.99342	151	1	152
12	"12-out1544"	.70033	208	89	297
12	"12-out1545"	.36585	120	208	328
12	"12-out1546"	.47629	221	243	464
12	"12-out1547"	.99494	197	1	198
12	"12-out1548"	.49548	659	671	1330
12	"12-out1549"	.46673	891	1018	1909
12	"12-out1550"	.28603	127	317	444
12	"12-out1551"	.38248	166	268	434
12	"12-out1552"	.35497	164	298	462
12	"12-out1553"	.57625	1636	1203	2839
12	"12-out1554"	.36589	221	383	604
12	"12-out1555"	.68333	615	285	900
12	"12-out1556"	.94202	195	12	207
12	"12-out1557"	.36697	160	276	436
12	"12-out1558"	.49268	202	208	410
12	"12-out1559"	.16197	23	119	142
12	"12-out1560"	.97835	226	5	231
12	"12-out1561"	.55025	219	179	398
12	"12-out1562"	.45567	221	264	485
12	"12-out1563"	.74944	338	113	451
12	"12-out1564"	.99354	308	2	310
12	"12-out1565"	.76280	283	88	371
12	"12-out1566"	.37362	102	171	273
12	"12-out1567"	.62926	258	152	410
12	"12-out1568"	.69817	421	182	603
12	"12-out1569"	.47530	154	170	324
12	"12-out1570"	.83700	683	133	816
12	"12-out1571"	.46594	301	345	646
12	"12-out1572"	.23974	152	482	634
12	"12-out1573"	.39920	101	152	253
12	"12-out1574"	.55281	157	127	284
12	"12-out1575"	.51581	261	245	506
12	"12-out1576"	.46440	274	316	590
12	"12-out1577"	.59890	109	73	182
12	"12-out1578"	.62813	451	267	718
12	"12-out1579"	.51219	168	160	328
12	"12-out1580"	.43302	139	182	321
12	"12-out1581"	.86400	108	17	125
12	"12-out1582"	.87622	446	63	509
12	"12-out1583"	.35924	416	742	1158
12	"12-out1584"	.56410	110	85	195
12	"12-out1585"	.46681	204	233	437
12	"12-out1586"	.33846	176	344	520
12	"12-out1587"	.43457	186	242	428
12	"12-out1588"	.80000	248	62	310
12	"12-out1589"	.35609	73	132	205
12	"12-out1590"	.95468	316	15	331
12	"12-out1591"	.38216	60	97	157
12	"12-out1592"	.85185	207	36	243
12	"12-out1593"	.96050	608	25	633
12	"12-out1594"	.99686	636	2	638
12	"12-out1595"	.99889	901	1	902
12	"12-out1596"	.50000	57	57	114
12	"12-out1597"	.66129	82	42	124
12	"12-out1598"	.76543	62	19	81
12	"12-out1599"	.52851	139	124	263
12	"12-out1600"	.99590	243	1	244
12	"12-out1601"	.99761	418	1	419
12	"12-out1602"	.31504	201	437	638
12	"12-out1603"	.31487	307	668	975
12	"12-out1604"	.46201	298	347	645
12	"12-out1605"	.49744	487	492	979
12	"12-out1606"	.38313	377	607	984
12	"12-out1607"	.37023	398	677	1075
12	"12-out1608"	.99793	483	1	484
12	"12-out1609"	.39824	182	275	457
12	"12-out1610"	.52248	1092	998	2090
12	"12-out1611"	.66304	183	93	276
12	"12-out1612"	.44927	93	114	207
12	"12-out1613"	.98958	95	1	96
12	"12-out1614"	.65610	145	76	221
12	"12-out1615"	.27218	138	369	507
12	"12-out1616"	.21806	99	355	454
12	"12-out1617"	.39439	338	519	857
12	"12-out1618"	.89958	430	48	478
12	"12-out1619"	.39393	104	160	264
12	"12-out1620"	.98666	74	1	75
12	"12-out1621"	.29925	240	562	802
12	"12-out1622"	.56719	287	219	506
12	"12-out1623"	.99774	442	1	443
12	"12-out1624"	.27391	209	554	763
12	"12-out1625"	.43414	590	769	1359
12	"12-out1626"	.21654	123	445	568
12	"12-out1627"	.33255	143	287	430
12	"12-out1628"	.39852	108	163	271
12	"12-out1629"	.24013	146	462	608
12	"12-out1630"	.37338	954	1601	2555
12	"12-out1631"	.99714	349	1	350
12	"12-out1632"	.98915	365	4	369
12	"12-out1633"	.99714	349	1	350
12	"12-out1634"	.99728	368	1	369
12	"12-out1635"	.99728	368	1	369
12	"12-out1636"	.64485	138	76	214
12	"12-out1637"	.99400	497	3	500
12	"12-out1638"	.42346	83	113	196
12	"12-out1639"	.99393	164	1	165
12	"12-out1640"	.22315	133	463	596
12	"12-out1641"	.40740	198	288	486
12	"12-out1642"	.19124	83	351	434
12	"12-out1643"	.48898	222	232	454
12	"12-out1644"	.81012	192	45	237
12	"12-out1645"	.19718	28	114	142
12	"12-out1646"	.52331	101	92	193
12	"12-out1647"	.99891	920	1	921
12	"12-out1648"	.39817	481	727	1208
12	"12-out1649"	.45358	171	206	377
12	"12-out1650"	.30191	442	1022	1464
12	"12-out1651"	.42487	164	222	386
12	"12-out1652"	.40692	1023	1491	2514
12	"12-out1653"	.35602	68	123	191
12	"12-out1654"	.95744	180	8	188
12	"12-out1655"	.65977	287	148	435
12	"12-out1656"	.99186	244	2	246
12	"12-out1657"	.93707	417	28	445
12	"12-out1658"	.65662	218	114	332
12	"12-out1659"	.41487	251	354	605
12	"12-out1660"	.37649	157	260	417
12	"12-out1661"	.30681	162	366	528
12	"12-out1662"	.36873	559	957	1516
12	"12-out1663"	.36315	138	242	380
12	"12-out1664"	.40773	137	199	336
12	"12-out1665"	.27590	213	559	772
12	"12-out1666"	.36079	254	450	704
12	"12-out1667"	.40466	191	281	472
12	"12-out1668"	.98996	789	8	797
12	"12-out1669"	.38802	149	235	384
12	"12-out1670"	.85915	183	30	213
12	"12-out1671"	.23977	299	948	1247
12	"12-out1672"	.99346	152	1	153
12	"12-out1673"	.36069	167	296	463
12	"12-out1674"	.62123	433	264	697
12	"12-out1675"	.36231	75	132	207
12	"12-out1676"	.33944	148	288	436
12	"12-out1677"	.99918	1221	1	1222
12	"12-out1678"	.99714	349	1	350
12	"12-out1679"	.51123	91	87	178
12	"12-out1680"	.30263	115	265	380
12	"12-out1681"	.28643	114	284	398
12	"12-out1682"	.27559	105	276	381
12	"12-out1683"	.43287	187	245	432
12	"12-out1684"	.41509	154	217	371
12	"12-out1685"	.47135	181	203	384
12	"12-out1686"	.39393	91	140	231
12	"12-out1687"	.98529	67	1	68
12	"12-out1688"	.99082	108	1	109
12	"12-out1689"	.38567	1039	1655	2694
12	"12-out1690"	.51295	198	188	386
12	"12-out1691"	.41358	335	475	810
12	"12-out1692"	.99598	248	1	249
12	"12-out1693"	.30000	63	147	210
12	"12-out1694"	.25128	98	292	390
12	"12-out1695"	.32947	228	464	692
12	"12-out1696"	.55676	510	406	916
12	"12-out1697"	.84645	215	39	254
12	"12-out1698"	.43569	393	509	902
12	"12-out1699"	.25906	193	552	745
12	"12-out1700"	.94556	469	27	496
12	"12-out1701"	.32402	116	242	358
12	"12-out1702"	.39612	654	997	1651
12	"12-out1703"	.38492	1803	2881	4684
12	"12-out1704"	.77714	272	78	350
12	"12-out1705"	.61410	148	93	241
12	"12-out1706"	.45689	106	126	232
12	"12-out1707"	.32894	175	357	532
12	"12-out1708"	.98666	74	1	75
12	"12-out1709"	.29428	422	1012	1434
12	"12-out1710"	.99782	459	1	460
12	"12-out1711"	.99692	324	1	325
12	"12-out1712"	.29803	152	358	510
12	"12-out1713"	.99065	106	1	107
12	"12-out1714"	.55102	81	66	147
12	"12-out1715"	.84775	490	88	578
12	"12-out1716"	.84905	270	48	318
12	"12-out1717"	.31992	167	355	522
12	"12-out1718"	.35133	501	925	1426
12	"12-out1719"	.99823	564	1	565
12	"12-out1720"	.54062	173	147	320
12	"12-out1721"	.36811	254	436	690
12	"12-out1722"	.38952	171	268	439
12	"12-out1723"	.61066	229	146	375
12	"12-out1724"	.28988	129	316	445
12	"12-out1725"	.32989	32	65	97
12	"12-out1726"	.40350	253	374	627
12	"12-out1727"	.57021	268	202	470
12	"12-out1728"	.27911	151	390	541
12	"12-out1729"	.36096	209	370	579
12	"12-out1730"	.22302	31	108	139
12	"12-out1731"	.99762	839	2	841
12	"12-out1732"	.48664	328	346	674
12	"12-out1733"	.35820	72	129	201
12	"12-out1734"	.31872	793	1695	2488
12	"12-out1735"	.38029	907	1478	2385
12	"12-out1736"	.46739	129	147	276
12	"12-out1737"	.24019	98	310	408
12	"12-out1738"	.17441	45	213	258
12	"12-out1739"	.95276	585	29	614
12	"12-out1740"	.56707	1192	910	2102
12	"12-out1741"	.20343	166	650	816
12	"12-out1742"	.45989	86	101	187
12	"12-out1743"	.35179	235	433	668
12	"12-out1744"	.39363	396	610	1006
12	"12-out1745"	.86861	119	18	137
12	"12-out1746"	.16385	68	347	415
12	"12-out1747"	.99543	218	1	219
12	"12-out1748"	.38666	145	230	375
12	"12-out1749"	.42897	151	201	352
12	"12-out1750"	.23437	30	98	128
12	"12-out1751"	.37606	132	219	351
12	"12-out1752"	.99263	809	6	815
12	"12-out1753"	.48038	404	437	841
12	"12-out1754"	.32222	87	183	270
12	"12-out1755"	.71955	195	76	271
12	"12-out1756"	.96983	836	26	862
12	"12-out1757"	.17757	76	352	428
12	"12-out1758"	.24400	173	536	709
12	"12-out1759"	.41246	139	198	337
12	"12-out1760"	.80555	145	35	180
12	"12-out1761"	.98958	95	1	96
12	"12-out1762"	.79482	399	103	502
12	"12-out1763"	.36835	554	950	1504
12	"12-out1764"	.21190	178	662	840
12	"12-out1765"	.66155	561	287	848
12	"12-out1766"	.32700	224	461	685
12	"12-out1767"	.96528	723	26	749
12	"12-out1768"	.48137	336	362	698
12	"12-out1769"	.30031	191	445	636
12	"12-out1770"	.41865	211	293	504
12	"12-out1771"	.98666	74	1	75
12	"12-out1772"	.55407	1286	1035	2321
12	"12-out1773"	.75645	205	66	271
12	"12-out1774"	.33226	310	623	933
12	"12-out1775"	.33846	110	215	325
12	"12-out1776"	.62099	213	130	343
12	"12-out1777"	.99655	1157	4	1161
12	"12-out1778"	.36991	182	310	492
12	"12-out1779"	.26910	81	220	301
12	"12-out1780"	.36019	447	794	1241
12	"12-out1781"	.99748	396	1	397
12	"12-out1782"	.48377	164	175	339
12	"12-out1783"	.99637	275	1	276
12	"12-out1784"	.44331	1306	1640	2946
12	"12-out1785"	.53929	199	170	369
12	"12-out1786"	.40847	270	391	661
12	"12-out1787"	.34990	190	353	543
12	"12-out1788"	.32828	65	133	198
12	"12-out1789"	.85869	158	26	184
12	"12-out1790"	.21904	92	328	420
12	"12-out1791"	.54430	129	108	237
12	"12-out1792"	.59558	162	110	272
12	"12-out1793"	.33924	134	261	395
12	"12-out1794"	.17452	37	175	212
12	"12-out1795"	.99333	149	1	150
12	"12-out1796"	.32798	143	293	436
12	"12-out1797"	.43440	202	263	465
12	"12-out1798"	.33173	69	139	208
12	"12-out1799"	.38028	81	132	213
12	"12-out1800"	.52257	382	349	731
12	"12-out1801"	.81319	949	218	1167
12	"12-out1802"	.51851	308	286	594
12	"12-out1803"	.29454	162	388	550
12	"12-out1804"	.28571	110	275	385
12	"12-out1805"	.32427	561	1169	1730
12	"12-out1806"	.31578	36	78	114
12	"12-out1807"	.21571	129	469	598
12	"12-out1808"	.52875	331	295	626
12	"12-out1809"	.37185	428	723	1151
12	"12-out1810"	.32731	381	783	1164
12	"12-out1811"	.33906	217	423	640
12	"12-out1812"	.40588	345	505	850
12	"12-out1813"	.47709	125	137	262
12	"12-out1814"	.30000	69	161	230
12	"12-out1815"	.36461	136	237	373
12	"12-out1816"	.40661	172	251	423
12	"12-out1817"	.48326	794	849	1643
12	"12-out1818"	.33333	76	152	228
12	"12-out1819"	.39968	255	383	638
12	"12-out1820"	.99921	1266	1	1267
12	"12-out1821"	.67315	173	84	257
12	"12-out1822"	.52470	361	327	688
12	"12-out1823"	.77682	543	156	699
12	"12-out1824"	.20749	72	275	347
12	"12-out1825"	.41958	180	249	429
12	"12-out1826"	.30272	244	562	806
12	"12-out1827"	.85937	55	9	64
12	"12-out1828"	.23472	73	238	311
12	"12-out1829"	.49307	570	586	1156
12	"12-out1830"	.33252	274	550	824
12	"12-out1831"	.41806	250	348	598
12	"12-out1832"	.35928	180	321	501
12	"12-out1833"	.31028	166	369	535
12	"12-out1834"	.09356	16	155	171
12	"12-out1835"	.26106	171	484	655
12	"12-out1836"	.62337	240	145	385
12	"12-out1837"	.39498	126	193	319
12	"12-out1838"	.99408	168	1	169
12	"12-out1839"	.41852	244	339	583
12	"12-out1840"	.95000	171	9	180
12	"12-out1841"	.83536	137	27	164
12	"12-out1842"	.99487	194	1	195
12	"12-out1843"	.69581	183	80	263
12	"12-out1844"	.38402	250	401	651
12	"12-out1845"	.39938	129	194	323
12	"12-out1846"	.22580	56	192	248
12	"12-out1847"	.21262	64	237	301
12	"12-out1848"	.99862	1455	2	1457
12	"12-out1849"	.97979	97	2	99
12	"12-out1850"	.35904	135	241	376
12	"12-out1851"	.24116	157	494	651
12	"12-out1852"	.41372	211	299	510
12	"12-out1853"	.41896	1153	1599	2752
12	"12-out1854"	.38380	218	350	568
12	"12-out1855"	.20000	14	56	70
12	"12-out1856"	.32105	244	516	760
12	"12-out1857"	.98765	80	1	81
12	"12-out1858"	.99137	115	1	116
12	"12-out1859"	.98979	97	1	98
12	"12-out1860"	.38293	193	311	504
12	"12-out1861"	.47996	527	571	1098
12	"12-out1862"	.31355	111	243	354
12	"12-out1863"	.71375	384	154	538
12	"12-out1864"	.31403	423	924	1347
12	"12-out1865"	.40000	242	363	605
12	"12-out1866"	.95965	666	28	694
12	"12-out1867"	.37393	132	221	353
12	"12-out1868"	.64529	151	83	234
12	"12-out1869"	.56675	208	159	367
12	"12-out1870"	.76981	204	61	265
12	"12-out1871"	.43636	72	93	165
12	"12-out1872"	.31639	193	417	610
12	"12-out1873"	.43913	303	387	690
12	"12-out1874"	.58333	231	165	396
12	"12-out1875"	.48936	161	168	329
12	"12-out1876"	.67222	242	118	360
12	"12-out1877"	.69491	246	108	354
12	"12-out1878"	.40438	203	299	502
12	"12-out1879"	.82107	670	146	816
12	"12-out1880"	.59414	142	97	239
12	"12-out1881"	.43309	123	161	284
12	"12-out1882"	.36013	103	183	286
12	"12-out1883"	.49587	481	489	970
12	"12-out1884"	.99702	335	1	336
12	"12-out1885"	.81868	149	33	182
12	"12-out1886"	.21710	33	119	152
12	"12-out1887"	.99271	409	3	412
12	"12-out1888"	.88456	636	83	719
12	"12-out1889"	.40520	280	411	691
12	"12-out1890"	.43589	306	396	702
12	"12-out1891"	.75709	1041	334	1375
12	"12-out1892"	.59149	779	538	1317
12	"12-out1893"	.59846	468	314	782
12	"12-out1894"	.96428	459	17	476
12	"12-out1895"	.99652	287	1	288
12	"12-out1896"	.98666	74	1	75
12	"12-out1897"	.16256	66	340	406
12	"12-out1898"	.63728	188	107	295
12	"12-out1899"	.53491	360	313	673
12	"12-out1900"	.21857	40	143	183
12	"12-out1901"	.72839	118	44	162
12	"12-out1902"	.99682	314	1	315
12	"12-out1903"	.65582	242	127	369
12	"12-out1904"	.99533	427	2	429
12	"12-out1905"	.48627	443	468	911
12	"12-out1906"	.30021	139	324	463
12	"12-out1907"	.44000	77	98	175
12	"12-out1908"	.70666	371	154	525
12	"12-out1909"	.14689	52	302	354
12	"12-out1910"	.21846	71	254	325
12	"12-out1911"	.84848	140	25	165
12	"12-out1912"	.22148	233	819	1052
12	"12-out1913"	.17413	101	479	580
12	"12-out1914"	.36219	205	361	566
12	"12-out1915"	.48314	86	92	178
12	"12-out1916"	.28833	173	427	600
12	"12-out1917"	.99678	310	1	311
12	"12-out1918"	.65925	178	92	270
12	"12-out1919"	.47154	116	130	246
12	"12-out1920"	.41266	215	306	521
12	"12-out1921"	.32688	355	731	1086
12	"12-out1922"	.40588	317	464	781
12	"12-out1923"	.46168	482	562	1044
12	"12-out1924"	.31131	311	688	999
12	"12-out1925"	.45810	82	97	179
12	"12-out1926"	.52845	520	464	984
12	"12-out1927"	.64827	282	153	435
12	"12-out1928"	.36412	205	358	563
12	"12-out1929"	.47340	89	99	188
12	"12-out1930"	.88571	124	16	140
12	"12-out1931"	.43478	50	65	115
12	"12-out1932"	.31992	175	372	547
12	"12-out1933"	.30107	140	325	465
12	"12-out1934"	.42575	496	669	1165
12	"12-out1935"	.43589	34	44	78
12	"12-out1936"	.34862	190	355	545
12	"12-out1937"	.44273	259	326	585
12	"12-out1938"	.49316	469	482	951
12	"12-out1939"	.43880	398	509	907
12	"12-out1940"	.99779	452	1	453
12	"12-out1941"	.36175	314	554	868
12	"12-out1942"	.50445	510	501	1011
12	"12-out1943"	.99792	480	1	481
12	"12-out1944"	.40490	198	291	489
12	"12-out1945"	.63219	923	537	1460
12	"12-out1946"	.99858	706	1	707
12	"12-out1947"	.99224	128	1	129
12	"12-out1948"	.53654	903	780	1683
12	"12-out1949"	.40892	229	331	560
12	"12-out1950"	.99921	1274	1	1275
12	"12-out1951"	.51567	296	278	574
12	"12-out1952"	.20218	37	146	183
12	"12-out1953"	.38504	345	551	896
12	"12-out1954"	.20261	124	488	612
12	"12-out1955"	.45508	228	273	501
12	"12-out1956"	.99750	399	1	400
12	"12-out1957"	.41788	229	319	548
12	"12-out1958"	.67567	250	120	370
12	"12-out1959"	.49797	123	124	247
12	"12-out1960"	.48500	97	103	200
12	"12-out1961"	.50184	272	270	542
12	"12-out1962"	.39759	264	400	664
12	"12-out1963"	.40143	279	416	695
12	"12-out1964"	.61214	262	166	428
12	"12-out1965"	.40049	161	241	402
12	"12-out1966"	.32413	47	98	145
12	"12-out1967"	.47531	260	287	547
12	"12-out1968"	.71708	1389	548	1937
12	"12-out1969"	.50253	99	98	197
12	"12-out1970"	.51228	396	377	773
12	"12-out1971"	.33685	287	565	852
12	"12-out1972"	.26741	238	652	890
12	"12-out1973"	.27849	237	614	851
12	"12-out1974"	.27225	156	417	573
12	"12-out1975"	.22848	154	520	674
12	"12-out1976"	.31561	190	412	602
12	"12-out1977"	.99894	946	1	947
12	"12-out1978"	.57852	291	212	503
12	"12-out1979"	.32375	259	541	800
12	"12-out1980"	.47468	150	166	316
12	"12-out1981"	.64285	153	85	238
12	"12-out1982"	.95628	350	16	366
12	"12-out1983"	.37701	210	347	557
12	"12-out1984"	.25619	93	270	363
12	"12-out1985"	.30788	125	281	406
12	"12-out1986"	.51378	205	194	399
12	"12-out1987"	.34782	72	135	207
12	"12-out1988"	.34763	235	441	676
12	"12-out1989"	.35846	271	485	756
12	"12-out1990"	.29945	109	255	364
12	"12-out1991"	.35339	681	1246	1927
12	"12-out1992"	.14245	50	301	351
12	"12-out1993"	.48927	251	262	513
12	"12-out1994"	.54113	171	145	316
12	"12-out1995"	.34925	234	436	670
12	"12-out1996"	.25757	51	147	198
12	"12-out1997"	.24375	156	484	640
12	"12-out1998"	.99919	1246	1	1247
12	"12-out1999"	.35592	1019	1844	2863
12	"12-out2000"	.31167	235	519	754
12	"12-out2001"	.35600	89	161	250
12	"12-out2002"	.49580	473	481	954
12	"12-out2003"	.15133	153	858	1011
12	"12-out2004"	.39952	338	508	846
12	"12-out2005"	.99808	522	1	523
12	"12-out2006"	.40716	125	182	307
12	"12-out2007"	.35814	534	957	1491
12	"12-out2008"	.41695	482	674	1156
12	"12-out2009"	.36176	263	464	727
12	"12-out2010"	.74566	129	44	173
12	"12-out2011"	.36580	169	293	462
12	"12-out2012"	.44202	1239	1564	2803
12	"12-out2013"	.39300	191	295	486
12	"12-out2014"	.29375	47	113	160
12	"12-out2015"	.60504	72	47	119
12	"12-out2016"	.99887	891	1	892
12	"12-out2017"	.74873	742	249	991
12	"12-out2018"	.29025	283	692	975
12	"12-out2019"	.22651	123	420	543
12	"12-out2020"	.27217	135	361	496
12	"12-out2021"	.23493	117	381	498
12	"12-out2022"	.34272	146	280	426
12	"12-out2023"	.35419	515	939	1454
12	"12-out2024"	.47710	198	217	415
12	"12-out2025"	.50000	87	87	174
12	"12-out2026"	.56598	446	342	788
12	"12-out2027"	.42987	377	500	877
12	"12-out2028"	.21212	56	208	264
12	"12-out2029"	.24064	238	751	989
12	"12-out2030"	.39694	52	79	131
12	"12-out2031"	.78651	140	38	178
12	"12-out2032"	.47639	111	122	233
12	"12-out2033"	.36164	132	233	365
12	"12-out2034"	.34883	165	308	473
12	"12-out2035"	.23859	272	868	1140
12	"12-out2036"	.51495	310	292	602
12	"12-out2037"	.99822	562	1	563
12	"12-out2038"	.57934	230	167	397
12	"12-out2039"	.98507	330	5	335
12	"12-out2040"	.45330	233	281	514
12	"12-out2041"	.53667	139	120	259
12	"12-out2042"	.99744	391	1	392
12	"12-out2043"	.44557	131	163	294
12	"12-out2044"	.48638	125	132	257
12	"12-out2045"	.57611	193	142	335
12	"12-out2046"	.38418	272	436	708
12	"12-out2047"	.37702	279	461	740
12	"12-out2048"	.49722	179	181	360
12	"12-out2049"	.53125	187	165	352
12	"12-out2050"	.51413	200	189	389
12	"12-out2051"	.99259	134	1	135
12	"12-out2052"	.44247	50	63	113
12	"12-out2053"	.20340	335	1312	1647
12	"12-out2054"	.99685	317	1	318
12	"12-out2055"	.35179	108	199	307
12	"12-out2056"	.60230	209	138	347
12	"12-out2057"	.42956	369	490	859
12	"12-out2058"	.65014	223	120	343
12	"12-out2059"	.99681	313	1	314
12	"12-out2060"	.88012	279	38	317
12	"12-out2061"	.86290	107	17	124
12	"12-out2062"	.49659	219	222	441
12	"12-out2063"	.54491	182	152	334
12	"12-out2064"	.37908	58	95	153
12	"12-out2065"	.42058	143	197	340
12	"12-out2066"	.40536	242	355	597
12	"12-out2067"	.37508	578	963	1541
12	"12-out2068"	.32496	414	860	1274
12	"12-out2069"	.51619	271	254	525
12	"12-out2070"	.57462	154	114	268
12	"12-out2071"	.97058	66	2	68
12	"12-out2072"	.32252	189	397	586
12	"12-out2073"	.29166	112	272	384
12	"12-out2074"	.49127	169	175	344
12	"12-out2075"	.99576	235	1	236
12	"12-out2076"	.98245	112	2	114
12	"12-out2077"	.89830	106	12	118
12	"12-out2078"	.31313	62	136	198
12	"12-out2079"	.55434	102	82	184
12	"12-out2080"	.99386	162	1	163
12	"12-out2081"	.46285	81	94	175
12	"12-out2082"	.99431	175	1	176
12	"12-out2083"	.38205	230	372	602
12	"12-out2084"	.40000	32	48	80
12	"12-out2085"	.25790	106	305	411
12	"12-out2086"	.18498	69	304	373
12	"12-out2087"	.65361	217	115	332
12	"12-out2088"	.85029	284	50	334
12	"12-out2089"	.91867	305	27	332
12	"12-out2090"	.98630	144	2	146
12	"12-out2091"	.51120	251	240	491
12	"12-out2092"	.25898	173	495	668
12	"12-out2093"	.62269	236	143	379
12	"12-out2094"	.19138	80	338	418
12	"12-out2095"	.94808	347	19	366
12	"12-out2096"	.47407	128	142	270
12	"12-out2097"	.45108	83	101	184
12	"12-out2098"	.44090	97	123	220
12	"12-out2099"	.48404	531	566	1097
12	"12-out2100"	.43797	519	666	1185
12	"12-out2101"	.78305	231	64	295
12	"12-out2102"	.47091	421	473	894
12	"12-out2103"	.53647	228	197	425
12	"12-out2104"	.33333	47	94	141
12	"12-out2105"	.33980	70	136	206
12	"12-out2106"	.49759	724	731	1455
12	"12-out2107"	.47802	87	95	182
12	"12-out2108"	.93464	143	10	153
12	"12-out2109"	.34360	145	277	422
12	"12-out2110"	.79452	116	30	146
12	"12-out2111"	.41103	298	427	725
12	"12-out2112"	.33905	237	462	699
12	"12-out2113"	.52412	239	217	456
12	"12-out2114"	.98771	402	5	407
12	"12-out2115"	.38078	214	348	562
12	"12-out2116"	.35087	160	296	456
12	"12-out2117"	.55679	250	199	449
12	"12-out2118"	.51737	268	250	518
12	"12-out2119"	.38852	298	469	767
12	"12-out2120"	.47815	197	215	412
12	"12-out2121"	.32222	145	305	450
12	"12-out2122"	.97435	418	11	429
12	"12-out2123"	.87992	2213	302	2515
12	"12-out2124"	.99623	529	2	531
12	"12-out2125"	.36119	121	214	335
12	"12-out2126"	.39614	185	282	467
12	"12-out2127"	.37323	53	89	142
12	"12-out2128"	.85220	542	94	636
12	"12-out2129"	.52229	246	225	471
12	"12-out2130"	.99799	498	1	499
12	"12-out2131"	.28638	122	304	426
12	"12-out2132"	.99047	312	3	315
12	"12-out2133"	.47756	149	163	312
12	"12-out2134"	.99356	309	2	311
12	"12-out2135"	.36923	216	369	585
12	"12-out2136"	.32812	147	301	448
12	"12-out2137"	.53184	167	147	314
12	"12-out2138"	.37125	124	210	334
12	"12-out2139"	.45731	150	178	328
12	"12-out2140"	.94025	299	19	318
12	"12-out2141"	.89714	471	54	525
12	"12-out2142"	.31794	792	1699	2491
12	"12-out2143"	.57643	181	133	314
12	"12-out2144"	.36942	116	198	314
12	"12-out2145"	.97727	301	7	308
12	"12-out2146"	.96035	654	27	681
12	"12-out2147"	.99657	291	1	292
12	"12-out2148"	.99827	579	1	580
12	"12-out2149"	.35737	109	196	305
12	"12-out2150"	.99636	274	1	275
12	"12-out2151"	.24349	159	494	653
12	"12-out2152"	.40540	105	154	259
12	"12-out2153"	.46376	160	185	345
12	"12-out2154"	.22162	82	288	370
12	"12-out2155"	.86904	219	33	252
12	"12-out2156"	.99280	138	1	139
12	"12-out2157"	.43759	284	365	649
12	"12-out2158"	.35810	106	190	296
12	"12-out2159"	.37614	123	204	327
12	"12-out2160"	.98989	196	2	198
12	"12-out2161"	.30486	207	472	679
12	"12-out2162"	.29125	233	567	800
12	"12-out2163"	.85145	321	56	377
12	"12-out2164"	.30031	188	438	626
12	"12-out2165"	.38988	131	205	336
12	"12-out2166"	.60061	194	129	323
12	"12-out2167"	.39301	540	834	1374
12	"12-out2168"	.48679	295	311	606
12	"12-out2169"	.30528	185	421	606
12	"12-out2170"	.99750	400	1	401
12	"12-out2171"	.33731	113	222	335
12	"12-out2172"	.89024	146	18	164
12	"12-out2173"	.40604	430	629	1059
12	"12-out2174"	.16666	101	505	606
12	"12-out2175"	.45970	348	409	757
12	"12-out2176"	.43467	173	225	398
12	"12-out2177"	.39716	168	255	423
12	"12-out2178"	.55737	204	162	366
12	"12-out2179"	.35588	142	257	399
12	"12-out2180"	.36597	228	395	623
12	"12-out2181"	.53470	339	295	634
12	"12-out2182"	.51666	279	261	540
12	"12-out2183"	.31506	115	250	365
12	"12-out2184"	.32627	185	382	567
12	"12-out2185"	.33478	231	459	690
12	"12-out2186"	.64000	160	90	250
12	"12-out2187"	.42612	845	1138	1983
12	"12-out2188"	.52519	396	358	754
12	"12-out2189"	.88782	277	35	312
12	"12-out2190"	.34130	257	496	753
12	"12-out2191"	.99242	131	1	132
12	"12-out2192"	.49067	684	710	1394
12	"12-out2193"	.51873	180	167	347
12	"12-out2194"	.31521	58	126	184
12	"12-out2195"	.61095	212	135	347
12	"12-out2196"	.54006	155	132	287
12	"12-out2197"	.47084	323	363	686
12	"12-out2198"	.32026	98	208	306
12	"12-out2199"	.33958	380	739	1119
12	"12-out2200"	.56298	581	451	1032
12	"12-out2201"	.33003	100	203	303
12	"12-out2202"	.99319	146	1	147
12	"12-out2203"	.39189	87	135	222
12	"12-out2204"	.71232	156	63	219
12	"12-out2205"	.99264	135	1	136
12	"12-out2206"	.80932	191	45	236
12	"12-out2207"	.73802	524	186	710
12	"12-out2208"	.63833	736	417	1153
12	"12-out2209"	.48241	1125	1207	2332
12	"12-out2210"	.37675	1102	1823	2925
12	"12-out2211"	.50104	239	238	477
12	"12-out2212"	.33451	188	374	562
12	"12-out2213"	.25676	370	1071	1441
12	"12-out2214"	.38908	328	515	843
12	"12-out2215"	.46985	265	299	564
12	"12-out2216"	.77130	371	110	481
12	"12-out2217"	.42031	240	331	571
12	"12-out2218"	.26801	119	325	444
12	"12-out2219"	.99915	1184	1	1185
12	"12-out2220"	.28505	124	311	435
12	"12-out2221"	.18750	27	117	144
12	"12-out2222"	.65771	98	51	149
12	"12-out2223"	.55172	80	65	145
12	"12-out2224"	.36363	64	112	176
12	"12-out2225"	.85638	161	27	188
12	"12-out2226"	.35338	235	430	665
12	"12-out2227"	.44947	298	365	663
12	"12-out2228"	.23931	112	356	468
12	"12-out2229"	.35617	343	620	963
12	"12-out2230"	.26659	237	652	889
12	"12-out2231"	.39120	347	540	887
12	"12-out2232"	.30604	415	941	1356
12	"12-out2233"	.30225	94	217	311
12	"12-out2234"	.43830	238	305	543
12	"12-out2235"	.89709	340	39	379
12	"12-out2236"	.35439	129	235	364
12	"12-out2237"	.27794	92	239	331
12	"12-out2238"	.35950	174	310	484
12	"12-out2239"	.99601	250	1	251
12	"12-out2240"	.80882	55	13	68
12	"12-out2241"	.59269	211	145	356
12	"12-out2242"	.99247	791	6	797
12	"12-out2243"	.99122	791	7	798
12	"12-out2244"	.88506	824	107	931
12	"12-out2245"	.97331	766	21	787
12	"12-out2246"	.20967	91	343	434
12	"12-out2247"	.34985	374	695	1069
12	"12-out2248"	.88669	853	109	962
12	"12-out2249"	.90516	859	90	949
12	"12-out2250"	.32151	263	555	818
12	"12-out2251"	.72431	578	220	798
12	"12-out2252"	.39453	101	155	256
12	"12-out2253"	.39428	138	212	350
12	"12-out2254"	.42021	158	218	376
12	"12-out2255"	.37436	222	371	593
12	"12-out2256"	.25217	87	258	345
12	"12-out2257"	.99728	367	1	368
12	"12-out2258"	.92952	488	37	525
12	"12-out2259"	.42945	277	368	645
12	"12-out2260"	.40655	211	308	519
12	"12-out2261"	.36739	151	260	411
12	"12-out2262"	.66267	886	451	1337
12	"12-out2263"	.43331	627	820	1447
12	"12-out2264"	.67019	317	156	473
12	"12-out2265"	.37948	148	242	390
12	"12-out2266"	.49339	112	115	227
12	"12-out2267"	.99751	401	1	402
12	"12-out2268"	.99864	737	1	738
12	"12-out2269"	.49320	399	410	809
12	"12-out2270"	.86148	510	82	592
12	"12-out2271"	.49452	316	323	639
12	"12-out2272"	.32590	190	393	583
12	"12-out2273"	.48643	520	549	1069
12	"12-out2274"	.51594	275	258	533
12	"12-out2275"	.35025	207	384	591
12	"12-out2276"	.30373	366	839	1205
12	"12-out2277"	.31498	269	585	854
12	"12-out2278"	.24046	82	259	341
12	"12-out2279"	.49950	1011	1013	2024
12	"12-out2280"	.30156	193	447	640
12	"12-out2281"	.57142	204	153	357
12	"12-out2282"	.46342	1546	1790	3336
12	"12-out2283"	.32302	564	1182	1746
12	"12-out2284"	.48794	506	531	1037
12	"12-out2285"	.23684	99	319	418
12	"12-out2286"	.65960	467	241	708
12	"12-out2287"	.63736	116	66	182
12	"12-out2288"	.37293	113	190	303
12	"12-out2289"	.39230	51	79	130
12	"12-out2290"	.28051	108	277	385
12	"12-out2291"	.24305	105	327	432
12	"12-out2292"	.33422	249	496	745
12	"12-out2293"	.38384	461	740	1201
12	"12-out2294"	.41029	279	401	680
12	"12-out2295"	.34871	68	127	195
12	"12-out2296"	.99864	736	1	737
12	"12-out2297"	.44687	143	177	320
12	"12-out2298"	.83858	213	41	254
12	"12-out2299"	.49236	258	266	524
12	"12-out2300"	.66507	139	70	209
12	"12-out2301"	.95490	360	17	377
12	"12-out2302"	.35164	96	177	273
12	"12-out2303"	.23939	79	251	330
12	"12-out2304"	.28647	108	269	377
12	"12-out2305"	.75661	143	46	189
12	"12-out2306"	.87006	1500	224	1724
12	"12-out2307"	.14322	56	335	391
12	"12-out2308"	.30222	136	314	450
12	"12-out2309"	.72876	266	99	365
12	"12-out2310"	.99119	788	7	795
12	"12-out2311"	.97856	776	17	793
12	"12-out2312"	.34082	182	352	534
12	"12-out2313"	.99250	794	6	800
12	"12-out2314"	.98619	786	11	797
12	"12-out2315"	.50551	275	269	544
12	"12-out2316"	.88457	820	107	927
12	"12-out2317"	.98067	761	15	776
12	"12-out2318"	.90631	861	89	950
12	"12-out2319"	.88197	822	110	932
12	"12-out2320"	.88304	823	109	932
12	"12-out2321"	.60833	511	329	840
12	"12-out2322"	.90860	855	86	941
12	"12-out2323"	.38319	187	301	488
12	"12-out2324"	.67279	695	338	1033
12	"12-out2325"	.52221	670	613	1283
12	"12-out2326"	.45454	70	84	154
12	"12-out2327"	.99492	196	1	197
12	"12-out2328"	.42175	159	218	377
12	"12-out2329"	.32852	205	419	624
12	"12-out2330"	.42365	763	1038	1801
12	"12-out2331"	.40560	275	403	678
12	"12-out2332"	.24870	96	290	386
12	"12-out2333"	.49913	289	290	579
12	"12-out2334"	.27764	118	307	425
12	"12-out2335"	.35073	168	311	479
12	"12-out2336"	.66764	227	113	340
12	"12-out2337"	.39846	673	1016	1689
12	"12-out2338"	.44158	223	282	505
12	"12-out2339"	.98496	786	12	798
12	"12-out2340"	.65813	283	147	430
12	"12-out2341"	.90315	858	92	950
12	"12-out2342"	.26226	246	692	938
12	"12-out2343"	.85188	903	157	1060
12	"12-out2344"	.88304	823	109	932
12	"12-out2345"	.43107	172	227	399
12	"12-out2346"	.22585	159	545	704
12	"12-out2347"	.90717	860	88	948
12	"12-out2348"	.98241	782	14	796
12	"12-out2349"	.46115	279	326	605
12	"12-out2350"	.99004	398	4	402
12	"12-out2351"	.22346	80	278	358
12	"12-out2352"	.99465	186	1	187
12	"12-out2353"	.85563	243	41	284
12	"12-out2354"	.43821	305	391	696
12	"12-out2355"	.28571	74	185	259
12	"12-out2356"	.38817	243	383	626
12	"12-out2357"	.72727	112	42	154
12	"12-out2358"	.43979	431	549	980
12	"12-out2359"	.43343	140	183	323
12	"12-out2360"	.99253	133	1	134
12	"12-out2361"	.23846	186	594	780
12	"12-out2362"	.99470	188	1	189
12	"12-out2363"	.76271	2459	765	3224
12	"12-out2364"	.50650	467	455	922
12	"12-out2365"	.38461	75	120	195
12	"12-out2366"	.26740	96	263	359
12	"12-out2367"	.36224	71	125	196
12	"12-out2368"	.51419	326	308	634
12	"12-out2369"	.69750	279	121	400
12	"12-out2370"	.66149	256	131	387
12	"12-out2371"	.73962	784	276	1060
12	"12-out2372"	.32926	81	165	246
12	"12-out2373"	.41933	720	997	1717
12	"12-out2374"	.99917	1207	1	1208
12	"12-out2375"	.41775	414	577	991
12	"12-out2376"	.99236	130	1	131
12	"12-out2377"	.27476	86	227	313
12	"12-out2378"	.38263	119	192	311
12	"12-out2379"	.88343	288	38	326
12	"12-out2380"	.98000	98	2	100
12	"12-out2381"	.31578	132	286	418
12	"12-out2382"	.42322	113	154	267
12	"12-out2383"	.98711	383	5	388
12	"12-out2384"	.44234	234	295	529
12	"12-out2385"	.33561	491	972	1463
12	"12-out2386"	.32122	168	355	523
12	"12-out2387"	.34738	610	1146	1756
12	"12-out2388"	.32252	179	376	555
12	"12-out2389"	.88195	523	70	593
12	"12-out2390"	.88729	370	47	417
12	"12-out2391"	.20524	227	879	1106
12	"12-out2392"	.15789	33	176	209
12	"12-out2393"	.28298	163	413	576
12	"12-out2394"	.42754	239	320	559
12	"12-out2395"	.40883	287	415	702
12	"12-out2396"	.27551	108	284	392
12	"12-out2397"	.35904	135	241	376
12	"12-out2398"	.42680	242	325	567
12	"12-out2399"	.35275	442	811	1253
12	"12-out2400"	.98711	383	5	388
12	"12-out2401"	.60227	159	105	264
12	"12-out2402"	.95901	117	5	122
12	"12-out2403"	.41967	128	177	305
12	"12-out2404"	.43431	162	211	373
12	"12-out2405"	.32975	123	250	373
12	"12-out2406"	.45608	405	483	888
12	"12-out2407"	.31206	181	399	580
12	"12-out2408"	.98705	991	13	1004
12	"12-out2409"	.26877	272	740	1012
12	"12-out2410"	.89156	444	54	498
12	"12-out2411"	.31034	126	280	406
12	"12-out2412"	.31476	113	246	359
12	"12-out2413"	.27051	211	569	780
12	"12-out2414"	.50844	301	291	592
12	"12-out2415"	.23984	124	393	517
12	"12-out2416"	.65256	216	115	331
12	"12-out2417"	.52758	306	274	580
12	"12-out2418"	.50000	281	281	562
12	"12-out2419"	.99264	270	2	272
12	"12-out2420"	.41528	125	176	301
12	"12-out2421"	.71259	781	315	1096
12	"12-out2422"	.44384	905	1134	2039
12	"12-out2423"	.37749	379	625	1004
12	"12-out2424"	.31758	121	260	381
12	"12-out2425"	.41421	548	775	1323
12	"12-out2426"	.99773	441	1	442
12	"12-out2427"	.61801	199	123	322
12	"12-out2428"	.39376	467	719	1186
12	"12-out2429"	.36363	88	154	242
12	"12-out2430"	.33505	325	645	970
12	"12-out2431"	.32446	122	254	376
12	"12-out2432"	.29929	340	796	1136
12	"12-out2433"	.44578	222	276	498
12	"12-out2434"	.99367	157	1	158
12	"12-out2435"	.67006	394	194	588
12	"12-out2436"	.41058	287	412	699
12	"12-out2437"	.99430	349	2	351
12	"12-out2438"	.99883	857	1	858
12	"12-out2439"	.99947	3841	2	3843
12	"12-out2440"	.24975	256	769	1025
12	"12-out2441"	.31644	456	985	1441
12	"12-out2442"	.42211	271	371	642
12	"12-out2443"	.34945	159	296	455
12	"12-out2444"	.38265	150	242	392
12	"12-out2445"	.57175	247	185	432
12	"12-out2446"	.40419	135	199	334
12	"12-out2447"	.99090	109	1	110
12	"12-out2448"	.91011	81	8	89
12	"12-out2449"	.98913	91	1	92
12	"12-out2450"	.43384	141	184	325
12	"12-out2451"	.43191	314	413	727
12	"12-out2452"	.49698	165	167	332
12	"12-out2453"	.39842	202	305	507
12	"12-out2454"	.27624	50	131	181
12	"12-out2455"	.82138	607	132	739
12	"12-out2456"	.67741	42	20	62
12	"12-out2457"	.99730	370	1	371
12	"12-out2458"	.28111	201	514	715
12	"12-out2459"	.40409	217	320	537
12	"12-out2460"	.37810	152	250	402
12	"12-out2461"	.44334	180	226	406
12	"12-out2462"	.44881	57	70	127
12	"12-out2463"	.32520	80	166	246
12	"12-out2464"	.38998	296	463	759
12	"12-out2465"	.48324	577	617	1194
12	"12-out2466"	.62500	165	99	264
12	"12-out2467"	.29940	50	117	167
12	"12-out2468"	.24310	141	439	580
12	"12-out2469"	.46758	238	271	509
12	"12-out2470"	.58447	128	91	219
12	"12-out2471"	.52107	309	284	593
12	"12-out2472"	.72000	234	91	325
12	"12-out2473"	.24633	84	257	341
12	"12-out2474"	.40480	202	297	499
12	"12-out2475"	.98159	480	9	489
12	"12-out2476"	.95238	460	23	483
12	"12-out2477"	.99832	597	1	598
12	"12-out2478"	.26947	128	347	475
12	"12-out2479"	.83468	722	143	865
12	"12-out2480"	.48876	87	91	178
12	"12-out2481"	.88038	184	25	209
12	"12-out2482"	.38186	278	450	728
12	"12-out2483"	.52552	350	316	666
12	"12-out2484"	.94301	331	20	351
12	"12-out2485"	.29487	115	275	390
12	"12-out2486"	.34760	138	259	397
12	"12-out2487"	.60705	241	156	397
12	"12-out2488"	.31896	37	79	116
12	"12-out2489"	.62608	288	172	460
12	"12-out2490"	.57989	225	163	388
12	"12-out2491"	.40763	267	388	655
12	"12-out2492"	.23687	167	538	705
12	"12-out2493"	.50884	115	111	226
12	"12-out2494"	.58247	113	81	194
12	"12-out2495"	.41076	145	208	353
12	"12-out2496"	.46606	309	354	663
12	"12-out2497"	.59593	205	139	344
12	"12-out2498"	.72960	483	179	662
12	"12-out2499"	.54198	71	60	131
12	"12-out2500"	.69683	154	67	221
12	"12-out2501"	.99404	167	1	168
12	"12-out2502"	.22829	71	240	311
12	"12-out2503"	.24438	87	269	356
12	"12-out2504"	.35964	82	146	228
12	"12-out2505"	.81702	1027	230	1257
12	"12-out2506"	.36059	388	688	1076
12	"12-out2507"	.30376	137	314	451
12	"12-out2508"	.46021	214	251	465
12	"12-out2509"	.50535	236	231	467
12	"12-out2510"	.82682	339	71	410
12	"12-out2511"	.99776	447	1	448
12	"12-out2512"	.28571	46	115	161
12	"12-out2513"	.55192	186	151	337
12	"12-out2514"	.20921	59	223	282
12	"12-out2515"	.64285	27	15	42
12	"12-out2516"	.51020	250	240	490
12	"12-out2517"	.30938	465	1038	1503
12	"12-out2518"	.38743	148	234	382
12	"12-out2519"	.36518	214	372	586
12	"12-out2520"	.22500	189	651	840
12	"12-out2521"	.26811	111	303	414
12	"12-out2522"	.54182	285	241	526
12	"12-out2523"	.33333	55	110	165
12	"12-out2524"	.99180	121	1	122
12	"12-out2525"	.44540	155	193	348
12	"12-out2526"	.41176	210	300	510
12	"12-out2527"	.16336	33	169	202
12	"12-out2528"	.23225	144	476	620
12	"12-out2529"	.54054	320	272	592
12	"12-out2530"	.46774	174	198	372
12	"12-out2531"	.59090	377	261	638
12	"12-out2532"	.35690	429	773	1202
12	"12-out2533"	.37563	74	123	197
12	"12-out2534"	.57569	270	199	469
12	"12-out2535"	.99830	589	1	590
12	"12-out2536"	.50000	687	687	1374
12	"12-out2537"	.22752	81	275	356
12	"12-out2538"	.71679	1387	548	1935
12	"12-out2539"	.51351	190	180	370
12	"12-out2540"	.29198	226	548	774
12	"12-out2541"	.33587	176	348	524
12	"12-out2542"	.64820	199	108	307
12	"12-out2543"	.51162	176	168	344
12	"12-out2544"	.48161	131	141	272
12	"12-out2545"	.31532	251	545	796
12	"12-out2546"	.27826	64	166	230
12	"12-out2547"	.25167	75	223	298
12	"12-out2548"	.36832	193	331	524
12	"12-out2549"	.29259	170	411	581
12	"12-out2550"	.20196	144	569	713
12	"12-out2551"	.43353	1970	2574	4544
12	"12-out2552"	.33728	199	391	590
12	"12-out2553"	.99019	101	1	102
12	"12-out2554"	.40000	148	222	370
12	"12-out2555"	.34908	229	427	656
12	"12-out2556"	.50428	294	289	583
12	"12-out2557"	.41366	539	764	1303
12	"12-out2558"	.50394	447	440	887
12	"12-out2559"	.99333	149	1	150
12	"12-out2560"	.48131	850	916	1766
12	"12-out2561"	.17311	85	406	491
12	"12-out2562"	.99371	158	1	159
12	"12-out2563"	.37898	119	195	314
12	"12-out2564"	.99581	238	1	239
12	"12-out2565"	.28040	196	503	699
12	"12-out2566"	.24327	235	731	966
12	"12-out2567"	.38057	239	389	628
12	"12-out2568"	.28418	106	267	373
12	"12-out2569"	.52941	252	224	476
12	"12-out2570"	.55681	98	78	176
12	"12-out2571"	.69435	209	92	301
12	"12-out2572"	.29455	238	570	808
12	"12-out2573"	.41772	231	322	553
12	"12-out2574"	.33835	292	571	863
12	"12-out2575"	.24523	180	554	734
12	"12-out2576"	.31065	105	233	338
12	"12-out2577"	.57370	611	454	1065
12	"12-out2578"	.63397	1183	683	1866
12	"12-out2579"	.49016	274	285	559
12	"12-out2580"	.35483	253	460	713
12	"12-out2581"	.40792	350	508	858
12	"12-out2582"	.99479	191	1	192
12	"12-out2583"	.34821	195	365	560
12	"12-out2584"	.38461	280	448	728
12	"12-out2585"	.80851	114	27	141
12	"12-out2586"	.70350	261	110	371
12	"12-out2587"	.99145	116	1	117
12	"12-out2588"	.99186	122	1	123
12	"12-out2589"	.99193	123	1	124
12	"12-out2590"	.99180	121	1	122
12	"12-out2591"	.99186	122	1	123
12	"12-out2592"	.42792	95	127	222
12	"12-out2593"	.44278	89	112	201
12	"12-out2594"	.49109	193	200	393
12	"12-out2595"	.64651	139	76	215
12	"12-out2596"	.34872	302	564	866
12	"12-out2597"	.52105	99	91	190
12	"12-out2598"	.39171	123	191	314
12	"12-out2599"	.99242	131	1	132
12	"12-out2600"	.70512	110	46	156
12	"12-out2601"	.32533	271	562	833
12	"12-out2602"	.41707	342	478	820
12	"12-out2603"	.53815	543	466	1009
12	"12-out2604"	.54335	188	158	346
12	"12-out2605"	.69364	240	106	346
12	"12-out2606"	.99711	346	1	347
12	"12-out2607"	.67283	218	106	324
12	"12-out2608"	.36256	583	1025	1608
12	"12-out2609"	.99681	313	1	314
12	"12-out2610"	.46967	395	446	841
12	"12-out2611"	.58675	514	362	876
12	"12-out2612"	.70570	235	98	333
12	"12-out2613"	.33307	429	859	1288
12	"12-out2614"	.35313	220	403	623
12	"12-out2615"	.99953	2155	1	2156
12	"12-out2616"	.38752	441	697	1138
12	"12-out2617"	.50413	122	120	242
12	"12-out2618"	.30824	172	386	558
12	"12-out2619"	.59956	274	183	457
12	"12-out2620"	.26136	69	195	264
12	"12-out2621"	.29643	158	375	533
12	"12-out2622"	.48397	438	467	905
12	"12-out2623"	.40155	155	231	386
12	"12-out2624"	.53693	298	257	555
12	"12-out2625"	.79200	99	26	125
12	"12-out2626"	.18810	117	505	622
12	"12-out2627"	.86068	729	118	847
12	"12-out2628"	.30650	99	224	323
12	"12-out2629"	.31443	122	266	388
12	"12-out2630"	.90229	157	17	174
12	"12-out2631"	.16393	10	51	61
12	"12-out2632"	.52000	130	120	250
12	"12-out2633"	.48821	290	304	594
12	"12-out2634"	.76905	333	100	433
12	"12-out2635"	.38159	369	598	967
12	"12-out2636"	.70762	167	69	236
12	"12-out2637"	.48331	362	387	749
12	"12-out2638"	.54506	127	106	233
12	"12-out2639"	.26598	233	643	876
12	"12-out2640"	.39826	92	139	231
12	"12-out2641"	.30402	121	277	398
12	"12-out2642"	.99316	436	3	439
12	"12-out2643"	.62371	121	73	194
12	"12-out2644"	.97147	613	18	631
12	"12-out2645"	.37901	177	290	467
12	"12-out2646"	.55408	1086	874	1960
12	"12-out2647"	.36913	354	605	959
12	"12-out2648"	.58974	115	80	195
12	"12-out2649"	.99421	172	1	173
12	"12-out2650"	.76442	159	49	208
12	"12-out2651"	.89403	135	16	151
12	"12-out2652"	.74418	128	44	172
12	"12-out2653"	.43873	333	426	759
12	"12-out2654"	.24963	516	1551	2067
12	"12-out2655"	.42204	157	215	372
12	"12-out2656"	.36961	163	278	441
12	"12-out2657"	.71551	581	231	812
12	"12-out2658"	.27049	132	356	488
12	"12-out2659"	.40809	131	190	321
12	"12-out2660"	.44905	238	292	530
12	"12-out2661"	.43953	338	431	769
12	"12-out2662"	.50796	319	309	628
12	"12-out2663"	.41417	263	372	635
12	"12-out2664"	.29792	115	271	386
12	"12-out2665"	.19169	60	253	313
12	"12-out2666"	.78017	362	102	464
12	"12-out2667"	.45980	286	336	622
12	"12-out2668"	.37051	1704	2895	4599
12	"12-out2669"	.28413	489	1232	1721
12	"12-out2670"	.99193	123	1	124
12	"12-out2671"	.99130	114	1	115
12	"12-out2672"	.99107	111	1	112
12	"12-out2673"	.39330	94	145	239
12	"12-out2674"	.99186	122	1	123
12	"12-out2675"	.36329	97	170	267
12	"12-out2676"	.35944	156	278	434
12	"12-out2677"	.20400	102	398	500
12	"12-out2678"	.53619	200	173	373
12	"12-out2679"	.85571	427	72	499
12	"12-out2680"	.98996	296	3	299
12	"12-out2681"	.94769	616	34	650
12	"12-out2682"	.45499	278	333	611
12	"12-out2683"	.48461	378	402	780
12	"12-out2684"	.23121	40	133	173
12	"12-out2685"	.99873	787	1	788
12	"12-out2686"	.39838	247	373	620
12	"12-out2687"	.37166	223	377	600
12	"12-out2688"	.46998	321	362	683
12	"12-out2689"	.99371	158	1	159
12	"12-out2690"	.36248	286	503	789
12	"12-out2691"	.19710	68	277	345
12	"12-out2692"	.50588	387	378	765
12	"12-out2693"	.50738	275	267	542
12	"12-out2694"	.21951	27	96	123
12	"12-out2695"	.31610	208	450	658
12	"12-out2696"	.99130	114	1	115
12	"12-out2697"	.99130	114	1	115
12	"12-out2698"	.26034	107	304	411
12	"12-out2699"	.41590	136	191	327
12	"12-out2700"	.38638	403	640	1043
12	"12-out2701"	.38060	416	677	1093
12	"12-out2702"	.32623	567	1171	1738
12	"12-out2703"	.99811	1060	2	1062
12	"12-out2704"	.99835	1212	2	1214
12	"12-out2705"	.27301	86	229	315
12	"12-out2706"	.31083	737	1634	2371
12	"12-out2707"	.95145	196	10	206
12	"12-out2708"	.49602	374	380	754
12	"12-out2709"	.28726	185	459	644
12	"12-out2710"	.41099	157	225	382
12	"12-out2711"	.35221	143	263	406
12	"12-out2712"	.19952	84	337	421
12	"12-out2713"	.99831	591	1	592
12	"12-out2714"	.48936	138	144	282
12	"12-out2715"	.34394	216	412	628
12	"12-out2716"	.96690	409	14	423
12	"12-out2717"	.72151	114	44	158
12	"12-out2718"	.20934	121	457	578
12	"12-out2719"	.56989	106	80	186
12	"12-out2720"	.93023	120	9	129
12	"12-out2721"	.98591	70	1	71
12	"12-out2722"	.30011	265	618	883
12	"12-out2723"	.38281	49	79	128
12	"12-out2724"	.52134	171	157	328
12	"12-out2725"	.51315	39	37	76
12	"12-out2726"	.52100	62	57	119
12	"12-out2727"	.46398	612	707	1319
12	"12-out2728"	.46351	470	544	1014
12	"12-out2729"	.89600	112	13	125
12	"12-out2730"	.29607	98	233	331
12	"12-out2731"	.28773	61	151	212
12	"12-out2732"	.29032	54	132	186
12	"12-out2733"	.39473	60	92	152
12	"12-out2734"	.75000	114	38	152
12	"12-out2735"	.36208	529	932	1461
12	"12-out2736"	.34661	261	492	753
12	"12-out2737"	.52804	273	244	517
12	"12-out2738"	.39411	201	309	510
12	"12-out2739"	.29310	136	328	464
12	"12-out2740"	.24172	73	229	302
12	"12-out2741"	.33728	199	391	590
12	"12-out2742"	.37907	337	552	889
12	"12-out2743"	.55925	151	119	270
12	"12-out2744"	.44773	257	317	574
12	"12-out2745"	.29196	327	793	1120
12	"12-out2746"	.20481	153	594	747
12	"12-out2747"	.88876	783	98	881
12	"12-out2748"	.99441	178	1	179
12	"12-out2749"	.22821	55	186	241
12	"12-out2750"	.31438	94	205	299
12	"12-out2751"	.44771	655	808	1463
12	"12-out2752"	.32200	161	339	500
12	"12-out2753"	.37454	515	860	1375
12	"12-out2754"	.36729	292	503	795
12	"12-out2755"	.41594	386	542	928
12	"12-out2756"	.41689	311	435	746
12	"12-out2757"	.88439	459	60	519
12	"12-out2758"	.37654	549	909	1458
12	"12-out2759"	.37376	265	444	709
12	"12-out2760"	.36184	55	97	152
12	"12-out2761"	.26535	108	299	407
12	"12-out2762"	.99115	112	1	113
12	"12-out2763"	.45873	239	282	521
12	"12-out2764"	.35121	72	133	205
12	"12-out2765"	.29508	90	215	305
12	"12-out2766"	.36477	321	559	880
12	"12-out2767"	.39762	134	203	337
12	"12-out2768"	.20426	115	448	563
12	"12-out2769"	.46740	509	580	1089
12	"12-out2770"	.50505	50	49	99
12	"12-out2771"	.63095	53	31	84
12	"12-out2772"	.86815	428	65	493
12	"12-out2773"	.99827	578	1	579
12	"12-out2774"	.41169	359	513	872
12	"12-out2775"	.59883	103	69	172
12	"12-out2776"	.76470	117	36	153
12	"12-out2777"	.97041	164	5	169
12	"12-out2778"	.95283	101	5	106
12	"12-out2779"	.48489	610	648	1258
12	"12-out2780"	.80751	172	41	213
12	"12-out2781"	.42016	100	138	238
12	"12-out2782"	.28945	376	923	1299
12	"12-out2783"	.57055	279	210	489
12	"12-out2784"	.38968	355	556	911
12	"12-out2785"	.28888	91	224	315
12	"12-out2786"	.24929	177	533	710
12	"12-out2787"	.26541	99	274	373
12	"12-out2788"	.46564	183	210	393
12	"12-out2789"	.99658	292	1	293
12	"12-out2790"	.19956	91	365	456
12	"12-out2791"	.34870	121	226	347
12	"12-out2792"	.47154	58	65	123
12	"12-out2793"	.71304	82	33	115
12	"12-out2794"	.48400	242	258	500
12	"12-out2795"	.80840	2038	483	2521
12	"12-out2796"	.74410	221	76	297
12	"12-out2797"	.32349	318	665	983
12	"12-out2798"	.48979	456	475	931
12	"12-out2799"	.41353	55	78	133
12	"12-out2800"	.43750	63	81	144
12	"12-out2801"	.26126	145	410	555
12	"12-out2802"	.22857	24	81	105
12	"12-out2803"	.43410	112	146	258
12	"12-out2804"	.31746	60	129	189
12	"12-out2805"	.36896	107	183	290
12	"12-out2806"	.62539	197	118	315
12	"12-out2807"	.42523	91	123	214
12	"12-out2808"	.98148	53	1	54
12	"12-out2809"	.38636	153	243	396
12	"12-out2810"	.41501	210	296	506
12	"12-out2811"	.44444	244	305	549
12	"12-out2812"	.32876	48	98	146
12	"12-out2813"	.43333	286	374	660
12	"12-out2814"	.46178	435	507	942
12	"12-out2815"	.37733	283	467	750
12	"12-out2816"	.29527	150	358	508
12	"12-out2817"	.59259	400	275	675
12	"12-out2818"	.45454	120	144	264
12	"12-out2819"	.44871	35	43	78
12	"12-out2820"	.31700	110	237	347
12	"12-out2821"	.58318	333	238	571
12	"12-out2822"	.34161	550	1060	1610
12	"12-out2823"	.66952	156	77	233
12	"12-out2824"	.58258	194	139	333
12	"12-out2825"	.99166	238	2	240
12	"12-out2826"	.96202	152	6	158
12	"12-out2827"	.55479	162	130	292
12	"12-out2828"	.47263	190	212	402
12	"12-out2829"	.41063	193	277	470
12	"12-out2830"	.37824	553	909	1462
12	"12-out2831"	.99513	409	2	411
12	"12-out2832"	.30020	290	676	966
12	"12-out2833"	.44198	80	101	181
12	"12-out2834"	.39068	327	510	837
12	"12-out2835"	.40423	534	787	1321
12	"12-out2836"	.41449	143	202	345
12	"12-out2837"	.58472	245	174	419
12	"12-out2838"	.32202	503	1059	1562
12	"12-out2839"	.78125	100	28	128
12	"12-out2840"	.38837	254	400	654
12	"12-out2841"	.87816	901	125	1026
12	"12-out2842"	.23182	118	391	509
12	"12-out2843"	.32572	371	768	1139
12	"12-out2844"	.44370	67	84	151
12	"12-out2845"	.45794	98	116	214
12	"12-out2846"	.79381	231	60	291
12	"12-out2847"	.50847	90	87	177
12	"12-out2848"	.36914	268	458	726
12	"12-out2849"	.98969	96	1	97
12	"12-out2850"	.51989	196	181	377
12	"12-out2851"	.47033	650	732	1382
12	"12-out2852"	.24159	79	248	327
12	"12-out2853"	.70036	194	83	277
12	"12-out2854"	.28365	59	149	208
12	"12-out2855"	.81204	337	78	415
12	"12-out2856"	.43873	222	284	506
12	"12-out2857"	.46467	388	447	835
12	"12-out2858"	.48626	177	187	364
12	"12-out2859"	.37339	174	292	466
12	"12-out2860"	.58803	177	124	301
12	"12-out2861"	.43259	1213	1591	2804
12	"12-out2862"	.49438	88	90	178
12	"12-out2863"	.39005	447	699	1146
12	"12-out2864"	.19874	95	383	478
12	"12-out2865"	.26724	217	595	812
12	"12-out2866"	.97876	461	10	471
12	"12-out2867"	.50709	572	556	1128
12	"12-out2868"	.99559	226	1	227
12	"12-out2869"	.99744	390	1	391
12	"12-out2870"	.99726	365	1	366
12	"12-out2871"	.16573	59	297	356
12	"12-out2872"	.41089	558	800	1358
12	"12-out2873"	.29086	121	295	416
12	"12-out2874"	.31360	53	116	169
12	"12-out2875"	.30185	163	377	540
12	"12-out2876"	.32515	212	440	652
12	"12-out2877"	.26587	67	185	252
12	"12-out2878"	.36118	134	237	371
12	"12-out2879"	.99270	136	1	137
12	"12-out2880"	.23356	206	676	882
12	"12-out2881"	.42382	370	503	873
12	"12-out2882"	.34210	130	250	380
12	"12-out2883"	.75000	129	43	172
12	"12-out2884"	.79636	219	56	275
12	"12-out2885"	.51553	365	343	708
12	"12-out2886"	.71245	835	337	1172
12	"12-out2887"	.41975	238	329	567
12	"12-out2888"	.40517	235	345	580
12	"12-out2889"	.50771	823	798	1621
12	"12-out2890"	.35459	328	597	925
12	"12-out2891"	.25542	106	309	415
12	"12-out2892"	.34194	331	637	968
12	"12-out2893"	.98947	94	1	95
12	"12-out2894"	.34204	942	1812	2754
12	"12-out2895"	.21842	83	297	380
12	"12-out2896"	.99668	301	1	302
12	"12-out2897"	.38580	424	675	1099
12	"12-out2898"	.36285	168	295	463
12	"12-out2899"	.69614	433	189	622
12	"12-out2900"	.99618	261	1	262
12	"12-out2901"	.87544	492	70	562
12	"12-out2902"	.47715	188	206	394
12	"12-out2903"	.33655	209	412	621
12	"12-out2904"	.46895	355	402	757
12	"12-out2905"	.48205	309	332	641
12	"12-out2906"	.50000	277	277	554
12	"12-out2907"	.38525	230	367	597
12	"12-out2908"	.34191	279	537	816
12	"12-out2909"	.76635	246	75	321
12	"12-out2910"	.95669	243	11	254
12	"12-out2911"	.53903	580	496	1076
12	"12-out2912"	.27156	85	228	313
12	"12-out2913"	.41993	396	547	943
12	"12-out2914"	.43891	97	124	221
12	"12-out2915"	.53386	268	234	502
12	"12-out2916"	.28070	80	205	285
12	"12-out2917"	.99618	261	1	262
12	"12-out2918"	.61034	354	226	580
12	"12-out2919"	.34872	219	409	628
12	"12-out2920"	.47647	81	89	170
12	"12-out2921"	.39190	600	931	1531
12	"12-out2922"	.72270	331	127	458
12	"12-out2923"	.56711	676	516	1192
12	"12-out2924"	.35515	179	325	504
12	"12-out2925"	.30033	91	212	303
12	"12-out2926"	.67528	1254	603	1857
12	"12-out2927"	.58536	48	34	82
12	"12-out2928"	.45708	442	525	967
12	"12-out2929"	.60714	153	99	252
12	"12-out2930"	.35966	173	308	481
12	"12-out2931"	.62204	79	48	127
12	"12-out2932"	.89274	283	34	317
12	"12-out2933"	.55910	175	138	313
12	"12-out2934"	.99678	310	1	311
12	"12-out2935"	.99698	331	1	332
12	"12-out2936"	.58208	195	140	335
12	"12-out2937"	.42857	135	180	315
12	"12-out2938"	.54687	315	261	576
12	"12-out2939"	.50931	164	158	322
12	"12-out2940"	.53605	171	148	319
12	"12-out2941"	.38461	120	192	312
12	"12-out2942"	.67280	329	160	489
12	"12-out2943"	.91449	246	23	269
12	"12-out2944"	.58709	182	128	310
12	"12-out2945"	.93870	291	19	310
12	"12-out2946"	.79746	252	64	316
12	"12-out2947"	.44512	146	182	328
12	"12-out2948"	.58507	196	139	335
12	"12-out2949"	.82187	263	57	320
12	"12-out2950"	.98076	306	6	312
12	"12-out2951"	.96250	308	12	320
12	"12-out2952"	.95268	302	15	317
12	"12-out2953"	.98437	315	5	320
12	"12-out2954"	.97798	311	7	318
12	"12-out2955"	.97523	315	8	323
12	"12-out2956"	.98705	305	4	309
12	"12-out2957"	.56451	175	135	310
12	"12-out2958"	.57366	183	136	319
12	"12-out2959"	.55555	190	152	342
12	"12-out2960"	.44267	139	175	314
12	"12-out2961"	.44582	144	179	323
12	"12-out2962"	.31498	103	224	327
12	"12-out2963"	.51572	164	154	318
12	"12-out2964"	.99675	307	1	308
12	"12-out2965"	.84615	275	50	325
12	"12-out2966"	.75700	243	78	321
12	"12-out2967"	.49816	136	137	273
12	"12-out2968"	.34492	248	471	719
12	"12-out2969"	.99862	1454	2	1456
12	"12-out2970"	.42857	333	444	777
12	"12-out2971"	.30633	208	471	679
12	"12-out2972"	.27626	213	558	771
12	"12-out2973"	.28888	234	576	810
12	"12-out2974"	.62962	119	70	189
12	"12-out2975"	.35694	131	236	367
12	"12-out2976"	.41359	213	302	515
12	"12-out2977"	.31513	635	1380	2015
12	"12-out2978"	.44598	1127	1400	2527
12	"12-out2979"	.40072	111	166	277
12	"12-out2980"	.32183	168	354	522
12	"12-out2981"	.83415	674	134	808
12	"12-out2982"	.36761	597	1027	1624
12	"12-out2983"	.19230	65	273	338
12	"12-out2984"	.99115	112	1	113
12	"12-out2985"	.56421	268	207	475
12	"12-out2986"	.47832	320	349	669
12	"12-out2987"	.40873	618	894	1512
12	"12-out2988"	.99193	123	1	124
12	"12-out2989"	.50390	129	127	256
12	"12-out2990"	.66146	424	217	641
12	"12-out2991"	.36250	377	663	1040
12	"12-out2992"	.35303	221	405	626
12	"12-out2993"	.46196	3413	3975	7388
12	"12-out2994"	.22222	88	308	396
12	"12-out2995"	.72251	276	106	382
12	"12-out2996"	.39717	309	469	778
12	"12-out2997"	.50898	170	164	334
12	"12-out2998"	.38303	316	509	825
12	"12-out2999"	.40030	265	397	662
12	"12-out3000"	.92863	989	76	1065
12	"12-out3001"	.46306	257	298	555
12	"12-out3002"	.36416	252	440	692
12	"12-out3003"	.34782	248	465	713
12	"12-out3004"	.26891	231	628	859
12	"12-out3005"	.23668	80	258	338
12	"12-out3006"	.41379	204	289	493
12	"12-out3007"	.25977	186	530	716
12	"12-out3008"	.99931	1452	1	1453
12	"12-out3009"	.29108	1355	3300	4655
12	"12-out3010"	.29776	173	408	581
12	"12-out3011"	.99487	194	1	195
12	"12-out3012"	.41168	317	453	770
12	"12-out3013"	.35695	680	1225	1905
12	"12-out3014"	.26782	432	1181	1613
12	"12-out3015"	.47106	407	457	864
12	"12-out3016"	.25833	93	267	360
12	"12-out3017"	.24817	34	103	137
12	"12-out3018"	.42400	53	72	125
12	"12-out3019"	.98989	98	1	99
12	"12-out3020"	.99180	121	1	122
12	"12-out3021"	.99166	119	1	120
12	"12-out3022"	.37169	197	333	530
12	"12-out3023"	.42146	1602	2199	3801
12	"12-out3024"	.99690	322	1	323
12	"12-out3025"	.78629	195	53	248
12	"12-out3026"	.95244	1442	72	1514
12	"12-out3027"	.38380	327	525	852
12	"12-out3028"	.42545	117	158	275
12	"12-out3029"	.99431	175	1	176
12	"12-out3030"	.40662	270	394	664
12	"12-out3031"	.38976	396	620	1016
12	"12-out3032"	.53882	798	683	1481
12	"12-out3033"	.25290	109	322	431
12	"12-out3034"	.20075	213	848	1061
12	"12-out3035"	.99568	231	1	232
12	"12-out3036"	.96276	181	7	188
12	"12-out3037"	.99672	304	1	305
12	"12-out3038"	.99743	389	1	390
12	"12-out3039"	.70376	411	173	584
12	"12-out3040"	.38235	39	63	102
12	"12-out3041"	.54736	104	86	190
12	"12-out3042"	.99358	155	1	156
12	"12-out3043"	.40122	979	1461	2440
12	"12-out3044"	.99867	753	1	754
12	"12-out3045"	.46593	424	486	910
12	"12-out3046"	.79958	387	97	484
12	"12-out3047"	.43654	172	222	394
12	"12-out3048"	.35209	269	495	764
12	"12-out3049"	.77586	45	13	58
12	"12-out3050"	.75418	135	44	179
12	"12-out3051"	.40776	84	122	206
12	"12-out3052"	.90639	794	82	876
12	"12-out3053"	.99934	1529	1	1530
12	"12-out3054"	.28593	183	457	640
12	"12-out3055"	.37095	733	1243	1976
12	"12-out3056"	.43186	206	271	477
12	"12-out3057"	.39325	175	270	445
12	"12-out3058"	.37880	436	715	1151
12	"12-out3059"	.30148	344	797	1141
12	"12-out3060"	.56866	265	201	466
12	"12-out3061"	.48693	932	982	1914
12	"12-out3062"	.29326	322	776	1098
12	"12-out3063"	.37450	94	157	251
12	"12-out3064"	.40190	211	314	525
12	"12-out3065"	.79398	686	178	864
12	"12-out3066"	.78194	459	128	587
12	"12-out3067"	.91364	328	31	359
12	"12-out3068"	.22448	22	76	98
12	"12-out3069"	.42695	1096	1471	2567
12	"12-out3070"	.48333	290	310	600
12	"12-out3071"	.30180	651	1506	2157
12	"12-out3072"	.33127	322	650	972
12	"12-out3073"	.94418	203	12	215
12	"12-out3074"	.46105	367	429	796
12	"12-out3075"	.41516	115	162	277
12	"12-out3076"	.81614	364	82	446
12	"12-out3077"	.50000	88	88	176
12	"12-out3078"	.41612	258	362	620
12	"12-out3079"	.40069	232	347	579
12	"12-out3080"	.47472	216	239	455
12	"12-out3081"	.38223	198	320	518
12	"12-out3082"	.77397	113	33	146
12	"12-out3083"	.67956	316	149	465
12	"12-out3084"	.37574	1137	1889	3026
12	"12-out3085"	.37198	77	130	207
12	"12-out3086"	.35913	167	298	465
12	"12-out3087"	.98979	97	1	98
12	"12-out3088"	.99782	458	1	459
12	"12-out3089"	.36538	57	99	156
12	"12-out3090"	.55389	519	418	937
12	"12-out3091"	.25757	68	196	264
12	"12-out3092"	.34459	306	582	888
12	"12-out3093"	.19918	49	197	246
12	"12-out3094"	.47756	149	163	312
12	"12-out3095"	.99649	284	1	285
12	"12-out3096"	.28045	99	254	353
12	"12-out3097"	.58004	971	703	1674
12	"12-out3098"	.39558	627	958	1585
12	"12-out3099"	.74810	986	332	1318
12	"12-out3100"	.99860	718	1	719
12	"12-out3101"	.28601	411	1026	1437
12	"12-out3102"	.56487	849	654	1503
12	"12-out3103"	.90376	216	23	239
12	"12-out3104"	.48120	448	483	931
12	"12-out3105"	.42035	380	524	904
12	"12-out3106"	.98210	439	8	447
12	"12-out3107"	.41500	83	117	200
12	"12-out3108"	.26571	186	514	700
12	"12-out3109"	.42606	850	1145	1995
12	"12-out3110"	.50000	124	124	248
12	"12-out3111"	.49938	409	410	819
12	"12-out3112"	.33482	75	149	224
12	"12-out3113"	.33960	361	702	1063
12	"12-out3114"	.28089	50	128	178
12	"12-out3115"	.44402	353	442	795
12	"12-out3116"	.58299	288	206	494
12	"12-out3117"	.45810	339	401	740
12	"12-out3118"	.77016	191	57	248
12	"12-out3119"	.95594	217	10	227
12	"12-out3120"	.33333	69	138	207
12	"12-out3121"	.99819	1109	2	1111
12	"12-out3122"	.31606	183	396	579
12	"12-out3123"	.39596	373	569	942
12	"12-out3124"	.40311	751	1112	1863
12	"12-out3125"	.52469	340	308	648
12	"12-out3126"	.44414	334	418	752
12	"12-out3127"	.90291	93	10	103
12	"12-out3128"	.64692	284	155	439
12	"12-out3129"	.34682	60	113	173
12	"12-out3130"	.29355	278	669	947
12	"12-out3131"	.52396	164	149	313
12	"12-out3132"	.61391	1191	749	1940
12	"12-out3133"	.39697	341	518	859
12	"12-out3134"	.37109	416	705	1121
12	"12-out3135"	.99367	157	1	158
12	"12-out3136"	.52209	189	173	362
12	"12-out3137"	.42147	365	501	866
12	"12-out3138"	.27514	145	382	527
12	"12-out3139"	.39522	149	228	377
12	"12-out3140"	.99769	867	2	869
12	"12-out3141"	.30379	240	550	790
12	"12-out3142"	.35884	511	913	1424
12	"12-out3143"	.31943	360	767	1127
12	"12-out3144"	.35336	729	1334	2063
12	"12-out3145"	.37094	240	407	647
12	"12-out3146"	.99145	116	1	117
12	"12-out3147"	.99145	116	1	117
12	"12-out3148"	.49399	535	548	1083
12	"12-out3149"	.35205	188	346	534
12	"12-out3150"	.39341	275	424	699
12	"12-out3151"	.37864	273	448	721
12	"12-out3152"	.29183	211	512	723
12	"12-out3153"	.35514	342	621	963
12	"12-out3154"	.21118	34	127	161
12	"12-out3155"	.91208	83	8	91
12	"12-out3156"	.99159	118	1	119
12	"12-out3157"	.99145	116	1	117
12	"12-out3158"	.37671	55	91	146
12	"12-out3159"	.73351	267	97	364
12	"12-out3160"	.99328	2809	19	2828
12	"12-out3161"	.99509	203	1	204
12	"12-out3162"	.19079	199	844	1043
12	"12-out3163"	.42844	949	1266	2215
12	"12-out3164"	.36507	69	120	189
12	"12-out3165"	.98637	724	10	734
12	"12-out3166"	.46497	823	947	1770
12	"12-out3167"	.27733	279	727	1006
12	"12-out3168"	.30746	313	705	1018
12	"12-out3169"	.24163	224	703	927
12	"12-out3170"	.87679	427	60	487
12	"12-out3171"	.99534	214	1	215
12	"12-out3172"	.71118	655	266	921
12	"12-out3173"	.53273	179	157	336
12	"12-out3174"	.50000	221	221	442
12	"12-out3175"	.41432	428	605	1033
12	"12-out3176"	.35270	261	479	740
12	"12-out3177"	.36418	362	632	994
12	"12-out3178"	.29666	356	844	1200
12	"12-out3179"	.42196	73	100	173
12	"12-out3180"	.99672	304	1	305
12	"12-out3181"	.99656	290	1	291
12	"12-out3182"	.90101	710	78	788
12	"12-out3183"	.99980	5206	1	5207
12	"12-out3184"	.52941	81	72	153
12	"12-out3185"	.41000	1918	2760	4678
12	"12-out3186"	.30703	288	650	938
12	"12-out3187"	.71870	1395	546	1941
12	"12-out3188"	.45054	583	711	1294
12	"12-out3189"	.53787	71	61	132
12	"12-out3190"	.74671	852	289	1141
12	"12-out3191"	.27551	351	923	1274
12	"12-out3192"	.39224	506	784	1290
12	"12-out3193"	.54468	451	377	828
12	"12-out3194"	.98809	83	1	84
12	"12-out3195"	.44718	779	963	1742
12	"12-out3196"	.22189	229	803	1032
12	"12-out3197"	.40928	97	140	237
12	"12-out3198"	.34061	78	151	229
12	"12-out3199"	.43973	394	502	896
12	"12-out3200"	.42137	410	563	973
12	"12-out3201"	.99755	408	1	409
12	"12-out3202"	.32558	112	232	344
12	"12-out3203"	.99897	979	1	980
12	"12-out3204"	.26908	282	766	1048
12	"12-out3205"	.80821	236	56	292
12	"12-out3206"	.24637	34	104	138
12	"12-out3207"	.43859	200	256	456
12	"12-out3208"	.99671	303	1	304
12	"12-out3209"	.38572	724	1153	1877
12	"12-out3210"	.38507	129	206	335
12	"12-out3211"	.48087	88	95	183
12	"12-out3212"	.36619	182	315	497
12	"12-out3213"	.65822	52	27	79
12	"12-out3214"	.99489	195	1	196
12	"12-out3215"	.83174	262	53	315
12	"12-out3216"	.41037	277	398	675
12	"12-out3217"	.63860	311	176	487
12	"12-out3218"	.46138	233	272	505
12	"12-out3219"	.74187	388	135	523
12	"12-out3220"	.77358	246	72	318
12	"12-out3221"	.95364	144	7	151
12	"12-out3222"	.92138	293	25	318
12	"12-out3223"	.41368	127	180	307
12	"12-out3224"	.48701	150	158	308
12	"12-out3225"	.48603	87	92	179
12	"12-out3226"	.98392	306	5	311
12	"12-out3227"	.36279	78	137	215
12	"12-out3228"	.87401	111	16	127
12	"12-out3229"	.99367	157	1	158
12	"12-out3230"	.80322	249	61	310
12	"12-out3231"	.43962	142	181	323
12	"12-out3232"	.78164	247	69	316
12	"12-out3233"	.79268	260	68	328
12	"12-out3234"	.99035	308	3	311
12	"12-out3235"	.99352	307	2	309
12	"12-out3236"	.49358	154	158	312
12	"12-out3237"	.94426	288	17	305
12	"12-out3238"	.97756	305	7	312
12	"12-out3239"	.98722	309	4	313
12	"12-out3240"	.96805	303	10	313
12	"12-out3241"	.62500	195	117	312
12	"12-out3242"	.96153	300	12	312
12	"12-out3243"	.42586	135	182	317
12	"12-out3244"	.54777	172	142	314
12	"12-out3245"	.49038	153	159	312
12	"12-out3246"	.50000	163	163	326
12	"12-out3247"	.53618	163	141	304
12	"12-out3248"	.56645	179	137	316
12	"12-out3249"	.62179	194	118	312
12	"12-out3250"	.96636	316	11	327
12	"12-out3251"	.84664	265	48	313
12	"12-out3252"	.74062	237	83	320
12	"12-out3253"	.97115	202	6	208
12	"12-out3254"	.27216	132	353	485
12	"12-out3255"	.39636	109	166	275
12	"12-out3256"	.28942	301	739	1040
12	"12-out3257"	.37150	918	1553	2471
12	"12-out3258"	.36459	828	1443	2271
12	"12-out3259"	.58695	216	152	368
12	"12-out3260"	.50665	723	704	1427
12	"12-out3261"	.36336	121	212	333
12	"12-out3262"	.41895	504	699	1203
12	"12-out3263"	.65084	192	103	295
12	"12-out3264"	.26852	250	681	931
12	"12-out3265"	.35967	569	1013	1582
12	"12-out3266"	.15189	12	67	79
12	"12-out3267"	.96415	538	20	558
12	"12-out3268"	.31501	430	935	1365
12	"12-out3269"	.25000	87	261	348
12	"12-out3270"	.99386	162	1	163
12	"12-out3271"	.39080	34	53	87
12	"12-out3272"	.96341	158	6	164
12	"12-out3273"	.60941	220	141	361
12	"12-out3274"	.20348	35	137	172
12	"12-out3275"	.44034	155	197	352
12	"12-out3276"	.39856	277	418	695
12	"12-out3277"	.35443	112	204	316
12	"12-out3278"	.99504	201	1	202
12	"12-out3279"	.47983	226	245	471
12	"12-out3280"	.24484	95	293	388
12	"12-out3281"	.35828	134	240	374
12	"12-out3282"	.47368	162	180	342
12	"12-out3283"	.48587	172	182	354
12	"12-out3284"	.12332	46	327	373
12	"12-out3285"	.41868	605	840	1445
12	"12-out3286"	.40896	301	435	736
12	"12-out3287"	.46468	329	379	708
12	"12-out3288"	.45788	337	399	736
12	"12-out3289"	.36121	95	168	263
12	"12-out3290"	.99580	475	2	477
12	"12-out3291"	.53592	455	394	849
12	"12-out3292"	.99868	760	1	761
12	"12-out3293"	.51145	201	192	393
12	"12-out3294"	.30441	207	473	680
12	"12-out3295"	.25908	164	469	633
12	"12-out3296"	.32596	236	488	724
12	"12-out3297"	.34615	252	476	728
12	"12-out3298"	.31756	47	101	148
12	"12-out3299"	.99746	393	1	394
12	"12-out3300"	.21739	30	108	138
12	"12-out3301"	.52806	207	185	392
12	"12-out3302"	.91125	575	56	631
12	"12-out3303"	.56677	365	279	644
12	"12-out3304"	.52617	201	181	382
12	"12-out3305"	.46361	344	398	742
12	"12-out3306"	.45852	304	359	663
12	"12-out3307"	.29218	142	344	486
12	"12-out3308"	.37048	246	418	664
12	"12-out3309"	.38175	113	183	296
12	"12-out3310"	.45967	114	134	248
12	"12-out3311"	.98991	687	7	694
12	"12-out3312"	.99811	530	1	531
12	"12-out3313"	.66666	74	37	111
12	"12-out3314"	.25765	101	291	392
12	"12-out3315"	.36961	163	278	441
12	"12-out3316"	.68493	100	46	146
12	"12-out3317"	.99099	110	1	111
12	"12-out3318"	.40707	46	67	113
12	"12-out3319"	.80000	76	19	95
12	"12-out3320"	.94082	318	20	338
12	"12-out3321"	.30894	38	85	123
12	"12-out3322"	.99582	477	2	479
12	"12-out3323"	.36330	198	347	545
12	"12-out3324"	.66030	346	178	524
12	"12-out3325"	.77326	457	134	591
12	"12-out3326"	.98780	162	2	164
12	"12-out3327"	.98780	162	2	164
12	"12-out3328"	.98780	162	2	164
12	"12-out3329"	.40050	475	711	1186
12	"12-out3330"	.47071	651	732	1383
12	"12-out3331"	.41952	159	220	379
12	"12-out3332"	.34625	134	253	387
12	"12-out3333"	.48494	290	308	598
12	"12-out3334"	.34527	212	402	614
12	"12-out3335"	.89500	179	21	200
12	"12-out3336"	.38373	269	432	701
12	"12-out3337"	.35403	114	208	322
12	"12-out3338"	.65600	246	129	375
12	"12-out3339"	.79980	811	203	1014
12	"12-out3340"	.61337	211	133	344
12	"12-out3341"	.45340	180	217	397
12	"12-out3342"	.30276	208	479	687
12	"12-out3343"	.23655	88	284	372
12	"12-out3344"	.32795	122	250	372
12	"12-out3345"	.99570	232	1	233
12	"12-out3346"	.48964	449	468	917
12	"12-out3347"	.40032	500	749	1249
12	"12-out3348"	.23717	111	357	468
12	"12-out3349"	.57727	127	93	220
12	"12-out3350"	.96078	49	2	51
12	"12-out3351"	.33052	157	318	475
12	"12-out3352"	.87996	931	127	1058
12	"12-out3353"	.52205	355	325	680
12	"12-out3354"	.39721	114	173	287
12	"12-out3355"	.99687	319	1	320
12	"12-out3356"	.98360	60	1	61
12	"12-out3357"	.18253	23	103	126
12	"12-out3358"	.30880	407	911	1318
12	"12-out3359"	.60625	388	252	640
12	"12-out3360"	.47795	336	367	703
12	"12-out3361"	.98275	57	1	58
12	"12-out3362"	.43159	306	403	709
12	"12-out3363"	.99431	175	1	176
12	"12-out3364"	.34351	135	258	393
12	"12-out3365"	.35593	42	76	118
12	"12-out3366"	.54191	181	153	334
12	"12-out3367"	.99593	245	1	246
12	"12-out3368"	.82203	97	21	118
12	"12-out3369"	.30303	50	115	165
12	"12-out3370"	.65126	155	83	238
12	"12-out3371"	.26943	52	141	193
12	"12-out3372"	.50724	105	102	207
12	"12-out3373"	.33939	56	109	165
12	"12-out3374"	.32176	343	723	1066
12	"12-out3375"	.99619	262	1	263
12	"12-out3376"	.99065	106	1	107
12	"12-out3377"	.99408	168	1	169
12	"12-out3378"	.52688	49	44	93
12	"12-out3379"	.61386	62	39	101
12	"12-out3380"	.47252	516	576	1092
12	"12-out3381"	.80645	275	66	341
12	"12-out3382"	.37486	1044	1741	2785
12	"12-out3383"	.50000	62	62	124
12	"12-out3384"	.99832	596	1	597
12	"12-out3385"	.51216	358	341	699
12	"12-out3386"	.34192	146	281	427
12	"12-out3387"	.99173	120	1	121
12	"12-out3388"	.99462	185	1	186
12	"12-out3389"	.60775	141	91	232
12	"12-out3390"	.35288	343	629	972
12	"12-out3391"	.21739	35	126	161
12	"12-out3392"	.85975	141	23	164
12	"12-out3393"	.47813	503	549	1052
12	"12-out3394"	.44897	66	81	147
12	"12-out3395"	.30617	218	494	712
12	"12-out3396"	.46304	520	603	1123
12	"12-out3397"	.38304	375	604	979
12	"12-out3398"	.99720	357	1	358
12	"12-out3399"	.36578	124	215	339
12	"12-out3400"	.60089	134	89	223
12	"12-out3401"	.39229	173	268	441
12	"12-out3402"	.28244	185	470	655
12	"12-out3403"	.99635	273	1	274
12	"12-out3404"	.99810	527	1	528
12	"12-out3405"	.30448	95	217	312
12	"12-out3406"	.99622	528	2	530
12	"12-out3407"	.75570	232	75	307
12	"12-out3408"	.58450	83	59	142
12	"12-out3409"	.32218	501	1054	1555
12	"12-out3410"	.43579	638	826	1464
12	"12-out3411"	.78678	631	171	802
12	"12-out3412"	.53144	169	149	318
12	"12-out3413"	.49791	358	361	719
12	"12-out3414"	.98867	524	6	530
12	"12-out3415"	.55430	296	238	534
12	"12-out3416"	.99590	243	1	244
12	"12-out3417"	.99593	245	1	246
12	"12-out3418"	.57786	141	103	244
12	"12-out3419"	.99700	333	1	334
12	"12-out3420"	.97967	241	5	246
12	"12-out3421"	.39768	412	624	1036
12	"12-out3422"	.39830	188	284	472
12	"12-out3423"	.27083	130	350	480
12	"12-out3424"	.39927	884	1330	2214
12	"12-out3425"	.43577	475	615	1090
12	"12-out3426"	.32097	303	641	944
12	"12-out3427"	.36090	336	595	931
12	"12-out3428"	.42888	196	261	457
12	"12-out3429"	.48900	778	813	1591
12	"12-out3430"	.55598	144	115	259
12	"12-out3431"	.39786	335	507	842
12	"12-out3432"	.25813	246	707	953
12	"12-out3433"	.32068	845	1790	2635
12	"12-out3434"	.29650	966	2292	3258
12	"12-out3435"	.40000	324	486	810
12	"12-out3436"	.98569	620	9	629
12	"12-out3437"	.41889	1268	1759	3027
12	"12-out3438"	.41247	172	245	417
12	"12-out3439"	.48251	207	222	429
12	"12-out3440"	.50902	282	272	554
12	"12-out3441"	.81759	381	85	466
12	"12-out3442"	.25000	47	141	188
12	"12-out3443"	.50303	83	82	165
12	"12-out3444"	.33750	54	106	160
12	"12-out3445"	.36477	58	101	159
12	"12-out3446"	.33617	197	389	586
12	"12-out3447"	.41646	339	475	814
12	"12-out3448"	.38461	45	72	117
12	"12-out3449"	.91603	720	66	786
12	"12-out3450"	.40377	107	158	265
12	"12-out3451"	.36824	109	187	296
12	"12-out3452"	.71845	541	212	753
12	"12-out3453"	.36745	140	241	381
12	"12-out3454"	.99890	913	1	914
12	"12-out3455"	.37101	466	790	1256
12	"12-out3456"	.99841	631	1	632
12	"12-out3457"	.53871	327	280	607
12	"12-out3458"	.34045	510	988	1498
12	"12-out3459"	.34171	163	314	477
12	"12-out3460"	.44870	328	403	731
12	"12-out3461"	.89789	299	34	333
12	"12-out3462"	.31262	161	354	515
12	"12-out3463"	.20594	90	347	437
12	"12-out3464"	.45454	70	84	154
12	"12-out3465"	.40720	147	214	361
12	"12-out3466"	.38413	310	497	807
12	"12-out3467"	.36141	369	652	1021
12	"12-out3468"	.51952	306	283	589
12	"12-out3469"	.61267	261	165	426
12	"12-out3470"	.98280	400	7	407
12	"12-out3471"	.40758	86	125	211
12	"12-out3472"	.90337	402	43	445
12	"12-out3473"	.35135	117	216	333
12	"12-out3474"	.26217	70	197	267
12	"12-out3475"	.39119	151	235	386
12	"12-out3476"	.73913	459	162	621
12	"12-out3477"	.99633	544	2	546
12	"12-out3478"	.34519	97	184	281
12	"12-out3479"	.58839	223	156	379
12	"12-out3480"	.57369	253	188	441
12	"12-out3481"	.33509	443	879	1322
12	"12-out3482"	.59533	153	104	257
12	"12-out3483"	.99856	698	1	699
12	"12-out3484"	.37309	147	247	394
12	"12-out3485"	.44420	406	508	914
12	"12-out3486"	.63230	368	214	582
12	"12-out3487"	.46265	254	295	549
12	"12-out3488"	.31724	46	99	145
12	"12-out3489"	.29411	85	204	289
12	"12-out3490"	.28852	88	217	305
12	"12-out3491"	.73780	242	86	328
12	"12-out3492"	.72250	289	111	400
12	"12-out3493"	.99855	692	1	693
12	"12-out3494"	.99855	692	1	693
12	"12-out3495"	.99834	602	1	603
12	"12-out3496"	.99832	596	1	597
12	"12-out3497"	.99767	429	1	430
12	"12-out3498"	.41707	425	594	1019
12	"12-out3499"	.44591	202	251	453
12	"12-out3500"	.46666	231	264	495
12	"12-out3501"	.22826	21	71	92
12	"12-out3502"	.37000	37	63	100
12	"12-out3503"	.40692	188	274	462
12	"12-out3504"	.36548	144	250	394
12	"12-out3505"	.32954	145	295	440
12	"12-out3506"	.34955	158	294	452
12	"12-out3507"	.99851	674	1	675
12	"12-out3508"	.56400	141	109	250
12	"12-out3509"	.68867	146	66	212
12	"12-out3510"	.99242	131	1	132
12	"12-out3511"	.39498	126	193	319
12	"12-out3512"	.99731	372	1	373
12	"12-out3513"	.49546	164	167	331
12	"12-out3514"	.48459	456	485	941
12	"12-out3515"	.28437	273	687	960
12	"12-out3516"	.60828	191	123	314
12	"12-out3517"	.50400	252	248	500
12	"12-out3518"	.33333	94	188	282
12	"12-out3519"	.91650	472	43	515
12	"12-out3520"	.18333	66	294	360
12	"12-out3521"	.76601	275	84	359
12	"12-out3522"	.34908	133	248	381
12	"12-out3523"	.46153	174	203	377
12	"12-out3524"	.36619	130	225	355
12	"12-out3525"	.56684	212	162	374
12	"12-out3526"	.98913	182	2	184
12	"12-out3527"	.58497	327	232	559
12	"12-out3528"	.74884	325	109	434
12	"12-out3529"	.44009	191	243	434
12	"12-out3530"	.59907	260	174	434
12	"12-out3531"	.81337	292	67	359
12	"12-out3532"	.36723	130	224	354
12	"12-out3533"	.41470	282	398	680
12	"12-out3534"	.99855	692	1	693
12	"12-out3535"	.32792	283	580	863
12	"12-out3536"	.34090	210	406	616
12	"12-out3537"	.47557	331	365	696
12	"12-out3538"	.35743	173	311	484
12	"12-out3539"	.38274	173	279	452
12	"12-out3540"	.29974	116	271	387
12	"12-out3541"	.82630	490	103	593
12	"12-out3542"	.76168	326	102	428
12	"12-out3543"	.36609	149	258	407
12	"12-out3544"	.44444	124	155	279
12	"12-out3545"	.53888	388	332	720
12	"12-out3546"	.99683	315	1	316
12	"12-out3547"	.31884	88	188	276
12	"12-out3548"	.99767	429	1	430
12	"12-out3549"	.42057	368	507	875
12	"12-out3550"	.91616	918	84	1002
12	"12-out3551"	.51031	1138	1092	2230
12	"12-out3552"	.99173	120	1	121
12	"12-out3553"	.41766	175	244	419
12	"12-out3554"	.99750	400	1	401
12	"12-out3555"	.99749	398	1	399
12	"12-out3556"	.51342	153	145	298
12	"12-out3557"	.76237	77	24	101
12	"12-out3558"	.30023	251	585	836
12	"12-out3559"	.25737	253	730	983
12	"12-out3560"	.39097	52	81	133
12	"12-out3561"	.40556	481	705	1186
12	"12-out3562"	.20710	35	134	169
12	"12-out3563"	.28017	376	966	1342
12	"12-out3564"	.30721	294	663	957
12	"12-out3565"	.41680	521	729	1250
12	"12-out3566"	.45296	313	378	691
12	"12-out3567"	.74858	265	89	354
12	"12-out3568"	.55981	248	195	443
12	"12-out3569"	.64743	101	55	156
12	"12-out3570"	.56732	868	662	1530
12	"12-out3571"	.68461	89	41	130
12	"12-out3572"	.45852	304	359	663
12	"12-out3573"	.99264	135	1	136
12	"12-out3574"	.90922	611	61	672
12	"12-out3575"	.52706	185	166	351
12	"12-out3576"	.39900	401	604	1005
12	"12-out3577"	.28748	209	518	727
12	"12-out3578"	.29668	421	998	1419
12	"12-out3579"	.26792	142	388	530
12	"12-out3580"	.35593	168	304	472
12	"12-out3581"	.38547	207	330	537
12	"12-out3582"	.68539	61	28	89
12	"12-out3583"	.72380	152	58	210
12	"12-out3584"	.39935	1607	2417	4024
12	"12-out3585"	.99137	115	1	116
12	"12-out3586"	.63841	113	64	177
12	"12-out3587"	.31760	1420	3051	4471
12	"12-out3588"	.53138	127	112	239
12	"12-out3589"	.52996	283	251	534
12	"12-out3590"	.34438	187	356	543
12	"12-out3591"	.99890	912	1	913
12	"12-out3592"	.98599	352	5	357
12	"12-out3593"	.22115	46	162	208
12	"12-out3594"	.23769	140	449	589
12	"12-out3595"	.50350	287	283	570
12	"12-out3596"	.99828	583	1	584
12	"12-out3597"	.68421	52	24	76
12	"12-out3598"	.99476	190	1	191
12	"12-out3599"	.99792	481	1	482
12	"12-out3600"	.99464	557	3	560
12	"12-out3601"	.99856	698	1	699
12	"12-out3602"	.99856	697	1	698
12	"12-out3603"	.99489	585	3	588
12	"12-out3604"	.99848	660	1	661
12	"12-out3605"	.98775	242	3	245
12	"12-out3606"	.55555	145	116	261
12	"12-out3607"	.36723	130	224	354
12	"12-out3608"	.46275	205	238	443
12	"12-out3609"	.99591	244	1	245
12	"12-out3610"	.45963	279	328	607
12	"12-out3611"	.23728	70	225	295
12	"12-out3612"	.44034	155	197	352
12	"12-out3613"	.26158	96	271	367
12	"12-out3614"	.20789	79	301	380
12	"12-out3615"	.99633	544	2	546
12	"12-out3616"	.26296	71	199	270
12	"12-out3617"	.41478	331	467	798
12	"12-out3618"	.36380	199	348	547
12	"12-out3619"	.99152	117	1	118
12	"12-out3620"	.40955	120	173	293
12	"12-out3621"	.99823	2262	4	2266
12	"12-out3622"	.39858	169	255	424
12	"12-out3623"	.40963	34	49	83
12	"12-out3624"	.22180	59	207	266
12	"12-out3625"	.38867	103	162	265
12	"12-out3626"	.97553	319	8	327
12	"12-out3627"	.34065	667	1291	1958
12	"12-out3628"	.41603	109	153	262
12	"12-out3629"	.27995	278	715	993
12	"12-out3630"	.42830	451	602	1053
12	"12-out3631"	.14012	22	135	157
12	"12-out3632"	.45634	115	137	252
12	"12-out3633"	.73773	436	155	591
12	"12-out3634"	.80124	387	96	483
12	"12-out3635"	.99668	301	1	302
12	"12-out3636"	.99668	301	1	302
12	"12-out3637"	.14087	71	433	504
12	"12-out3638"	.26585	109	301	410
12	"12-out3639"	.99619	524	2	526
12	"12-out3640"	.29569	110	262	372
12	"12-out3641"	.37172	213	360	573
12	"12-out3642"	.43773	232	298	530
12	"12-out3643"	.84507	120	22	142
12	"12-out3644"	.31690	45	97	142
12	"12-out3645"	.36597	355	615	970
12	"12-out3646"	.99367	157	1	158
12	"12-out3647"	.33809	142	278	420
12	"12-out3648"	.14202	49	296	345
12	"12-out3649"	.28735	100	248	348
12	"12-out3650"	.29473	252	603	855
12	"12-out3651"	.92132	445	38	483
12	"12-out3652"	.89090	588	72	660
12	"12-out3653"	.96675	2559	88	2647
12	"12-out3654"	.26415	84	234	318
12	"12-out3655"	.45578	134	160	294
12	"12-out3656"	.46031	261	306	567
12	"12-out3657"	.23123	77	256	333
12	"12-out3658"	.99820	557	1	558
12	"12-out3659"	.24746	390	1186	1576
12	"12-out3660"	.88031	1118	152	1270
12	"12-out3661"	.89445	339	40	379
12	"12-out3662"	.20104	77	306	383
12	"12-out3663"	.79527	1919	494	2413
12	"12-out3664"	.40852	163	236	399
12	"12-out3665"	.43915	397	507	904
12	"12-out3666"	.98275	114	2	116
12	"12-out3667"	.42829	218	291	509
12	"12-out3668"	.52941	297	264	561
12	"12-out3669"	.43650	220	284	504
12	"12-out3670"	.50292	172	170	342
12	"12-out3671"	.45776	168	199	367
12	"12-out3672"	.61239	425	269	694
12	"12-out3673"	.19153	95	401	496
12	"12-out3674"	.33009	34	69	103
12	"12-out3675"	.24608	173	530	703
12	"12-out3676"	.99090	327	3	330
12	"12-out3677"	.61217	674	427	1101
12	"12-out3678"	.47946	572	621	1193
12	"12-out3679"	.26032	271	770	1041
12	"12-out3680"	.40186	172	256	428
12	"12-out3681"	.47209	203	227	430
12	"12-out3682"	.64556	204	112	316
12	"12-out3683"	.40293	110	163	273
12	"12-out3684"	.33760	237	465	702
12	"12-out3685"	.48044	172	186	358
12	"12-out3686"	.36666	88	152	240
12	"12-out3687"	.38403	101	162	263
12	"12-out3688"	.60237	406	268	674
12	"12-out3689"	.90265	510	55	565
12	"12-out3690"	.38936	1619	2539	4158
12	"12-out3691"	.63276	112	65	177
12	"12-out3692"	.47703	1475	1617	3092
12	"12-out3693"	.42737	153	205	358
12	"12-out3694"	.39303	79	122	201
12	"12-out3695"	.54826	835	688	1523
12	"12-out3696"	.44198	240	303	543
12	"12-out3697"	.35151	58	107	165
12	"12-out3698"	.45625	146	174	320
12	"12-out3699"	.18934	231	989	1220
12	"12-out3700"	.40811	171	248	419
12	"12-out3701"	.44444	236	295	531
12	"12-out3702"	.48881	153	160	313
12	"12-out3703"	.53467	424	369	793
12	"12-out3704"	.33657	173	341	514
12	"12-out3705"	.52020	103	95	198
12	"12-out3706"	.44230	46	58	104
12	"12-out3707"	.45188	216	262	478
12	"12-out3708"	.38280	374	603	977
12	"12-out3709"	.29166	28	68	96
12	"12-out3710"	.29613	207	492	699
12	"12-out3711"	.99764	423	1	424
12	"12-out3712"	.99492	196	1	197
12	"12-out3713"	.92805	645	50	695
12	"12-out3714"	.35733	263	473	736
12	"12-out3715"	.37745	77	127	204
12	"12-out3716"	.41099	568	814	1382
12	"12-out3717"	.18150	106	478	584
12	"12-out3718"	.26086	42	119	161
12	"12-out3719"	.99576	235	1	236
12	"12-out3720"	.69266	151	67	218
12	"12-out3721"	.15598	56	303	359
12	"12-out3722"	.28396	232	585	817
12	"12-out3723"	.74336	336	116	452
12	"12-out3724"	.29669	359	851	1210
12	"12-out3725"	.42401	279	379	658
12	"12-out3726"	.37611	463	768	1231
12	"12-out3727"	.56637	64	49	113
12	"12-out3728"	.86347	487	77	564
12	"12-out3729"	.47123	213	239	452
12	"12-out3730"	.42809	128	171	299
12	"12-out3731"	.25644	209	606	815
12	"12-out3732"	.40178	360	536	896
12	"12-out3733"	.36414	717	1252	1969
12	"12-out3734"	.57471	150	111	261
12	"12-out3735"	.52552	700	632	1332
12	"12-out3736"	.42978	355	471	826
12	"12-out3737"	.40452	411	605	1016
12	"12-out3738"	.43472	333	433	766
12	"12-out3739"	.39667	453	689	1142
12	"12-out3740"	.39669	96	146	242
12	"12-out3741"	.42799	318	425	743
12	"12-out3742"	.44111	221	280	501
12	"12-out3743"	.94857	332	18	350
12	"12-out3744"	.78911	232	62	294
12	"12-out3745"	.31597	91	197	288
12	"12-out3746"	.58589	324	229	553
12	"12-out3747"	.35381	190	347	537
12	"12-out3748"	.28390	157	396	553
12	"12-out3749"	.30390	179	410	589
12	"12-out3750"	.99438	177	1	178
12	"12-out3751"	.52631	360	324	684
12	"12-out3752"	.99386	162	1	163
12	"12-out3753"	.63819	127	72	199
12	"12-out3754"	.88888	240	30	270
12	"12-out3755"	.77777	280	80	360
12	"12-out3756"	.14393	57	339	396
12	"12-out3757"	.36307	118	207	325
12	"12-out3758"	.99521	208	1	209
12	"12-out3759"	.40512	79	116	195
12	"12-out3760"	.40993	132	190	322
12	"12-out3761"	.39280	295	456	751
12	"12-out3762"	.26033	63	179	242
12	"12-out3763"	.39726	58	88	146
12	"12-out3764"	.30707	230	519	749
12	"12-out3765"	.58577	140	99	239
12	"12-out3766"	.79583	191	49	240
12	"12-out3767"	.31775	68	146	214
12	"12-out3768"	.31858	72	154	226
12	"12-out3769"	.61568	157	98	255
12	"12-out3770"	.28292	58	147	205
12	"12-out3771"	.49765	106	107	213
12	"12-out3772"	.63445	151	87	238
12	"12-out3773"	.39035	89	139	228
12	"12-out3774"	.99736	379	1	380
12	"12-out3775"	.31803	97	208	305
12	"12-out3776"	.98734	78	1	79
12	"12-out3777"	.98734	78	1	79
12	"12-out3778"	.99295	141	1	142
12	"12-out3779"	.38176	134	217	351
12	"12-out3780"	.72897	78	29	107
12	"12-out3781"	.68461	178	82	260
12	"12-out3782"	.39943	282	424	706
12	"12-out3783"	.24436	130	402	532
12	"12-out3784"	.49127	197	204	401
12	"12-out3785"	.28958	139	341	480
12	"12-out3786"	.98936	93	1	94
12	"12-out3787"	.39706	1082	1643	2725
12	"12-out3788"	.50000	34	34	68
12	"12-out3789"	.40102	314	469	783
12	"12-out3790"	.48297	156	167	323
12	"12-out3791"	.30340	98	225	323
12	"12-out3792"	.33300	336	673	1009
12	"12-out3793"	.33359	425	849	1274
12	"12-out3794"	.64786	379	206	585
12	"12-out3795"	.22704	272	926	1198
12	"12-out3796"	.35059	88	163	251
12	"12-out3797"	.98947	94	1	95
12	"12-out3798"	.23214	39	129	168
12	"12-out3799"	.34124	115	222	337
12	"12-out3800"	.20439	158	615	773
12	"12-out3801"	.22857	168	567	735
12	"12-out3802"	.43000	129	171	300
12	"12-out3803"	.29677	92	218	310
12	"12-out3804"	.99706	340	1	341
12	"12-out3805"	.77551	76	22	98
12	"12-out3806"	.46896	68	77	145
12	"12-out3807"	.68041	66	31	97
12	"12-out3808"	.98507	66	1	67
12	"12-out3809"	.40622	483	706	1189
12	"12-out3810"	.38461	780	1248	2028
12	"12-out3811"	.98630	72	1	73
12	"12-out3812"	.35666	214	386	600
12	"12-out3813"	.59033	232	161	393
12	"12-out3814"	.68092	207	97	304
12	"12-out3815"	.31984	245	521	766
12	"12-out3816"	.22739	83	282	365
12	"12-out3817"	.32897	856	1746	2602
12	"12-out3818"	.60316	1029	677	1706
12	"12-out3819"	.35403	171	312	483
12	"12-out3820"	.26495	341	946	1287
12	"12-out3821"	.40642	215	314	529
12	"12-out3822"	.44893	211	259	470
12	"12-out3823"	.92121	152	13	165
12	"12-out3824"	.68041	132	62	194
12	"12-out3825"	.98437	63	1	64
12	"12-out3826"	.36318	292	512	804
12	"12-out3827"	.98571	69	1	70
12	"12-out3828"	.43877	473	605	1078
12	"12-out3829"	.87500	147	21	168
12	"12-out3830"	.88095	74	10	84
12	"12-out3831"	.48989	194	202	396
12	"12-out3832"	.23260	127	419	546
12	"12-out3833"	.28070	112	287	399
12	"12-out3834"	.20701	236	904	1140
12	"12-out3835"	.21467	196	717	913
12	"12-out3836"	.32197	274	577	851
12	"12-out3837"	.47351	438	487	925
12	"12-out3838"	.90000	90	10	100
12	"12-out3839"	.44788	275	339	614
12	"12-out3840"	.61448	1052	660	1712
12	"12-out3841"	.70000	49	21	70
12	"12-out3842"	.50686	406	395	801
12	"12-out3843"	.42456	394	534	928
12	"12-out3844"	.98397	798	13	811
12	"12-out3845"	.45531	107	128	235
12	"12-out3846"	.42441	452	613	1065
12	"12-out3847"	.21473	102	373	475
12	"12-out3848"	.30208	203	469	672
12	"12-out3849"	.43209	175	230	405
12	"12-out3850"	.48820	621	651	1272
12	"12-out3851"	.30813	159	357	516
12	"12-out3852"	.32160	64	135	199
12	"12-out3853"	.39421	218	335	553
12	"12-out3854"	.94505	258	15	273
12	"12-out3855"	.81012	128	30	158
12	"12-out3856"	.29256	354	856	1210
12	"12-out3857"	.98717	77	1	78
12	"12-out3858"	.56813	296	225	521
12	"12-out3859"	.98924	92	1	93
12	"12-out3860"	.55873	195	154	349
12	"12-out3861"	.99718	354	1	355
12	"12-out3862"	.47261	233	260	493
12	"12-out3863"	.43269	450	590	1040
12	"12-out3864"	.99894	949	1	950
12	"12-out3865"	.44776	150	185	335
12	"12-out3866"	.42324	397	541	938
12	"12-out3867"	.36942	174	297	471
12	"12-out3868"	.63793	148	84	232
12	"12-out3869"	.45285	389	470	859
12	"12-out3870"	.47245	283	316	599
12	"12-out3871"	.65500	393	207	600
12	"12-out3872"	.37837	280	460	740
12	"12-out3873"	.98936	93	1	94
12	"12-out3874"	.47334	293	326	619
12	"12-out3875"	.51577	425	399	824
12	"12-out3876"	.43355	447	584	1031
12	"12-out3877"	.33009	170	345	515
12	"12-out3878"	.52592	213	192	405
12	"12-out3879"	.38354	387	622	1009
12	"12-out3880"	.38552	618	985	1603
12	"12-out3881"	.40094	85	127	212
12	"12-out3882"	.48942	162	169	331
12	"12-out3883"	.74556	252	86	338
12	"12-out3884"	.81410	254	58	312
12	"12-out3885"	.29098	355	865	1220
12	"12-out3886"	.79617	750	192	942
12	"12-out3887"	.66168	487	249	736
12	"12-out3888"	.31897	237	506	743
12	"12-out3889"	.64041	732	411	1143
12	"12-out3890"	.35064	135	250	385
12	"12-out3891"	.45296	130	157	287
12	"12-out3892"	.64269	277	154	431
12	"12-out3893"	.38115	534	867	1401
12	"12-out3894"	.48195	187	201	388
12	"12-out3895"	.36572	286	496	782
12	"12-out3896"	.92105	280	24	304
12	"12-out3897"	.57928	358	260	618
12	"12-out3898"	.50630	241	235	476
12	"12-out3899"	.37527	173	288	461
12	"12-out3900"	.42391	195	265	460
12	"12-out3901"	.17058	29	141	170
12	"12-out3902"	.32786	80	164	244
12	"12-out3903"	.29797	118	278	396
12	"12-out3904"	.32084	137	290	427
12	"12-out3905"	.29903	186	436	622
12	"12-out3906"	.06918	22	296	318
12	"12-out3907"	.67870	526	249	775
12	"12-out3908"	.54934	334	274	608
12	"12-out3909"	.61087	146	93	239
12	"12-out3910"	.77743	255	73	328
12	"12-out3911"	.82811	925	192	1117
12	"12-out3912"	.55000	154	126	280
12	"12-out3913"	.43253	436	572	1008
12	"12-out3914"	.29706	273	646	919
12	"12-out3915"	.36473	422	735	1157
12	"12-out3916"	.82798	645	134	779
12	"12-out3917"	.32723	733	1507	2240
12	"12-out3918"	.37724	587	969	1556
12	"12-out3919"	.41269	312	444	756
12	"12-out3920"	.33431	114	227	341
12	"12-out3921"	.49428	173	177	350
12	"12-out3922"	.74793	181	61	242
12	"12-out3923"	.35282	350	642	992
12	"12-out3924"	.27624	200	524	724
12	"12-out3925"	.98630	72	1	73
12	"12-out3926"	.46620	338	387	725
12	"12-out3927"	.36677	117	202	319
12	"12-out3928"	.97629	659	16	675
12	"12-out3929"	.79944	578	145	723
12	"12-out3930"	.98611	71	1	72
12	"12-out3931"	.47245	283	316	599
12	"12-out3932"	.55297	428	346	774
12	"12-out3933"	.77105	357	106	463
12	"12-out3934"	.97604	326	8	334
12	"12-out3935"	.56504	278	214	492
12	"12-out3936"	.48784	301	316	617
12	"12-out3937"	.39041	114	178	292
12	"12-out3938"	.52049	127	117	244
12	"12-out3939"	.64736	123	67	190
12	"12-out3940"	.82352	84	18	102
12	"12-out3941"	.34035	97	188	285
12	"12-out3942"	.38076	380	618	998
12	"12-out3943"	.99253	133	1	134
12	"12-out3944"	.84803	625	112	737
12	"12-out3945"	.91428	800	75	875
12	"12-out3946"	.35350	111	203	314
12	"12-out3947"	.22699	74	252	326
12	"12-out3948"	.32035	181	384	565
12	"12-out3949"	.24615	112	343	455
12	"12-out3950"	.30359	388	890	1278
12	"12-out3951"	.22768	176	597	773
12	"12-out3952"	.39337	190	293	483
12	"12-out3953"	.36325	263	461	724
12	"12-out3954"	.79305	525	137	662
12	"12-out3955"	.99896	969	1	970
12	"12-out3956"	.72427	528	201	729
12	"12-out3957"	.98936	93	1	94
12	"12-out3958"	.94650	230	13	243
12	"12-out3959"	.86914	445	67	512
12	"12-out3960"	.99494	197	1	198
12	"12-out3961"	.36831	551	945	1496
12	"12-out3962"	.43792	836	1073	1909
12	"12-out3963"	.58774	355	249	604
12	"12-out3964"	.28092	109	279	388
12	"12-out3965"	.99545	219	1	220
12	"12-out3966"	.97670	545	13	558
12	"12-out3967"	.27245	91	243	334
12	"12-out3968"	.98461	64	1	65
12	"12-out3969"	.30283	96	221	317
12	"12-out3970"	.26591	188	519	707
12	"12-out3971"	.99719	356	1	357
12	"12-out3972"	.99371	158	1	159
12	"12-out3973"	.36907	389	665	1054
12	"12-out3974"	.41379	108	153	261
12	"12-out3975"	.28318	96	243	339
12	"12-out3976"	.28427	226	569	795
12	"12-out3977"	.48970	523	545	1068
12	"12-out3978"	.99889	906	1	907
12	"12-out3979"	.99290	140	1	141
12	"12-out3980"	.95744	135	6	141
12	"12-out3981"	.42875	325	433	758
12	"12-out3982"	.44444	84	105	189
12	"12-out3983"	.68627	105	48	153
12	"12-out3984"	.68627	70	32	102
12	"12-out3985"	.62195	51	31	82
12	"12-out3986"	.98863	87	1	88
12	"12-out3987"	.54545	42	35	77
12	"12-out3988"	.55230	132	107	239
12	"12-out3989"	.48648	126	133	259
12	"12-out3990"	.55393	190	153	343
12	"12-out3991"	.58317	305	218	523
12	"12-out3992"	.34545	38	72	110
12	"12-out3993"	.89961	233	26	259
12	"12-out3994"	.59493	141	96	237
12	"12-out3995"	.45744	215	255	470
12	"12-out3996"	.47888	431	469	900
12	"12-out3997"	.38677	275	436	711
12	"12-out3998"	.32537	259	537	796
12	"12-out3999"	.29259	158	382	540
12	"12-out4000"	.62612	417	249	666
12	"12-out4001"	.47543	300	331	631
12	"12-out4002"	.36776	324	557	881
12	"12-out4003"	.98358	659	11	670
12	"12-out4004"	.30347	166	381	547
12	"12-out4005"	.70546	297	124	421
12	"12-out4006"	.39322	116	179	295
12	"12-out4007"	.48180	821	883	1704
12	"12-out4008"	.95073	193	10	203
12	"12-out4009"	.75000	99	33	132
12	"12-out4010"	.25602	170	494	664
12	"12-out4011"	.72767	163	61	224
12	"12-out4012"	.54545	90	75	165
12	"12-out4013"	.54485	249	208	457
12	"12-out4014"	.99489	195	1	196
12	"12-out4015"	.99549	221	1	222
12	"12-out4016"	.62612	139	83	222
12	"12-out4017"	.89230	174	21	195
12	"12-out4018"	.26530	52	144	196
12	"12-out4019"	.48201	201	216	417
12	"12-out4020"	.94642	106	6	112
12	"12-out4021"	.40362	245	362	607
12	"12-out4022"	.30463	46	105	151
12	"12-out4023"	.50493	256	251	507
12	"12-out4024"	.47120	450	505	955
12	"12-out4025"	.50368	205	202	407
12	"12-out4026"	.30071	169	393	562
12	"12-out4027"	.60516	164	107	271
12	"12-out4028"	.52941	171	152	323
12	"12-out4029"	.32027	188	399	587
12	"12-out4030"	.39735	180	273	453
12	"12-out4031"	.61587	287	179	466
12	"12-out4032"	.38507	129	206	335
12	"12-out4033"	.43500	174	226	400
12	"12-out4034"	.35991	325	578	903
12	"12-out4035"	.48608	227	240	467
12	"12-out4036"	.49152	116	120	236
12	"12-out4037"	.21666	39	141	180
12	"12-out4038"	.96043	267	11	278
12	"12-out4039"	.89189	165	20	185
12	"12-out4040"	.38341	74	119	193
12	"12-out4041"	.44444	84	105	189
12	"12-out4042"	.38601	596	948	1544
12	"12-out4043"	.29647	244	579	823
12	"12-out4044"	.18888	34	146	180
12	"12-out4045"	.26917	193	524	717
12	"12-out4046"	.34474	272	517	789
12	"12-out4047"	.63235	301	175	476
12	"12-out4048"	.20865	82	311	393
12	"12-out4049"	.40522	186	273	459
12	"12-out4050"	.33119	155	313	468
12	"12-out4051"	.61386	186	117	303
12	"12-out4052"	.33854	65	127	192
12	"12-out4053"	.37782	184	303	487
12	"12-out4054"	.29973	571	1334	1905
12	"12-out4055"	.40248	291	432	723
12	"12-out4056"	.24620	146	447	593
12	"12-out4057"	.33167	267	538	805
12	"12-out4058"	.63043	58	34	92
12	"12-out4059"	.26293	244	684	928
12	"12-out4060"	.25129	97	289	386
12	"12-out4061"	.48724	191	201	392
12	"12-out4062"	.33851	196	383	579
12	"12-out4063"	.98809	83	1	84
12	"12-out4064"	.56338	80	62	142
12	"12-out4065"	.99559	226	1	227
12	"12-out4066"	.43736	391	503	894
12	"12-out4067"	.65381	831	440	1271
12	"12-out4068"	.99418	171	1	172
12	"12-out4069"	.41631	296	415	711
12	"12-out4070"	.98260	904	16	920
12	"12-out4071"	.55813	72	57	129
12	"12-out4072"	.72807	83	31	114
12	"12-out4073"	.99846	650	1	651
12	"12-out4074"	.26213	108	304	412
12	"12-out4075"	.27343	140	372	512
12	"12-out4076"	.55747	291	231	522
12	"12-out4077"	.93425	611	43	654
12	"12-out4078"	.44134	79	100	179
12	"12-out4079"	.99576	235	1	236
12	"12-out4080"	.99800	499	1	500
12	"12-out4081"	.31485	159	346	505
12	"12-out4082"	.39912	182	274	456
12	"12-out4083"	.32611	256	529	785
12	"12-out4084"	.10500	21	179	200
12	"12-out4085"	.66115	80	41	121
12	"12-out4086"	.35638	67	121	188
12	"12-out4087"	.43262	122	160	282
12	"12-out4088"	.24074	13	41	54
12	"12-out4089"	.27616	190	498	688
12	"12-out4090"	.31964	109	232	341
12	"12-out4091"	.35480	325	591	916
12	"12-out4092"	.48837	294	308	602
12	"12-out4093"	.51173	109	104	213
12	"12-out4094"	.64414	143	79	222
12	"12-out4095"	.46351	108	125	233
12	"12-out4096"	.99415	170	1	171
12	"12-out4097"	.55223	111	90	201
12	"12-out4098"	.42604	193	260	453
12	"12-out4099"	.33743	274	538	812
12	"12-out4100"	.43382	59	77	136
12	"12-out4101"	.20352	127	497	624
12	"12-out4102"	.80622	337	81	418
12	"12-out4103"	.94761	199	11	210
12	"12-out4104"	.47089	89	100	189
12	"12-out4105"	.33783	100	196	296
12	"12-out4106"	.60430	365	239	604
12	"12-out4107"	.48148	325	350	675
12	"12-out4108"	.99047	104	1	105
12	"12-out4109"	.91119	236	23	259
12	"12-out4110"	.89719	96	11	107
12	"12-out4111"	.28305	137	347	484
12	"12-out4112"	.84203	645	121	766
12	"12-out4113"	.41656	342	479	821
12	"12-out4114"	.32782	238	488	726
12	"12-out4115"	.35204	232	427	659
12	"12-out4116"	.68181	375	175	550
12	"12-out4117"	.61208	314	199	513
12	"12-out4118"	.33149	60	121	181
12	"12-out4119"	.99230	129	1	130
12	"12-out4120"	.30705	148	334	482
12	"12-out4121"	.94033	394	25	419
12	"12-out4122"	.71372	182	73	255
12	"12-out4123"	.14285	12	72	84
12	"12-out4124"	.47161	108	121	229
12	"12-out4125"	.80555	203	49	252
12	"12-out4126"	.99315	145	1	146
12	"12-out4127"	.37388	126	211	337
12	"12-out4128"	.41941	229	317	546
12	"12-out4129"	.46822	280	318	598
12	"12-out4130"	.44475	318	397	715
12	"12-out4131"	.99310	144	1	145
12	"12-out4132"	.27878	477	1234	1711
12	"12-out4133"	.29820	249	586	835
12	"12-out4134"	.43632	209	270	479
12	"12-out4135"	.41904	88	122	210
12	"12-out4136"	.44059	89	113	202
12	"12-out4137"	.43778	95	122	217
12	"12-out4138"	.34844	146	273	419
12	"12-out4139"	.26315	65	182	247
12	"12-out4140"	.99616	260	1	261
12	"12-out4141"	.40801	326	473	799
12	"12-out4142"	.60507	501	327	828
12	"12-out4143"	.56741	303	231	534
12	"12-out4144"	.45605	192	229	421
12	"12-out4145"	.46198	79	92	171
12	"12-out4146"	.30451	155	354	509
12	"12-out4147"	.98305	116	2	118
12	"12-out4148"	.99633	272	1	273
12	"12-out4149"	.41666	85	119	204
12	"12-out4150"	.89911	508	57	565
12	"12-out4151"	.18972	48	205	253
12	"12-out4152"	.23748	517	1660	2177
12	"12-out4153"	.21025	205	770	975
12	"12-out4154"	.99797	493	1	494
12	"12-out4155"	.35632	31	56	87
12	"12-out4156"	.99004	398	4	402
12	"12-out4157"	.55118	140	114	254
12	"12-out4158"	.37012	114	194	308
12	"12-out4159"	.47826	253	276	529
12	"12-out4160"	.31573	329	713	1042
12	"12-out4161"	.42378	392	533	925
12	"12-out4162"	.31021	161	358	519
12	"12-out4163"	.31151	576	1273	1849
12	"12-out4164"	.52709	214	192	406
12	"12-out4165"	.31827	310	664	974
12	"12-out4166"	.98370	483	8	491
12	"12-out4167"	.69014	98	44	142
12	"12-out4168"	.42197	192	263	455
12	"12-out4169"	.28773	122	302	424
12	"12-out4170"	.39018	151	236	387
12	"12-out4171"	.24489	96	296	392
12	"12-out4172"	.86654	461	71	532
12	"12-out4173"	.30664	337	762	1099
12	"12-out4174"	.51262	203	193	396
12	"12-out4175"	.15328	21	116	137
12	"12-out4176"	.34939	87	162	249
12	"12-out4177"	.56530	290	223	513
12	"12-out4178"	.42766	1679	2247	3926
12	"12-out4179"	.87234	205	30	235
12	"12-out4180"	.32911	78	159	237
12	"12-out4181"	.27710	299	780	1079
12	"12-out4182"	.44615	87	108	195
12	"12-out4183"	.99795	489	1	490
12	"12-out4184"	.37677	133	220	353
12	"12-out4185"	.99465	186	1	187
12	"12-out4186"	.34959	1698	3159	4857
12	"12-out4187"	.20168	72	285	357
12	"12-out4188"	.99004	398	4	402
12	"12-out4189"	.25985	178	507	685
12	"12-out4190"	.57950	164	119	283
12	"12-out4191"	.51086	94	90	184
12	"12-out4192"	.82839	1062	220	1282
12	"12-out4193"	.58823	70	49	119
12	"12-out4194"	.99137	115	1	116
12	"12-out4195"	.99846	650	1	651
12	"12-out4196"	.34806	189	354	543
12	"12-out4197"	.43076	532	703	1235
12	"12-out4198"	.30697	132	298	430
12	"12-out4199"	.33141	173	349	522
12	"12-out4200"	.55119	1884	1534	3418
12	"12-out4201"	.37418	229	383	612
12	"12-out4202"	.36413	402	702	1104
12	"12-out4203"	.45523	478	572	1050
12	"12-out4204"	.43594	473	612	1085
12	"12-out4205"	.99862	724	1	725
12	"12-out4206"	.94827	110	6	116
12	"12-out4207"	.96444	217	8	225
12	"12-out4208"	.99843	637	1	638
12	"12-out4209"	.49311	179	184	363
12	"12-out4210"	.99797	493	1	494
12	"12-out4211"	.33759	132	259	391
12	"12-out4212"	.88372	152	20	172
12	"12-out4213"	.44954	637	780	1417
12	"12-out4214"	.26122	291	823	1114
12	"12-out4215"	.80540	149	36	185
12	"12-out4216"	.22718	224	762	986
12	"12-out4217"	.42924	273	363	636
12	"12-out4218"	.49315	108	111	219
12	"12-out4219"	.56050	176	138	314
12	"12-out4220"	.50952	107	103	210
12	"12-out4221"	.99719	356	1	357
12	"12-out4222"	.35238	37	68	105
12	"12-out4223"	.93833	700	46	746
12	"12-out4224"	.23046	59	197	256
12	"12-out4225"	.57977	1766	1280	3046
12	"12-out4226"	.98666	74	1	75
12	"12-out4227"	.31269	101	222	323
12	"12-out4228"	.60597	446	290	736
12	"12-out4229"	.52346	658	599	1257
12	"12-out4230"	.86264	515	82	597
12	"12-out4231"	.43888	79	101	180
12	"12-out4232"	.46687	148	169	317
12	"12-out4233"	.32286	72	151	223
12	"12-out4234"	.30974	302	673	975
12	"12-out4235"	.59000	295	205	500
12	"12-out4236"	.58368	279	199	478
12	"12-out4237"	.55617	99	79	178
12	"12-out4238"	.92000	115	10	125
12	"12-out4239"	.36941	587	1002	1589
12	"12-out4240"	.66463	218	110	328
12	"12-out4241"	.28571	146	365	511
12	"12-out4242"	.42911	227	302	529
12	"12-out4243"	.86288	472	75	547
12	"12-out4244"	.36250	58	102	160
12	"12-out4245"	.55576	867	693	1560
12	"12-out4246"	.34722	175	329	504
12	"12-out4247"	.65898	143	74	217
12	"12-out4248"	.37176	187	316	503
12	"12-out4249"	.17475	36	170	206
12	"12-out4250"	.70370	76	32	108
12	"12-out4251"	.36301	106	186	292
12	"12-out4252"	.60809	706	455	1161
12	"12-out4253"	.36538	133	231	364
12	"12-out4254"	.38273	235	379	614
12	"12-out4255"	.36769	107	184	291
12	"12-out4256"	.50436	231	227	458
12	"12-out4257"	.28547	169	423	592
12	"12-out4258"	.99310	144	1	145
12	"12-out4259"	.40449	324	477	801
12	"12-out4260"	.32412	129	269	398
12	"12-out4261"	.19316	147	614	761
12	"12-out4262"	.31960	388	826	1214
12	"12-out4263"	.40049	161	241	402
12	"12-out4264"	.48962	236	246	482
12	"12-out4265"	.48734	77	81	158
12	"12-out4266"	.40213	113	168	281
12	"12-out4267"	.34269	244	468	712
12	"12-out4268"	.99805	512	1	513
12	"12-out4269"	.99310	144	1	145
12	"12-out4270"	.24285	34	106	140
12	"12-out4271"	.57238	514	384	898
12	"12-out4272"	.44321	160	201	361
12	"12-out4273"	.56024	93	73	166
12	"12-out4274"	.31640	218	471	689
12	"12-out4275"	.25080	156	466	622
12	"12-out4276"	.34306	141	270	411
12	"12-out4277"	.78723	74	20	94
12	"12-out4278"	.27272	150	400	550
12	"12-out4279"	.98765	80	1	81
12	"12-out4280"	.36480	85	148	233
12	"12-out4281"	.44057	278	353	631
12	"12-out4282"	.59609	183	124	307
12	"12-out4283"	.74371	296	102	398
12	"12-out4284"	.51393	166	157	323
12	"12-out4285"	.36056	128	227	355
12	"12-out4286"	.50172	291	289	580
12	"12-out4287"	.50802	190	184	374
12	"12-out4288"	.20588	77	297	374
12	"12-out4289"	.23280	88	290	378
12	"12-out4290"	.34444	310	590	900
12	"12-out4291"	.36301	265	465	730
12	"12-out4292"	.99792	481	1	482
12	"12-out4293"	.99119	788	7	795
12	"12-out4294"	.19745	62	252	314
12	"12-out4295"	.88888	104	13	117
12	"12-out4296"	.49025	176	183	359
12	"12-out4297"	.72131	44	17	61
12	"12-out4298"	.38864	89	140	229
12	"12-out4299"	.42266	235	321	556
12	"12-out4300"	.88764	474	60	534
12	"12-out4301"	.61861	206	127	333
12	"12-out4302"	.49032	304	316	620
12	"12-out4303"	.12734	34	233	267
12	"12-out4304"	.34323	104	199	303
12	"12-out4305"	.42228	432	591	1023
12	"12-out4306"	.42519	557	753	1310
12	"12-out4307"	.44854	170	209	379
12	"12-out4308"	.46938	138	156	294
12	"12-out4309"	.60317	76	50	126
12	"12-out4310"	.74509	76	26	102
12	"12-out4311"	.96387	507	19	526
12	"12-out4312"	.63089	1564	915	2479
12	"12-out4313"	.29211	137	332	469
12	"12-out4314"	.45478	508	609	1117
12	"12-out4315"	.26500	53	147	200
12	"12-out4316"	.28941	123	302	425
12	"12-out4317"	.78066	210	59	269
12	"12-out4318"	.98518	266	4	270
12	"12-out4319"	.39593	156	238	394
12	"12-out4320"	.22459	42	145	187
12	"12-out4321"	.38888	189	297	486
12	"12-out4322"	.48177	185	199	384
12	"12-out4323"	.32666	98	202	300
12	"12-out4324"	.38000	57	93	150
12	"12-out4325"	.93823	562	37	599
12	"12-out4326"	.46015	485	569	1054
12	"12-out4327"	.38324	215	346	561
12	"12-out4328"	.31907	276	589	865
12	"12-out4329"	.69057	520	233	753
12	"12-out4330"	.69402	186	82	268
12	"12-out4331"	.56034	260	204	464
12	"12-out4332"	.48314	129	138	267
12	"12-out4333"	.86577	258	40	298
12	"12-out4334"	.41875	317	440	757
12	"12-out4335"	.56951	340	257	597
12	"12-out4336"	.54491	91	76	167
12	"12-out4337"	.66487	371	187	558
12	"12-out4338"	.99230	129	1	130
12	"12-out4339"	.41142	144	206	350
12	"12-out4340"	.99630	270	1	271
12	"12-out4341"	.99152	117	1	118
12	"12-out4342"	.43711	285	367	652
12	"12-out4343"	.73553	178	64	242
12	"12-out4344"	.98684	75	1	76
12	"12-out4345"	.99462	185	1	186
12	"12-out4346"	.70078	89	38	127
12	"12-out4347"	.36428	51	89	140
12	"12-out4348"	.51078	947	907	1854
12	"12-out4349"	.99551	222	1	223
12	"12-out4350"	.68497	2183	1004	3187
12	"12-out4351"	.32903	204	416	620
12	"12-out4352"	.40853	67	97	164
12	"12-out4353"	.63545	190	109	299
12	"12-out4354"	.56916	144	109	253
12	"12-out4355"	.42703	556	746	1302
12	"12-out4356"	.67295	107	52	159
12	"12-out4357"	.15665	60	323	383
12	"12-out4358"	.33333	79	158	237
12	"12-out4359"	.65527	230	121	351
12	"12-out4360"	.62244	183	111	294
12	"12-out4361"	.44848	74	91	165
12	"12-out4362"	.38378	71	114	185
12	"12-out4363"	.56576	542	416	958
12	"12-out4364"	.99509	203	1	204
12	"12-out4365"	.38842	94	148	242
12	"12-out4366"	.42181	116	159	275
12	"12-out4367"	.51336	192	182	374
12	"12-out4368"	.58227	552	396	948
12	"12-out4369"	.50434	58	57	115
12	"12-out4370"	.62626	62	37	99
12	"12-out4371"	.58620	136	96	232
12	"12-out4372"	.38095	128	208	336
12	"12-out4373"	.38904	135	212	347
12	"12-out4374"	.99459	184	1	185
12	"12-out4375"	.28045	221	567	788
12	"12-out4376"	.90898	749	75	824
12	"12-out4377"	.25747	112	323	435
12	"12-out4378"	.37130	176	298	474
12	"12-out4379"	.73858	178	63	241
12	"12-out4380"	.50000	126	126	252
12	"12-out4381"	.30056	266	619	885
12	"12-out4382"	.85863	164	27	191
12	"12-out4383"	.21123	94	351	445
12	"12-out4384"	.97535	277	7	284
12	"12-out4385"	.74414	445	153	598
12	"12-out4386"	.36912	110	188	298
12	"12-out4387"	.51136	90	86	176
12	"12-out4388"	.96464	1528	56	1584
12	"12-out4389"	.99716	352	1	353
12	"12-out4390"	.99551	222	1	223
12	"12-out4391"	.31525	93	202	295
12	"12-out4392"	.36675	706	1219	1925
12	"12-out4393"	.62805	591	350	941
12	"12-out4394"	.60000	195	130	325
12	"12-out4395"	.69811	407	176	583
12	"12-out4396"	.49342	75	77	152
12	"12-out4397"	.33717	117	230	347
12	"12-out4398"	.60544	178	116	294
12	"12-out4399"	.59740	92	62	154
12	"12-out4400"	.98930	185	2	187
12	"12-out4401"	.49609	254	258	512
12	"12-out4402"	.31250	170	374	544
12	"12-out4403"	.44400	222	278	500
12	"12-out4404"	.51351	1254	1188	2442
12	"12-out4405"	.96531	501	18	519
12	"12-out4406"	.99705	339	1	340
12	"12-out4407"	.25969	154	439	593
12	"12-out4408"	.43113	72	95	167
12	"12-out4409"	.39473	45	69	114
12	"12-out4410"	.34527	241	457	698
12	"12-out4411"	.97674	84	2	86
12	"12-out4412"	.99447	180	1	181
12	"12-out4413"	.48175	330	355	685
12	"12-out4414"	.98518	133	2	135
12	"12-out4415"	.25221	114	338	452
12	"12-out4416"	.38921	534	838	1372
12	"12-out4417"	.66787	185	92	277
12	"12-out4418"	.28725	133	330	463
12	"12-out4419"	.53412	180	157	337
12	"12-out4420"	.97872	322	7	329
12	"12-out4421"	.99743	389	1	390
12	"12-out4422"	.46941	353	399	752
12	"12-out4423"	.85535	479	81	560
12	"12-out4424"	.96601	398	14	412
12	"12-out4425"	.34090	135	261	396
12	"12-out4426"	.99751	401	1	402
12	"12-out4427"	.99115	112	1	113
12	"12-out4428"	.46917	137	155	292
12	"12-out4429"	.45925	62	73	135
12	"12-out4430"	.30800	77	173	250
12	"12-out4431"	.99386	162	1	163
12	"12-out4432"	.40720	226	329	555
12	"12-out4433"	.45491	222	266	488
12	"12-out4434"	.58235	548	393	941
12	"12-out4435"	.31092	37	82	119
12	"12-out4436"	.46420	201	232	433
12	"12-out4437"	.95593	282	13	295
12	"12-out4438"	.39534	136	208	344
12	"12-out4439"	.49134	142	147	289
12	"12-out4440"	.31297	246	540	786
12	"12-out4441"	.38591	137	218	355
12	"12-out4442"	.99872	782	1	783
12	"12-out4443"	.31620	80	173	253
12	"12-out4444"	.42318	471	642	1113
12	"12-out4445"	.99644	280	1	281
12	"12-out4446"	.42538	248	335	583
12	"12-out4447"	.21238	48	178	226
12	"12-out4448"	.41737	197	275	472
12	"12-out4449"	.32727	72	148	220
12	"12-out4450"	.57142	188	141	329
12	"12-out4451"	.64809	221	120	341
12	"12-out4452"	.34463	122	232	354
12	"12-out4453"	.44311	296	372	668
12	"12-out4454"	.51242	433	412	845
12	"12-out4455"	.52830	196	175	371
12	"12-out4456"	.60754	161	104	265
12	"12-out4457"	.17961	37	169	206
12	"12-out4458"	.32547	69	143	212
12	"12-out4459"	.44378	671	841	1512
12	"12-out4460"	.45790	1191	1410	2601
12	"12-out4461"	.62068	162	99	261
12	"12-out4462"	.44295	66	83	149
12	"12-out4463"	.40887	424	613	1037
12	"12-out4464"	.18103	21	95	116
12	"12-out4465"	.37695	265	438	703
12	"12-out4466"	.29482	171	409	580
12	"12-out4467"	.54141	353	299	652
12	"12-out4468"	.42857	96	128	224
12	"12-out4469"	.23414	48	157	205
12	"12-out4470"	.46015	306	359	665
12	"12-out4471"	.55828	91	72	163
12	"12-out4472"	.44620	647	803	1450
12	"12-out4473"	.99459	184	1	185
12	"12-out4474"	.21524	48	175	223
12	"12-out4475"	.50187	268	266	534
12	"12-out4476"	.55000	143	117	260
12	"12-out4477"	.23195	45	149	194
12	"12-out4478"	.67095	261	128	389
12	"12-out4479"	.45921	152	179	331
12	"12-out4480"	.59000	59	41	100
12	"12-out4481"	.61133	151	96	247
12	"12-out4482"	.76237	154	48	202
12	"12-out4483"	.20000	72	288	360
12	"12-out4484"	.14285	45	270	315
12	"12-out4485"	.28571	28	70	98
12	"12-out4486"	.27794	92	239	331
12	"12-out4487"	.44000	66	84	150
12	"12-out4488"	.47126	205	230	435
12	"12-out4489"	.89784	334	38	372
12	"12-out4490"	.49537	375	382	757
12	"12-out4491"	.60795	214	138	352
12	"12-out4492"	.32231	234	492	726
12	"12-out4493"	.32246	89	187	276
12	"12-out4494"	.28217	57	145	202
12	"12-out4495"	.78296	285	79	364
12	"12-out4496"	.34821	117	219	336
12	"12-out4497"	.53501	275	239	514
12	"12-out4498"	.48492	595	632	1227
12	"12-out4499"	.43846	114	146	260
12	"12-out4500"	.27878	138	357	495
12	"12-out4501"	.49002	172	179	351
12	"12-out4502"	.35409	108	197	305
12	"12-out4503"	.47609	239	263	502
12	"12-out4504"	.62569	224	134	358
12	"12-out4505"	.71739	99	39	138
12	"12-out4506"	.53354	167	146	313
12	"12-out4507"	.43005	83	110	193
12	"12-out4508"	.36611	644	1115	1759
12	"12-out4509"	.26858	112	305	417
12	"12-out4510"	.38061	161	262	423
12	"12-out4511"	.47826	660	720	1380
12	"12-out4512"	.62780	280	166	446
12	"12-out4513"	.32891	298	608	906
12	"12-out4514"	.50253	297	294	591
12	"12-out4515"	.95300	507	25	532
12	"12-out4516"	.45985	126	148	274
12	"12-out4517"	.41176	63	90	153
12	"12-out4518"	.64397	123	68	191
12	"12-out4519"	.29482	74	177	251
12	"12-out4520"	.43126	411	542	953
12	"12-out4521"	.39939	131	197	328
12	"12-out4522"	.39192	359	557	916
12	"12-out4523"	.36666	99	171	270
12	"12-out4524"	.34493	109	207	316
12	"12-out4525"	.50246	204	202	406
12	"12-out4526"	.99624	265	1	266
12	"12-out4527"	.46428	104	120	224
12	"12-out4528"	.39544	191	292	483
12	"12-out4529"	.63265	279	162	441
12	"12-out4530"	.21641	29	105	134
12	"12-out4531"	.99082	108	1	109
12	"12-out4532"	.40972	177	255	432
12	"12-out4533"	.67955	246	116	362
12	"12-out4534"	.54050	754	641	1395
12	"12-out4535"	.49807	259	261	520
12	"12-out4536"	.40857	143	207	350
12	"12-out4537"	.34527	106	201	307
12	"12-out4538"	.68292	140	65	205
12	"12-out4539"	.48228	177	190	367
12	"12-out4540"	.21008	50	188	238
12	"12-out4541"	.31275	76	167	243
12	"12-out4542"	.23626	43	139	182
12	"12-out4543"	.47598	218	240	458
12	"12-out4544"	.21491	49	179	228
12	"12-out4545"	.38805	104	164	268
12	"12-out4546"	.28987	249	610	859
12	"12-out4547"	.28658	47	117	164
12	"12-out4548"	.42929	85	113	198
12	"12-out4549"	.45553	210	251	461
12	"12-out4550"	.16666	28	140	168
12	"12-out4551"	.51984	275	254	529
12	"12-out4552"	.32479	482	1002	1484
12	"12-out4553"	.88252	308	41	349
12	"12-out4554"	.22463	31	107	138
12	"12-out4555"	.48695	392	413	805
12	"12-out4556"	.26968	137	371	508
12	"12-out4557"	.83333	115	23	138
12	"12-out4558"	.31098	909	2014	2923
12	"12-out4559"	.45145	93	113	206
12	"12-out4560"	.86754	131	20	151
12	"12-out4561"	.56458	695	536	1231
12	"12-out4562"	.48691	279	294	573
12	"12-out4563"	.42836	290	387	677
12	"12-out4564"	.99795	489	1	490
12	"12-out4565"	.88524	1242	161	1403
12	"12-out4566"	.47712	73	80	153
12	"12-out4567"	.85915	122	20	142
12	"12-out4568"	.66336	134	68	202
12	"12-out4569"	.44083	190	241	431
12	"12-out4570"	.35463	222	404	626
12	"12-out4571"	.26204	272	766	1038
12	"12-out4572"	.32293	321	673	994
12	"12-out4573"	.53928	151	129	280
12	"12-out4574"	.30508	144	328	472
12	"12-out4575"	.27551	54	142	196
12	"12-out4576"	.70078	178	76	254
12	"12-out4577"	.24019	98	310	408
12	"12-out4578"	.23966	174	552	726
12	"12-out4579"	.47560	117	129	246
12	"12-out4580"	.32666	604	1245	1849
12	"12-out4581"	.76487	270	83	353
12	"12-out4582"	.98809	83	1	84
12	"12-out4583"	.52631	90	81	171
12	"12-out4584"	.93113	311	23	334
12	"12-out4585"	.30449	88	201	289
12	"12-out4586"	.44268	112	141	253
12	"12-out4587"	.99547	220	1	221
12	"12-out4588"	.93939	341	22	363
12	"12-out4589"	.48314	301	322	623
12	"12-out4590"	.49182	481	497	978
12	"12-out4591"	.64056	180	101	281
12	"12-out4592"	.99724	362	1	363
12	"12-out4593"	.39240	31	48	79
12	"12-out4594"	.55967	136	107	243
12	"12-out4595"	.61081	226	144	370
12	"12-out4596"	.45070	64	78	142
12	"12-out4597"	.26538	138	382	520
12	"12-out4598"	.34683	274	516	790
12	"12-out4599"	.35103	271	501	772
12	"12-out4600"	.38300	347	559	906
12	"12-out4601"	.53709	181	156	337
12	"12-out4602"	.24672	226	690	916
12	"12-out4603"	.46454	190	219	409
12	"12-out4604"	.74884	325	109	434
12	"12-out4605"	.43388	210	274	484
12	"12-out4606"	.36303	110	193	303
12	"12-out4607"	.43302	139	182	321
12	"12-out4608"	.53571	195	169	364
12	"12-out4609"	.25426	134	393	527
12	"12-out4610"	.42598	141	190	331
12	"12-out4611"	.99029	408	4	412
12	"12-out4612"	.18518	30	132	162
12	"12-out4613"	.63402	123	71	194
12	"12-out4614"	.49519	103	105	208
12	"12-out4615"	.33797	194	380	574
12	"12-out4616"	.98561	137	2	139
12	"12-out4617"	.80000	236	59	295
12	"12-out4618"	.33813	305	597	902
12	"12-out4619"	.22434	94	325	419
12	"12-out4620"	.37762	378	623	1001
12	"12-out4621"	.22862	115	388	503
12	"12-out4622"	.25308	41	121	162
12	"12-out4623"	.55721	112	89	201
12	"12-out4624"	.45888	173	204	377
12	"12-out4625"	.29139	88	214	302
12	"12-out4626"	.44017	412	524	936
12	"12-out4627"	.99657	291	1	292
12	"12-out4628"	.75968	196	62	258
12	"12-out4629"	.99663	296	1	297
12	"12-out4630"	.67210	371	181	552
12	"12-out4631"	.57439	498	369	867
12	"12-out4632"	.56666	119	91	210
12	"12-out4633"	.55244	395	320	715
12	"12-out4634"	.99736	379	1	380
12	"12-out4635"	.36166	200	353	553
12	"12-out4636"	.71581	267	106	373
12	"12-out4637"	.81250	416	96	512
12	"12-out4638"	.69615	181	79	260
12	"12-out4639"	.77232	441	130	571
12	"12-out4640"	.47916	46	50	96
12	"12-out4641"	.40206	39	58	97
12	"12-out4642"	.41732	53	74	127
12	"12-out4643"	.58657	166	117	283
12	"12-out4644"	.37127	137	232	369
12	"12-out4645"	.98947	94	1	95
12	"12-out4646"	.33333	22	44	66
12	"12-out4647"	.53266	106	93	199
12	"12-out4648"	.82151	359	78	437
12	"12-out4649"	.27685	183	478	661
12	"12-out4650"	.37500	90	150	240
12	"12-out4651"	.24218	31	97	128
12	"12-out4652"	.31417	82	179	261
12	"12-out4653"	.49549	165	168	333
12	"12-out4654"	.62803	466	276	742
12	"12-out4655"	.21052	36	135	171
12	"12-out4656"	.57446	135	100	235
12	"12-out4657"	.30512	137	312	449
12	"12-out4658"	.37520	224	373	597
12	"12-out4659"	.71502	138	55	193
12	"12-out4660"	.52403	109	99	208
12	"12-out4661"	.37858	198	325	523
12	"12-out4662"	.81385	1915	438	2353
12	"12-out4663"	.54700	1216	1007	2223
12	"12-out4664"	.48583	223	236	459
12	"12-out4665"	.34365	111	212	323
12	"12-out4666"	.31954	139	296	435
12	"12-out4667"	.96093	123	5	128
12	"12-out4668"	.40634	128	187	315
12	"12-out4669"	.38823	66	104	170
12	"12-out4670"	.33957	544	1058	1602
12	"12-out4671"	.33906	217	423	640
12	"12-out4672"	.32895	451	920	1371
12	"12-out4673"	.28717	168	417	585
12	"12-out4674"	.40000	102	153	255
12	"12-out4675"	.39457	189	290	479
12	"12-out4676"	.54545	150	125	275
12	"12-out4677"	.33779	101	198	299
12	"12-out4678"	.30890	333	745	1078
12	"12-out4679"	.99541	217	1	218
12	"12-out4680"	.46200	152	177	329
12	"12-out4681"	.96932	158	5	163
12	"12-out4682"	.32458	136	283	419
12	"12-out4683"	.32281	317	665	982
12	"12-out4684"	.27947	64	165	229
12	"12-out4685"	.23956	132	419	551
12	"12-out4686"	.23956	132	419	551
12	"12-out4687"	.27835	27	70	97
12	"12-out4688"	.54873	152	125	277
12	"12-out4689"	.48821	290	304	594
12	"12-out4690"	.61043	901	575	1476
12	"12-out4691"	.99746	394	1	395
12	"12-out4692"	.47191	126	141	267
12	"12-out4693"	.59215	861	593	1454
12	"12-out4694"	.71084	767	312	1079
12	"12-out4695"	.30365	133	305	438
12	"12-out4696"	.48387	45	48	93
12	"12-out4697"	.39925	107	161	268
12	"12-out4698"	.57720	314	230	544
12	"12-out4699"	.43308	233	305	538
12	"12-out4700"	.23085	196	653	849
12	"12-out4701"	.98823	420	5	425
12	"12-out4702"	.98901	90	1	91
12	"12-out4703"	.56960	446	337	783
12	"12-out4704"	.80636	304	73	377
12	"12-out4705"	.41540	275	387	662
12	"12-out4706"	.25082	76	227	303
12	"12-out4707"	.29457	114	273	387
12	"12-out4708"	.89160	255	31	286
12	"12-out4709"	.39479	364	558	922
12	"12-out4710"	.67664	226	108	334
12	"12-out4711"	.48148	78	84	162
12	"12-out4712"	.99074	107	1	108
12	"12-out4713"	.48717	57	60	117
12	"12-out4714"	.24830	220	666	886
12	"12-out4715"	.55468	71	57	128
12	"12-out4716"	.44800	517	637	1154
12	"12-out4717"	.55223	370	300	670
12	"12-out4718"	.28888	52	128	180
12	"12-out4719"	.36704	225	388	613
12	"12-out4720"	.42533	564	762	1326
12	"12-out4721"	.55131	607	494	1101
12	"12-out4722"	.85433	217	37	254
12	"12-out4723"	.72893	199	74	273
12	"12-out4724"	.61846	201	124	325
12	"12-out4725"	.55000	110	90	200
12	"12-out4726"	.35473	221	402	623
12	"12-out4727"	.59574	196	133	329
12	"12-out4728"	.56256	535	416	951
12	"12-out4729"	.98888	89	1	90
12	"12-out4730"	.99305	143	1	144
12	"12-out4731"	.88664	1228	157	1385
12	"12-out4732"	.94565	87	5	92
12	"12-out4733"	.51041	49	47	96
12	"12-out4734"	.46315	88	102	190
12	"12-out4735"	.31652	113	244	357
12	"12-out4736"	.33978	158	307	465
12	"12-out4737"	.39444	142	218	360
12	"12-out4738"	.60162	222	147	369
12	"12-out4739"	.53465	216	188	404
12	"12-out4740"	.98790	245	3	248
12	"12-out4741"	.52881	156	139	295
12	"12-out4742"	.98060	354	7	361
12	"12-out4743"	.48096	695	750	1445
12	"12-out4744"	.25912	71	203	274
12	"12-out4745"	.98924	92	1	93
12	"12-out4746"	.20731	34	130	164
12	"12-out4747"	.57534	126	93	219
12	"12-out4748"	.44324	164	206	370
12	"12-out4749"	.21186	50	186	236
12	"12-out4750"	.79894	302	76	378
12	"12-out4751"	.99447	360	2	362
12	"12-out4752"	.18320	24	107	131
12	"12-out4753"	.61676	103	64	167
12	"12-out4754"	.99218	127	1	128
12	"12-out4755"	.48648	378	399	777
12	"12-out4756"	.41780	826	1151	1977
12	"12-out4757"	.99672	304	1	305
12	"12-out4758"	.60907	483	310	793
12	"12-out4759"	.30909	204	456	660
12	"12-out4760"	.20103	78	310	388
12	"12-out4761"	.29022	101	247	348
12	"12-out4762"	.35040	431	799	1230
12	"12-out4763"	.30922	124	277	401
12	"12-out4764"	.27591	197	517	714
12	"12-out4765"	.31513	202	439	641
12	"12-out4766"	.48230	109	117	226
12	"12-out4767"	.25589	152	442	594
12	"12-out4768"	.31610	104	225	329
12	"12-out4769"	.44611	178	221	399
12	"12-out4770"	.90209	258	28	286
12	"12-out4771"	.77333	116	34	150
12	"12-out4772"	.59541	78	53	131
12	"12-out4773"	.34649	79	149	228
12	"12-out4774"	.62048	103	63	166
12	"12-out4775"	.33647	143	282	425
12	"12-out4776"	.16864	71	350	421
12	"12-out4777"	.31425	335	731	1066
12	"12-out4778"	.41083	182	261	443
12	"12-out4779"	.29257	134	324	458
12	"12-out4780"	.33678	65	128	193
12	"12-out4781"	.24331	91	283	374
12	"12-out4782"	.36445	890	1552	2442
12	"12-out4783"	.35084	167	309	476
12	"12-out4784"	.39070	479	747	1226
12	"12-out4785"	.33122	157	317	474
12	"12-out4786"	.99841	629	1	630
12	"12-out4787"	.99746	394	1	395
12	"12-out4788"	.98529	67	1	68
12	"12-out4789"	.38800	660	1041	1701
12	"12-out4790"	.74263	378	131	509
12	"12-out4791"	.40067	119	178	297
12	"12-out4792"	.83166	415	84	499
12	"12-out4793"	.28482	92	231	323
12	"12-out4794"	.35714	145	261	406
12	"12-out4795"	.52542	279	252	531
12	"12-out4796"	.33384	216	431	647
12	"12-out4797"	.23684	45	145	190
12	"12-out4798"	.44354	110	138	248
12	"12-out4799"	.99565	229	1	230
12	"12-out4800"	.50118	212	211	423
12	"12-out4801"	.68562	229	105	334
12	"12-out4802"	.99870	774	1	775
12	"12-out4803"	.44629	349	433	782
12	"12-out4804"	.19207	63	265	328
12	"12-out4805"	.42345	130	177	307
12	"12-out4806"	.99655	289	1	290
12	"12-out4807"	.39558	233	356	589
12	"12-out4808"	.23098	167	556	723
12	"12-out4809"	.40000	234	351	585
12	"12-out4810"	.50000	151	151	302
12	"12-out4811"	.35532	140	254	394
12	"12-out4812"	.37831	698	1147	1845
12	"12-out4813"	.63805	446	253	699
12	"12-out4814"	.44351	318	399	717
12	"12-out4815"	.30784	302	679	981
12	"12-out4816"	.59195	103	71	174
12	"12-out4817"	.32984	315	640	955
12	"12-out4818"	.46478	66	76	142
12	"12-out4819"	.96969	32	1	33
12	"12-out4820"	.26218	113	318	431
12	"12-out4821"	.34126	43	83	126
12	"12-out4822"	.08196	10	112	122
12	"12-out4823"	.99621	263	1	264
12	"12-out4824"	.98958	285	3	288
12	"12-out4825"	.87290	261	38	299
12	"12-out4826"	.72857	153	57	210
12	"12-out4827"	.54478	663	554	1217
12	"12-out4828"	.63055	355	208	563
12	"12-out4829"	.47970	461	500	961
12	"12-out4830"	.28735	75	186	261
12	"12-out4831"	.32971	91	185	276
12	"12-out4832"	.99613	774	3	777
12	"12-out4833"	.49775	111	112	223
12	"12-out4834"	.93235	317	23	340
12	"12-out4835"	.78082	114	32	146
12	"12-out4836"	.41201	295	421	716
12	"12-out4837"	.16279	42	216	258
12	"12-out4838"	.88469	445	58	503
12	"12-out4839"	.54385	62	52	114
12	"12-out4840"	.54844	334	275	609
12	"12-out4841"	.92029	739	64	803
12	"12-out4842"	.40448	415	611	1026
12	"12-out4843"	.35452	184	335	519
12	"12-out4844"	.99705	2033	6	2039
12	"12-out4845"	.99679	311	1	312
12	"12-out4846"	.43935	192	245	437
12	"12-out4847"	.99757	411	1	412
12	"12-out4848"	.51029	223	214	437
12	"12-out4849"	.89892	418	47	465
12	"12-out4850"	.70918	139	57	196
12	"12-out4851"	.71839	125	49	174
12	"12-out4852"	.34615	63	119	182
12	"12-out4853"	.69306	70	31	101
12	"12-out4854"	.50947	215	207	422
12	"12-out4855"	.81147	396	92	488
12	"12-out4856"	.90580	1827	190	2017
12	"12-out4857"	.36513	111	193	304
12	"12-out4858"	.99651	286	1	287
12	"12-out4859"	.39504	271	415	686
12	"12-out4860"	.26200	131	369	500
12	"12-out4861"	.40404	200	295	495
12	"12-out4862"	.34387	87	166	253
12	"12-out4863"	.49875	200	201	401
12	"12-out4864"	.19653	34	139	173
12	"12-out4865"	.33552	51	101	152
12	"12-out4866"	.38983	46	72	118
12	"12-out4867"	.41025	48	69	117
12	"12-out4868"	.39316	138	213	351
12	"12-out4869"	.24401	51	158	209
12	"12-out4870"	.59689	77	52	129
12	"12-out4871"	.99494	197	1	198
12	"12-out4872"	.58088	79	57	136
12	"12-out4873"	.25963	128	365	493
12	"12-out4874"	.99019	101	1	102
12	"12-out4875"	.76682	638	194	832
12	"12-out4876"	.46099	260	304	564
12	"12-out4877"	.19653	34	139	173
12	"12-out4878"	.29687	76	180	256
12	"12-out4879"	.41696	231	323	554
12	"12-out4880"	.99539	216	1	217
12	"12-out4881"	.52083	75	69	144
12	"12-out4882"	.87212	341	50	391
12	"12-out4883"	.42976	615	816	1431
12	"12-out4884"	.39018	469	733	1202
12	"12-out4885"	.91560	358	33	391
12	"12-out4886"	.57894	165	120	285
12	"12-out4887"	.56415	277	214	491
12	"12-out4888"	.18711	61	265	326
12	"12-out4889"	.88439	306	40	346
12	"12-out4890"	.99397	165	1	166
12	"12-out4891"	.99814	539	1	540
12	"12-out4892"	.37765	71	117	188
12	"12-out4893"	.59375	57	39	96
12	"12-out4894"	.54312	762	641	1403
12	"12-out4895"	.43956	240	306	546
12	"12-out4896"	.47637	373	410	783
12	"12-out4897"	.49850	667	671	1338
12	"12-out4898"	.35988	253	450	703
12	"12-out4899"	.87116	142	21	163
12	"12-out4900"	.99512	204	1	205
12	"12-out4901"	.38947	148	232	380
12	"12-out4902"	.48408	806	859	1665
12	"12-out4903"	.87916	211	29	240
12	"12-out4904"	.33905	79	154	233
12	"12-out4905"	.38613	78	124	202
12	"12-out4906"	.99393	164	1	165
12	"12-out4907"	.69058	154	69	223
12	"12-out4908"	.99009	100	1	101
12	"12-out4909"	.32532	176	365	541
12	"12-out4910"	.41728	169	236	405
12	"12-out4911"	.98913	91	1	92
12	"12-out4912"	.41935	104	144	248
12	"12-out4913"	.44871	105	129	234
12	"12-out4914"	.42600	95	128	223
12	"12-out4915"	.28901	50	123	173
12	"12-out4916"	.51315	78	74	152
12	"12-out4917"	.42642	142	191	333
12	"12-out4918"	.91082	286	28	314
12	"12-out4919"	.72222	65	25	90
12	"12-out4920"	.49122	28	29	57
12	"12-out4921"	.99805	512	1	513
12	"12-out4922"	.27933	269	694	963
12	"12-out4923"	.30905	157	351	508
12	"12-out4924"	.59493	94	64	158
12	"12-out4925"	.97692	508	12	520
12	"12-out4926"	.99798	496	1	497
12	"12-out4927"	.93509	461	32	493
12	"12-out4928"	.24657	126	385	511
12	"12-out4929"	.42675	370	497	867
12	"12-out4930"	.48814	247	259	506
12	"12-out4931"	.69781	351	152	503
12	"12-out4932"	.45415	213	256	469
12	"12-out4933"	.39824	227	343	570
12	"12-out4934"	.54909	151	124	275
12	"12-out4935"	.98571	69	1	70
12	"12-out4936"	.49618	195	198	393
12	"12-out4937"	.61073	91	58	149
12	"12-out4938"	.18547	166	729	895
12	"12-out4939"	.32865	351	717	1068
12	"12-out4940"	.38383	38	61	99
12	"12-out4941"	.88059	59	8	67
12	"12-out4942"	.43157	41	54	95
12	"12-out4943"	.47887	34	37	71
12	"12-out4944"	.72881	215	80	295
12	"12-out4945"	.33544	53	105	158
12	"12-out4946"	.30712	125	282	407
12	"12-out4947"	.35121	216	399	615
12	"12-out4948"	.69166	415	185	600
12	"12-out4949"	.96671	610	21	631
12	"12-out4950"	.33810	189	370	559
12	"12-out4951"	.40838	185	268	453
12	"12-out4952"	.47787	162	177	339
12	"12-out4953"	.71490	331	132	463
12	"12-out4954"	.21052	72	270	342
12	"12-out4955"	.54405	389	326	715
12	"12-out4956"	.47612	369	406	775
12	"12-out4957"	.50952	214	206	420
12	"12-out4958"	.24035	81	256	337
12	"12-out4959"	.67196	465	227	692
12	"12-out4960"	.78021	142	40	182
12	"12-out4961"	.11444	42	325	367
12	"12-out4962"	.82008	392	86	478
12	"12-out4963"	.85803	411	68	479
12	"12-out4964"	.23859	68	217	285
12	"12-out4965"	.40236	68	101	169
12	"12-out4966"	.78414	643	177	820
12	"12-out4967"	.27461	53	140	193
12	"12-out4968"	.33826	183	358	541
12	"12-out4969"	.23900	125	398	523
12	"12-out4970"	.36250	58	102	160
12	"12-out4971"	.39705	54	82	136
12	"12-out4972"	.98850	86	1	87
12	"12-out4973"	.33333	23	46	69
12	"12-out4974"	.22368	17	59	76
12	"12-out4975"	.99820	557	1	558
12	"12-out4976"	.28854	131	323	454
12	"12-out4977"	.52525	260	235	495
12	"12-out4978"	.34501	325	617	942
12	"12-out4979"	.25675	190	550	740
12	"12-out4980"	.25617	166	482	648
12	"12-out4981"	.27528	49	129	178
12	"12-out4982"	.31720	59	127	186
12	"12-out4983"	.41317	395	561	956
12	"12-out4984"	.37596	488	810	1298
12	"12-out4985"	.29870	46	108	154
12	"12-out4986"	.98571	69	1	70
12	"12-out4987"	.70491	43	18	61
12	"12-out4988"	.56716	38	29	67
12	"12-out4989"	.34324	127	243	370
12	"12-out4990"	.32193	113	238	351
12	"12-out4991"	.63604	547	313	860
12	"12-out4992"	.89512	1596	187	1783
12	"12-out4993"	.86677	553	85	638
12	"12-out4994"	.33848	197	385	582
12	"12-out4995"	.48000	156	169	325
12	"12-out4996"	.26666	80	220	300
12	"12-out4997"	.99734	375	1	376
12	"12-out4998"	.98461	64	1	65
12	"12-out4999"	.99736	756	2	758
12	"12-out5000"	.50273	92	91	183
12	"12-out5001"	.39518	164	251	415
12	"12-out5002"	.09803	10	92	102
12	"12-out5003"	.56910	70	53	123
12	"12-out5004"	.98484	65	1	66
12	"12-out5005"	.26923	21	57	78
12	"12-out5006"	.99358	155	1	156
12	"12-out5007"	.37837	42	69	111
12	"12-out5008"	.99324	147	1	148
12	"12-out5009"	.53164	210	185	395
12	"12-out5010"	.35845	195	349	544
12	"12-out5011"	.92584	412	33	445
12	"12-out5012"	.56000	182	143	325
12	"12-out5013"	.49413	295	302	597
12	"12-out5014"	.29629	64	152	216
12	"12-out5015"	.43461	226	294	520
12	"12-out5016"	.22077	51	180	231
12	"12-out5017"	.50895	767	740	1507
12	"12-out5018"	.52521	250	226	476
12	"12-out5019"	.28265	409	1038	1447
12	"12-out5020"	.26046	168	477	645
12	"12-out5021"	.20463	53	206	259
12	"12-out5022"	.28643	114	284	398
12	"12-out5023"	.35714	35	63	98
12	"12-out5024"	.39301	439	678	1117
12	"12-out5025"	.61349	100	63	163
12	"12-out5026"	.99173	240	2	242
12	"12-out5027"	.44619	170	211	381
12	"12-out5028"	.44567	242	301	543
12	"12-out5029"	.99761	419	1	420
12	"12-out5030"	.31122	183	405	588
12	"12-out5031"	.63928	179	101	280
12	"12-out5032"	.38938	44	69	113
12	"12-out5033"	.39594	293	447	740
12	"12-out5034"	.99865	743	1	744
12	"12-out5035"	.99794	485	1	486
12	"12-out5036"	.99827	578	1	579
12	"12-out5037"	.93175	628	46	674
12	"12-out5038"	.31860	137	293	430
12	"12-out5039"	.30209	432	998	1430
12	"12-out5040"	.76036	495	156	651
12	"12-out5041"	.59195	206	142	348
12	"12-out5042"	.37309	147	247	394
12	"12-out5043"	.99487	194	1	195
12	"12-out5044"	.99737	380	1	381
12	"12-out5045"	.50417	181	178	359
12	"12-out5046"	.67567	425	204	629
12	"12-out5047"	.44247	50	63	113
12	"12-out5048"	.99386	162	1	163
12	"12-out5049"	.37272	287	483	770
12	"12-out5050"	.33500	134	266	400
12	"12-out5051"	.47295	481	536	1017
12	"12-out5052"	.82978	117	24	141
12	"12-out5053"	.51386	278	263	541
12	"12-out5054"	.99763	421	1	422
12	"12-out5055"	.35526	297	539	836
12	"12-out5056"	.99883	854	1	855
12	"12-out5057"	.99270	136	1	137
12	"12-out5058"	.41764	284	396	680
12	"12-out5059"	.41674	473	662	1135
12	"12-out5060"	.37568	207	344	551
12	"12-out5061"	.64000	144	81	225
12	"12-out5062"	.63834	263	149	412
12	"12-out5063"	.38817	151	238	389
12	"12-out5064"	.92875	352	27	379
12	"12-out5065"	.27917	311	803	1114
12	"12-out5066"	.49230	160	165	325
12	"12-out5067"	.71693	309	122	431
12	"12-out5068"	.53257	188	165	353
12	"12-out5069"	.41142	72	103	175
12	"12-out5070"	.76555	160	49	209
12	"12-out5071"	.59677	111	75	186
12	"12-out5072"	.42771	71	95	166
12	"12-out5073"	.99275	137	1	138
12	"12-out5074"	.44499	271	338	609
12	"12-out5075"	.51094	420	402	822
12	"12-out5076"	.16334	41	210	251
12	"12-out5077"	.32421	154	321	475
12	"12-out5078"	.46804	542	616	1158
12	"12-out5079"	.43724	317	408	725
12	"12-out5080"	.41176	189	270	459
12	"12-out5081"	.50202	124	123	247
12	"12-out5082"	.88690	447	57	504
12	"12-out5083"	.59708	123	83	206
12	"12-out5084"	.99393	328	2	330
12	"12-out5085"	.63151	509	297	806
12	"12-out5086"	.69758	376	163	539
12	"12-out5087"	.93567	1091	75	1166
12	"12-out5088"	.22425	98	339	437
12	"12-out5089"	.33536	386	765	1151
12	"12-out5090"	.36456	214	373	587
12	"12-out5091"	.64931	237	128	365
12	"12-out5092"	.43386	164	214	378
12	"12-out5093"	.35517	271	492	763
12	"12-out5094"	.98181	324	6	330
12	"12-out5095"	.26621	234	645	879
12	"12-out5096"	.33267	169	339	508
12	"12-out5097"	.41463	204	288	492
12	"12-out5098"	.31113	986	2183	3169
12	"12-out5099"	.59030	487	338	825
12	"12-out5100"	.45263	258	312	570
12	"12-out5101"	.33130	163	329	492
12	"12-out5102"	.11646	58	440	498
12	"12-out5103"	.43773	232	298	530
12	"12-out5104"	.98000	196	4	200
12	"12-out5105"	.39784	74	112	186
12	"12-out5106"	.35311	119	218	337
12	"12-out5107"	.21522	82	299	381
12	"12-out5108"	.99180	121	1	122
12	"12-out5109"	.36105	178	315	493
12	"12-out5110"	.51995	482	445	927
12	"12-out5111"	.65454	684	361	1045
12	"12-out5112"	.30732	193	435	628
12	"12-out5113"	.25175	179	532	711
12	"12-out5114"	.83510	157	31	188
12	"12-out5115"	.43750	161	207	368
12	"12-out5116"	.49347	227	233	460
12	"12-out5117"	.73041	317	117	434
12	"12-out5118"	.43666	131	169	300
12	"12-out5119"	.40606	134	196	330
12	"12-out5120"	.97976	339	7	346
12	"12-out5121"	.48806	184	193	377
12	"12-out5122"	.38199	314	508	822
12	"12-out5123"	.76288	148	46	194
12	"12-out5124"	.42847	605	807	1412
12	"12-out5125"	.76502	140	43	183
12	"12-out5126"	.99502	200	1	201
12	"12-out5127"	.77540	1854	537	2391
12	"12-out5128"	.36214	155	273	428
12	"12-out5129"	.25531	96	280	376
12	"12-out5130"	.30150	221	512	733
12	"12-out5131"	.40255	725	1076	1801
12	"12-out5132"	.64723	211	115	326
12	"12-out5133"	.35655	215	388	603
12	"12-out5134"	.50958	186	179	365
12	"12-out5135"	.99803	507	1	508
12	"12-out5136"	.18737	92	399	491
12	"12-out5137"	.45989	172	202	374
12	"12-out5138"	.33447	974	1938	2912
12	"12-out5139"	.90732	607	62	669
12	"12-out5140"	.38478	349	558	907
12	"12-out5141"	.99826	577	1	578
12	"12-out5142"	.91564	521	48	569
12	"12-out5143"	.81502	141	32	173
12	"12-out5144"	.35756	241	433	674
12	"12-out5145"	.89759	149	17	166
12	"12-out5146"	.67801	219	104	323
12	"12-out5147"	.26655	636	1750	2386
12	"12-out5148"	.56854	282	214	496
12	"12-out5149"	.50342	147	145	292
12	"12-out5150"	.43511	114	148	262
12	"12-out5151"	.62428	761	458	1219
12	"12-out5152"	.98070	559	11	570
12	"12-out5153"	.74553	167	57	224
12	"12-out5154"	.98876	88	1	89
12	"12-out5155"	.27566	145	381	526
12	"12-out5156"	.99557	225	1	226
12	"12-out5157"	.60784	155	100	255
12	"12-out5158"	.98765	240	3	243
12	"12-out5159"	.60332	327	215	542
12	"12-out5160"	.31764	108	232	340
12	"12-out5161"	.39837	1468	2217	3685
12	"12-out5162"	.28935	1191	2925	4116
12	"12-out5163"	.34364	1589	3035	4624
12	"12-out5164"	.27442	1275	3371	4646
12	"12-out5165"	.41176	259	370	629
12	"12-out5166"	.58112	2038	1469	3507
12	"12-out5167"	.22795	137	464	601
12	"12-out5168"	.39038	203	317	520
12	"12-out5169"	.26764	91	249	340
12	"12-out5170"	.69438	309	136	445
12	"12-out5171"	.37394	178	298	476
12	"12-out5172"	.74153	241	84	325
12	"12-out5173"	.99612	257	1	258
12	"12-out5174"	.38472	277	443	720
12	"12-out5175"	.32428	215	448	663
12	"12-out5176"	.87968	563	77	640
12	"12-out5177"	.50377	200	197	397
12	"12-out5178"	.53821	169	145	314
12	"12-out5179"	.32634	109	225	334
12	"12-out5180"	.32049	208	441	649
12	"12-out5181"	.49115	333	345	678
12	"12-out5182"	.29054	215	525	740
12	"12-out5183"	.99606	253	1	254
12	"12-out5184"	.68690	215	98	313
12	"12-out5185"	.44585	210	261	471
12	"12-out5186"	.46240	246	286	532
12	"12-out5187"	.39875	128	193	321
12	"12-out5188"	.26401	113	315	428
12	"12-out5189"	.91721	421	38	459
12	"12-out5190"	.55405	123	99	222
12	"12-out5191"	.43116	523	690	1213
12	"12-out5192"	.58943	1015	707	1722
12	"12-out5193"	.36372	395	691	1086
12	"12-out5194"	.24577	131	402	533
12	"12-out5195"	.97737	432	10	442
12	"12-out5196"	.30803	69	155	224
12	"12-out5197"	.54670	556	461	1017
12	"12-out5198"	.82306	828	178	1006
12	"12-out5199"	.82626	409	86	495
12	"12-out5200"	.61159	211	134	345
12	"12-out5201"	.99944	1793	1	1794
12	"12-out5202"	.27856	573	1484	2057
12	"12-out5203"	.33333	619	1238	1857
12	"12-out5204"	.96205	355	14	369
12	"12-out5205"	.40753	119	173	292
12	"12-out5206"	.52777	342	306	648
12	"12-out5207"	.35396	183	334	517
12	"12-out5208"	.99331	297	2	299
12	"12-out5209"	.34039	450	872	1322
12	"12-out5210"	.57558	198	146	344
12	"12-out5211"	.89520	299	35	334
12	"12-out5212"	.32506	131	272	403
12	"12-out5213"	.28688	140	348	488
12	"12-out5214"	.38362	178	286	464
12	"12-out5215"	.43441	308	401	709
12	"12-out5216"	.99651	286	1	287
12	"12-out5217"	.26778	192	525	717
12	"12-out5218"	.40051	155	232	387
12	"12-out5219"	.47612	329	362	691
12	"12-out5220"	.10903	35	286	321
12	"12-out5221"	.36131	297	525	822
12	"12-out5222"	.31753	67	144	211
12	"12-out5223"	.44370	469	588	1057
12	"12-out5224"	.31457	123	268	391
12	"12-out5225"	.17487	71	335	406
12	"12-out5226"	.50214	117	116	233
12	"12-out5227"	.34693	51	96	147
12	"12-out5228"	.58064	108	78	186
12	"12-out5229"	.21179	97	361	458
12	"12-out5230"	.99540	650	3	653
12	"12-out5231"	.49679	155	157	312
12	"12-out5232"	.71428	160	64	224
12	"12-out5233"	.25448	71	208	279
12	"12-out5234"	.35796	310	556	866
12	"12-out5235"	.31419	312	681	993
12	"12-out5236"	.71176	1010	409	1419
12	"12-out5237"	.99724	362	1	363
12	"12-out5238"	.46835	296	336	632
12	"12-out5239"	.46694	226	258	484
12	"12-out5240"	.52884	110	98	208
12	"12-out5241"	.64872	229	124	353
12	"12-out5242"	.40078	307	459	766
12	"12-out5243"	.18944	79	338	417
12	"12-out5244"	.88405	183	24	207
12	"12-out5245"	.49790	119	120	239
12	"12-out5246"	.28873	82	202	284
12	"12-out5247"	.27884	58	150	208
12	"12-out5248"	.33739	277	544	821
12	"12-out5249"	.99696	329	1	330
12	"12-out5250"	.46894	536	607	1143
12	"12-out5251"	.39735	180	273	453
12	"12-out5252"	.60183	263	174	437
12	"12-out5253"	.40202	199	296	495
12	"12-out5254"	.22773	289	980	1269
12	"12-out5255"	.23008	26	87	113
12	"12-out5256"	.26751	126	345	471
12	"12-out5257"	.24148	156	490	646
12	"12-out5258"	.93785	166	11	177
12	"12-out5259"	.99319	146	1	147
12	"12-out5260"	.64644	309	169	478
12	"12-out5261"	.24563	183	562	745
12	"12-out5262"	.42469	344	466	810
12	"12-out5263"	.98642	218	3	221
12	"12-out5264"	.98148	106	2	108
12	"12-out5265"	.65443	214	113	327
12	"12-out5266"	.36659	169	292	461
12	"12-out5267"	.31690	45	97	142
12	"12-out5268"	.35526	189	343	532
12	"12-out5269"	.98876	88	1	89
12	"12-out5270"	.37840	389	639	1028
12	"12-out5271"	.47572	147	162	309
12	"12-out5272"	.90099	455	50	505
12	"12-out5273"	.40285	141	209	350
12	"12-out5274"	.75536	176	57	233
12	"12-out5275"	.89047	187	23	210
12	"12-out5276"	.98090	411	8	419
12	"12-out5277"	.73061	358	132	490
12	"12-out5278"	.95000	361	19	380
12	"12-out5279"	.65882	112	58	170
12	"12-out5280"	.37037	90	153	243
12	"12-out5281"	.49384	722	740	1462
12	"12-out5282"	.58937	122	85	207
12	"12-out5283"	.41203	89	127	216
12	"12-out5284"	.30223	81	187	268
12	"12-out5285"	.34707	404	760	1164
12	"12-out5286"	.67741	105	50	155
12	"12-out5287"	.51658	109	102	211
12	"12-out5288"	.34594	64	121	185
12	"12-out5289"	.26460	154	428	582
12	"12-out5290"	.53703	58	50	108
12	"12-out5291"	.20057	70	279	349
12	"12-out5292"	.24778	112	340	452
12	"12-out5293"	.98876	88	1	89
12	"12-out5294"	.31944	46	98	144
12	"12-out5295"	.97415	490	13	503
12	"12-out5296"	.79251	741	194	935
12	"12-out5297"	.31225	79	174	253
12	"12-out5298"	.36734	90	155	245
12	"12-out5299"	.43473	373	485	858
12	"12-out5300"	.67477	222	107	329
12	"12-out5301"	.39208	109	169	278
12	"12-out5302"	.38754	112	177	289
12	"12-out5303"	.59798	119	80	199
12	"12-out5304"	.05917	10	159	169
12	"12-out5305"	.13736	25	157	182
12	"12-out5306"	.99193	123	1	124
12	"12-out5307"	.65517	95	50	145
12	"12-out5308"	.31612	49	106	155
12	"12-out5309"	.99931	1467	1	1468
12	"12-out5310"	.35294	96	176	272
12	"12-out5311"	.43305	207	271	478
12	"12-out5312"	.41871	85	118	203
12	"12-out5313"	.53312	1336	1170	2506
12	"12-out5314"	.41818	92	128	220
12	"12-out5315"	.41941	981	1358	2339
12	"12-out5316"	.18860	149	641	790
12	"12-out5317"	.50406	186	183	369
12	"12-out5318"	.37442	82	137	219
12	"12-out5319"	.30162	241	558	799
12	"12-out5320"	.48107	394	425	819
12	"12-out5321"	.37220	233	393	626
12	"12-out5322"	.45505	162	194	356
12	"12-out5323"	.26829	88	240	328
12	"12-out5324"	.36440	129	225	354
12	"12-out5325"	.49679	155	157	312
12	"12-out5326"	.27597	85	223	308
12	"12-out5327"	.40883	74	107	181
12	"12-out5328"	.95312	366	18	384
12	"12-out5329"	.44295	66	83	149
12	"12-out5330"	.93684	445	30	475
12	"12-out5331"	.49662	147	149	296
12	"12-out5332"	.33395	179	357	536
12	"12-out5333"	.34812	102	191	293
12	"12-out5334"	.32448	110	229	339
12	"12-out5335"	.97468	77	2	79
12	"12-out5336"	.42994	224	297	521
12	"12-out5337"	.44703	249	308	557
12	"12-out5338"	.39024	112	175	287
12	"12-out5339"	.79579	265	68	333
12	"12-out5340"	.37923	179	293	472
12	"12-out5341"	.44514	211	263	474
12	"12-out5342"	.34042	48	93	141
12	"12-out5343"	.24253	130	406	536
12	"12-out5344"	.53526	258	224	482
12	"12-out5345"	.22975	122	409	531
12	"12-out5346"	.41929	213	295	508
12	"12-out5347"	.54530	337	281	618
12	"12-out5348"	.99756	410	1	411
12	"12-out5349"	.48773	159	167	326
12	"12-out5350"	.31416	153	334	487
12	"12-out5351"	.22585	283	970	1253
12	"12-out5352"	.38663	162	257	419
12	"12-out5353"	.48484	64	68	132
12	"12-out5354"	.71888	335	131	466
12	"12-out5355"	.69345	371	164	535
12	"12-out5356"	.41269	156	222	378
12	"12-out5357"	.38235	442	714	1156
12	"12-out5358"	.38906	370	581	951
12	"12-out5359"	.62605	149	89	238
12	"12-out5360"	.37883	247	405	652
12	"12-out5361"	.32113	79	167	246
12	"12-out5362"	.25396	64	188	252
12	"12-out5363"	.34291	167	320	487
12	"12-out5364"	.43395	703	917	1620
12	"12-out5365"	.30353	343	787	1130
12	"12-out5366"	.23098	252	839	1091
12	"12-out5367"	.16831	17	84	101
12	"12-out5368"	.99487	194	1	195
12	"12-out5369"	.99526	210	1	211
12	"12-out5370"	.44665	381	472	853
12	"12-out5371"	.39884	69	104	173
12	"12-out5372"	.31179	275	607	882
12	"12-out5373"	.26595	892	2462	3354
12	"12-out5374"	.46412	207	239	446
12	"12-out5375"	.99828	583	1	584
12	"12-out5376"	.99367	157	1	158
12	"12-out5377"	.34920	44	82	126
12	"12-out5378"	.99365	313	2	315
12	"12-out5379"	.40690	389	567	956
12	"12-out5380"	.65652	367	192	559
12	"12-out5381"	.38832	306	482	788
12	"12-out5382"	.41100	127	182	309
12	"12-out5383"	.60000	189	126	315
12	"12-out5384"	.37404	98	164	262
12	"12-out5385"	.82309	670	144	814
12	"12-out5386"	.23699	82	264	346
12	"12-out5387"	.58351	269	192	461
12	"12-out5388"	.20958	105	396	501
12	"12-out5389"	.99839	1247	2	1249
12	"12-out5390"	.28286	71	180	251
12	"12-out5391"	.98888	89	1	90
12	"12-out5392"	.86143	373	60	433
12	"12-out5393"	.54956	438	359	797
12	"12-out5394"	.87190	211	31	242
12	"12-out5395"	.30048	125	291	416
12	"12-out5396"	.27528	49	129	178
12	"12-out5397"	.78439	553	152	705
12	"12-out5398"	.37777	153	252	405
12	"12-out5399"	.55555	145	116	261
12	"12-out5400"	.36842	161	276	437
12	"12-out5401"	.47619	60	66	126
12	"12-out5402"	.87190	211	31	242
12	"12-out5403"	.43805	396	508	904
12	"12-out5404"	.38133	286	464	750
12	"12-out5405"	.42577	1044	1408	2452
12	"12-out5406"	.51612	144	135	279
12	"12-out5407"	.60599	283	184	467
12	"12-out5408"	.68726	545	248	793
12	"12-out5409"	.29915	178	417	595
12	"12-out5410"	.53264	359	315	674
12	"12-out5411"	.98907	181	2	183
12	"12-out5412"	.26947	211	572	783
12	"12-out5413"	.99029	204	2	206
12	"12-out5414"	.32183	56	118	174
12	"12-out5415"	.99658	292	1	293
12	"12-out5416"	.23157	66	219	285
12	"12-out5417"	.48408	289	308	597
12	"12-out5418"	.82230	870	188	1058
12	"12-out5419"	.58677	71	50	121
12	"12-out5420"	.98958	95	1	96
12	"12-out5421"	.99206	125	1	126
12	"12-out5422"	.29257	67	162	229
12	"12-out5423"	.39968	253	380	633
12	"12-out5424"	.31859	209	447	656
12	"12-out5425"	.42143	936	1285	2221
12	"12-out5426"	.36538	304	528	832
12	"12-out5427"	.33249	264	530	794
12	"12-out5428"	.39806	330	499	829
12	"12-out5429"	.39142	274	426	700
12	"12-out5430"	.39181	268	416	684
12	"12-out5431"	.36954	500	853	1353
12	"12-out5432"	.36481	421	733	1154
12	"12-out5433"	.99561	227	1	228
12	"12-out5434"	.89603	362	42	404
12	"12-out5435"	.23626	43	139	182
12	"12-out5436"	.25671	86	249	335
12	"12-out5437"	.43007	326	432	758
12	"12-out5438"	.39882	136	205	341
12	"12-out5439"	.54699	518	429	947
12	"12-out5440"	.95256	502	25	527
12	"12-out5441"	.50572	221	216	437
12	"12-out5442"	.99838	1235	2	1237
12	"12-out5443"	.87533	323	46	369
12	"12-out5444"	.87087	317	47	364
12	"12-out5445"	.33647	107	211	318
12	"12-out5446"	.33430	230	458	688
12	"12-out5447"	.73937	261	92	353
12	"12-out5448"	.21739	55	198	253
12	"12-out5449"	.78059	185	52	237
12	"12-out5450"	.42857	63	84	147
12	"12-out5451"	.54098	99	84	183
12	"12-out5452"	.42815	146	195	341
12	"12-out5453"	.49302	106	109	215
12	"12-out5454"	.39080	102	159	261
12	"12-out5455"	.32319	255	534	789
12	"12-out5456"	.35243	449	825	1274
12	"12-out5457"	.33919	135	263	398
12	"12-out5458"	.34052	142	275	417
12	"12-out5459"	.34226	281	540	821
12	"12-out5460"	.35426	237	432	669
12	"12-out5461"	.33796	438	858	1296
12	"12-out5462"	.50099	503	501	1004
12	"12-out5463"	.16744	214	1064	1278
12	"12-out5464"	.42857	204	272	476
12	"12-out5465"	.29489	312	746	1058
12	"12-out5466"	.87403	680	98	778
12	"12-out5467"	.40399	728	1074	1802
12	"12-out5468"	.99601	250	1	251
12	"12-out5469"	.87422	424	61	485
12	"12-out5470"	.52851	278	248	526
12	"12-out5471"	.99808	522	1	523
12	"12-out5472"	.99829	585	1	586
12	"12-out5473"	.61224	60	38	98
12	"12-out5474"	.99408	168	1	169
12	"12-out5475"	.98979	97	1	98
12	"12-out5476"	.58778	154	108	262
12	"12-out5477"	.99949	1981	1	1982
12	"12-out5478"	.57798	189	138	327
12	"12-out5479"	.66481	240	121	361
12	"12-out5480"	.38144	74	120	194
12	"12-out5481"	.44029	59	75	134
12	"12-out5482"	.99462	185	1	186
12	"12-out5483"	.40608	467	683	1150
12	"12-out5484"	.41818	115	160	275
12	"12-out5485"	.43840	363	465	828
12	"12-out5486"	.27386	218	578	796
12	"12-out5487"	.99859	712	1	713
12	"12-out5488"	.47370	1126	1251	2377
12	"12-out5489"	.58909	281	196	477
12	"12-out5490"	.38988	262	410	672
12	"12-out5491"	.30756	187	421	608
12	"12-out5492"	.26498	221	613	834
12	"12-out5493"	.32283	164	344	508
12	"12-out5494"	.19472	133	550	683
12	"12-out5495"	.93918	139	9	148
12	"12-out5496"	.34801	158	296	454
12	"12-out5497"	.33905	79	154	233
12	"12-out5498"	.40000	128	192	320
12	"12-out5499"	.34365	344	657	1001
12	"12-out5500"	.99050	313	3	316
12	"12-out5501"	.50000	130	130	260
12	"12-out5502"	.99929	1426	1	1427
12	"12-out5503"	.98608	496	7	503
12	"12-out5504"	.99290	140	1	141
12	"12-out5505"	.44803	651	802	1453
12	"12-out5506"	.68292	196	91	287
12	"12-out5507"	.97457	115	3	118
12	"12-out5508"	.31250	65	143	208
12	"12-out5509"	.96363	106	4	110
12	"12-out5510"	.38482	279	446	725
12	"12-out5511"	.30201	90	208	298
12	"12-out5512"	.52358	111	101	212
12	"12-out5513"	.36254	182	320	502
12	"12-out5514"	.98837	85	1	86
12	"12-out5515"	.33452	187	372	559
12	"12-out5516"	.46348	165	191	356
12	"12-out5517"	.44370	201	252	453
12	"12-out5518"	.54219	212	179	391
12	"12-out5519"	.63708	323	184	507
12	"12-out5520"	.36090	144	255	399
12	"12-out5521"	.48384	659	703	1362
12	"12-out5522"	.38364	122	196	318
12	"12-out5523"	.41119	169	242	411
12	"12-out5524"	.32946	397	808	1205
12	"12-out5525"	.59523	150	102	252
12	"12-out5526"	.59805	677	455	1132
12	"12-out5527"	.89052	423	52	475
12	"12-out5528"	.99699	332	1	333
12	"12-out5529"	.38775	95	150	245
12	"12-out5530"	.45045	100	122	222
12	"12-out5531"	.42695	301	404	705
12	"12-out5532"	.40000	116	174	290
12	"12-out5533"	.23809	140	448	588
12	"12-out5534"	.41722	247	345	592
12	"12-out5535"	.51853	1203	1117	2320
12	"12-out5536"	.41331	770	1093	1863
12	"12-out5537"	.29503	226	540	766
12	"12-out5538"	.75047	394	131	525
12	"12-out5539"	.99560	453	2	455
12	"12-out5540"	.99656	290	1	291
12	"12-out5541"	.28260	143	363	506
12	"12-out5542"	.24398	71	220	291
12	"12-out5543"	.25000	96	288	384
12	"12-out5544"	.39591	213	325	538
12	"12-out5545"	.99699	332	1	333
12	"12-out5546"	.53355	477	417	894
12	"12-out5547"	.61757	260	161	421
12	"12-out5548"	.44396	309	387	696
12	"12-out5549"	.46578	1096	1257	2353
12	"12-out5550"	.43900	439	561	1000
12	"12-out5551"	.40572	170	249	419
12	"12-out5552"	.30285	106	244	350
12	"12-out5553"	.33157	377	760	1137
12	"12-out5554"	.33165	66	133	199
12	"12-out5555"	.63855	53	30	83
12	"12-out5556"	.38888	49	77	126
12	"12-out5557"	.70750	283	117	400
12	"12-out5558"	.52592	142	128	270
12	"12-out5559"	.99736	379	1	380
12	"12-out5560"	.36468	252	439	691
12	"12-out5561"	.41012	162	233	395
12	"12-out5562"	.33874	167	326	493
12	"12-out5563"	.33592	777	1536	2313
12	"12-out5564"	.38942	324	508	832
12	"12-out5565"	.28959	128	314	442
12	"12-out5566"	.31543	47	102	149
12	"12-out5567"	.44295	66	83	149
12	"12-out5568"	.38347	571	918	1489
12	"12-out5569"	.52534	114	103	217
12	"12-out5570"	.42895	317	422	739
12	"12-out5571"	.44071	223	283	506
12	"12-out5572"	.48956	352	367	719
12	"12-out5573"	.40713	331	482	813
12	"12-out5574"	.44381	312	391	703
12	"12-out5575"	.36521	252	438	690
12	"12-out5576"	.47058	80	90	170
12	"12-out5577"	.39774	282	427	709
12	"12-out5578"	.36823	415	712	1127
12	"12-out5579"	.38989	108	169	277
12	"12-out5580"	.43992	454	578	1032
12	"12-out5581"	.37318	231	388	619
12	"12-out5582"	.87588	247	35	282
12	"12-out5583"	.33569	237	469	706
12	"12-out5584"	.72480	187	71	258
12	"12-out5585"	.41666	155	217	372
12	"12-out5586"	.49758	309	312	621
12	"12-out5587"	.41185	257	367	624
12	"12-out5588"	.17472	47	222	269
12	"12-out5589"	.23868	58	185	243
12	"12-out5590"	.72357	89	34	123
12	"12-out5591"	.60068	176	117	293
12	"12-out5592"	.38775	38	60	98
12	"12-out5593"	.99200	124	1	125
12	"12-out5594"	.63888	115	65	180
12	"12-out5595"	.60176	68	45	113
12	"12-out5596"	.31126	691	1529	2220
12	"12-out5597"	.45602	503	600	1103
12	"12-out5598"	.34090	165	319	484
12	"12-out5599"	.80909	89	21	110
12	"12-out5600"	.30087	241	560	801
12	"12-out5601"	.20636	162	623	785
12	"12-out5602"	.32808	709	1452	2161
12	"12-out5603"	.40548	133	195	328
12	"12-out5604"	.30232	104	240	344
12	"12-out5605"	.35031	110	204	314
12	"12-out5606"	.36153	94	166	260
12	"12-out5607"	.22316	185	644	829
12	"12-out5608"	.56466	179	138	317
12	"12-out5609"	.28443	223	561	784
12	"12-out5610"	.59574	84	57	141
12	"12-out5611"	.32621	611	1262	1873
12	"12-out5612"	.51660	140	131	271
12	"12-out5613"	.26588	159	439	598
12	"12-out5614"	.39285	77	119	196
12	"12-out5615"	.31506	46	100	146
12	"12-out5616"	.88976	113	14	127
12	"12-out5617"	.40944	208	300	508
12	"12-out5618"	.38025	470	766	1236
12	"12-out5619"	.96408	1047	39	1086
12	"12-out5620"	.38626	180	286	466
12	"12-out5621"	.99040	413	4	417
12	"12-out5622"	.47607	199	219	418
12	"12-out5623"	.32875	431	880	1311
12	"12-out5624"	.99137	115	1	116
12	"12-out5625"	.99145	116	1	117
12	"12-out5626"	.99849	665	1	666
12	"12-out5627"	.40701	383	558	941
12	"12-out5628"	.99849	665	1	666
12	"12-out5629"	.48750	78	82	160
12	"12-out5630"	.26415	42	117	159
12	"12-out5631"	.35727	199	358	557
12	"12-out5632"	.99404	167	1	168
12	"12-out5633"	.32991	225	457	682
12	"12-out5634"	.45686	932	1108	2040
12	"12-out5635"	.34331	711	1360	2071
12	"12-out5636"	.48333	232	248	480
12	"12-out5637"	.36899	169	289	458
12	"12-out5638"	.58940	267	186	453
12	"12-out5639"	.45798	218	258	476
12	"12-out5640"	.42083	101	139	240
12	"12-out5641"	.99354	154	1	155
12	"12-out5642"	.60262	505	333	838
12	"12-out5643"	.71014	245	100	345
12	"12-out5644"	.19910	89	358	447
12	"12-out5645"	.39355	220	339	559
12	"12-out5646"	.51020	100	96	196
12	"12-out5647"	.28512	69	173	242
12	"12-out5648"	.37175	129	218	347
12	"12-out5649"	.98290	115	2	117
12	"12-out5650"	.97142	34	1	35
12	"12-out5651"	.45901	112	132	244
12	"12-out5652"	.19967	124	497	621
12	"12-out5653"	.28690	103	256	359
12	"12-out5654"	.30281	129	297	426
12	"12-out5655"	.51982	236	218	454
12	"12-out5656"	.30286	169	389	558
12	"12-out5657"	.28616	91	227	318
12	"12-out5658"	.27657	333	871	1204
12	"12-out5659"	.36272	687	1207	1894
12	"12-out5660"	.44444	104	130	234
12	"12-out5661"	.66509	141	71	212
12	"12-out5662"	.28703	93	231	324
12	"12-out5663"	.84267	466	87	553
12	"12-out5664"	.41578	158	222	380
12	"12-out5665"	.64411	257	142	399
12	"12-out5666"	.67021	252	124	376
12	"12-out5667"	.42352	288	392	680
12	"12-out5668"	.70250	196	83	279
12	"12-out5669"	.25628	265	769	1034
12	"12-out5670"	.99428	174	1	175
12	"12-out5671"	.57414	151	112	263
12	"12-out5672"	.94418	203	12	215
12	"12-out5673"	.48212	634	681	1315
12	"12-out5674"	.35376	127	232	359
12	"12-out5675"	.50530	143	140	283
12	"12-out5676"	.91290	283	27	310
12	"12-out5677"	.23569	280	908	1188
12	"12-out5678"	.99570	232	1	233
12	"12-out5679"	.40563	144	211	355
12	"12-out5680"	.40715	182	265	447
12	"12-out5681"	.45161	70	85	155
12	"12-out5682"	.27895	118	305	423
12	"12-out5683"	.32170	286	603	889
12	"12-out5684"	.50681	372	362	734
12	"12-out5685"	.97979	194	4	198
12	"12-out5686"	.47495	256	283	539
12	"12-out5687"	.50170	147	146	293
12	"12-out5688"	.40594	287	420	707
12	"12-out5689"	.38461	230	368	598
12	"12-out5690"	.36595	86	149	235
12	"12-out5691"	.99428	174	1	175
12	"12-out5692"	.22727	150	510	660
12	"12-out5693"	.20030	130	519	649
12	"12-out5694"	.48235	123	132	255
12	"12-out5695"	.19767	34	138	172
12	"12-out5696"	.37561	228	379	607
12	"12-out5697"	.99569	463	2	465
12	"12-out5698"	.99038	412	4	416
12	"12-out5699"	.46981	249	281	530
12	"12-out5700"	.53571	75	65	140
12	"12-out5701"	.52760	172	154	326
12	"12-out5702"	.99137	115	1	116
12	"12-out5703"	.99090	109	1	110
12	"12-out5704"	.31130	179	396	575
12	"12-out5705"	.41379	48	68	116
12	"12-out5706"	.99850	666	1	667
12	"12-out5707"	.46418	162	187	349
12	"12-out5708"	.66352	211	107	318
12	"12-out5709"	.99425	173	1	174
12	"12-out5710"	.45051	305	372	677
12	"12-out5711"	.66616	439	220	659
12	"12-out5712"	.47863	168	183	351
12	"12-out5713"	.29116	1167	2841	4008
12	"12-out5714"	.97925	472	10	482
12	"12-out5715"	.45736	59	70	129
12	"12-out5716"	.26943	201	545	746
12	"12-out5717"	.59633	65	44	109
12	"12-out5718"	.99798	495	1	496
12	"12-out5719"	.23376	72	236	308
12	"12-out5720"	.99791	478	1	479
12	"12-out5721"	.20175	138	546	684
12	"12-out5722"	.43678	38	49	87
12	"12-out5723"	.99438	177	1	178
12	"12-out5724"	.76842	73	22	95
12	"12-out5725"	.30956	178	397	575
12	"12-out5726"	.43632	209	270	479
12	"12-out5727"	.35616	130	235	365
12	"12-out5728"	.99849	665	1	666
12	"12-out5729"	.98458	447	7	454
12	"12-out5730"	.32562	169	350	519
12	"12-out5731"	.45454	100	120	220
12	"12-out5732"	.45977	240	282	522
12	"12-out5733"	.27586	96	252	348
12	"12-out5734"	.64133	270	151	421
12	"12-out5735"	.99257	668	5	673
12	"12-out5736"	.79704	216	55	271
12	"12-out5737"	.59713	292	197	489
12	"12-out5738"	.99065	106	1	107
12	"12-out5739"	.52673	266	239	505
12	"12-out5740"	.98701	152	2	154
12	"12-out5741"	.90374	338	36	374
12	"12-out5742"	.99707	341	1	342
12	"12-out5743"	.28982	151	370	521
12	"12-out5744"	.37226	255	430	685
12	"12-out5745"	.36734	234	403	637
12	"12-out5746"	.35398	240	438	678
12	"12-out5747"	.29071	166	405	571
12	"12-out5748"	.33760	79	155	234
12	"12-out5749"	.45174	646	784	1430
12	"12-out5750"	.33552	1631	3230	4861
12	"12-out5751"	.70148	3391	1443	4834
12	"12-out5752"	.39661	211	321	532
12	"12-out5753"	.46636	513	587	1100
12	"12-out5754"	.45585	253	302	555
12	"12-out5755"	.33973	407	791	1198
12	"12-out5756"	.25283	156	461	617
12	"12-out5757"	.98095	412	8	420
12	"12-out5758"	.99544	437	2	439
12	"12-out5759"	.63664	417	238	655
12	"12-out5760"	.30069	172	400	572
12	"12-out5761"	.99470	188	1	189
12	"12-out5762"	.49587	361	367	728
12	"12-out5763"	.45622	198	236	434
12	"12-out5764"	.80167	574	142	716
12	"12-out5765"	.99038	412	4	416
12	"12-out5766"	.47788	335	366	701
12	"12-out5767"	.24719	22	67	89
12	"12-out5768"	.42527	461	623	1084
12	"12-out5769"	.36788	181	311	492
12	"12-out5770"	.24737	519	1579	2098
12	"12-out5771"	.48520	164	174	338
12	"12-out5772"	.69461	348	153	501
12	"12-out5773"	.96933	727	23	750
12	"12-out5774"	.64379	244	135	379
12	"12-out5775"	.77027	342	102	444
12	"12-out5776"	.36012	224	398	622
12	"12-out5777"	.78660	317	86	403
12	"12-out5778"	.48808	430	451	881
12	"12-out5779"	.32250	139	292	431
12	"12-out5780"	.99640	277	1	278
12	"12-out5781"	.99645	281	1	282
12	"12-out5782"	.99640	277	1	278
12	"12-out5783"	.95081	174	9	183
12	"12-out5784"	.34683	1045	1968	3013
12	"12-out5785"	.34970	762	1417	2179
12	"12-out5786"	.66583	536	269	805
12	"12-out5787"	.39294	312	482	794
12	"12-out5788"	.74074	460	161	621
12	"12-out5789"	.31352	211	462	673
12	"12-out5790"	.46666	140	160	300
12	"12-out5791"	.99040	413	4	417
12	"12-out5792"	.90529	325	34	359
12	"12-out5793"	.99849	665	1	666
12	"12-out5794"	.26016	32	91	123
12	"12-out5795"	.17857	85	391	476
12	"12-out5796"	.33563	340	673	1013
12	"12-out5797"	.33220	491	987	1478
12	"12-out5798"	.91290	587	56	643
12	"12-out5799"	.99690	322	1	323
12	"12-out5800"	.36920	199	340	539
12	"12-out5801"	.95722	1007	45	1052
12	"12-out5802"	.42946	137	182	319
12	"12-out5803"	.20661	125	480	605
12	"12-out5804"	.43968	113	144	257
12	"12-out5805"	.50097	258	257	515
12	"12-out5806"	.34782	240	450	690
12	"12-out5807"	.21777	49	176	225
12	"12-out5808"	.47755	117	128	245
12	"12-out5809"	.79446	201	52	253
12	"12-out5810"	.79069	204	54	258
12	"12-out5811"	.16203	35	181	216
12	"12-out5812"	.41068	584	838	1422
12	"12-out5813"	.83703	226	44	270
12	"12-out5814"	.33992	258	501	759
12	"12-out5815"	.29642	83	197	280
12	"12-out5816"	.71885	427	167	594
12	"12-out5817"	.30921	47	105	152
12	"12-out5818"	.32835	66	135	201
12	"12-out5819"	.36966	78	133	211
12	"12-out5820"	.36105	165	292	457
12	"12-out5821"	.53535	212	184	396
12	"12-out5822"	.37651	218	361	579
12	"12-out5823"	.53177	251	221	472
12	"12-out5824"	.80933	208	49	257
12	"12-out5825"	.24390	140	434	574
12	"12-out5826"	.99687	319	1	320
12	"12-out5827"	.28897	456	1122	1578
12	"12-out5828"	.45238	323	391	714
12	"12-out5829"	.27722	140	365	505
12	"12-out5830"	.34356	291	556	847
12	"12-out5831"	.29651	102	242	344
12	"12-out5832"	.57564	3976	2931	6907
12	"12-out5833"	.46280	112	130	242
12	"12-out5834"	.40527	261	383	644
12	"12-out5835"	.53453	178	155	333
12	"12-out5836"	.99845	646	1	647
12	"12-out5837"	.30064	187	435	622
12	"12-out5838"	.21929	75	267	342
12	"12-out5839"	.60206	233	154	387
12	"12-out5840"	.31683	32	69	101
12	"12-out5841"	.43773	116	149	265
12	"12-out5842"	.62222	112	68	180
12	"12-out5843"	.80571	141	34	175
12	"12-out5844"	.27281	269	717	986
12	"12-out5845"	.30988	163	363	526
12	"12-out5846"	.35016	416	772	1188
12	"12-out5847"	.32004	257	546	803
12	"12-out5848"	.50276	91	90	181
12	"12-out5849"	.47826	88	96	184
12	"12-out5850"	.46882	376	426	802
12	"12-out5851"	.64406	228	126	354
12	"12-out5852"	.92893	183	14	197
12	"12-out5853"	.97740	173	4	177
12	"12-out5854"	.97504	547	14	561
12	"12-out5855"	.51869	652	605	1257
12	"12-out5856"	.39484	184	282	466
12	"12-out5857"	.36134	172	304	476
12	"12-out5858"	.69244	376	167	543
12	"12-out5859"	.49488	242	247	489
12	"12-out5860"	.52026	475	438	913
12	"12-out5861"	.38351	349	561	910
12	"12-out5862"	.24538	186	572	758
12	"12-out5863"	.48399	257	274	531
12	"12-out5864"	.37873	317	520	837
12	"12-out5865"	.21630	69	250	319
12	"12-out5866"	.51841	971	902	1873
12	"12-out5867"	.44086	123	156	279
12	"12-out5868"	.99948	1943	1	1944
12	"12-out5869"	.39941	137	206	343
12	"12-out5870"	.31989	119	253	372
12	"12-out5871"	.51393	166	157	323
12	"12-out5872"	.98802	165	2	167
12	"12-out5873"	.35359	64	117	181
12	"12-out5874"	.48420	659	702	1361
12	"12-out5875"	.44883	250	307	557
12	"12-out5876"	.44692	80	99	179
12	"12-out5877"	.63978	119	67	186
12	"12-out5878"	.53456	317	276	593
12	"12-out5879"	.60679	250	162	412
12	"12-out5880"	.51524	676	636	1312
12	"12-out5881"	.25543	47	137	184
12	"12-out5882"	.60761	463	299	762
12	"12-out5883"	.48288	395	423	818
12	"12-out5884"	.73758	208	74	282
12	"12-out5885"	.42380	292	397	689
12	"12-out5886"	.43348	378	494	872
12	"12-out5887"	.98013	148	3	151
12	"12-out5888"	.16363	18	92	110
12	"12-out5889"	.39050	781	1219	2000
12	"12-out5890"	.37001	723	1231	1954
12	"12-out5891"	.31896	866	1849	2715
12	"12-out5892"	.42561	1233	1664	2897
12	"12-out5893"	.36026	214	380	594
12	"12-out5894"	.53656	587	507	1094
12	"12-out5895"	.31499	229	498	727
12	"12-out5896"	.59838	222	149	371
12	"12-out5897"	.48691	93	98	191
12	"12-out5898"	.26095	274	776	1050
12	"12-out5899"	.30483	246	561	807
12	"12-out5900"	.40476	34	50	84
12	"12-out5901"	.31888	103	220	323
12	"12-out5902"	.13333	58	377	435
12	"12-out5903"	.30550	183	416	599
12	"12-out5904"	.40874	159	230	389
12	"12-out5905"	.33635	334	659	993
12	"12-out5906"	.27042	139	375	514
12	"12-out5907"	.92887	222	17	239
12	"12-out5908"	.92432	342	28	370
12	"12-out5909"	.32033	115	244	359
12	"12-out5910"	.50738	412	400	812
12	"12-out5911"	.92128	316	27	343
12	"12-out5912"	.28235	96	244	340
12	"12-out5913"	.44290	384	483	867
12	"12-out5914"	.43727	244	314	558
12	"12-out5915"	.63551	68	39	107
12	"12-out5916"	.52154	230	211	441
12	"12-out5917"	.62711	74	44	118
12	"12-out5918"	.48538	830	880	1710
12	"12-out5919"	.31097	932	2065	2997
12	"12-out5920"	.39867	301	454	755
12	"12-out5921"	.37957	1732	2831	4563
12	"12-out5922"	.33082	88	178	266
12	"12-out5923"	.99376	319	2	321
12	"12-out5924"	.23800	124	397	521
12	"12-out5925"	.43093	78	103	181
12	"12-out5926"	.40112	142	212	354
12	"12-out5927"	.60064	185	123	308
12	"12-out5928"	.45333	306	369	675
12	"12-out5929"	.44144	343	434	777
12	"12-out5930"	.35549	540	979	1519
12	"12-out5931"	.39429	235	361	596
12	"12-out5932"	.29720	436	1031	1467
12	"12-out5933"	.44338	607	762	1369
12	"12-out5934"	.43406	79	103	182
12	"12-out5935"	.41323	924	1312	2236
12	"12-out5936"	.96500	193	7	200
12	"12-out5937"	.99465	186	1	187
12	"12-out5938"	.38117	332	539	871
12	"12-out5939"	.38423	156	250	406
12	"12-out5940"	.33541	429	850	1279
12	"12-out5941"	.82463	569	121	690
12	"12-out5942"	.95679	1528	69	1597
12	"12-out5943"	.65570	598	314	912
12	"12-out5944"	.29792	460	1084	1544
12	"12-out5945"	.31629	266	575	841
12	"12-out5946"	.94707	340	19	359
12	"12-out5947"	.99395	329	2	331
12	"12-out5948"	.28571	56	140	196
12	"12-out5949"	.50000	102	102	204
12	"12-out5950"	.55307	99	80	179
12	"12-out5951"	.75659	373	120	493
12	"12-out5952"	.40404	240	354	594
12	"12-out5953"	.27027	60	162	222
12	"12-out5954"	.98872	263	3	266
12	"12-out5955"	.99723	361	1	362
12	"12-out5956"	.99723	361	1	362
12	"12-out5957"	.39949	157	236	393
12	"12-out5958"	.98630	360	5	365
12	"12-out5959"	.40333	121	179	300
12	"12-out5960"	.39120	338	526	864
12	"12-out5961"	.35828	201	360	561
12	"12-out5962"	.99878	822	1	823
12	"12-out5963"	.35410	125	228	353
12	"12-out5964"	.84801	385	69	454
12	"12-out5965"	.22962	62	208	270
12	"12-out5966"	.20245	66	260	326
12	"12-out5967"	.38641	182	289	471
12	"12-out5968"	.32458	408	849	1257
12	"12-out5969"	.51928	175	162	337
12	"12-out5970"	.56224	280	218	498
12	"12-out5971"	.38613	195	310	505
12	"12-out5972"	.99802	1009	2	1011
12	"12-out5973"	.99196	247	2	249
12	"12-out5974"	.52978	249	221	470
12	"12-out5975"	.75708	374	120	494
12	"12-out5976"	.99621	263	1	264
12	"12-out5977"	.19289	76	318	394
12	"12-out5978"	.22829	213	720	933
12	"12-out5979"	.95544	579	27	606
12	"12-out5980"	.90184	147	16	163
12	"12-out5981"	.39751	128	194	322
12	"12-out5982"	.47010	228	257	485
12	"12-out5983"	.99710	344	1	345
12	"12-out5984"	.41692	133	186	319
12	"12-out5985"	.65523	344	181	525
12	"12-out5986"	.31237	154	339	493
12	"12-out5987"	.41310	271	385	656
12	"12-out5988"	.93859	1605	105	1710
12	"12-out5989"	.29153	286	695	981
12	"12-out5990"	.47242	197	220	417
12	"12-out5991"	.42617	407	548	955
12	"12-out5992"	.33971	142	276	418
12	"12-out5993"	.35961	187	333	520
12	"12-out5994"	.21782	22	79	101
12	"12-out5995"	.45794	196	232	428
12	"12-out5996"	.27241	395	1055	1450
12	"12-out5997"	.99793	483	1	484
12	"12-out5998"	.46868	464	526	990
12	"12-out5999"	.98415	497	8	505
12	"12-out6000"	.35645	149	269	418
12	"12-out6001"	.33055	119	241	360
12	"12-out6002"	.41346	516	732	1248
12	"12-out6003"	.43307	110	144	254
12	"12-out6004"	.22008	217	769	986
12	"12-out6005"	.25917	219	626	845
12	"12-out6006"	.30732	130	293	423
12	"12-out6007"	.33173	138	278	416
12	"12-out6008"	.77720	150	43	193
12	"12-out6009"	.99236	520	4	524
12	"12-out6010"	.99367	157	1	158
12	"12-out6011"	.77108	64	19	83
12	"12-out6012"	.32241	246	517	763
12	"12-out6013"	.71362	309	124	433
12	"12-out6014"	.32653	112	231	343
12	"12-out6015"	.41472	214	302	516
12	"12-out6016"	.99878	822	1	823
12	"12-out6017"	.35925	231	412	643
12	"12-out6018"	.63432	170	98	268
12	"12-out6019"	.47619	210	231	441
12	"12-out6020"	.32474	252	524	776
12	"12-out6021"	.36484	274	477	751
12	"12-out6022"	.36705	127	219	346
12	"12-out6023"	.99524	628	3	631
12	"12-out6024"	.55429	245	197	442
12	"12-out6025"	.29577	42	100	142
12	"12-out6026"	.51310	137	130	267
12	"12-out6027"	.99661	294	1	295
12	"12-out6028"	.83980	173	33	206
12	"12-out6029"	.32208	105	221	326
12	"12-out6030"	.92682	456	36	492
12	"12-out6031"	.36205	332	585	917
12	"12-out6032"	.66666	288	144	432
12	"12-out6033"	.39154	287	446	733
12	"12-out6034"	.44425	263	329	592
12	"12-out6035"	.40983	225	324	549
12	"12-out6036"	.45728	273	324	597
12	"12-out6037"	.38848	270	425	695
12	"12-out6038"	.42857	321	428	749
12	"12-out6039"	.41404	224	317	541
12	"12-out6040"	.29120	106	258	364
12	"12-out6041"	.99145	116	1	117
12	"12-out6042"	.99145	116	1	117
12	"12-out6043"	.09740	15	139	154
12	"12-out6044"	.27303	163	434	597
12	"12-out6045"	.29452	258	618	876
12	"12-out6046"	.29868	273	641	914
12	"12-out6047"	.28571	132	330	462
12	"12-out6048"	.50853	298	288	586
12	"12-out6049"	.37500	27	45	72
12	"12-out6050"	.98550	68	1	69
12	"12-out6051"	.54682	181	150	331
12	"12-out6052"	.32506	498	1034	1532
12	"12-out6053"	.44560	213	265	478
12	"12-out6054"	.27764	113	294	407
12	"12-out6055"	.44805	138	170	308
12	"12-out6056"	.88440	329	43	372
12	"12-out6057"	.48251	207	222	429
12	"12-out6058"	.23626	86	278	364
12	"12-out6059"	.32000	80	170	250
12	"12-out6060"	.34131	171	330	501
12	"12-out6061"	.51648	235	220	455
12	"12-out6062"	.67111	302	148	450
12	"12-out6063"	.27173	200	536	736
12	"12-out6064"	.35268	164	301	465
12	"12-out6065"	.99823	567	1	568
12	"12-out6066"	.99310	144	1	145
12	"12-out6067"	.99310	144	1	145
12	"12-out6068"	.99619	262	1	263
12	"12-out6069"	.99619	262	1	263
12	"12-out6070"	.99619	262	1	263
12	"12-out6071"	.98113	104	2	106
12	"12-out6072"	.98113	104	2	106
12	"12-out6073"	.97549	199	5	204
12	"12-out6074"	.35301	299	548	847
12	"12-out6075"	.99115	112	1	113
12	"12-out6076"	.99047	104	1	105
12	"12-out6077"	.46338	367	425	792
12	"12-out6078"	.49734	187	189	376
12	"12-out6079"	.53296	485	425	910
12	"12-out6080"	.97826	90	2	92
12	"12-out6081"	.30500	61	139	200
12	"12-out6082"	.87330	193	28	221
12	"12-out6083"	.90147	183	20	203
12	"12-out6084"	.47085	105	118	223
12	"12-out6085"	.31162	67	148	215
12	"12-out6086"	.32773	156	320	476
12	"12-out6087"	.50724	105	102	207
12	"12-out6088"	.66117	482	247	729
12	"12-out6089"	.98039	50	1	51
12	"12-out6090"	.99297	424	3	427
12	"12-out6091"	.42705	363	487	850
12	"12-out6092"	.92565	772	62	834
12	"12-out6093"	.71244	166	67	233
12	"12-out6094"	.39678	148	225	373
12	"12-out6095"	.27319	53	141	194
12	"12-out6096"	.82773	591	123	714
12	"12-out6097"	.49321	109	112	221
12	"12-out6098"	.29957	71	166	237
12	"12-out6099"	.44700	97	120	217
12	"12-out6100"	.90610	193	20	213
12	"12-out6101"	.92094	233	20	253
12	"12-out6102"	.29693	242	573	815
12	"12-out6103"	.79551	284	73	357
12	"12-out6104"	.49159	234	242	476
12	"12-out6105"	.23006	101	338	439
12	"12-out6106"	.93587	613	42	655
12	"12-out6107"	.98172	913	17	930
12	"12-out6108"	.53521	114	99	213
12	"12-out6109"	.42394	131	178	309
12	"12-out6110"	.46982	436	492	928
12	"12-out6111"	.17241	35	168	203
12	"12-out6112"	.45703	117	139	256
12	"12-out6113"	.98924	92	1	93
12	"12-out6114"	.41441	138	195	333
12	"12-out6115"	.18055	39	177	216
12	"12-out6116"	.25118	53	158	211
12	"12-out6117"	.39690	77	117	194
12	"12-out6118"	.43378	95	124	219
12	"12-out6119"	.66504	137	69	206
12	"12-out6120"	.27403	57	151	208
12	"12-out6121"	.90944	231	23	254
12	"12-out6122"	.92913	236	18	254
12	"12-out6123"	.94029	189	12	201
12	"12-out6124"	.99497	198	1	199
12	"12-out6125"	.47100	268	301	569
12	"12-out6126"	.46875	90	102	192
12	"12-out6127"	.86846	548	83	631
12	"12-out6128"	.43636	216	279	495
12	"12-out6129"	.45655	599	713	1312
12	"12-out6130"	.30655	229	518	747
12	"12-out6131"	.50704	216	210	426
12	"12-out6132"	.97766	394	9	403
12	"12-out6133"	.38562	118	188	306
12	"12-out6134"	.34417	656	1250	1906
12	"12-out6135"	.39506	224	343	567
12	"12-out6136"	.64077	132	74	206
12	"12-out6137"	.84239	155	29	184
12	"12-out6138"	.25622	72	209	281
12	"12-out6139"	.99128	796	7	803
12	"12-out6140"	.55291	559	452	1011
12	"12-out6141"	.52403	109	99	208
12	"12-out6142"	.41411	135	191	326
12	"12-out6143"	.33644	108	213	321
12	"12-out6144"	.33174	139	280	419
12	"12-out6145"	.34925	373	695	1068
12	"12-out6146"	.34372	386	737	1123
12	"12-out6147"	.42083	202	278	480
12	"12-out6148"	.12264	39	279	318
12	"12-out6149"	.58551	291	206	497
12	"12-out6150"	.99479	191	1	192
12	"12-out6151"	.37884	566	928	1494
12	"12-out6152"	.43336	400	523	923
12	"12-out6153"	.34186	588	1132	1720
12	"12-out6154"	.41930	278	385	663
12	"12-out6155"	.25757	17	49	66
12	"12-out6156"	.99833	599	1	600
12	"12-out6157"	.43606	133	172	305
12	"12-out6158"	.46130	155	181	336
12	"12-out6159"	.37837	126	207	333
12	"12-out6160"	.39044	139	217	356
12	"12-out6161"	.23466	88	287	375
12	"12-out6162"	.50263	191	189	380
12	"12-out6163"	.71587	257	102	359
12	"12-out6164"	.51758	206	192	398
12	"12-out6165"	.26386	138	385	523
12	"12-out6166"	.34042	96	186	282
12	"12-out6167"	.42901	139	185	324
12	"12-out6168"	.28996	78	191	269
12	"12-out6169"	.41640	132	185	317
12	"12-out6170"	.25348	91	268	359
12	"12-out6171"	.43596	177	229	406
12	"12-out6172"	.54442	288	241	529
12	"12-out6173"	.42933	161	214	375
12	"12-out6174"	.31818	133	285	418
12	"12-out6175"	.20913	174	658	832
12	"12-out6176"	.84097	587	111	698
12	"12-out6177"	.92773	552	43	595
12	"12-out6178"	.99747	395	1	396
12	"12-out6179"	.99756	409	1	410
12	"12-out6180"	.28426	56	141	197
12	"12-out6181"	.99455	548	3	551
12	"12-out6182"	.89079	416	51	467
12	"12-out6183"	.46871	367	416	783
12	"12-out6184"	.91828	236	21	257
12	"12-out6185"	.31230	99	218	317
12	"12-out6186"	.99122	113	1	114
12	"12-out6187"	.35474	243	442	685
12	"12-out6188"	.39016	119	186	305
12	"12-out6189"	.81770	157	35	192
12	"12-out6190"	.28400	238	600	838
12	"12-out6191"	.50409	369	363	732
12	"12-out6192"	.18367	27	120	147
12	"12-out6193"	.39730	118	179	297
12	"12-out6194"	.42204	157	215	372
12	"12-out6195"	.19594	29	119	148
12	"12-out6196"	.98951	283	3	286
12	"12-out6197"	.40520	218	320	538
12	"12-out6198"	.44171	72	91	163
12	"12-out6199"	.30749	361	813	1174
12	"12-out6200"	.99130	114	1	115
12	"12-out6201"	.42519	54	73	127
12	"12-out6202"	.45215	241	292	533
12	"12-out6203"	.43390	302	394	696
12	"12-out6204"	.55415	220	177	397
12	"12-out6205"	.34156	249	480	729
12	"12-out6206"	.97340	183	5	188
12	"12-out6207"	.55136	161	131	292
12	"12-out6208"	.55056	98	80	178
12	"12-out6209"	.31250	40	88	128
12	"12-out6210"	.24936	98	295	393
12	"12-out6211"	.22894	87	293	380
12	"12-out6212"	.58108	172	124	296
12	"12-out6213"	.72682	298	112	410
12	"12-out6214"	.32807	187	383	570
12	"12-out6215"	.37048	246	418	664
12	"12-out6216"	.38285	134	216	350
12	"12-out6217"	.63461	99	57	156
12	"12-out6218"	.51397	239	226	465
12	"12-out6219"	.25581	66	192	258
12	"12-out6220"	.99761	419	1	420
12	"12-out6221"	.95652	176	8	184
12	"12-out6222"	.33333	42	84	126
12	"12-out6223"	.40114	140	209	349
12	"12-out6224"	.43037	136	180	316
12	"12-out6225"	.99494	197	1	198
12	"12-out6226"	.35483	99	180	279
12	"12-out6227"	.33759	132	259	391
12	"12-out6228"	.57397	225	167	392
12	"12-out6229"	.37604	135	224	359
12	"12-out6230"	.46283	274	318	592
12	"12-out6231"	.30769	76	171	247
12	"12-out6232"	.99346	152	1	153
12	"12-out6233"	.51041	98	94	192
12	"12-out6234"	.99841	630	1	631
12	"12-out6235"	.99591	244	1	245
12	"12-out6236"	.77872	183	52	235
12	"12-out6237"	.69458	141	62	203
12	"12-out6238"	.58695	135	95	230
12	"12-out6239"	.39175	266	413	679
12	"12-out6240"	.39662	94	143	237
12	"12-out6241"	.68181	150	70	220
12	"12-out6242"	.50262	287	284	571
12	"12-out6243"	.99342	151	1	152
12	"12-out6244"	.99705	339	1	340
12	"12-out6245"	.42803	113	151	264
12	"12-out6246"	.94225	359	22	381
12	"12-out6247"	.19397	58	241	299
12	"12-out6248"	.86896	378	57	435
12	"12-out6249"	.36111	78	138	216
12	"12-out6250"	.81640	209	47	256
12	"12-out6251"	.35018	187	347	534
12	"12-out6252"	.23884	332	1058	1390
12	"12-out6253"	.35490	532	967	1499
12	"12-out6254"	.25563	34	99	133
12	"12-out6255"	.42498	592	801	1393
12	"12-out6256"	.37671	275	455	730
12	"12-out6257"	.89411	912	108	1020
12	"12-out6258"	.89367	311	37	348
12	"12-out6259"	.30894	38	85	123
12	"12-out6260"	.86274	264	42	306
12	"12-out6261"	.96116	99	4	103
12	"12-out6262"	.56250	72	56	128
12	"12-out6263"	.28134	92	235	327
12	"12-out6264"	.57281	118	88	206
12	"12-out6265"	.52682	108	97	205
12	"12-out6266"	.58252	120	86	206
12	"12-out6267"	.41223	155	221	376
12	"12-out6268"	.30440	214	489	703
12	"12-out6269"	.40112	284	424	708
12	"12-out6270"	.99672	304	1	305
12	"12-out6271"	.50315	239	236	475
12	"12-out6272"	.43992	443	564	1007
12	"12-out6273"	.44192	156	197	353
12	"12-out6274"	.99551	222	1	223
12	"12-out6275"	.75675	112	36	148
12	"12-out6276"	.41354	287	407	694
12	"12-out6277"	.55636	153	122	275
12	"12-out6278"	.33255	142	285	427
12	"12-out6279"	.95092	155	8	163
12	"12-out6280"	.45412	198	238	436
12	"12-out6281"	.31302	185	406	591
12	"12-out6282"	.49401	660	676	1336
12	"12-out6283"	.92452	196	16	212
12	"12-out6284"	.48865	280	293	573
12	"12-out6285"	.29283	229	553	782
12	"12-out6286"	.44352	322	404	726
12	"12-out6287"	.24666	37	113	150
12	"12-out6288"	.99473	189	1	190
12	"12-out6289"	.37073	76	129	205
12	"12-out6290"	.35632	93	168	261
12	"12-out6291"	.86956	100	15	115
12	"12-out6292"	.44897	66	81	147
12	"12-out6293"	.60413	438	287	725
12	"12-out6294"	.96774	360	12	372
12	"12-out6295"	.97641	207	5	212
12	"12-out6296"	.84482	49	9	58
12	"12-out6297"	.99130	114	1	115
12	"12-out6298"	.67336	268	130	398
12	"12-out6299"	.99180	121	1	122
12	"12-out6300"	.99523	209	1	210
12	"12-out6301"	.44878	92	113	205
12	"12-out6302"	.58360	356	254	610
12	"12-out6303"	.42307	132	180	312
12	"12-out6304"	.42465	93	126	219
12	"12-out6305"	.43317	94	123	217
12	"12-out6306"	.99539	216	1	217
12	"12-out6307"	.99310	144	1	145
12	"12-out6308"	.93430	128	9	137
12	"12-out6309"	1.00000	59	0	59
12	"12-out6310"	.99621	263	1	264
12	"12-out6311"	.99588	242	1	243
12	"12-out6312"	.99489	195	1	196
12	"12-out6313"	.47761	64	70	134
12	"12-out6314"	.33526	290	575	865
12	"12-out6315"	.35181	165	304	469
12	"12-out6316"	.99833	599	1	600
12	"12-out6317"	.87262	596	87	683
12	"12-out6318"	.20456	251	976	1227
12	"12-out6319"	.94578	157	9	166
12	"12-out6320"	.48230	586	629	1215
12	"12-out6321"	.43146	192	253	445
12	"12-out6322"	.81749	215	48	263
12	"12-out6323"	.91707	188	17	205
12	"12-out6324"	.56521	65	50	115
12	"12-out6325"	.33687	127	250	377
12	"12-out6326"	.32209	191	402	593
12	"12-out6327"	.32402	58	121	179
12	"12-out6328"	.27249	321	857	1178
12	"12-out6329"	.73195	71	26	97
12	"12-out6330"	.99596	494	2	496
12	"12-out6331"	.42987	141	187	328
12	"12-out6332"	.40000	78	117	195
12	"12-out6333"	.33417	266	530	796
12	"12-out6334"	.18390	48	213	261
12	"12-out6335"	.45588	124	148	272
12	"12-out6336"	.30673	519	1173	1692
12	"12-out6337"	.35714	145	261	406
12	"12-out6338"	.83804	326	63	389
12	"12-out6339"	.99069	213	2	215
12	"12-out6340"	.97340	183	5	188
12	"12-out6341"	.99264	135	1	136
12	"12-out6342"	.26765	72	197	269
12	"12-out6343"	.94859	203	11	214
12	"12-out6344"	.99507	202	1	203
12	"12-out6345"	.98461	128	2	130
12	"12-out6346"	.99789	473	1	474
12	"12-out6347"	.99789	473	1	474
12	"12-out6348"	.99789	475	1	476
12	"12-out6349"	.99789	473	1	474
12	"12-out6350"	.54029	362	308	670
12	"12-out6351"	.69674	1050	457	1507
12	"12-out6352"	.99547	220	1	221
12	"12-out6353"	.99547	220	1	221
12	"12-out6354"	.98317	409	7	416
12	"12-out6355"	.99029	306	3	309
12	"12-out6356"	.60612	851	553	1404
12	"12-out6357"	.26217	210	591	801
12	"12-out6358"	.85714	192	32	224
12	"12-out6359"	.99450	181	1	182
12	"12-out6360"	.22104	208	733	941
12	"12-out6361"	.97826	135	3	138
12	"12-out6362"	.49028	328	341	669
12	"12-out6363"	.98535	471	7	478
12	"12-out6364"	.22985	97	325	422
12	"12-out6365"	.37786	396	652	1048
12	"12-out6366"	.47419	147	163	310
12	"12-out6367"	.99431	175	1	176
12	"12-out6368"	.95223	319	16	335
12	"12-out6369"	.98826	421	5	426
12	"12-out6370"	.41345	762	1081	1843
12	"12-out6371"	.68857	241	109	350
12	"12-out6372"	.54166	143	121	264
12	"12-out6373"	.28455	35	88	123
12	"12-out6374"	.56844	436	331	767
12	"12-out6375"	.52706	185	166	351
12	"12-out6376"	.34303	165	316	481
12	"12-out6377"	.34141	169	326	495
12	"12-out6378"	.40380	170	251	421
12	"12-out6379"	.31421	356	777	1133
12	"12-out6380"	.32389	103	215	318
12	"12-out6381"	.99038	103	1	104
12	"12-out6382"	.40585	222	325	547
12	"12-out6383"	.99047	104	1	105
12	"12-out6384"	.40151	265	395	660
12	"12-out6385"	.61728	350	217	567
12	"12-out6386"	.99736	379	1	380
12	"12-out6387"	.40301	455	674	1129
12	"12-out6388"	.30786	137	308	445
12	"12-out6389"	.33948	92	179	271
12	"12-out6390"	.33476	156	310	466
12	"12-out6391"	.39843	306	462	768
12	"12-out6392"	.13846	54	336	390
12	"12-out6393"	.42084	327	450	777
12	"12-out6394"	.55980	117	92	209
12	"12-out6395"	.43798	339	435	774
12	"12-out6396"	.91005	344	34	378
12	"12-out6397"	.65918	323	167	490
12	"12-out6398"	.99845	646	1	647
12	"12-out6399"	.22562	199	683	882
12	"12-out6400"	.26335	69	193	262
12	"12-out6401"	.99886	1756	2	1758
12	"12-out6402"	.38765	226	357	583
12	"12-out6403"	.55345	88	71	159
12	"12-out6404"	.48166	197	212	409
12	"12-out6405"	.60465	182	119	301
12	"12-out6406"	.88594	668	86	754
12	"12-out6407"	.40993	66	95	161
12	"12-out6408"	.23076	12	40	52
12	"12-out6409"	.44676	214	265	479
12	"12-out6410"	.28264	171	434	605
12	"12-out6411"	.38543	291	464	755
12	"12-out6412"	.45594	207	247	454
12	"12-out6413"	.56511	243	187	430
12	"12-out6414"	.42473	158	214	372
12	"12-out6415"	.59216	408	281	689
12	"12-out6416"	.96085	859	35	894
12	"12-out6417"	.99791	478	1	479
12	"12-out6418"	.40876	289	418	707
12	"12-out6419"	.99803	508	1	509
12	"12-out6420"	.40019	415	622	1037
12	"12-out6421"	.99790	477	1	478
12	"12-out6422"	.87373	173	25	198
12	"12-out6423"	.41158	661	945	1606
12	"12-out6424"	.56613	107	82	189
12	"12-out6425"	.99975	4127	1	4128
12	"12-out6426"	.62439	384	231	615
12	"12-out6427"	.21145	48	179	227
12	"12-out6428"	.70212	66	28	94
12	"12-out6429"	.33233	223	448	671
12	"12-out6430"	.35555	192	348	540
12	"12-out6431"	.28682	37	92	129
12	"12-out6432"	.45119	208	253	461
12	"12-out6433"	.56567	323	248	571
12	"12-out6434"	.38055	137	223	360
12	"12-out6435"	.49146	144	149	293
12	"12-out6436"	.98513	265	4	269
12	"12-out6437"	.98837	340	4	344
12	"12-out6438"	.99719	355	1	356
12	"12-out6439"	.97727	430	10	440
12	"12-out6440"	.31543	94	204	298
12	"12-out6441"	.39059	216	337	553
12	"12-out6442"	.26835	106	289	395
12	"12-out6443"	.99336	599	4	603
12	"12-out6444"	.39419	95	146	241
12	"12-out6445"	.34893	82	153	235
12	"12-out6446"	.29739	342	808	1150
12	"12-out6447"	.41737	394	550	944
12	"12-out6448"	.39745	312	473	785
12	"12-out6449"	.69366	197	87	284
12	"12-out6450"	.55778	362	287	649
12	"12-out6451"	.93145	231	17	248
12	"12-out6452"	.38788	493	778	1271
12	"12-out6453"	.33576	46	91	137
12	"12-out6454"	.26675	203	558	761
12	"12-out6455"	.49289	104	107	211
12	"12-out6456"	.42168	105	144	249
12	"12-out6457"	.40349	393	581	974
12	"12-out6458"	.46261	495	575	1070
12	"12-out6459"	.53256	278	244	522
12	"12-out6460"	.25509	238	695	933
12	"12-out6461"	.56976	98	74	172
12	"12-out6462"	.95876	186	8	194
12	"12-out6463"	.39319	462	713	1175
12	"12-out6464"	.52766	267	239	506
12	"12-out6465"	.30319	114	262	376
12	"12-out6466"	.55121	113	92	205
12	"12-out6467"	.32798	143	293	436
12	"12-out6468"	.62663	240	143	383
12	"12-out6469"	.27422	167	442	609
12	"12-out6470"	1.00000	969	0	969
12	"12-out6471"	1.00000	812	0	812
12	"12-out6472"	1.00000	1459	0	1459
12	"12-out6473"	.28364	196	495	691
12	"12-out6474"	.18965	132	564	696
12	"12-out6475"	.59477	364	248	612
12	"12-out6476"	.34032	292	566	858
12	"12-out6477"	.44736	68	84	152
12	"12-out6478"	.46718	299	341	640
12	"12-out6479"	.85454	94	16	110
12	"12-out6480"	.66666	178	89	267
12	"12-out6481"	.57261	138	103	241
12	"12-out6482"	.99669	302	1	303
12	"12-out6483"	.18099	80	362	442
12	"12-out6484"	.99629	269	1	270
12	"12-out6485"	.47872	135	147	282
12	"12-out6486"	.99886	1756	2	1758
12	"12-out6487"	.51211	148	141	289
12	"12-out6488"	.56254	814	633	1447
12	"12-out6489"	.28501	116	291	407
12	"12-out6490"	.43130	248	327	575
12	"12-out6491"	.60736	198	128	326
12	"12-out6492"	.57589	368	271	639
12	"12-out6493"	.82692	86	18	104
12	"12-out6494"	.47404	137	152	289
12	"12-out6495"	.39130	99	154	253
12	"12-out6496"	.44574	152	189	341
12	"12-out6497"	.99218	127	1	128
12	"12-out6498"	.32014	178	378	556
12	"12-out6499"	.50501	151	148	299
12	"12-out6500"	.33875	333	650	983
12	"12-out6501"	.40417	736	1085	1821
12	"12-out6502"	.41687	168	235	403
12	"12-out6503"	.24833	186	563	749
12	"12-out6504"	.43500	599	778	1377
12	"12-out6505"	.99318	437	3	440
12	"12-out6506"	.99663	296	1	297
12	"12-out6507"	.39432	403	619	1022
12	"12-out6508"	.30020	148	345	493
12	"12-out6509"	.55580	249	199	448
12	"12-out6510"	.26211	146	411	557
12	"12-out6511"	.99749	398	1	399
12	"12-out6512"	.83779	532	103	635
12	"12-out6513"	.99509	203	1	204
12	"12-out6514"	.32577	115	238	353
12	"12-out6515"	.47109	220	247	467
12	"12-out6516"	.78571	165	45	210
12	"12-out6517"	.97122	135	4	139
12	"12-out6518"	.31065	105	233	338
12	"12-out6519"	.38721	103	163	266
12	"12-out6520"	.87179	510	75	585
12	"12-out6521"	.90551	230	24	254
12	"12-out6522"	.29660	323	766	1089
12	"12-out6523"	.37500	162	270	432
12	"12-out6524"	.34166	287	553	840
12	"12-out6525"	.96341	79	3	82
12	"12-out6526"	.21212	70	260	330
12	"12-out6527"	.46965	178	201	379
12	"12-out6528"	.36554	1551	2692	4243
12	"12-out6529"	.97302	505	14	519
12	"12-out6530"	.99744	390	1	391
12	"12-out6531"	.32056	1306	2768	4074
12	"12-out6532"	.96000	168	7	175
12	"12-out6533"	.36708	58	100	158
12	"12-out6534"	.36363	504	882	1386
12	"12-out6535"	.48407	152	162	314
12	"12-out6536"	.54081	477	405	882
12	"12-out6537"	.51190	129	123	252
12	"12-out6538"	.27645	209	547	756
12	"12-out6539"	.45276	139	168	307
12	"12-out6540"	.29702	30	71	101
12	"12-out6541"	.48987	121	126	247
12	"12-out6542"	.44827	221	272	493
12	"12-out6543"	.43983	106	135	241
12	"12-out6544"	.27224	254	679	933
12	"12-out6545"	.56595	266	204	470
12	"12-out6546"	.88601	171	22	193
12	"12-out6547"	.38858	354	557	911
12	"12-out6548"	.40674	1786	2605	4391
12	"12-out6549"	.51383	1300	1230	2530
12	"12-out6550"	.45198	273	331	604
12	"12-out6551"	.56834	237	180	417
12	"12-out6552"	.30133	113	262	375
12	"12-out6553"	.53582	172	149	321
12	"12-out6554"	.44169	125	158	283
12	"12-out6555"	.43386	164	214	378
12	"12-out6556"	.46110	569	665	1234
12	"12-out6557"	.49028	227	236	463
12	"12-out6558"	.60074	322	214	536
12	"12-out6559"	.24324	63	196	259
12	"12-out6560"	.99404	167	1	168
12	"12-out6561"	.99481	192	1	193
12	"12-out6562"	.54878	135	111	246
12	"12-out6563"	.19189	90	379	469
12	"12-out6564"	.40088	182	272	454
12	"12-out6565"	.28947	198	486	684
12	"12-out6566"	.32149	371	783	1154
12	"12-out6567"	.33566	240	475	715
12	"12-out6568"	.14173	36	218	254
12	"12-out6569"	.20033	120	479	599
12	"12-out6570"	.40816	80	116	196
12	"12-out6571"	.64573	144	79	223
12	"12-out6572"	.91538	119	11	130
12	"12-out6573"	.45906	757	892	1649
12	"12-out6574"	.32677	249	513	762
12	"12-out6575"	.79141	129	34	163
12	"12-out6576"	.23348	53	174	227
12	"12-out6577"	.55867	219	173	392
12	"12-out6578"	.43102	1228	1621	2849
12	"12-out6579"	.27722	112	292	404
12	"12-out6580"	.47036	373	420	793
12	"12-out6581"	.45412	292	351	643
12	"12-out6582"	.38783	306	483	789
12	"12-out6583"	.36672	216	373	589
12	"12-out6584"	.39632	302	460	762
12	"12-out6585"	.40707	495	721	1216
12	"12-out6586"	.74576	1012	345	1357
12	"12-out6587"	.99640	277	1	278
12	"12-out6588"	.24600	123	377	500
12	"12-out6589"	.98913	91	1	92
12	"12-out6590"	.27000	81	219	300
12	"12-out6591"	.59600	239	162	401
12	"12-out6592"	.40944	52	75	127
12	"12-out6593"	.43287	158	207	365
12	"12-out6594"	.94666	213	12	225
12	"12-out6595"	.22115	23	81	104
12	"12-out6596"	.43630	137	177	314
12	"12-out6597"	.26804	78	213	291
12	"12-out6598"	.99942	1731	1	1732
12	"12-out6599"	.39919	596	897	1493
12	"12-out6600"	.62913	190	112	302
12	"12-out6601"	.43624	65	84	149
12	"12-out6602"	.62162	138	84	222
12	"12-out6603"	.43649	543	701	1244
12	"12-out6604"	.42772	577	772	1349
12	"12-out6605"	.35018	485	900	1385
12	"12-out6606"	.40372	325	480	805
12	"12-out6607"	.54807	342	282	624
12	"12-out6608"	.33370	296	591	887
12	"12-out6609"	.31775	102	219	321
12	"12-out6610"	.31826	176	377	553
12	"12-out6611"	.40789	248	360	608
12	"12-out6612"	.44894	532	653	1185
12	"12-out6613"	.54158	267	226	493
12	"12-out6614"	.78888	639	171	810
12	"12-out6615"	.23636	299	966	1265
12	"12-out6616"	.47104	667	749	1416
12	"12-out6617"	.95563	1788	83	1871
12	"12-out6618"	.99826	577	1	578
12	"12-out6619"	.70812	279	115	394
12	"12-out6620"	.59214	196	135	331
12	"12-out6621"	.60800	76	49	125
12	"12-out6622"	.42411	517	702	1219
12	"12-out6623"	.34303	271	519	790
12	"12-out6624"	.36470	155	270	425
12	"12-out6625"	.42025	469	647	1116
12	"12-out6626"	.40060	133	199	332
12	"12-out6627"	.99905	1055	1	1056
12	"12-out6628"	.86285	151	24	175
12	"12-out6629"	.37746	325	536	861
12	"12-out6630"	.41991	194	268	462
12	"12-out6631"	.52298	546	498	1044
12	"12-out6632"	.32768	232	476	708
12	"12-out6633"	.91773	3949	354	4303
12	"12-out6634"	.71351	132	53	185
12	"12-out6635"	.40140	57	85	142
12	"12-out6636"	.75743	331	106	437
12	"12-out6637"	.29493	128	306	434
12	"12-out6638"	.34354	774	1479	2253
12	"12-out6639"	.38571	189	301	490
12	"12-out6640"	.51648	188	176	364
12	"12-out6641"	.24031	310	980	1290
12	"12-out6642"	.33608	569	1124	1693
12	"12-out6643"	.34977	383	712	1095
12	"12-out6644"	.42413	478	649	1127
12	"12-out6645"	.99690	322	1	323
12	"12-out6646"	.20000	61	244	305
12	"12-out6647"	.27097	197	530	727
12	"12-out6648"	.43962	324	413	737
12	"12-out6649"	.29810	220	518	738
12	"12-out6650"	.41983	796	1100	1896
12	"12-out6651"	.99333	149	1	150
12	"12-out6652"	.47983	916	993	1909
12	"12-out6653"	.37882	594	974	1568
12	"12-out6654"	.99885	1746	2	1748
12	"12-out6655"	.99814	537	1	538
12	"12-out6656"	.99943	1764	1	1765
12	"12-out6657"	.69942	121	52	173
12	"12-out6658"	.99122	113	1	114
12	"12-out6659"	.20476	86	334	420
12	"12-out6660"	.29388	226	543	769
12	"12-out6661"	.81926	1301	287	1588
12	"12-out6662"	.52212	590	540	1130
12	"12-out6663"	.28140	56	143	199
12	"12-out6664"	.31168	72	159	231
12	"12-out6665"	.21974	325	1154	1479
12	"12-out6666"	.44063	553	702	1255
12	"12-out6667"	.32443	231	481	712
12	"12-out6668"	.99873	789	1	790
12	"12-out6669"	.59887	318	213	531
12	"12-out6670"	.34883	45	84	129
12	"12-out6671"	.52131	159	146	305
12	"12-out6672"	.28571	224	560	784
12	"12-out6673"	.36734	72	124	196
12	"12-out6674"	.33251	136	273	409
12	"12-out6675"	.37279	444	747	1191
12	"12-out6676"	.48210	512	550	1062
12	"12-out6677"	.57044	166	125	291
12	"12-out6678"	.33651	459	905	1364
12	"12-out6679"	.99666	299	1	300
12	"12-out6680"	.70089	546	233	779
12	"12-out6681"	.29794	334	787	1121
12	"12-out6682"	.42758	124	166	290
12	"12-out6683"	.43765	179	230	409
12	"12-out6684"	.41632	204	286	490
12	"12-out6685"	.46660	1006	1150	2156
12	"12-out6686"	.42899	145	193	338
12	"12-out6687"	.33704	363	714	1077
12	"12-out6688"	.47982	107	116	223
12	"12-out6689"	.27040	53	143	196
12	"12-out6690"	.40396	387	571	958
12	"12-out6691"	.50707	215	209	424
12	"12-out6692"	.28461	553	1390	1943
12	"12-out6693"	.39018	318	497	815
12	"12-out6694"	.70620	512	213	725
12	"12-out6695"	.97475	502	13	515
12	"12-out6696"	.98936	279	3	282
12	"12-out6697"	.43188	149	196	345
12	"12-out6698"	.55185	149	121	270
12	"12-out6699"	.52300	466	425	891
12	"12-out6700"	.21839	152	544	696
12	"12-out6701"	.16331	138	707	845
12	"12-out6702"	.46673	456	521	977
12	"12-out6703"	.43249	362	475	837
12	"12-out6704"	.19206	184	774	958
12	"12-out6705"	.38190	304	492	796
12	"12-out6706"	.37426	570	953	1523
12	"12-out6707"	.51428	342	323	665
12	"12-out6708"	.58627	299	211	510
12	"12-out6709"	.33541	161	319	480
12	"12-out6710"	.32926	162	330	492
12	"12-out6711"	.38223	99	160	259
12	"12-out6712"	.52559	154	139	293
12	"12-out6713"	.40371	174	257	431
12	"12-out6714"	.49122	168	174	342
12	"12-out6715"	.54054	140	119	259
12	"12-out6716"	.44000	209	266	475
12	"12-out6717"	.51651	469	439	908
12	"12-out6718"	.35232	439	807	1246
12	"12-out6719"	.98101	155	3	158
12	"12-out6720"	.61139	590	375	965
12	"12-out6721"	.99386	162	1	163
12	"12-out6722"	.50839	424	410	834
12	"12-out6723"	.36466	291	507	798
12	"12-out6724"	.39586	230	351	581
12	"12-out6725"	.61087	719	458	1177
12	"12-out6726"	.43582	146	189	335
12	"12-out6727"	.54216	180	152	332
12	"12-out6728"	.99242	131	1	132
12	"12-out6729"	.49295	280	288	568
12	"12-out6730"	.44406	258	323	581
12	"12-out6731"	.45291	101	122	223
12	"12-out6732"	.55517	322	258	580
12	"12-out6733"	.27906	48	124	172
12	"12-out6734"	.70751	433	179	612
12	"12-out6735"	.99561	227	1	228
12	"12-out6736"	.24088	152	479	631
12	"12-out6737"	.37500	261	435	696
12	"12-out6738"	.99285	278	2	280
12	"12-out6739"	.99393	164	1	165
12	"12-out6740"	.30487	75	171	246
12	"12-out6741"	.63231	227	132	359
12	"12-out6742"	.57028	142	107	249
12	"12-out6743"	.99732	373	1	374
12	"12-out6744"	.53642	162	140	302
12	"12-out6745"	.24734	93	283	376
12	"12-out6746"	.32527	269	558	827
12	"12-out6747"	.78479	547	150	697
12	"12-out6748"	.68597	225	103	328
12	"12-out6749"	.99792	480	1	481
12	"12-out6750"	.47637	373	410	783
12	"12-out6751"	.35529	329	597	926
12	"12-out6752"	.98717	77	1	78
12	"12-out6753"	.35869	33	59	92
12	"12-out6754"	.62637	57	34	91
12	"12-out6755"	.28851	221	545	766
12	"12-out6756"	.91538	119	11	130
12	"12-out6757"	.98947	94	1	95
12	"12-out6758"	.98181	54	1	55
12	"12-out6759"	.37031	247	420	667
12	"12-out6760"	.98305	58	1	59
12	"12-out6761"	.98591	70	1	71
12	"12-out6762"	.99029	102	1	103
12	"12-out6763"	.99242	131	1	132
12	"12-out6764"	.98823	84	1	85
12	"12-out6765"	.98924	92	1	93
12	"12-out6766"	.29501	154	368	522
12	"12-out6767"	.33583	134	265	399
12	"12-out6768"	.39000	156	244	400
12	"12-out6769"	.95588	195	9	204
12	"12-out6770"	.95871	209	9	218
12	"12-out6771"	.98854	259	3	262
12	"12-out6772"	.32613	423	874	1297
12	"12-out6773"	.93718	373	25	398
12	"12-out6774"	.99431	175	1	176
12	"12-out6775"	.36130	676	1195	1871
12	"12-out6776"	.99029	102	1	103
12	"12-out6777"	.42105	192	264	456
12	"12-out6778"	.44686	349	432	781
12	"12-out6779"	.50588	129	126	255
12	"12-out6780"	.99173	120	1	121
12	"12-out6781"	.54368	224	188	412
12	"12-out6782"	.40389	145	214	359
12	"12-out6783"	.42405	134	182	316
12	"12-out6784"	.43840	363	465	828
12	"12-out6785"	.69536	315	138	453
12	"12-out6786"	.87374	436	63	499
12	"12-out6787"	.89848	416	47	463
12	"12-out6788"	.31188	412	909	1321
12	"12-out6789"	.53140	110	97	207
12	"12-out6790"	.50542	233	228	461
12	"12-out6791"	.97297	72	2	74
12	"12-out6792"	.98214	55	1	56
12	"12-out6793"	.25239	79	234	313
12	"12-out6794"	.33689	126	248	374
12	"12-out6795"	.36999	471	802	1273
12	"12-out6796"	.30206	351	811	1162
12	"12-out6797"	.19745	62	252	314
12	"12-out6798"	.50967	158	152	310
12	"12-out6799"	.35492	126	229	355
12	"12-out6800"	.60283	170	112	282
12	"12-out6801"	.87711	571	80	651
12	"12-out6802"	.48223	95	102	197
12	"12-out6803"	.99741	386	1	387
12	"12-out6804"	.56986	208	157	365
12	"12-out6805"	.36981	588	1002	1590
12	"12-out6806"	.28953	119	292	411
12	"12-out6807"	.57794	849	620	1469
12	"12-out6808"	.39473	195	299	494
12	"12-out6809"	.39393	52	80	132
12	"12-out6810"	.89677	139	16	155
12	"12-out6811"	.59603	301	204	505
12	"12-out6812"	.37285	629	1058	1687
12	"12-out6813"	.61347	865	545	1410
12	"12-out6814"	.45571	355	424	779
12	"12-out6815"	.37801	313	515	828
12	"12-out6816"	.84392	757	140	897
12	"12-out6817"	.40049	163	244	407
12	"12-out6818"	.25757	34	98	132
12	"12-out6819"	.49806	515	519	1034
12	"12-out6820"	.48634	285	301	586
12	"12-out6821"	.28354	467	1180	1647
12	"12-out6822"	.37234	105	177	282
12	"12-out6823"	.45370	245	295	540
12	"12-out6824"	.91666	77	7	84
12	"12-out6825"	.49246	98	101	199
12	"12-out6826"	.44159	155	196	351
12	"12-out6827"	.41666	95	133	228
12	"12-out6828"	.36521	84	146	230
12	"12-out6829"	.28508	323	810	1133
12	"12-out6830"	.58583	1406	994	2400
12	"12-out6831"	.21409	243	892	1135
12	"12-out6832"	.40196	82	122	204
12	"12-out6833"	.18208	63	283	346
12	"12-out6834"	.90140	128	14	142
12	"12-out6835"	.23343	236	775	1011
12	"12-out6836"	.42973	688	913	1601
12	"12-out6837"	.34292	441	845	1286
12	"12-out6838"	.53015	167	148	315
12	"12-out6839"	.45355	249	300	549
12	"12-out6840"	.39858	169	255	424
12	"12-out6841"	.38617	190	302	492
12	"12-out6842"	.99748	397	1	398
12	"12-out6843"	.24728	114	347	461
12	"12-out6844"	.99684	316	1	317
12	"12-out6845"	.62561	254	152	406
12	"12-out6846"	.58405	337	240	577
12	"12-out6847"	.44041	255	324	579
12	"12-out6848"	.41818	207	288	495
12	"12-out6849"	.14285	25	150	175
12	"12-out6850"	.41867	139	193	332
12	"12-out6851"	.25000	28	84	112
12	"12-out6852"	.38405	53	85	138
12	"12-out6853"	.90683	146	15	161
12	"12-out6854"	.30745	202	455	657
12	"12-out6855"	.40364	310	458	768
12	"12-out6856"	.54953	294	241	535
12	"12-out6857"	.34682	120	226	346
12	"12-out6858"	.19787	112	454	566
12	"12-out6859"	.99696	328	1	329
12	"12-out6860"	.95192	594	30	624
12	"12-out6861"	.88818	421	53	474
12	"12-out6862"	.32461	149	310	459
12	"12-out6863"	.47706	104	114	218
12	"12-out6864"	.24000	36	114	150
12	"12-out6865"	.99561	227	1	228
12	"12-out6866"	.90497	200	21	221
12	"12-out6867"	.21241	89	330	419
12	"12-out6868"	.18927	60	257	317
12	"12-out6869"	.39588	327	499	826
12	"12-out6870"	.61801	199	123	322
12	"12-out6871"	.28374	391	987	1378
12	"12-out6872"	.44308	615	773	1388
12	"12-out6873"	.30357	425	975	1400
12	"12-out6874"	.94811	201	11	212
12	"12-out6875"	.98290	115	2	117
12	"12-out6876"	.38805	26	41	67
12	"12-out6877"	.73923	309	109	418
12	"12-out6878"	.45635	779	928	1707
12	"12-out6879"	.40335	793	1173	1966
12	"12-out6880"	.99512	1224	6	1230
12	"12-out6881"	.31523	180	391	571
12	"12-out6882"	.37500	96	160	256
12	"12-out6883"	.62987	97	57	154
12	"12-out6884"	.45400	2364	2843	5207
12	"12-out6885"	.97222	175	5	180
12	"12-out6886"	.55769	174	138	312
12	"12-out6887"	.39393	143	220	363
12	"12-out6888"	.20557	59	228	287
12	"12-out6889"	.77108	256	76	332
12	"12-out6890"	.52964	134	119	253
12	"12-out6891"	.73498	416	150	566
12	"12-out6892"	.14204	25	151	176
12	"12-out6893"	.37719	129	213	342
12	"12-out6894"	.55831	225	178	403
12	"12-out6895"	.37050	309	525	834
12	"12-out6896"	.29245	93	225	318
12	"12-out6897"	.41791	84	117	201
12	"12-out6898"	.99540	433	2	435
12	"12-out6899"	.63097	330	193	523
12	"12-out6900"	.43457	93	121	214
12	"12-out6901"	.99669	302	1	303
12	"12-out6902"	.61589	93	58	151
12	"12-out6903"	.77372	106	31	137
12	"12-out6904"	.38858	143	225	368
12	"12-out6905"	.42268	164	224	388
12	"12-out6906"	.92142	129	11	140
12	"12-out6907"	.52586	61	55	116
12	"12-out6908"	.37209	48	81	129
12	"12-out6909"	.56310	232	180	412
12	"12-out6910"	.34725	133	250	383
12	"12-out6911"	.39575	112	171	283
12	"12-out6912"	.72892	320	119	439
12	"12-out6913"	.64597	281	154	435
12	"12-out6914"	.99791	479	1	480
12	"12-out6915"	.99509	203	1	204
12	"12-out6916"	.51612	240	225	465
12	"12-out6917"	.27992	145	373	518
12	"12-out6918"	.16858	88	434	522
12	"12-out6919"	.24855	86	260	346
12	"12-out6920"	.89543	805	94	899
12	"12-out6921"	.61538	160	100	260
12	"12-out6922"	.49387	121	124	245
12	"12-out6923"	.86440	255	40	295
12	"12-out6924"	.40995	173	249	422
12	"12-out6925"	.61442	247	155	402
12	"12-out6926"	.94858	369	20	389
12	"12-out6927"	.52014	142	131	273
12	"12-out6928"	.85398	193	33	226
12	"12-out6929"	.99122	113	1	114
12	"12-out6930"	.48295	510	546	1056
12	"12-out6931"	.37890	388	636	1024
12	"12-out6932"	.28664	221	550	771
12	"12-out6933"	.78918	146	39	185
12	"12-out6934"	.39243	332	514	846
12	"12-out6935"	.83969	220	42	262
12	"12-out6936"	.56379	380	294	674
12	"12-out6937"	.26063	49	139	188
12	"12-out6938"	.43584	214	277	491
12	"12-out6939"	.98148	53	1	54
12	"12-out6940"	.96951	477	15	492
12	"12-out6941"	.42745	601	805	1406
12	"12-out6942"	.49007	716	745	1461
12	"12-out6943"	.28056	358	918	1276
12	"12-out6944"	.99032	307	3	310
12	"12-out6945"	.36300	783	1374	2157
12	"12-out6946"	.31757	262	563	825
12	"12-out6947"	.23633	147	475	622
12	"12-out6948"	.47463	262	290	552
12	"12-out6949"	.99843	640	1	641
12	"12-out6950"	.41554	246	346	592
12	"12-out6951"	.34500	138	262	400
12	"12-out6952"	.54940	139	114	253
12	"12-out6953"	.56621	124	95	219
12	"12-out6954"	.99733	374	1	375
12	"12-out6955"	.45426	149	179	328
12	"12-out6956"	.98850	86	1	87
12	"12-out6957"	.99680	312	1	313
12	"12-out6958"	.75519	327	106	433
12	"12-out6959"	.99642	279	1	280
12	"12-out6960"	.44309	183	230	413
12	"12-out6961"	.32515	106	220	326
12	"12-out6962"	.51724	210	196	406
12	"12-out6963"	.51603	177	166	343
12	"12-out6964"	.54512	151	126	277
12	"12-out6965"	.51388	259	245	504
12	"12-out6966"	.89207	810	98	908
12	"12-out6967"	.98326	235	4	239
12	"12-out6968"	.40727	224	326	550
12	"12-out6969"	.99099	110	1	111
12	"12-out6970"	.29411	30	72	102
12	"12-out6971"	.64052	98	55	153
12	"12-out6972"	.39062	325	507	832
12	"12-out6973"	.34677	86	162	248
12	"12-out6974"	.97485	659	17	676
12	"12-out6975"	.59375	76	52	128
12	"12-out6976"	.99925	1345	1	1346
12	"12-out6977"	.69683	154	67	221
12	"12-out6978"	.70319	154	65	219
12	"12-out6979"	.51960	159	147	306
12	"12-out6980"	.99545	219	1	220
12	"12-out6981"	.28977	102	250	352
12	"12-out6982"	.65625	168	88	256
12	"12-out6983"	.13636	36	228	264
12	"12-out6984"	.45312	116	140	256
12	"12-out6985"	.98090	411	8	419
12	"12-out6986"	.43147	85	112	197
12	"12-out6987"	.38188	97	157	254
12	"12-out6988"	.39936	125	188	313
12	"12-out6989"	.98194	272	5	277
12	"12-out6990"	.75595	254	82	336
12	"12-out6991"	.40780	188	273	461
12	"12-out6992"	.56785	318	242	560
12	"12-out6993"	.40655	211	308	519
12	"12-out6994"	.99285	139	1	140
12	"12-out6995"	.32865	164	335	499
12	"12-out6996"	.44411	151	189	340
12	"12-out6997"	.99685	317	1	318
12	"12-out6998"	.66811	614	305	919
12	"12-out6999"	.15981	35	184	219
12	"12-out7000"	.82675	377	79	456
12	"12-out7001"	.23880	176	561	737
12	"12-out7002"	.49468	93	95	188
12	"12-out7003"	.50000	137	137	274
12	"12-out7004"	.99324	147	1	148
12	"12-out7005"	.41709	244	341	585
12	"12-out7006"	.58893	149	104	253
12	"12-out7007"	.28708	120	298	418
12	"12-out7008"	.99697	330	1	331
12	"12-out7009"	.30290	73	168	241
12	"12-out7010"	.98913	182	2	184
12	"12-out7011"	.97606	367	9	376
12	"12-out7012"	.29166	63	153	216
12	"12-out7013"	.99295	423	3	426
12	"12-out7014"	.98148	318	6	324
12	"12-out7015"	.45714	288	342	630
12	"12-out7016"	.99790	477	1	478
12	"12-out7017"	.53605	513	444	957
12	"12-out7018"	.99789	473	1	474
12	"12-out7019"	.98603	353	5	358
12	"12-out7020"	.99086	217	2	219
12	"12-out7021"	.33585	266	526	792
12	"12-out7022"	.45707	559	664	1223
12	"12-out7023"	.99425	173	1	174
12	"12-out7024"	.56603	180	138	318
12	"12-out7025"	.40689	118	172	290
12	"12-out7026"	.48000	144	156	300
12	"12-out7027"	.19665	47	192	239
12	"12-out7028"	.25000	69	207	276
12	"12-out7029"	.51932	309	286	595
12	"12-out7030"	.91987	287	25	312
12	"12-out7031"	.99792	482	1	483
12	"12-out7032"	.99791	478	1	479
12	"12-out7033"	.99789	473	1	474
12	"12-out7034"	.99789	475	1	476
12	"12-out7035"	.35078	134	248	382
12	"12-out7036"	.99790	477	1	478
12	"12-out7037"	.99337	150	1	151
12	"12-out7038"	.99547	220	1	221
12	"12-out7039"	.99547	220	1	221
12	"12-out7040"	.99789	474	1	475
12	"12-out7041"	.54504	121	101	222
12	"12-out7042"	.45168	776	942	1718
12	"12-out7043"	.41697	113	158	271
12	"12-out7044"	.50934	109	105	214
12	"12-out7045"	.43988	450	573	1023
12	"12-out7046"	.39442	368	565	933
12	"12-out7047"	.41290	192	273	465
12	"12-out7048"	.51584	293	275	568
12	"12-out7049"	.60465	78	51	129
12	"12-out7050"	.31753	67	144	211
12	"12-out7051"	.24207	229	717	946
12	"12-out7052"	.37132	215	364	579
12	"12-out7053"	.72486	137	52	189
12	"12-out7054"	.99619	262	1	263
12	"12-out7055"	.84988	385	68	453
12	"12-out7056"	.31994	988	2100	3088
12	"12-out7057"	.57272	63	47	110
12	"12-out7058"	.27966	66	170	236
12	"12-out7059"	.56935	275	208	483
12	"12-out7060"	.38157	87	141	228
12	"12-out7061"	.88781	459	58	517
12	"12-out7062"	.32230	302	635	937
12	"12-out7063"	.20572	194	749	943
12	"12-out7064"	.27724	145	378	523
12	"12-out7065"	.27234	128	342	470
12	"12-out7066"	.25675	133	385	518
12	"12-out7067"	.98136	316	6	322
12	"12-out7068"	.24032	149	471	620
12	"12-out7069"	.97698	382	9	391
12	"12-out7070"	.31693	58	125	183
12	"12-out7071"	.99047	104	1	105
12	"12-out7072"	.99047	104	1	105
12	"12-out7073"	.33470	325	646	971
12	"12-out7074"	.34547	256	485	741
12	"12-out7075"	.38294	283	456	739
12	"12-out7076"	.88689	494	63	557
12	"12-out7077"	.39800	80	121	201
12	"12-out7078"	.31349	79	173	252
12	"12-out7079"	.57254	146	109	255
12	"12-out7080"	.36186	93	164	257
12	"12-out7081"	.24867	47	142	189
12	"12-out7082"	.98104	207	4	211
12	"12-out7083"	.99397	165	1	166
12	"12-out7084"	.99397	165	1	166
12	"12-out7085"	.40207	503	748	1251
12	"12-out7086"	.43130	1350	1780	3130
12	"12-out7087"	.99651	286	1	287
12	"12-out7088"	.71280	412	166	578
12	"12-out7089"	.26721	97	266	363
12	"12-out7090"	.32188	150	316	466
12	"12-out7091"	.93375	296	21	317
12	"12-out7092"	.38304	375	604	979
12	"12-out7093"	.97791	310	7	317
12	"12-out7094"	.47626	311	342	653
12	"12-out7095"	.34189	466	897	1363
12	"12-out7096"	.87850	188	26	214
12	"12-out7097"	.45036	186	227	413
12	"12-out7098"	.56041	589	462	1051
12	"12-out7099"	.64560	235	129	364
12	"12-out7100"	.41360	450	638	1088
12	"12-out7101"	.33333	52	104	156
12	"12-out7102"	.95977	501	21	522
12	"12-out7103"	.45228	109	132	241
12	"12-out7104"	.85819	351	58	409
12	"12-out7105"	.30562	364	827	1191
12	"12-out7106"	.53627	170	147	317
12	"12-out7107"	.99047	104	1	105
12	"12-out7108"	.71641	144	57	201
12	"12-out7109"	.27601	955	2505	3460
12	"12-out7110"	.15097	93	523	616
12	"12-out7111"	.96178	151	6	157
12	"12-out7112"	.46310	295	342	637
12	"12-out7113"	.69907	151	65	216
12	"12-out7114"	.32470	389	809	1198
12	"12-out7115"	.34927	168	313	481
12	"12-out7116"	.37622	883	1464	2347
12	"12-out7117"	.43602	535	692	1227
12	"12-out7118"	.73024	268	99	367
12	"12-out7119"	.35564	85	154	239
12	"12-out7120"	.99593	245	1	246
12	"12-out7121"	.57446	216	160	376
12	"12-out7122"	.35483	121	220	341
12	"12-out7123"	.47765	748	818	1566
12	"12-out7124"	.52542	186	168	354
12	"12-out7125"	.48180	609	655	1264
12	"12-out7126"	.99651	286	1	287
12	"12-out7127"	.40852	230	333	563
12	"12-out7128"	.37605	402	667	1069
12	"12-out7129"	.40129	559	834	1393
12	"12-out7130"	.31645	50	108	158
12	"12-out7131"	.53195	258	227	485
12	"12-out7132"	.44444	236	295	531
12	"12-out7133"	.35261	128	235	363
12	"12-out7134"	.41500	83	117	200
12	"12-out7135"	.97520	118	3	121
12	"12-out7136"	.37352	127	213	340
12	"12-out7137"	.48090	617	666	1283
12	"12-out7138"	.48280	365	391	756
12	"12-out7139"	.37878	300	492	792
12	"12-out7140"	.46666	63	72	135
12	"12-out7141"	.81428	285	65	350
12	"12-out7142"	.75373	101	33	134
12	"12-out7143"	.54954	61	50	111
12	"12-out7144"	.33842	377	737	1114
12	"12-out7145"	.29722	118	279	397
12	"12-out7146"	.45818	526	622	1148
12	"12-out7147"	.32812	168	344	512
12	"12-out7148"	.29115	214	521	735
12	"12-out7149"	.23777	107	343	450
12	"12-out7150"	.34037	145	281	426
12	"12-out7151"	.74320	246	85	331
12	"12-out7152"	.43798	618	793	1411
12	"12-out7153"	.42857	132	176	308
12	"12-out7154"	.22676	61	208	269
12	"12-out7155"	.58109	455	328	783
12	"12-out7156"	.35754	320	575	895
12	"12-out7157"	.36040	355	630	985
12	"12-out7158"	.57549	202	149	351
12	"12-out7159"	.35840	162	290	452
12	"12-out7160"	.99438	177	1	178
12	"12-out7161"	.99526	210	1	211
12	"12-out7162"	.63479	332	191	523
12	"12-out7163"	.98187	325	6	331
12	"12-out7164"	.99647	283	1	284
12	"12-out7165"	.88943	1086	135	1221
12	"12-out7166"	.25123	102	304	406
12	"12-out7167"	.79146	334	88	422
12	"12-out7168"	.26227	203	571	774
12	"12-out7169"	.51365	301	285	586
12	"12-out7170"	.26538	69	191	260
12	"12-out7171"	.34220	90	173	263
12	"12-out7172"	.30013	217	506	723
12	"12-out7173"	.80063	506	126	632
12	"12-out7174"	.43506	268	348	616
12	"12-out7175"	.33409	146	291	437
12	"12-out7176"	.38254	355	573	928
12	"12-out7177"	.36585	75	130	205
12	"12-out7178"	.56906	103	78	181
12	"12-out7179"	.27542	130	342	472
12	"12-out7180"	.46666	231	264	495
12	"12-out7181"	.38888	70	110	180
12	"12-out7182"	.32846	45	92	137
12	"12-out7183"	.30409	104	238	342
12	"12-out7184"	.46135	197	230	427
12	"12-out7185"	.34825	70	131	201
12	"12-out7186"	.99809	525	1	526
12	"12-out7187"	.88148	238	32	270
12	"12-out7188"	.58426	208	148	356
12	"12-out7189"	.25792	122	351	473
12	"12-out7190"	.34986	127	236	363
12	"12-out7191"	.51030	198	190	388
12	"12-out7192"	.36842	56	96	152
12	"12-out7193"	.35071	74	137	211
12	"12-out7194"	.31909	239	510	749
12	"12-out7195"	.44547	241	300	541
12	"12-out7196"	.99065	106	1	107
12	"12-out7197"	.72262	99	38	137
12	"12-out7198"	.99065	212	2	214
12	"12-out7199"	.94291	446	27	473
12	"12-out7200"	.99561	227	1	228
12	"12-out7201"	.99561	227	1	228
12	"12-out7202"	.36472	244	425	669
12	"12-out7203"	.51578	98	92	190
12	"12-out7204"	.28437	273	687	960
12	"12-out7205"	.77715	279	80	359
12	"12-out7206"	.56346	475	368	843
12	"12-out7207"	.43992	443	564	1007
12	"12-out7208"	.80377	426	104	530
12	"12-out7209"	.49238	97	100	197
12	"12-out7210"	.79646	90	23	113
12	"12-out7211"	.99596	494	2	496
12	"12-out7212"	.34083	106	205	311
12	"12-out7213"	.99596	494	2	496
12	"12-out7214"	.99596	494	2	496
12	"12-out7215"	.31012	98	218	316
12	"12-out7216"	.99047	104	1	105
12	"12-out7217"	.99130	114	1	115
12	"12-out7218"	.58415	177	126	303
12	"12-out7219"	.37244	73	123	196
12	"12-out7220"	.26119	35	99	134
12	"12-out7221"	.30224	175	404	579
12	"12-out7222"	.40707	495	721	1216
12	"12-out7223"	.39932	119	179	298
12	"12-out7224"	.51965	661	611	1272
12	"12-out7225"	.53406	290	253	543
12	"12-out7226"	.99425	173	1	174
12	"12-out7227"	.84482	343	63	406
12	"12-out7228"	.24957	148	445	593
12	"12-out7229"	.37288	88	148	236
12	"12-out7230"	.30552	249	566	815
12	"12-out7231"	.99652	287	1	288
12	"12-out7232"	.41897	318	441	759
12	"12-out7233"	.45897	537	633	1170
12	"12-out7234"	.53380	150	131	281
12	"12-out7235"	.35085	327	605	932
12	"12-out7236"	.32707	122	251	373
12	"12-out7237"	.45370	49	59	108
12	"12-out7238"	.99596	494	2	496
12	"12-out7239"	.55589	184	147	331
12	"12-out7240"	.56973	625	472	1097
12	"12-out7241"	.95798	456	20	476
12	"12-out7242"	.29648	59	140	199
12	"12-out7243"	.22222	30	105	135
12	"12-out7244"	.41117	206	295	501
12	"12-out7245"	.54084	384	326	710
12	"12-out7246"	.99393	164	1	165
12	"12-out7247"	.99684	316	1	317
12	"12-out7248"	.36184	165	291	456
12	"12-out7249"	.77083	148	44	192
12	"12-out7250"	.67114	100	49	149
12	"12-out7251"	.99363	156	1	157
12	"12-out7252"	.99596	247	1	248
12	"12-out7253"	.99324	147	1	148
12	"12-out7254"	.99371	158	1	159
12	"12-out7255"	.45538	148	177	325
12	"12-out7256"	.61967	189	116	305
12	"12-out7257"	.45692	122	145	267
12	"12-out7258"	.23448	34	111	145
12	"12-out7259"	.47928	243	264	507
12	"12-out7260"	.79787	150	38	188
12	"12-out7261"	.35804	198	355	553
12	"12-out7262"	.38394	177	284	461
12	"12-out7263"	.35996	473	841	1314
12	"12-out7264"	.38085	179	291	470
12	"12-out7265"	.62136	663	404	1067
12	"12-out7266"	.48475	159	169	328
12	"12-out7267"	.62730	340	202	542
12	"12-out7268"	.99337	150	1	151
12	"12-out7269"	.51149	979	935	1914
12	"12-out7270"	.23611	51	165	216
12	"12-out7271"	.92720	242	19	261
12	"12-out7272"	.68000	170	80	250
12	"12-out7273"	.31968	164	349	513
12	"12-out7274"	.70155	315	134	449
12	"12-out7275"	.43870	68	87	155
12	"12-out7276"	.44565	41	51	92
12	"12-out7277"	.97435	380	10	390
12	"12-out7278"	.92253	131	11	142
12	"12-out7279"	.31756	47	101	148
12	"12-out7280"	.45016	140	171	311
12	"12-out7281"	.40122	197	294	491
12	"12-out7282"	.22830	121	409	530
12	"12-out7283"	.64792	219	119	338
12	"12-out7284"	.19920	50	201	251
12	"12-out7285"	.81993	255	56	311
12	"12-out7286"	.42857	426	568	994
12	"12-out7287"	.18721	82	356	438
12	"12-out7288"	.95102	233	12	245
12	"12-out7289"	.70135	775	330	1105
12	"12-out7290"	.79220	122	32	154
12	"12-out7291"	.23717	37	119	156
12	"12-out7292"	.44177	569	719	1288
12	"12-out7293"	.33333	141	282	423
12	"12-out7294"	.41228	94	134	228
12	"12-out7295"	.31907	97	207	304
12	"12-out7296"	.47520	297	328	625
12	"12-out7297"	.59124	81	56	137
12	"12-out7298"	.22435	35	121	156
12	"12-out7299"	.44297	167	210	377
12	"12-out7300"	.27753	63	164	227
12	"12-out7301"	.87962	380	52	432
12	"12-out7302"	.68589	107	49	156
12	"12-out7303"	.41411	569	805	1374
12	"12-out7304"	.65423	386	204	590
12	"12-out7305"	.32038	165	350	515
12	"12-out7306"	.30946	134	299	433
12	"12-out7307"	.63059	676	396	1072
12	"12-out7308"	.80000	152	38	190
12	"12-out7309"	.38738	172	272	444
12	"12-out7310"	.45165	626	760	1386
12	"12-out7311"	.99624	265	1	266
12	"12-out7312"	.80000	320	80	400
12	"12-out7313"	.44350	314	394	708
12	"12-out7314"	.48364	281	300	581
12	"12-out7315"	.34808	173	324	497
12	"12-out7316"	.88311	68	9	77
12	"12-out7317"	.29767	64	151	215
12	"12-out7318"	.61538	40	25	65
12	"12-out7319"	.91251	605	58	663
12	"12-out7320"	.98757	159	2	161
12	"12-out7321"	.99598	248	1	249
12	"12-out7322"	.31848	236	505	741
12	"12-out7323"	.42329	229	312	541
12	"12-out7324"	.40690	330	481	811
12	"12-out7325"	.50770	824	799	1623
12	"12-out7326"	.21551	50	182	232
12	"12-out7327"	.16299	37	190	227
12	"12-out7328"	.12295	30	214	244
12	"12-out7329"	.51388	222	210	432
12	"12-out7330"	.74452	510	175	685
12	"12-out7331"	.51546	250	235	485
12	"12-out7332"	.63414	104	60	164
12	"12-out7333"	.29776	120	283	403
12	"12-out7334"	.27222	49	131	180
12	"12-out7335"	.53012	88	78	166
12	"12-out7336"	.87974	139	19	158
12	"12-out7337"	.99319	146	1	147
12	"12-out7338"	.47133	148	166	314
12	"12-out7339"	.26293	61	171	232
12	"12-out7340"	.30607	131	297	428
12	"12-out7341"	.76470	117	36	153
12	"12-out7342"	.43000	172	228	400
12	"12-out7343"	.48148	208	224	432
12	"12-out7344"	.42378	367	499	866
12	"12-out7345"	.46687	296	338	634
12	"12-out7346"	.43370	157	205	362
12	"12-out7347"	.27075	212	571	783
12	"12-out7348"	.45967	57	67	124
12	"12-out7349"	.06493	10	144	154
12	"12-out7350"	.33165	66	133	199
12	"12-out7351"	.28636	63	157	220
12	"12-out7352"	.50373	135	133	268
12	"12-out7353"	.43816	124	159	283
12	"12-out7354"	.66666	242	121	363
12	"12-out7355"	.47756	149	163	312
12	"12-out7356"	.47239	154	172	326
12	"12-out7357"	.37577	549	912	1461
12	"12-out7358"	.60833	73	47	120
12	"12-out7359"	.09174	10	99	109
12	"12-out7360"	.73724	578	206	784
12	"12-out7361"	.20149	269	1066	1335
12	"12-out7362"	.58730	148	104	252
12	"12-out7363"	.70417	388	163	551
12	"12-out7364"	.99596	494	2	496
12	"12-out7365"	.38170	121	196	317
12	"12-out7366"	.99494	197	1	198
12	"12-out7367"	.48809	164	172	336
12	"12-out7368"	.99047	104	1	105
12	"12-out7369"	.40601	108	158	266
12	"12-out7370"	.28388	354	893	1247
12	"12-out7371"	.45234	280	339	619
12	"12-out7372"	.51150	200	191	391
12	"12-out7373"	.79629	86	22	108
12	"12-out7374"	.37058	126	214	340
12	"12-out7375"	.32500	234	486	720
12	"12-out7376"	.32173	37	78	115
12	"12-out7377"	.44848	74	91	165
12	"12-out7378"	.29127	187	455	642
12	"12-out7379"	.93846	427	28	455
12	"12-out7380"	.99811	529	1	530
12	"12-out7381"	.55291	303	245	548
12	"12-out7382"	.33744	82	161	243
12	"12-out7383"	.11891	22	163	185
12	"12-out7384"	.65000	208	112	320
12	"12-out7385"	.44636	233	289	522
12	"12-out7386"	.99786	467	1	468
12	"12-out7387"	.44378	225	282	507
12	"12-out7388"	.30596	313	710	1023
12	"12-out7389"	.16788	46	228	274
12	"12-out7390"	.80622	233	56	289
12	"12-out7391"	.53025	184	163	347
12	"12-out7392"	.35311	119	218	337
12	"12-out7393"	.40384	126	186	312
12	"12-out7394"	.58810	514	360	874
12	"12-out7395"	.37857	53	87	140
12	"12-out7396"	.99919	1248	1	1249
12	"12-out7397"	.99880	833	1	834
12	"12-out7398"	.99918	1228	1	1229
12	"12-out7399"	.93493	273	19	292
12	"12-out7400"	.35472	105	191	296
12	"12-out7401"	.33675	164	323	487
12	"12-out7402"	.33262	628	1260	1888
12	"12-out7403"	.89603	181	21	202
12	"12-out7404"	.41854	167	232	399
12	"12-out7405"	.32997	131	266	397
12	"12-out7406"	.26777	113	309	422
12	"12-out7407"	.49747	296	299	595
12	"12-out7408"	.34748	131	246	377
12	"12-out7409"	.33353	545	1089	1634
12	"12-out7410"	.52439	172	156	328
12	"12-out7411"	.99721	358	1	359
12	"12-out7412"	.48225	231	248	479
12	"12-out7413"	.51767	249	232	481
12	"12-out7414"	.31775	170	365	535
12	"12-out7415"	.23904	120	382	502
12	"12-out7416"	.49819	415	418	833
12	"12-out7417"	.55109	151	123	274
12	"12-out7418"	.97475	811	21	832
12	"12-out7419"	.30440	242	553	795
12	"12-out7420"	.34490	159	302	461
12	"12-out7421"	.49056	312	324	636
12	"12-out7422"	.23271	138	455	593
12	"12-out7423"	.60312	193	127	320
12	"12-out7424"	.48410	396	422	818
12	"12-out7425"	.94197	487	30	517
12	"12-out7426"	.39222	333	516	849
12	"12-out7427"	.62345	101	61	162
12	"12-out7428"	.98780	162	2	164
12	"12-out7429"	.98780	162	2	164
12	"12-out7430"	.98780	162	2	164
12	"12-out7431"	.98780	162	2	164
12	"12-out7432"	.66121	566	290	856
12	"12-out7433"	.57057	384	289	673
12	"12-out7434"	.43012	237	314	551
12	"12-out7435"	.17361	125	595	720
12	"12-out7436"	.29118	350	852	1202
12	"12-out7437"	.99346	304	2	306
12	"12-out7438"	.98717	77	1	78
12	"12-out7439"	.77108	64	19	83
12	"12-out7440"	.98901	90	1	91
12	"12-out7441"	.43434	43	56	99
12	"12-out7442"	.99152	117	1	118
12	"12-out7443"	.98947	94	1	95
12	"12-out7444"	.37313	25	42	67
12	"12-out7445"	.99259	134	1	135
12	"12-out7446"	.99418	171	1	172
12	"12-out7447"	.99342	151	1	152
12	"12-out7448"	.99019	101	1	102
12	"12-out7449"	.98924	92	1	93
12	"12-out7450"	.77752	678	194	872
12	"12-out7451"	.98529	67	1	68
12	"12-out7452"	.45969	479	563	1042
12	"12-out7453"	.39750	159	241	400
12	"12-out7454"	.39709	301	457	758
12	"12-out7455"	.33714	59	116	175
12	"12-out7456"	.60915	173	111	284
12	"12-out7457"	.58419	170	121	291
12	"12-out7458"	.43975	146	186	332
12	"12-out7459"	.99864	738	1	739
12	"12-out7460"	.49269	337	347	684
12	"12-out7461"	.43131	314	414	728
12	"12-out7462"	.94405	945	56	1001
12	"12-out7463"	.28817	234	578	812
12	"12-out7464"	.37388	335	561	896
12	"12-out7465"	.36322	243	426	669
12	"12-out7466"	.43565	281	364	645
12	"12-out7467"	.43016	231	306	537
12	"12-out7468"	.49555	557	567	1124
12	"12-out7469"	.32238	108	227	335
12	"12-out7470"	.34035	97	188	285
12	"12-out7471"	.53287	154	135	289
12	"12-out7472"	.36594	101	175	276
12	"12-out7473"	.28352	74	187	261
12	"12-out7474"	.51701	547	511	1058
12	"12-out7475"	.31262	478	1051	1529
12	"12-out7476"	.43643	539	696	1235
12	"12-out7477"	.91009	820	81	901
12	"12-out7478"	.99134	573	5	578
12	"12-out7479"	.36732	335	577	912
12	"12-out7480"	.16608	142	713	855
12	"12-out7481"	.65432	159	84	243
12	"12-out7482"	.28808	104	257	361
12	"12-out7483"	.39384	243	374	617
12	"12-out7484"	.30049	61	142	203
12	"12-out7485"	.50403	125	123	248
12	"12-out7486"	.30598	138	313	451
12	"12-out7487"	.95736	247	11	258
12	"12-out7488"	.31034	117	260	377
12	"12-out7489"	.99295	141	1	142
12	"12-out7490"	1.00000	2	0	2
12	"12-out7491"	.36499	196	341	537
12	"12-out7492"	.38839	174	274	448
12	"12-out7493"	.98406	494	8	502
12	"12-out7494"	.30065	46	107	153
12	"12-out7495"	.50872	175	169	344
12	"12-out7496"	.48734	77	81	158
12	"12-out7497"	.99453	182	1	183
12	"12-out7498"	.53807	106	91	197
12	"12-out7499"	.31105	121	268	389
12	"12-out7500"	.97297	72	2	74
12	"12-out7501"	.98442	948	15	963
12	"12-out7502"	.75135	278	92	370
12	"12-out7503"	.43157	164	216	380
12	"12-out7504"	.28993	265	649	914
12	"12-out7505"	.42748	1120	1500	2620
12	"12-out7506"	.51478	470	443	913
12	"12-out7507"	.37685	355	587	942
12	"12-out7508"	.48034	391	423	814
12	"12-out7509"	.35508	370	672	1042
12	"12-out7510"	.35174	242	446	688
12	"12-out7511"	.39886	700	1055	1755
12	"12-out7512"	.32235	137	288	425
12	"12-out7513"	.43897	223	285	508
12	"12-out7514"	.42944	210	279	489
12	"12-out7515"	.93178	560	41	601
12	"12-out7516"	.32884	171	349	520
12	"12-out7517"	.77220	200	59	259
12	"12-out7518"	.35294	114	209	323
12	"12-out7519"	.25631	71	206	277
12	"12-out7520"	.97847	2500	55	2555
12	"12-out7521"	.19088	88	373	461
12	"12-out7522"	.30049	122	284	406
12	"12-out7523"	.54677	526	436	962
12	"12-out7524"	.18075	124	562	686
12	"12-out7525"	.35270	431	791	1222
12	"12-out7526"	.99519	207	1	208
12	"12-out7527"	.99778	451	1	452
12	"12-out7528"	.99678	310	1	311
12	"12-out7529"	.99834	603	1	604
12	"12-out7530"	.99285	139	1	140
12	"12-out7531"	.99453	182	1	183
12	"12-out7532"	.98924	92	1	93
12	"12-out7533"	.99346	152	1	153
12	"12-out7534"	.99386	162	1	163
12	"12-out7535"	.99551	222	1	223
12	"12-out7536"	.99567	230	1	231
12	"12-out7537"	.98734	78	1	79
12	"12-out7538"	.99728	368	1	369
12	"12-out7539"	.99280	138	1	139
12	"12-out7540"	.34227	434	834	1268
12	"12-out7541"	.31594	212	459	671
12	"12-out7542"	.28657	237	590	827
12	"12-out7543"	.72605	379	143	522
12	"12-out7544"	.99745	392	1	393
12	"12-out7545"	.99549	221	1	222
12	"12-out7546"	.55782	82	65	147
12	"12-out7547"	.80446	144	35	179
12	"12-out7548"	.86857	760	115	875
12	"12-out7549"	.40720	441	642	1083
12	"12-out7550"	.42510	210	284	494
12	"12-out7551"	.30265	171	394	565
12	"12-out7552"	.22479	136	469	605
12	"12-out7553"	.40606	549	803	1352
12	"12-out7554"	.75997	1219	385	1604
12	"12-out7555"	.30176	325	752	1077
12	"12-out7556"	.48821	497	521	1018
12	"12-out7557"	.42254	581	794	1375
12	"12-out7558"	.43091	446	589	1035
12	"12-out7559"	.31775	306	657	963
12	"12-out7560"	.29714	323	764	1087
12	"12-out7561"	.41099	441	632	1073
12	"12-out7562"	.27622	237	621	858
12	"12-out7563"	.29500	195	466	661
12	"12-out7564"	.85256	532	92	624
12	"12-out7565"	.29894	142	333	475
12	"12-out7566"	.18390	48	213	261
12	"12-out7567"	.52615	171	154	325
12	"12-out7568"	.99646	282	1	283
12	"12-out7569"	.37681	52	86	138
12	"12-out7570"	.65168	348	186	534
12	"12-out7571"	.80645	100	24	124
12	"12-out7572"	.48447	78	83	161
12	"12-out7573"	.25081	77	230	307
12	"12-out7574"	.39065	184	287	471
12	"12-out7575"	.38323	64	103	167
12	"12-out7576"	.46977	373	421	794
12	"12-out7577"	.57981	879	637	1516
12	"12-out7578"	.99691	323	1	324
12	"12-out7579"	.37587	215	357	572
12	"12-out7580"	.44723	89	110	199
12	"12-out7581"	.98947	94	1	95
12	"12-out7582"	.24000	24	76	100
12	"12-out7583"	.55319	78	63	141
12	"12-out7584"	.21052	112	420	532
12	"12-out7585"	.99545	219	1	220
12	"12-out7586"	.98550	68	1	69
12	"12-out7587"	.29158	149	362	511
12	"12-out7588"	.17073	35	170	205
12	"12-out7589"	.84098	238	45	283
12	"12-out7590"	.52304	1963	1790	3753
12	"12-out7591"	1.00000	156	0	156
12	"12-out7592"	.37763	233	384	617
12	"12-out7593"	.99610	256	1	257
12	"12-out7594"	.28159	127	324	451
12	"12-out7595"	.38636	85	135	220
12	"12-out7596"	.26470	108	300	408
12	"12-out7597"	.41666	135	189	324
12	"12-out7598"	.33653	70	138	208
12	"12-out7599"	.42410	95	129	224
12	"12-out7600"	.99373	317	2	319
12	"12-out7601"	.54572	185	154	339
12	"12-out7602"	.45679	148	176	324
12	"12-out7603"	.63030	104	61	165
12	"12-out7604"	.21634	45	163	208
12	"12-out7605"	.40459	176	259	435
12	"12-out7606"	.33333	117	234	351
12	"12-out7607"	.29694	68	161	229
12	"12-out7608"	.58914	76	53	129
12	"12-out7609"	.40690	271	395	666
12	"12-out7610"	.54085	278	236	514
12	"12-out7611"	.32352	44	92	136
12	"12-out7612"	.28741	121	300	421
12	"12-out7613"	.42592	69	93	162
12	"12-out7614"	.31403	179	391	570
12	"12-out7615"	.35000	84	156	240
12	"12-out7616"	.47387	263	292	555
12	"12-out7617"	.46206	67	78	145
12	"12-out7618"	.57986	167	121	288
12	"12-out7619"	.96059	195	8	203
12	"12-out7620"	.37400	141	236	377
12	"12-out7621"	.42261	142	194	336
12	"12-out7622"	.53846	84	72	156
12	"12-out7623"	.99595	246	1	247
12	"12-out7624"	.63535	115	66	181
12	"12-out7625"	.66926	601	297	898
12	"12-out7626"	.25418	228	669	897
12	"12-out7627"	.30320	104	239	343
12	"12-out7628"	.44912	128	157	285
12	"12-out7629"	.33464	85	169	254
12	"12-out7630"	.41666	115	161	276
12	"12-out7631"	.25959	284	810	1094
12	"12-out7632"	.41197	344	491	835
12	"12-out7633"	.28422	164	413	577
12	"12-out7634"	.40196	205	305	510
12	"12-out7635"	.51151	311	297	608
12	"12-out7636"	.45550	476	569	1045
12	"12-out7637"	.27372	274	727	1001
12	"12-out7638"	.38709	72	114	186
12	"12-out7639"	.81964	509	112	621
12	"12-out7640"	.58039	444	321	765
12	"12-out7641"	.99285	139	1	140
12	"12-out7642"	.46961	85	96	181
12	"12-out7643"	.36916	728	1244	1972
12	"12-out7644"	.99285	139	1	140
12	"12-out7645"	.46341	665	770	1435
12	"12-out7646"	.35491	159	289	448
12	"12-out7647"	.99616	520	2	522
12	"12-out7648"	.24128	277	871	1148
12	"12-out7649"	.99428	174	1	175
12	"12-out7650"	.78756	304	82	386
12	"12-out7651"	.39852	216	326	542
12	"12-out7652"	.99107	111	1	112
12	"12-out7653"	.99082	108	1	109
12	"12-out7654"	.99107	111	1	112
12	"12-out7655"	.99115	112	1	113
12	"12-out7656"	.99107	111	1	112
12	"12-out7657"	.99122	113	1	114
12	"12-out7658"	.99047	104	1	105
12	"12-out7659"	.98214	110	2	112
12	"12-out7660"	.99082	108	1	109
12	"12-out7661"	.98165	107	2	109
12	"12-out7662"	.99159	118	1	119
12	"12-out7663"	.99115	112	1	113
12	"12-out7664"	.99115	112	1	113
12	"12-out7665"	.99122	113	1	114
12	"12-out7666"	.99115	112	1	113
12	"12-out7667"	.99107	111	1	112
12	"12-out7668"	.99122	113	1	114
12	"12-out7669"	.99130	114	1	115
12	"12-out7670"	.99082	108	1	109
12	"12-out7671"	.99193	123	1	124
12	"12-out7672"	.98260	113	2	115
12	"12-out7673"	.99099	110	1	111
12	"12-out7674"	.99130	114	1	115
12	"12-out7675"	.99122	113	1	114
12	"12-out7676"	.99130	114	1	115
12	"12-out7677"	.99099	110	1	111
12	"12-out7678"	.99122	113	1	114
12	"12-out7679"	.99122	113	1	114
12	"12-out7680"	.99122	113	1	114
12	"12-out7681"	.99122	113	1	114
12	"12-out7682"	.99122	113	1	114
12	"12-out7683"	.63141	197	115	312
12	"12-out7684"	.56462	332	256	588
12	"12-out7685"	.40350	276	408	684
12	"12-out7686"	.80385	250	61	311
12	"12-out7687"	.99659	293	1	294
12	"12-out7688"	.93666	488	33	521
12	"12-out7689"	.64734	134	73	207
12	"12-out7690"	.20190	106	419	525
12	"12-out7691"	.62776	199	118	317
12	"12-out7692"	.30335	344	790	1134
12	"12-out7693"	.37442	164	274	438
12	"12-out7694"	.48823	83	87	170
12	"12-out7695"	.30225	94	217	311
12	"12-out7696"	.26857	141	384	525
12	"12-out7697"	.99746	394	1	395
12	"12-out7698"	.23735	122	392	514
12	"12-out7699"	.99719	356	1	357
12	"12-out7700"	.98203	492	9	501
12	"12-out7701"	.70119	176	75	251
12	"12-out7702"	.35833	301	539	840
12	"12-out7703"	1.00000	156	0	156
12	"12-out7704"	.56862	116	88	204
12	"12-out7705"	.45275	230	278	508
12	"12-out7706"	.85161	132	23	155
12	"12-out7707"	.94957	113	6	119
12	"12-out7708"	.96713	206	7	213
12	"12-out7709"	.60344	175	115	290
12	"12-out7710"	.54957	194	159	353
12	"12-out7711"	.99009	100	1	101
12	"12-out7712"	.43653	227	293	520
12	"12-out7713"	.69724	228	99	327
12	"12-out7714"	.44210	126	159	285
12	"12-out7715"	1.00000	156	0	156
12	"12-out7716"	1.00000	156	0	156
12	"12-out7717"	.58947	168	117	285
12	"12-out7718"	.32162	174	367	541
12	"12-out7719"	.62017	289	177	466
12	"12-out7720"	.46641	243	278	521
12	"12-out7721"	.91304	189	18	207
12	"12-out7722"	.50226	111	110	221
12	"12-out7723"	.42324	193	263	456
12	"12-out7724"	.29304	354	854	1208
12	"12-out7725"	.34581	351	664	1015
12	"12-out7726"	.45625	339	404	743
12	"12-out7727"	.31088	240	532	772
12	"12-out7728"	.86292	661	105	766
12	"12-out7729"	.42105	176	242	418
12	"12-out7730"	.29092	263	641	904
12	"12-out7731"	.32093	69	146	215
12	"12-out7732"	.99122	113	1	114
12	"12-out7733"	.32000	40	85	125
12	"12-out7734"	.27835	54	140	194
12	"12-out7735"	.95238	100	5	105
12	"12-out7736"	.45789	174	206	380
12	"12-out7737"	.57651	162	119	281
12	"12-out7738"	.41603	109	153	262
12	"12-out7739"	.42105	112	154	266
12	"12-out7740"	.87214	191	28	219
12	"12-out7741"	.43678	152	196	348
12	"12-out7742"	.40316	102	151	253
12	"12-out7743"	.54798	177	146	323
12	"12-out7744"	.99661	589	2	591
12	"12-out7745"	.99844	641	1	642
12	"12-out7746"	.34955	158	294	452
12	"12-out7747"	.46697	205	234	439
12	"12-out7748"	.47382	905	1005	1910
12	"12-out7749"	.34108	44	85	129
12	"12-out7750"	.31279	66	145	211
12	"12-out7751"	.26889	306	832	1138
12	"12-out7752"	.47875	293	319	612
12	"12-out7753"	.49238	517	533	1050
12	"12-out7754"	.28496	163	409	572
12	"12-out7755"	.99773	440	1	441
12	"12-out7756"	.39644	134	204	338
12	"12-out7757"	.62348	308	186	494
12	"12-out7758"	.54623	443	368	811
12	"12-out7759"	.60305	474	312	786
12	"12-out7760"	.53316	418	366	784
12	"12-out7761"	.25201	125	371	496
12	"12-out7762"	.45736	59	70	129
12	"12-out7763"	.94326	399	24	423
12	"12-out7764"	.50228	220	218	438
12	"12-out7765"	.58125	93	67	160
12	"12-out7766"	.40315	281	416	697
12	"12-out7767"	.30000	105	245	350
12	"12-out7768"	.24242	24	75	99
12	"12-out7769"	.57303	102	76	178
12	"12-out7770"	.49367	156	160	316
12	"12-out7771"	.27745	48	125	173
12	"12-out7772"	.26737	150	411	561
12	"12-out7773"	.46408	168	194	362
12	"12-out7774"	.99574	234	1	235
12	"12-out7775"	.47297	140	156	296
12	"12-out7776"	.76000	228	72	300
12	"12-out7777"	.99740	384	1	385
12	"12-out7778"	.26086	42	119	161
12	"12-out7779"	.27777	170	442	612
12	"12-out7780"	.37681	78	129	207
12	"12-out7781"	.35897	98	175	273
12	"12-out7782"	.40265	91	135	226
12	"12-out7783"	.30841	33	74	107
12	"12-out7784"	.36315	276	484	760
12	"12-out7785"	.39272	108	167	275
12	"12-out7786"	.38090	419	681	1100
12	"12-out7787"	.34690	230	433	663
12	"12-out7788"	.55639	74	59	133
12	"12-out7789"	.45412	292	351	643
12	"12-out7790"	.38211	188	304	492
12	"12-out7791"	.24242	56	175	231
12	"12-out7792"	.40707	92	134	226
12	"12-out7793"	.57081	133	100	233
12	"12-out7794"	.46747	115	131	246
12	"12-out7795"	.59119	94	65	159
12	"12-out7796"	.30819	94	211	305
12	"12-out7797"	.49285	69	71	140
12	"12-out7798"	.45597	290	346	636
12	"12-out7799"	.40597	136	199	335
12	"12-out7800"	.95862	139	6	145
12	"12-out7801"	.43892	672	859	1531
12	"12-out7802"	.39139	191	297	488
12	"12-out7803"	.33121	417	842	1259
12	"12-out7804"	.97142	238	7	245
12	"12-out7805"	.28235	48	122	170
12	"12-out7806"	.58098	165	119	284
12	"12-out7807"	.30961	161	359	520
12	"12-out7808"	.41176	182	260	442
12	"12-out7809"	.99122	113	1	114
12	"12-out7810"	.99122	113	1	114
12	"12-out7811"	.99122	113	1	114
12	"12-out7812"	.99899	992	1	993
12	"12-out7813"	.37096	46	78	124
12	"12-out7814"	.30102	59	137	196
12	"12-out7815"	.51757	162	151	313
12	"12-out7816"	.99295	141	1	142
12	"12-out7817"	.56484	466	359	825
12	"12-out7818"	.28861	71	175	246
12	"12-out7819"	.80000	192	48	240
12	"12-out7820"	.45507	233	279	512
12	"12-out7821"	.80722	67	16	83
12	"12-out7822"	.39220	171	265	436
12	"12-out7823"	.99000	99	1	100
12	"12-out7824"	.41739	48	67	115
12	"12-out7825"	.29107	62	151	213
12	"12-out7826"	.17989	34	155	189
12	"12-out7827"	.33744	82	161	243
12	"12-out7828"	.28429	201	506	707
12	"12-out7829"	.98319	117	2	119
12	"12-out7830"	.61016	72	46	118
12	"12-out7831"	.46093	59	69	128
12	"12-out7832"	.29722	107	253	360
12	"12-out7833"	.93251	152	11	163
12	"12-out7834"	.50588	86	84	170
12	"12-out7835"	.54268	89	75	164
12	"12-out7836"	.34934	160	298	458
12	"12-out7837"	.21753	67	241	308
12	"12-out7838"	.98437	63	1	64
12	"12-out7839"	.43650	385	497	882
12	"12-out7840"	.32057	268	568	836
12	"12-out7841"	.39908	87	131	218
12	"12-out7842"	.54517	175	146	321
12	"12-out7843"	.99256	267	2	269
12	"12-out7844"	.38947	185	290	475
12	"12-out7845"	.42704	120	161	281
12	"12-out7846"	.36683	73	126	199
12	"12-out7847"	.21354	41	151	192
12	"12-out7848"	.43333	130	170	300
12	"12-out7849"	.53921	110	94	204
12	"12-out7850"	.35714	150	270	420
12	"12-out7851"	.23744	52	167	219
12	"12-out7852"	.30813	53	119	172
12	"12-out7853"	.22147	33	116	149
12	"12-out7854"	.21022	111	417	528
12	"12-out7855"	.40131	244	364	608
12	"12-out7856"	.65151	344	184	528
12	"12-out7857"	.90707	205	21	226
12	"12-out7858"	.70731	87	36	123
12	"12-out7859"	.38535	200	319	519
12	"12-out7860"	.98666	74	1	75
12	"12-out7861"	.99350	153	1	154
12	"12-out7862"	.84827	123	22	145
12	"12-out7863"	.27902	298	770	1068
12	"12-out7864"	.39112	97	151	248
12	"12-out7865"	.94684	285	16	301
12	"12-out7866"	.99137	115	1	116
12	"12-out7867"	.34536	67	127	194
12	"12-out7868"	.95077	734	38	772
12	"12-out7869"	.39069	84	131	215
12	"12-out7870"	.47402	365	405	770
12	"12-out7871"	.37121	98	166	264
12	"12-out7872"	.47393	100	111	211
12	"12-out7873"	.34259	74	142	216
12	"12-out7874"	.52432	97	88	185
12	"12-out7875"	.60176	68	45	113
12	"12-out7876"	.72852	212	79	291
12	"12-out7877"	.31188	63	139	202
12	"12-out7878"	.50284	442	437	879
12	"12-out7879"	.32754	132	271	403
12	"12-out7880"	.99543	218	1	219
12	"12-out7881"	.71518	226	90	316
12	"12-out7882"	.99280	138	1	139
12	"12-out7883"	.66816	149	74	223
12	"12-out7884"	.38709	84	133	217
12	"12-out7885"	.44036	48	61	109
12	"12-out7886"	.38738	215	340	555
12	"12-out7887"	.19148	45	190	235
12	"12-out7888"	.62420	98	59	157
12	"12-out7889"	.66723	393	196	589
12	"12-out7890"	.27721	219	571	790
12	"12-out7891"	.66831	135	67	202
12	"12-out7892"	.99047	208	2	210
12	"12-out7893"	.45733	209	248	457
12	"12-out7894"	.35245	86	158	244
12	"12-out7895"	.48895	155	162	317
12	"12-out7896"	.99645	281	1	282
12	"12-out7897"	.25136	46	137	183
12	"12-out7898"	.79642	223	57	280
12	"12-out7899"	.68408	288	133	421
12	"12-out7900"	.27840	49	127	176
12	"12-out7901"	.49819	138	139	277
12	"12-out7902"	.48837	126	132	258
12	"12-out7903"	.99638	276	1	277
12	"12-out7904"	.36324	85	149	234
12	"12-out7905"	.34533	633	1200	1833
12	"12-out7906"	.69294	167	74	241
12	"12-out7907"	.34492	119	226	345
12	"12-out7908"	.37802	172	283	455
12	"12-out7909"	.34707	160	301	461
12	"12-out7910"	.32549	83	172	255
12	"12-out7911"	.47002	196	221	417
12	"12-out7912"	.90540	67	7	74
12	"12-out7913"	.42071	130	179	309
12	"12-out7914"	.98337	355	6	361
12	"12-out7915"	.55392	452	364	816
12	"12-out7916"	.29017	65	159	224
12	"12-out7917"	.85029	142	25	167
12	"12-out7918"	.74137	215	75	290
12	"12-out7919"	.41379	60	85	145
12	"12-out7920"	.42488	1004	1359	2363
12	"12-out7921"	.87500	217	31	248
12	"12-out7922"	.59634	424	287	711
12	"12-out7923"	.40696	304	443	747
12	"12-out7924"	.70656	183	76	259
12	"12-out7925"	1.00000	153	0	153
12	"12-out7926"	.42592	184	248	432
12	"12-out7927"	.29393	97	233	330
12	"12-out7928"	.64566	82	45	127
12	"12-out7929"	.97727	43	1	44
12	"12-out7930"	.96946	127	4	131
12	"12-out7931"	.40707	46	67	113
12	"12-out7932"	.50105	238	237	475
12	"12-out7933"	.80000	192	48	240
12	"12-out7934"	.42519	162	219	381
12	"12-out7935"	.60340	461	303	764
12	"12-out7936"	.46652	216	247	463
12	"12-out7937"	.34567	140	265	405
12	"12-out7938"	.67912	218	103	321
12	"12-out7939"	.39500	79	121	200
12	"12-out7940"	.99019	101	1	102
12	"12-out7941"	.32407	175	365	540
12	"12-out7942"	.58119	68	49	117
12	"12-out7943"	.99363	156	1	157
12	"12-out7944"	.65517	114	60	174
12	"12-out7945"	.80821	59	14	73
12	"12-out7946"	.34066	449	869	1318
12	"12-out7947"	.41005	465	669	1134
12	"12-out7948"	.27578	238	625	863
12	"12-out7949"	.39123	527	820	1347
12	"12-out7950"	.56815	446	339	785
12	"12-out7951"	.88972	710	88	798
12	"12-out7952"	.43221	424	557	981
12	"12-out7953"	.40379	426	629	1055
12	"12-out7954"	.92204	343	29	372
12	"12-out7955"	.41765	1481	2065	3546
12	"12-out7956"	.34894	462	862	1324
12	"12-out7957"	.51843	478	444	922
12	"12-out7958"	.99738	381	1	382
12	"12-out7959"	.44285	62	78	140
12	"12-out7960"	.12222	22	158	180
12	"12-out7961"	.99275	137	1	138
12	"12-out7962"	.75994	554	175	729
12	"12-out7963"	.50364	828	816	1644
12	"12-out7964"	.40033	472	707	1179
12	"12-out7965"	.99512	204	1	205
12	"12-out7966"	.99122	113	1	114
12	"12-out7967"	.99074	107	1	108
12	"12-out7968"	.99056	105	1	106
12	"12-out7969"	.99107	111	1	112
12	"12-out7970"	.99107	111	1	112
12	"12-out7971"	.99137	115	1	116
12	"12-out7972"	.99107	111	1	112
12	"12-out7973"	.99090	109	1	110
12	"12-out7974"	.99082	108	1	109
12	"12-out7975"	.99242	131	1	132
12	"12-out7976"	.99115	112	1	113
12	"12-out7977"	.99115	112	1	113
12	"12-out7978"	.99130	114	1	115
12	"12-out7979"	.99107	111	1	112
12	"12-out7980"	.99107	111	1	112
12	"12-out7981"	.99130	114	1	115
12	"12-out7982"	.99107	111	1	112
12	"12-out7983"	.99115	112	1	113
12	"12-out7984"	.99082	108	1	109
12	"12-out7985"	.99130	114	1	115
12	"12-out7986"	.99130	114	1	115
12	"12-out7987"	.99130	114	1	115
12	"12-out7988"	.99130	114	1	115
12	"12-out7989"	.99130	114	1	115
12	"12-out7990"	.99122	113	1	114
12	"12-out7991"	.99099	110	1	111
12	"12-out7992"	.99122	113	1	114
12	"12-out7993"	.99122	113	1	114
12	"12-out7994"	.99122	113	1	114
12	"12-out7995"	.99122	113	1	114
12	"12-out7996"	.99859	713	1	714
12	"12-out7997"	.34954	230	428	658
12	"12-out7998"	.97727	43	1	44
12	"12-out7999"	.56353	204	158	362
12	"12-out8000"	.56890	322	244	566
12	"12-out16001"	.40173	139	207	346
12	"12-out16002"	.50000	128	128	256
12	"12-out16003"	.61280	383	242	625
12	"12-out16004"	.29096	103	251	354
12	"12-out16005"	.29508	180	430	610
12	"12-out16006"	.38320	146	235	381
12	"12-out16007"	.39265	139	215	354
12	"12-out16008"	.98795	82	1	83
12	"12-out16009"	.33802	120	235	355
12	"12-out16010"	.21406	70	257	327
12	"12-out16011"	.82534	241	51	292
12	"12-out16012"	.32608	180	372	552
12	"12-out16013"	.47243	437	488	925
12	"12-out16014"	.99841	631	1	632
12	"12-out16015"	.99841	631	1	632
12	"12-out16016"	.78832	108	29	137
12	"12-out16017"	.80131	367	91	458
12	"12-out16018"	.48831	209	219	428
12	"12-out16019"	.28476	172	432	604
12	"12-out16020"	.91724	399	36	435
12	"12-out16021"	.36136	159	281	440
12	"12-out16022"	.36168	353	623	976
12	"12-out16023"	.92906	406	31	437
12	"12-out16024"	.42857	246	328	574
12	"12-out16025"	.26076	109	309	418
12	"12-out16026"	.54154	189	160	349
12	"12-out16027"	.32027	139	295	434
12	"12-out16028"	.46791	175	199	374
12	"12-out16029"	.57456	262	194	456
12	"12-out16030"	.60887	288	185	473
12	"12-out16031"	.56690	161	123	284
12	"12-out16032"	.44482	258	322	580
12	"12-out16033"	.33628	304	600	904
12	"12-out16034"	.43956	120	153	273
12	"12-out16035"	.88888	232	29	261
12	"12-out16036"	.21261	118	437	555
12	"12-out16037"	.38876	360	566	926
12	"12-out16038"	.50000	112	112	224
12	"12-out16039"	.28447	295	742	1037
12	"12-out16040"	.29536	306	730	1036
12	"12-out16041"	.22169	47	165	212
12	"12-out16042"	.43413	613	799	1412
12	"12-out16043"	.64625	95	52	147
12	"12-out16044"	.36516	130	226	356
12	"12-out16045"	.32850	272	556	828
12	"12-out16046"	.24137	70	220	290
12	"12-out16047"	.99874	794	1	795
12	"12-out16048"	.57614	401	295	696
12	"12-out16049"	.64781	355	193	548
12	"12-out16050"	.99047	104	1	105
12	"12-out16051"	.37572	130	216	346
12	"12-out16052"	.53002	256	227	483
12	"12-out16053"	.25949	123	351	474
12	"12-out16054"	.38315	182	293	475
12	"12-out16055"	.59829	280	188	468
12	"12-out16056"	.70120	406	173	579
12	"12-out16057"	.46038	215	252	467
12	"12-out16058"	.32009	129	274	403
12	"12-out16059"	.30839	136	305	441
12	"12-out16060"	.45464	421	505	926
12	"12-out16061"	.42857	174	232	406
12	"12-out16062"	.76343	810	251	1061
12	"12-out16063"	.83687	354	69	423
12	"12-out16064"	.21478	93	340	433
12	"12-out16065"	.99790	476	1	477
12	"12-out16066"	.50345	364	359	723
12	"12-out16067"	.61006	194	124	318
12	"12-out16068"	.43497	97	126	223
12	"12-out16069"	.35869	66	118	184
12	"12-out16070"	.97540	833	21	854
12	"12-out16071"	.99549	221	1	222
12	"12-out16072"	.34285	204	391	595
12	"12-out16073"	.27507	96	253	349
12	"12-out16074"	.38353	219	352	571
12	"12-out16075"	.70782	407	168	575
12	"12-out16076"	.30496	86	196	282
12	"12-out16077"	.18206	201	903	1104
12	"12-out16078"	.53311	491	430	921
12	"12-out16079"	.24379	216	670	886
12	"12-out16080"	.72246	669	257	926
12	"12-out16081"	.98305	58	1	59
12	"12-out16082"	.98305	58	1	59
12	"12-out16083"	.98305	58	1	59
12	"12-out16084"	.57357	191	142	333
12	"12-out16085"	.29335	181	436	617
12	"12-out16086"	.75555	68	22	90
12	"12-out16087"	.49212	125	129	254
12	"12-out16088"	.21315	94	347	441
12	"12-out16089"	.55555	245	196	441
12	"12-out16090"	.28571	62	155	217
12	"12-out16091"	.61212	101	64	165
12	"12-out16092"	.52455	235	213	448
12	"12-out16093"	.30769	128	288	416
12	"12-out16094"	.56019	228	179	407
12	"12-out16095"	.31991	159	338	497
12	"12-out16096"	.46696	212	242	454
12	"12-out16097"	.31565	381	826	1207
12	"12-out16098"	.36338	262	459	721
12	"12-out16099"	.29457	114	273	387
12	"12-out16100"	.52991	310	275	585
12	"12-out16101"	.37641	233	386	619
12	"12-out16102"	.23719	88	283	371
12	"12-out16103"	.64748	180	98	278
12	"12-out16104"	.60686	230	149	379
12	"12-out16105"	.26523	161	446	607
12	"12-out16106"	.35104	185	342	527
12	"12-out16107"	.38957	254	398	652
12	"12-out16108"	.42546	137	185	322
12	"12-out16109"	.55102	162	132	294
12	"12-out16110"	.42665	637	856	1493
12	"12-out16111"	.41161	163	233	396
12	"12-out16112"	.28669	375	933	1308
12	"12-out16113"	.33177	71	143	214
12	"12-out16114"	.30244	173	399	572
12	"12-out16115"	.99559	226	1	227
12	"12-out16116"	.74734	633	214	847
12	"12-out16117"	.42112	299	411	710
12	"12-out16118"	.34666	130	245	375
12	"12-out16119"	.50873	437	422	859
12	"12-out16120"	.35125	196	362	558
12	"12-out16121"	.43184	396	521	917
12	"12-out16122"	.28837	62	153	215
12	"12-out16123"	.27081	283	762	1045
12	"12-out16124"	.30340	1392	3196	4588
12	"12-out16125"	.27645	1377	3604	4981
12	"12-out16126"	.46197	164	191	355
12	"12-out16127"	.31005	111	247	358
12	"12-out16128"	.35816	125	224	349
12	"12-out16129"	.40415	175	258	433
12	"12-out16130"	.44571	505	628	1133
12	"12-out16131"	.43385	305	398	703
12	"12-out16132"	.35050	415	769	1184
12	"12-out16133"	.25056	111	332	443
12	"12-out16134"	.49844	160	161	321
12	"12-out16135"	.47972	142	154	296
12	"12-out16136"	.50706	359	349	708
12	"12-out16137"	.99642	279	1	280
12	"12-out16138"	.23261	97	320	417
12	"12-out16139"	.34883	30	56	86
12	"12-out16140"	.89077	367	45	412
12	"12-out16141"	.33215	188	378	566
12	"12-out16142"	.36774	1033	1776	2809
12	"12-out16143"	.33571	47	93	140
12	"12-out16144"	.38347	232	373	605
12	"12-out16145"	.34449	216	411	627
12	"12-out16146"	.50588	43	42	85
12	"12-out16147"	.77343	792	232	1024
12	"12-out16148"	.32812	42	86	128
12	"12-out16149"	.79545	105	27	132
12	"12-out16150"	.41666	55	77	132
12	"12-out16151"	.27118	48	129	177
12	"12-out16152"	.60555	109	71	180
12	"12-out16153"	.31051	127	282	409
12	"12-out16154"	.31034	99	220	319
12	"12-out16155"	.83146	296	60	356
12	"12-out16156"	.99699	332	1	333
12	"12-out16157"	.33940	149	290	439
12	"12-out16158"	.35675	198	357	555
12	"12-out16159"	.48228	177	190	367
12	"12-out16160"	.91482	290	27	317
12	"12-out16161"	.29411	130	312	442
12	"12-out16162"	.27424	82	217	299
12	"12-out16163"	.50742	444	431	875
12	"12-out16164"	.56000	154	121	275
12	"12-out16165"	.34846	215	402	617
12	"12-out16166"	.33514	123	244	367
12	"12-out16167"	.41884	160	222	382
12	"12-out16168"	.71428	170	68	238
12	"12-out16169"	.31887	125	267	392
12	"12-out16170"	.35171	338	623	961
12	"12-out16171"	.36641	240	415	655
12	"12-out16172"	.50000	44	44	88
12	"12-out16173"	.37219	83	140	223
12	"12-out16174"	.99305	286	2	288
12	"12-out16175"	.38941	206	323	529
12	"12-out16176"	.34285	360	690	1050
12	"12-out16177"	.81898	837	185	1022
12	"12-out16178"	.35439	129	235	364
12	"12-out16179"	.43380	213	278	491
12	"12-out16180"	.46785	131	149	280
12	"12-out16181"	.16346	34	174	208
12	"12-out16182"	.40648	326	476	802
12	"12-out16183"	.51141	112	107	219
12	"12-out16184"	.27751	58	151	209
12	"12-out16185"	.93129	3782	279	4061
12	"12-out16186"	.42369	186	253	439
12	"12-out16187"	.99295	141	1	142
12	"12-out16188"	.25735	70	202	272
12	"12-out16189"	.36410	142	248	390
12	"12-out16190"	.57142	100	75	175
12	"12-out16191"	.98734	78	1	79
12	"12-out16192"	.53288	397	348	745
12	"12-out16193"	.99450	181	1	182
12	"12-out16194"	.99275	137	1	138
12	"12-out16195"	.99242	131	1	132
12	"12-out16196"	.50270	93	92	185
12	"12-out16197"	.80487	165	40	205
12	"12-out16198"	.43712	219	282	501
12	"12-out16199"	.82278	65	14	79
12	"12-out16200"	.40000	98	147	245
12	"12-out16201"	.34660	235	443	678
12	"12-out16202"	.34962	236	439	675
12	"12-out16203"	.66176	45	23	68
12	"12-out16204"	.31578	150	325	475
12	"12-out16205"	.52678	59	53	112
12	"12-out16206"	.43333	299	391	690
12	"12-out16207"	.25000	166	498	664
12	"12-out16208"	.42355	1097	1493	2590
12	"12-out16209"	.42713	340	456	796
12	"12-out16210"	.34552	170	322	492
12	"12-out16211"	.66078	487	250	737
12	"12-out16212"	.40600	311	455	766
12	"12-out16213"	.40693	352	513	865
12	"12-out16214"	.25055	225	673	898
12	"12-out16215"	.24333	210	653	863
12	"12-out16216"	.99664	297	1	298
12	"12-out16217"	.99371	158	1	159
12	"12-out16218"	.76315	232	72	304
12	"12-out16219"	.81896	95	21	116
12	"12-out16220"	.84816	162	29	191
12	"12-out16221"	.81445	338	77	415
12	"12-out16222"	.41075	168	241	409
12	"12-out16223"	.98989	98	1	99
12	"12-out16224"	.36780	377	648	1025
12	"12-out16225"	.29370	168	404	572
12	"12-out16226"	.30594	175	397	572
12	"12-out16227"	.24912	142	428	570
12	"12-out16228"	.75699	433	139	572
12	"12-out16229"	.32978	186	378	564
12	"12-out16230"	.98872	263	3	266
12	"12-out16231"	.99248	264	2	266
12	"12-out16232"	.98872	263	3	266
12	"12-out16233"	.56124	252	197	449
12	"12-out16234"	.39172	322	500	822
12	"12-out16235"	.42702	316	424	740
12	"12-out16236"	.47107	228	256	484
12	"12-out16237"	.18929	99	424	523
12	"12-out16238"	.42259	202	276	478
12	"12-out16239"	.41317	207	294	501
12	"12-out16240"	.40136	295	440	735
12	"12-out16241"	.36613	320	554	874
12	"12-out16242"	.56133	151	118	269
12	"12-out16243"	.41083	182	261	443
12	"12-out16244"	.28026	125	321	446
12	"12-out16245"	.23024	102	341	443
12	"12-out16246"	.29500	118	282	400
12	"12-out16247"	.75160	351	116	467
12	"12-out16248"	.87421	417	60	477
12	"12-out16249"	.46533	302	347	649
12	"12-out16250"	.93460	343	24	367
12	"12-out16251"	.18406	67	297	364
12	"12-out16252"	.52851	139	124	263
12	"12-out16253"	.85152	195	34	229
12	"12-out16254"	.13230	43	282	325
12	"12-out16255"	.50961	159	153	312
12	"12-out16256"	.96276	181	7	188
12	"12-out16257"	.05050	10	188	198
12	"12-out16258"	.99248	132	1	133
12	"12-out16259"	.97058	33	1	34
12	"12-out16260"	.46438	163	188	351
12	"12-out16261"	.66847	123	61	184
12	"12-out16262"	.66000	99	51	150
12	"12-out16263"	.07582	16	195	211
12	"12-out16264"	.43523	504	654	1158
12	"12-out16265"	.78977	139	37	176
12	"12-out16266"	.96825	61	2	63
12	"12-out16267"	.26977	133	360	493
12	"12-out16268"	.94927	262	14	276
12	"12-out16269"	.45609	187	223	410
12	"12-out16270"	.41789	1336	1861	3197
12	"12-out16271"	.81343	109	25	134
12	"12-out16272"	.36879	208	356	564
12	"12-out16273"	.22380	173	600	773
12	"12-out16274"	.32793	81	166	247
12	"12-out16275"	.92047	463	40	503
12	"12-out16276"	.97368	74	2	76
12	"12-out16277"	.99532	213	1	214
12	"12-out16278"	.77560	159	46	205
12	"12-out16279"	.51361	283	268	551
12	"12-out16280"	.99939	1654	1	1655
12	"12-out16281"	.35309	131	240	371
12	"12-out16282"	.51495	155	146	301
12	"12-out16283"	.20792	63	240	303
12	"12-out16284"	.29714	323	764	1087
12	"12-out16285"	.54487	85	71	156
12	"12-out16286"	.99099	110	1	111
12	"12-out16287"	.37500	294	490	784
12	"12-out16288"	.40277	58	86	144
12	"12-out16289"	.32005	450	956	1406
12	"12-out16290"	.20571	36	139	175
12	"12-out16291"	.42491	249	337	586
12	"12-out16292"	.99720	357	1	358
12	"12-out16293"	.99082	108	1	109
12	"12-out16294"	.40487	266	391	657
12	"12-out16295"	.35694	131	236	367
12	"12-out16296"	.61699	559	347	906
12	"12-out16297"	.36056	256	454	710
12	"12-out16298"	.52062	467	430	897
12	"12-out16299"	.42401	279	379	658
12	"12-out16300"	.37939	151	247	398
12	"12-out16301"	.37878	100	164	264
12	"12-out16302"	.33793	685	1342	2027
12	"12-out16303"	.99324	147	1	148
12	"12-out16304"	.31479	300	653	953
12	"12-out16305"	.32564	254	526	780
12	"12-out16306"	.44943	80	98	178
12	"12-out16307"	.31755	389	836	1225
12	"12-out16308"	.39045	663	1035	1698
12	"12-out16309"	.99563	228	1	229
12	"12-out16310"	.45882	195	230	425
12	"12-out16311"	.99771	436	1	437
12	"12-out16312"	.35198	302	556	858
12	"12-out16313"	.41732	53	74	127
12	"12-out16314"	.37423	61	102	163
12	"12-out16315"	.44055	252	320	572
12	"12-out16316"	.79445	773	200	973
12	"12-out16317"	.50303	249	246	495
12	"12-out16318"	.99828	583	1	584
12	"12-out16319"	.99810	526	1	527
12	"12-out16320"	.73684	294	105	399
12	"12-out16321"	.43544	172	223	395
12	"12-out16322"	.61137	129	82	211
12	"12-out16323"	.48936	46	48	94
12	"12-out16324"	.49843	159	160	319
12	"12-out16325"	.57392	361	268	629
12	"12-out16326"	.34177	27	52	79
12	"12-out16327"	.99452	363	2	365
12	"12-out16328"	.98952	378	4	382
12	"12-out16329"	.97526	276	7	283
12	"12-out16330"	.49122	56	58	114
12	"12-out16331"	.46875	60	68	128
12	"12-out16332"	.29595	95	226	321
12	"12-out16333"	.64597	281	154	435
12	"12-out16334"	.42135	217	298	515
12	"12-out16335"	.22443	79	273	352
12	"12-out16336"	.31818	63	135	198
12	"12-out16337"	.88805	119	15	134
12	"12-out16338"	.99561	227	1	228
12	"12-out16339"	.97307	506	14	520
12	"12-out16340"	.48157	549	591	1140
12	"12-out16341"	.58283	292	209	501
12	"12-out16342"	.49947	3781	3789	7570
12	"12-out16343"	.99801	504	1	505
12	"12-out16344"	.47327	363	404	767
12	"12-out16345"	.33651	247	487	734
12	"12-out16346"	.97472	617	16	633
12	"12-out16347"	.86454	434	68	502
12	"12-out16348"	.98245	56	1	57
12	"12-out16349"	.59469	1121	764	1885
12	"12-out16350"	.28623	156	389	545
12	"12-out16351"	.31961	233	496	729
12	"12-out16352"	.13888	35	217	252
12	"12-out16353"	.34807	181	339	520
12	"12-out16354"	.62255	287	174	461
12	"12-out16355"	.45012	176	215	391
12	"12-out16356"	.38329	537	864	1401
12	"12-out16357"	.31338	199	436	635
12	"12-out16358"	.45509	299	358	657
12	"12-out16359"	.48849	573	600	1173
12	"12-out16360"	.32871	190	388	578
12	"12-out16361"	.35300	329	603	932
12	"12-out16362"	.43817	489	627	1116
12	"12-out16363"	.48580	462	489	951
12	"12-out16364"	.31837	369	790	1159
12	"12-out16365"	.31000	62	138	200
12	"12-out16366"	.44791	215	265	480
12	"12-out16367"	.81115	378	88	466
12	"12-out16368"	.33553	558	1105	1663
12	"12-out16369"	.43867	93	119	212
12	"12-out16370"	.44277	325	409	734
12	"12-out16371"	.99280	138	1	139
12	"12-out16372"	.99346	152	1	153
12	"12-out16373"	.99295	141	1	142
12	"12-out16374"	.70731	58	24	82
12	"12-out16375"	.58256	822	589	1411
12	"12-out16376"	.63038	278	163	441
12	"12-out16377"	.27592	157	412	569
12	"12-out16378"	.46632	180	206	386
12	"12-out16379"	.99783	461	1	462
12	"12-out16380"	.60180	467	309	776
12	"12-out16381"	.37544	945	1572	2517
12	"12-out16382"	.45125	412	501	913
12	"12-out16383"	.40293	110	163	273
12	"12-out16384"	.33783	50	98	148
12	"12-out16385"	.67549	102	49	151
12	"12-out16386"	.99411	169	1	170
12	"12-out16387"	.52816	75	67	142
12	"12-out16388"	.94422	237	14	251
12	"12-out16389"	.99644	280	1	281
12	"12-out16390"	.58039	527	381	908
12	"12-out16391"	.99696	329	1	330
12	"12-out16392"	.23862	173	552	725
12	"12-out16393"	.47457	224	248	472
12	"12-out16394"	.98734	78	1	79
12	"12-out16395"	.99367	157	1	158
12	"12-out16396"	.99367	157	1	158
12	"12-out16397"	.99305	143	1	144
12	"12-out16398"	.41624	82	115	197
12	"12-out16399"	.64381	385	213	598
12	"12-out16400"	.99453	182	1	183
12	"12-out16401"	.77906	67	19	86
12	"12-out16402"	.99801	502	1	503
12	"12-out16403"	.98863	87	1	88
12	"12-out16404"	.46777	254	289	543
12	"12-out16405"	.42035	95	131	226
12	"12-out16406"	.35135	117	216	333
12	"12-out16407"	.36090	96	170	266
12	"12-out16408"	.38461	105	168	273
12	"12-out16409"	.39664	142	216	358
12	"12-out16410"	.39463	103	158	261
12	"12-out16411"	.80286	224	55	279
12	"12-out16412"	.26771	68	186	254
12	"12-out16413"	.38978	145	227	372
12	"12-out16414"	.37051	93	158	251
12	"12-out16415"	.41608	119	167	286
12	"12-out16416"	.24064	45	142	187
12	"12-out16417"	.41176	343	490	833
12	"12-out16418"	.31406	201	439	640
12	"12-out16419"	.66964	750	370	1120
12	"12-out16420"	.65979	192	99	291
12	"12-out16421"	.45273	91	110	201
12	"12-out16422"	.93352	323	23	346
12	"12-out16423"	.24024	80	253	333
12	"12-out16424"	.54411	185	155	340
12	"12-out16425"	.30065	365	849	1214
12	"12-out16426"	.98819	1256	15	1271
12	"12-out16427"	.46984	148	167	315
12	"12-out16428"	.31849	93	199	292
12	"12-out16429"	.31153	81	179	260
12	"12-out16430"	.48770	119	125	244
12	"12-out16431"	.40790	361	524	885
12	"12-out16432"	.68224	934	435	1369
12	"12-out16433"	.85234	127	22	149
12	"12-out16434"	.64800	243	132	375
12	"12-out16435"	.27443	73	193	266
12	"12-out16436"	.31970	219	466	685
12	"12-out16437"	.38327	110	177	287
12	"12-out16438"	.22285	39	136	175
12	"12-out16439"	.50561	495	484	979
12	"12-out16440"	.71848	587	230	817
12	"12-out16441"	.50945	431	415	846
12	"12-out16442"	.35174	675	1244	1919
12	"12-out16443"	.60627	348	226	574
12	"12-out16444"	.23657	1009	3256	4265
12	"12-out16445"	.52416	141	128	269
12	"12-out16446"	.27129	207	556	763
12	"12-out16447"	.40863	1760	2547	4307
12	"12-out16448"	.35341	1596	2920	4516
12	"12-out16449"	.99465	186	1	187
12	"12-out16450"	.49820	2223	2239	4462
12	"12-out16451"	.18197	107	481	588
12	"12-out16452"	.33549	311	616	927
12	"12-out16453"	.36247	170	299	469
12	"12-out16454"	.25000	85	255	340
12	"12-out16455"	.28505	248	622	870
12	"12-out16456"	.31176	106	234	340
12	"12-out16457"	.28538	248	621	869
12	"12-out16458"	.29629	160	380	540
12	"12-out16459"	.24320	152	473	625
12	"12-out16460"	.38761	169	267	436
12	"12-out16461"	.32608	165	341	506
12	"12-out16462"	.25271	675	1996	2671
12	"12-out16463"	.58878	252	176	428
12	"12-out16464"	.37214	163	275	438
12	"12-out16465"	.41280	187	266	453
12	"12-out16466"	.60232	259	171	430
12	"12-out16467"	.99728	367	1	368
12	"12-out16468"	.33481	302	600	902
12	"12-out16469"	.43219	392	515	907
12	"12-out16470"	.32233	215	452	667
12	"12-out16471"	.48339	495	529	1024
12	"12-out16472"	.54924	290	238	528
12	"12-out16473"	.37932	690	1129	1819
12	"12-out16474"	.57657	448	329	777
12	"12-out16475"	.44943	80	98	178
12	"12-out16476"	.98431	1004	16	1020
12	"12-out16477"	.48883	197	206	403
12	"12-out16478"	.37246	257	433	690
12	"12-out16479"	.46174	338	394	732
12	"12-out16480"	.29402	182	437	619
12	"12-out16481"	.60777	375	242	617
12	"12-out16482"	.99796	490	1	491
12	"12-out16483"	.36265	202	355	557
12	"12-out16484"	.51898	82	76	158
12	"12-out16485"	.65000	104	56	160
12	"12-out16486"	.62151	156	95	251
12	"12-out16487"	.48898	111	116	227
12	"12-out16488"	.36974	176	300	476
12	"12-out16489"	.99837	615	1	616
12	"12-out16490"	.15813	34	181	215
12	"12-out16491"	.58181	128	92	220
12	"12-out16492"	.35410	125	228	353
12	"12-out16493"	.49242	195	201	396
12	"12-out16494"	.47457	196	217	413
12	"12-out16495"	.22736	113	384	497
12	"12-out16496"	.76244	337	105	442
12	"12-out16497"	.65296	540	287	827
12	"12-out16498"	.99422	689	4	693
12	"12-out16499"	.41730	164	229	393
12	"12-out16500"	.58139	125	90	215
12	"12-out16501"	.42654	180	242	422
12	"12-out16502"	.25842	46	132	178
12	"12-out16503"	.99038	103	1	104
12	"12-out16504"	.99462	185	1	186
12	"12-out16505"	.99549	221	1	222
12	"12-out16506"	.99727	732	2	734
12	"12-out16507"	.41881	227	315	542
12	"12-out16508"	.35315	285	522	807
12	"12-out16509"	.35087	280	518	798
12	"12-out16510"	.34351	180	344	524
12	"12-out16511"	.43656	117	151	268
12	"12-out16512"	.99750	399	1	400
12	"12-out16513"	.39613	82	125	207
12	"12-out16514"	.40000	140	210	350
12	"12-out16515"	.36501	338	588	926
12	"12-out16516"	.23777	107	343	450
12	"12-out16517"	.62753	278	165	443
12	"12-out16518"	.99453	364	2	366
12	"12-out16519"	.37003	121	206	327
12	"12-out16520"	.32000	88	187	275
12	"12-out16521"	.32954	87	177	264
12	"12-out16522"	.99029	204	2	206
12	"12-out16523"	.35777	1215	2181	3396
12	"12-out16524"	.90673	175	18	193
12	"12-out16525"	.28350	55	139	194
12	"12-out16526"	.38636	238	378	616
12	"12-out16527"	.44217	65	82	147
12	"12-out16528"	.84276	134	25	159
12	"12-out16529"	.55555	85	68	153
12	"12-out16530"	.99484	193	1	194
12	"12-out16531"	.98941	187	2	189
12	"12-out16532"	.99470	188	1	189
12	"12-out16533"	.99470	188	1	189
12	"12-out16534"	.99470	188	1	189
12	"12-out16535"	.99470	188	1	189
12	"12-out16536"	.99470	188	1	189
12	"12-out16537"	.99470	188	1	189
12	"12-out16538"	.98750	158	2	160
12	"12-out16539"	.46170	422	492	914
12	"12-out16540"	.42684	283	380	663
12	"12-out16541"	.52682	383	344	727
12	"12-out16542"	.92359	411	34	445
12	"12-out16543"	.97449	726	19	745
12	"12-out16544"	.99367	157	1	158
12	"12-out16545"	.99613	774	3	777
12	"12-out16546"	.79601	160	41	201
12	"12-out16547"	.22321	100	348	448
12	"12-out16548"	.46860	306	347	653
12	"12-out16549"	.28139	177	452	629
12	"12-out16550"	.37641	233	386	619
12	"12-out16551"	.31716	85	183	268
12	"12-out16552"	.99788	471	1	472
12	"12-out16553"	.38471	307	491	798
12	"12-out16554"	.75287	262	86	348
12	"12-out16555"	.46019	237	278	515
12	"12-out16556"	.22107	214	754	968
12	"12-out16557"	.34192	146	281	427
12	"12-out16558"	.56790	46	35	81
12	"12-out16559"	.99285	139	1	140
12	"12-out16560"	.98648	73	1	74
12	"12-out16561"	.41628	184	258	442
12	"12-out16562"	.99393	164	1	165
12	"12-out16563"	.99668	301	1	302
12	"12-out16564"	.56472	2046	1577	3623
12	"12-out16565"	.99783	461	1	462
12	"12-out16566"	.43205	124	163	287
12	"12-out16567"	.99784	462	1	463
12	"12-out16568"	.42147	314	431	745
12	"12-out16569"	.39664	71	108	179
12	"12-out16570"	.38290	327	527	854
12	"12-out16571"	.54166	195	165	360
12	"12-out16572"	.51149	712	680	1392
12	"12-out16573"	.30131	69	160	229
12	"12-out16574"	.75333	113	37	150
12	"12-out16575"	.39195	341	529	870
12	"12-out16576"	.77083	74	22	96
12	"12-out16577"	.55360	284	229	513
12	"12-out16578"	.99545	219	1	220
12	"12-out16579"	.99479	191	1	192
12	"12-out16580"	.40789	310	450	760
12	"12-out16581"	.61360	397	250	647
12	"12-out16582"	.37092	148	251	399
12	"12-out16583"	.46315	88	102	190
12	"12-out16584"	.29523	31	74	105
12	"12-out16585"	.35416	170	310	480
12	"12-out16586"	.49118	195	202	397
12	"12-out16587"	.95000	323	17	340
12	"12-out16588"	.95862	139	6	145
12	"12-out16589"	.59223	183	126	309
12	"12-out16590"	.44642	225	279	504
12	"12-out16591"	.98897	269	3	272
12	"12-out16592"	.96850	246	8	254
12	"12-out16593"	.97254	248	7	255
12	"12-out16594"	.24128	173	544	717
12	"12-out16595"	.27895	118	305	423
12	"12-out16596"	.99748	397	1	398
12	"12-out16597"	.37122	160	271	431
12	"12-out16598"	.25210	60	178	238
12	"12-out16599"	.49549	110	112	222
12	"12-out16600"	.36614	93	161	254
12	"12-out16601"	.19502	47	194	241
12	"12-out16602"	.18637	104	454	558
12	"12-out16603"	.36311	126	221	347
12	"12-out16604"	.47480	179	198	377
12	"12-out16605"	.34848	69	129	198
12	"12-out16606"	.36541	243	422	665
12	"12-out16607"	.35694	131	236	367
12	"12-out16608"	.99732	373	1	374
12	"12-out16609"	.45667	195	232	427
12	"12-out16610"	.71200	89	36	125
12	"12-out16611"	.44230	299	377	676
12	"12-out16612"	.30962	1389	3097	4486
12	"12-out16613"	.50224	336	333	669
12	"12-out16614"	.47106	407	457	864
12	"12-out16615"	.47116	335	376	711
12	"12-out16616"	.27363	55	146	201
12	"12-out16617"	.41095	210	301	511
12	"12-out16618"	.13090	72	478	550
12	"12-out16619"	.99598	248	1	249
12	"12-out16620"	.40778	199	289	488
12	"12-out16621"	.26098	101	286	387
12	"12-out16622"	.26295	274	768	1042
12	"12-out16623"	.48484	192	204	396
12	"12-out16624"	.20054	74	295	369
12	"12-out16625"	.40318	152	225	377
12	"12-out16626"	.26837	84	229	313
12	"12-out16627"	.43887	140	179	319
12	"12-out16628"	.39531	270	413	683
12	"12-out16629"	.49115	111	115	226
12	"12-out16630"	.39280	284	439	723
12	"12-out16631"	.36581	642	1113	1755
12	"12-out16632"	.49214	188	194	382
12	"12-out16633"	.40037	422	632	1054
12	"12-out16634"	.33832	158	309	467
12	"12-out16635"	.40943	434	626	1060
12	"12-out16636"	.41643	294	412	706
12	"12-out16637"	.38685	306	485	791
12	"12-out16638"	.32183	308	649	957
12	"12-out16639"	.99678	620	2	622
12	"12-out16640"	.46621	345	395	740
12	"12-out16641"	.30856	191	428	619
12	"12-out16642"	.34545	76	144	220
12	"12-out16643"	.29668	143	339	482
12	"12-out16644"	.35882	122	218	340
12	"12-out16645"	.70169	207	88	295
12	"12-out16646"	.64516	140	77	217
12	"12-out16647"	.54439	233	195	428
12	"12-out16648"	.38131	151	245	396
12	"12-out16649"	.83823	171	33	204
12	"12-out16650"	.19031	55	234	289
12	"12-out16651"	.39716	112	170	282
12	"12-out16652"	.96604	313	11	324
12	"12-out16653"	.56379	190	147	337
12	"12-out16654"	.34770	121	227	348
12	"12-out16655"	.84355	275	51	326
12	"12-out16656"	.19827	46	186	232
12	"12-out16657"	.53811	120	103	223
12	"12-out16658"	.73268	455	166	621
12	"12-out16659"	.31535	152	330	482
12	"12-out16660"	.21078	86	322	408
12	"12-out16661"	.96119	322	13	335
12	"12-out16662"	.47206	245	274	519
12	"12-out16663"	.99616	260	1	261
12	"12-out16664"	.75746	203	65	268
12	"12-out16665"	.91814	258	23	281
12	"12-out16666"	.99565	229	1	230
12	"12-out16667"	.25239	79	234	313
12	"12-out16668"	.27160	132	354	486
12	"12-out16669"	.26315	70	196	266
12	"12-out16670"	.73065	255	94	349
12	"12-out16671"	.35492	126	229	355
12	"12-out16672"	.28034	97	249	346
12	"12-out16673"	.24649	88	269	357
12	"12-out16674"	.99805	514	1	515
12	"12-out16675"	.32851	91	186	277
12	"12-out16676"	.32450	98	204	302
12	"12-out16677"	.37148	714	1208	1922
12	"12-out16678"	.40117	272	406	678
12	"12-out16679"	.31825	380	814	1194
12	"12-out16680"	.35754	128	230	358
12	"12-out16681"	.31250	70	154	224
12	"12-out16682"	.16862	43	212	255
12	"12-out16683"	.56683	335	256	591
12	"12-out16684"	.90934	642	64	706
12	"12-out16685"	.40248	97	144	241
12	"12-out16686"	.30145	145	336	481
12	"12-out16687"	.81746	206	46	252
12	"12-out16688"	.99411	169	1	170
12	"12-out16689"	.99492	196	1	197
12	"12-out16690"	.36312	260	456	716
12	"12-out16691"	.93283	625	45	670
12	"12-out16692"	.97058	33	1	34
12	"12-out16693"	.99849	665	1	666
12	"12-out16694"	.58149	396	285	681
12	"12-out16695"	.45681	402	478	880
12	"12-out16696"	.48414	336	358	694
12	"12-out16697"	.35590	247	447	694
12	"12-out16698"	.99303	570	4	574
12	"12-out16699"	.24486	1084	3343	4427
12	"12-out16700"	.36503	1639	2851	4490
12	"12-out16701"	.31460	28	61	89
12	"12-out16702"	.92035	104	9	113
12	"12-out16703"	.44336	364	457	821
12	"12-out16704"	.72164	70	27	97
12	"12-out16705"	.48919	317	331	648
12	"12-out16706"	.25526	109	318	427
12	"12-out16707"	.59904	378	253	631
12	"12-out16708"	.21232	62	230	292
12	"12-out16709"	.65333	245	130	375
12	"12-out16710"	.34587	993	1878	2871
12	"12-out16711"	.99545	219	1	220
12	"12-out16712"	.30720	243	548	791
12	"12-out16713"	.26666	80	220	300
12	"12-out16714"	.58148	157	113	270
12	"12-out16715"	.99280	276	2	278
12	"12-out16716"	.40043	555	831	1386
12	"12-out16717"	.27777	55	143	198
12	"12-out16718"	.27052	425	1146	1571
12	"12-out16719"	.31177	135	298	433
12	"12-out16720"	.33136	505	1019	1524
12	"12-out16721"	.35420	198	361	559
12	"12-out16722"	.42933	963	1280	2243
12	"12-out16723"	.31070	119	264	383
12	"12-out16724"	.13899	36	223	259
12	"12-out16725"	.46341	152	176	328
12	"12-out16726"	.42023	108	149	257
12	"12-out16727"	.36729	137	236	373
12	"12-out16728"	.99019	101	1	102
12	"12-out16729"	.35632	93	168	261
12	"12-out16730"	.43478	1320	1716	3036
12	"12-out16731"	.30600	459	1041	1500
12	"12-out16732"	.23552	118	383	501
12	"12-out16733"	.21974	227	806	1033
12	"12-out16734"	.37082	244	414	658
12	"12-out16735"	.98066	558	11	569
12	"12-out16736"	.54264	299	252	551
12	"12-out16737"	.99082	108	1	109
12	"12-out16738"	.39756	685	1038	1723
12	"12-out16739"	.77104	2290	680	2970
12	"12-out16740"	.65989	130	67	197
12	"12-out16741"	.48655	543	573	1116
12	"12-out16742"	.35826	297	532	829
12	"12-out16743"	.66666	66	33	99
12	"12-out16744"	.54137	157	133	290
12	"12-out16745"	.47142	198	222	420
12	"12-out16746"	.46222	208	242	450
12	"12-out16747"	.41025	176	253	429
12	"12-out16748"	.39593	253	386	639
12	"12-out16749"	.31143	128	283	411
12	"12-out16750"	.56647	196	150	346
12	"12-out16751"	.91103	256	25	281
12	"12-out16752"	.48275	84	90	174
12	"12-out16753"	.21118	68	254	322
12	"12-out16754"	.29633	307	729	1036
12	"12-out16755"	.36213	88	155	243
12	"12-out16756"	.99730	370	1	371
12	"12-out16757"	.28053	356	913	1269
12	"12-out16758"	.26560	234	647	881
12	"12-out16759"	.44278	445	560	1005
12	"12-out16760"	.40381	296	437	733
12	"12-out16761"	.49666	447	453	900
12	"12-out16762"	.99775	445	1	446
12	"12-out16763"	.35267	79	145	224
12	"12-out16764"	.52996	681	604	1285
12	"12-out16765"	.65833	79	41	120
12	"12-out16766"	.29032	234	572	806
12	"12-out16767"	.98717	77	1	78
12	"12-out16768"	.99212	126	1	127
12	"12-out16769"	.28048	161	413	574
12	"12-out16770"	.95424	146	7	153
12	"12-out16771"	.21071	118	442	560
12	"12-out16772"	.31818	1134	2430	3564
12	"12-out16773"	.27444	957	2530	3487
12	"12-out16774"	.35068	1300	2407	3707
12	"12-out16775"	.40196	123	183	306
12	"12-out16776"	.96650	202	7	209
12	"12-out16777"	.64912	37	20	57
12	"12-out16778"	.29220	225	545	770
12	"12-out16779"	.38101	309	502	811
12	"12-out16780"	.41162	517	739	1256
12	"12-out16781"	.89777	685	78	763
12	"12-out16782"	.78059	370	104	474
12	"12-out16783"	.37671	110	182	292
12	"12-out16784"	.59075	179	124	303
12	"12-out16785"	.50092	272	271	543
12	"12-out16786"	.24352	47	146	193
12	"12-out16787"	.28596	165	412	577
12	"12-out16788"	.75172	109	36	145
12	"12-out16789"	.39669	144	219	363
12	"12-out16790"	.24163	231	725	956
12	"12-out16791"	.45419	119	143	262
12	"12-out16792"	.37575	62	103	165
12	"12-out16793"	.55704	83	66	149
12	"12-out16794"	.99019	101	1	102
12	"12-out16795"	.34409	405	772	1177
12	"12-out16796"	.39669	48	73	121
12	"12-out16797"	.99444	179	1	180
12	"12-out16798"	.98648	73	1	74
12	"12-out16799"	.99871	776	1	777
12	"12-out16800"	.99871	776	1	777
12	"12-out16801"	.99809	523	1	524
12	"12-out16802"	.50000	319	319	638
12	"12-out16803"	.18817	70	302	372
12	"12-out16804"	.36551	53	92	145
12	"12-out16805"	.55118	70	57	127
12	"12-out16806"	.34594	320	605	925
12	"12-out16807"	.54869	524	431	955
12	"12-out16808"	.72222	91	35	126
12	"12-out16809"	.31887	441	942	1383
12	"12-out16810"	.42391	78	106	184
12	"12-out16811"	.44981	121	148	269
12	"12-out16812"	.99264	270	2	272
12	"12-out16813"	.99303	285	2	287
12	"12-out16814"	.51428	72	68	140
12	"12-out16815"	.48856	235	246	481
12	"12-out16816"	.33888	61	119	180
12	"12-out16817"	.25128	342	1019	1361
12	"12-out16818"	.54174	1687	1427	3114
12	"12-out16819"	.77327	191	56	247
12	"12-out16820"	.77800	389	111	500
12	"12-out16821"	.64319	685	380	1065
12	"12-out16822"	.32558	56	116	172
12	"12-out16823"	.53304	250	219	469
12	"12-out16824"	.32984	63	128	191
12	"12-out16825"	.45714	144	171	315
12	"12-out16826"	.43095	284	375	659
12	"12-out16827"	.37880	261	428	689
12	"12-out16828"	.99218	127	1	128
12	"12-out16829"	.50784	356	345	701
12	"12-out16830"	.49504	50	51	101
12	"12-out16831"	.60835	233	150	383
12	"12-out16832"	.51379	149	141	290
12	"12-out16833"	.56261	310	241	551
12	"12-out16834"	.48046	123	133	256
12	"12-out16835"	.41055	358	514	872
12	"12-out16836"	.98888	89	1	90
12	"12-out16837"	.99386	162	1	163
12	"12-out16838"	.60797	183	118	301
12	"12-out16839"	.39189	580	900	1480
12	"12-out16840"	.99019	101	1	102
12	"12-out16841"	.41706	176	246	422
12	"12-out16842"	.41538	216	304	520
12	"12-out16843"	.53947	41	35	76
12	"12-out16844"	.41886	111	154	265
12	"12-out16845"	.99310	144	1	145
12	"12-out16846"	.32176	102	215	317
12	"12-out16847"	.35074	141	261	402
12	"12-out16848"	.36363	48	84	132
12	"12-out16849"	.39279	240	371	611
12	"12-out16850"	.99387	487	3	490
12	"12-out16851"	.99795	489	1	490
12	"12-out16852"	.99801	503	1	504
12	"12-out16853"	.94847	497	27	524
12	"12-out16854"	.92141	469	40	509
12	"12-out16855"	.36619	182	315	497
12	"12-out16856"	.67039	120	59	179
12	"12-out16857"	.52898	73	65	138
12	"12-out16858"	.27152	41	110	151
12	"12-out16859"	.36496	50	87	137
12	"12-out16860"	.72789	107	40	147
12	"12-out16861"	.66000	33	17	50
12	"12-out16862"	.32707	209	430	639
12	"12-out16863"	.99470	188	1	189
12	"12-out16864"	.99470	188	1	189
12	"12-out16865"	.99470	188	1	189
12	"12-out16866"	.55147	75	61	136
12	"12-out16867"	.99512	204	1	205
12	"12-out16868"	.61020	263	168	431
12	"12-out16869"	.36504	330	574	904
12	"12-out16870"	.39772	175	265	440
12	"12-out16871"	.47601	129	142	271
12	"12-out16872"	.43076	420	555	975
12	"12-out16873"	.99871	776	1	777
12	"12-out16874"	.49283	172	177	349
12	"12-out16875"	.35813	77	138	215
12	"12-out16876"	.20821	147	559	706
12	"12-out16877"	.52263	127	116	243
12	"12-out16878"	.33779	202	396	598
12	"12-out16879"	.34353	247	472	719
12	"12-out16880"	.35826	182	326	508
12	"12-out16881"	.99378	160	1	161
12	"12-out16882"	.90494	238	25	263
12	"12-out16883"	.97718	257	6	263
12	"12-out16884"	.99811	529	1	530
12	"12-out16885"	.29497	264	631	895
12	"12-out16886"	.34699	271	510	781
12	"12-out16887"	.54201	129	109	238
12	"12-out16888"	.12345	10	71	81
12	"12-out16889"	.98765	80	1	81
12	"12-out16890"	.50000	54	54	108
12	"12-out16891"	.51863	167	155	322
12	"12-out16892"	.21004	46	173	219
12	"12-out16893"	.65686	134	70	204
12	"12-out16894"	.98076	51	1	52
12	"12-out16895"	.99206	125	1	126
12	"12-out16896"	.98437	63	1	64
12	"12-out16897"	.98701	76	1	77
12	"12-out16898"	.98305	58	1	59
12	"12-out16899"	.98181	54	1	55
12	"12-out16900"	.42730	529	709	1238
12	"12-out16901"	.47786	367	401	768
12	"12-out16902"	.42948	335	445	780
12	"12-out16903"	.99555	224	1	225
12	"12-out16904"	.60958	267	171	438
12	"12-out16905"	.98387	61	1	62
12	"12-out16906"	.36109	542	959	1501
12	"12-out16907"	.99200	124	1	125
12	"12-out16908"	.99805	513	1	514
12	"12-out16909"	.99082	108	1	109
12	"12-out16910"	.94594	210	12	222
12	"12-out16911"	.69072	67	30	97
12	"12-out16912"	.76204	253	79	332
12	"12-out16913"	.99074	107	1	108
12	"12-out16914"	.99074	107	1	108
12	"12-out16915"	.99425	173	1	174
12	"12-out16916"	.32163	284	599	883
12	"12-out16917"	.45152	163	198	361
12	"12-out16918"	.47323	168	187	355
12	"12-out16919"	.81927	68	15	83
12	"12-out16920"	.98765	80	1	81
12	"12-out16921"	.71929	82	32	114
12	"12-out16922"	.40643	139	203	342
12	"12-out16923"	.68571	240	110	350
12	"12-out16924"	.53811	120	103	223
12	"12-out16925"	.99065	106	1	107
12	"12-out16926"	.72566	82	31	113
12	"12-out16927"	.36736	349	601	950
12	"12-out16928"	.38650	252	400	652
12	"12-out16929"	.52109	247	227	474
12	"12-out16930"	.58715	192	135	327
12	"12-out16931"	.45818	126	149	275
12	"12-out16932"	.40887	175	253	428
12	"12-out16933"	.29054	129	315	444
12	"12-out16934"	.32258	30	63	93
12	"12-out16935"	.50000	60	60	120
12	"12-out16936"	.31715	98	211	309
12	"12-out16937"	.49629	134	136	270
12	"12-out16938"	.99709	343	1	344
12	"12-out16939"	.36950	126	215	341
12	"12-out16940"	.25974	220	627	847
12	"12-out16941"	.26933	101	274	375
12	"12-out16942"	.98750	79	1	80
12	"12-out16943"	.27333	82	218	300
12	"12-out16944"	.62371	242	146	388
12	"12-out16945"	.38035	213	347	560
12	"12-out16946"	.91089	368	36	404
12	"12-out16947"	.99523	209	1	210
12	"12-out16948"	.75928	634	201	835
12	"12-out16949"	.45226	90	109	199
12	"12-out16950"	.39924	212	319	531
12	"12-out16951"	.43205	248	326	574
12	"12-out16952"	.38028	81	132	213
12	"12-out16953"	.44107	131	166	297
12	"12-out16954"	.99468	187	1	188
12	"12-out16955"	.94186	243	15	258
12	"12-out16956"	.27561	156	410	566
12	"12-out16957"	.28877	54	133	187
12	"12-out16958"	.35770	181	325	506
12	"12-out16959"	.48648	288	304	592
12	"12-out16960"	.52690	901	809	1710
12	"12-out16961"	.28255	421	1069	1490
12	"12-out16962"	.44654	71	88	159
12	"12-out16963"	.35698	166	299	465
12	"12-out16964"	.29515	134	320	454
12	"12-out16965"	.76208	205	64	269
12	"12-out16966"	.28750	23	57	80
12	"12-out16967"	.64245	230	128	358
12	"12-out16968"	.51162	132	126	258
12	"12-out16969"	.50290	173	171	344
12	"12-out16970"	.99832	595	1	596
12	"12-out16971"	.99658	292	1	293
12	"12-out16972"	.40577	1223	1791	3014
12	"12-out16973"	.50442	171	168	339
12	"12-out16974"	.44666	134	166	300
12	"12-out16975"	.58644	1584	1117	2701
12	"12-out16976"	.27272	24	64	88
12	"12-out16977"	.28125	108	276	384
12	"12-out16978"	.45161	28	34	62
12	"12-out16979"	.98954	284	3	287
12	"12-out16980"	.61616	732	456	1188
12	"12-out16981"	.44672	109	135	244
12	"12-out16982"	.41860	126	175	301
12	"12-out16983"	.54407	179	150	329
12	"12-out16984"	.29677	341	808	1149
12	"12-out16985"	.25312	81	239	320
12	"12-out16986"	.36479	143	249	392
12	"12-out16987"	.48553	302	320	622
12	"12-out16988"	.41767	1134	1581	2715
12	"12-out16989"	.57330	305	227	532
12	"12-out16990"	.99967	3095	1	3096
12	"12-out16991"	.61739	71	44	115
12	"12-out16992"	.40321	452	669	1121
12	"12-out16993"	.48701	150	158	308
12	"12-out16994"	.99019	101	1	102
12	"12-out16995"	.72693	394	148	542
12	"12-out16996"	.88000	88	12	100
12	"12-out16997"	.51186	302	288	590
12	"12-out16998"	.21468	38	139	177
12	"12-out16999"	.99590	243	1	244
12	"12-out17000"	.98765	80	1	81
12	"12-out17001"	.44668	310	384	694
12	"12-out17002"	.34782	200	375	575
12	"12-out17003"	.31270	187	411	598
12	"12-out17004"	.62059	687	420	1107
12	"12-out17005"	.99786	468	1	469
12	"12-out17006"	.46995	219	247	466
12	"12-out17007"	.20560	22	85	107
12	"12-out17008"	.23709	542	1744	2286
12	"12-out17009"	.47248	249	278	527
12	"12-out17010"	.46938	69	78	147
12	"12-out17011"	.39316	46	71	117
12	"12-out17012"	.33010	409	830	1239
12	"12-out17013"	.29690	144	341	485
12	"12-out17014"	.31190	456	1006	1462
12	"12-out17015"	.49850	167	168	335
12	"12-out17016"	.31478	181	394	575
12	"12-out17017"	.55263	273	221	494
12	"12-out17018"	.44555	401	499	900
12	"12-out17019"	.43494	234	304	538
12	"12-out17020"	.79482	1259	325	1584
12	"12-out17021"	.98734	78	1	79
12	"12-out17022"	.91666	506	46	552
12	"12-out17023"	.90769	295	30	325
12	"12-out17024"	.58742	383	269	652
12	"12-out17025"	.55833	201	159	360
12	"12-out17026"	.58426	104	74	178
12	"12-out17027"	.52717	388	348	736
12	"12-out17028"	.50548	461	451	912
12	"12-out17029"	.24501	209	644	853
12	"12-out17030"	.41709	161	225	386
12	"12-out17031"	.34749	548	1029	1577
12	"12-out17032"	.26732	432	1184	1616
12	"12-out17033"	.28842	137	338	475
12	"12-out17034"	.54597	95	79	174
12	"12-out17035"	.17777	64	296	360
12	"12-out17036"	.29916	108	253	361
12	"12-out17037"	.75165	227	75	302
12	"12-out17038"	.49498	148	151	299
12	"12-out17039"	.39016	119	186	305
12	"12-out17040"	.46000	115	135	250
12	"12-out17041"	.52747	144	129	273
12	"12-out17042"	.42772	935	1251	2186
12	"12-out17043"	.83743	1736	337	2073
12	"12-out17044"	.24500	98	302	400
12	"12-out17045"	.93689	386	26	412
12	"12-out17046"	.33726	629	1236	1865
12	"12-out17047"	.27814	509	1321	1830
12	"12-out17048"	.23152	470	1560	2030
12	"12-out17049"	.43133	848	1118	1966
12	"12-out17050"	.32834	614	1256	1870
12	"12-out17051"	.30581	626	1421	2047
12	"12-out17052"	.38177	817	1323	2140
12	"12-out17053"	.36445	765	1334	2099
12	"12-out17054"	.33349	690	1379	2069
12	"12-out17055"	.56953	172	130	302
12	"12-out17056"	.79417	382	99	481
12	"12-out17057"	.30339	125	287	412
12	"12-out17058"	.50000	248	248	496
12	"12-out17059"	.32822	107	219	326
12	"12-out17060"	.26797	82	224	306
12	"12-out17061"	.25981	86	245	331
12	"12-out17062"	.51785	261	243	504
12	"12-out17063"	.29739	160	378	538
12	"12-out17064"	.60954	345	221	566
12	"12-out17065"	.37322	920	1545	2465
12	"12-out17066"	.31940	734	1564	2298
12	"12-out17067"	.99152	117	1	118
12	"12-out17068"	.21393	132	485	617
12	"12-out17069"	.04201	10	228	238
12	"12-out17070"	.35393	544	993	1537
12	"12-out17071"	.29737	102	241	343
12	"12-out17072"	.27187	87	233	320
12	"12-out17073"	.46826	332	377	709
12	"12-out17074"	.37198	247	417	664
12	"12-out17075"	.99186	122	1	123
12	"12-out17076"	.54615	142	118	260
12	"12-out17077"	.65503	169	89	258
12	"12-out17078"	.98837	170	2	172
12	"12-out17079"	.18719	38	165	203
12	"12-out17080"	.99756	410	1	411
12	"12-out17081"	.41563	202	284	486
12	"12-out17082"	.40778	199	289	488
12	"12-out17083"	.51315	195	185	380
12	"12-out17084"	.51058	193	185	378
12	"12-out17085"	.32279	143	300	443
12	"12-out17086"	.69734	341	148	489
12	"12-out17087"	.98717	77	1	78
12	"12-out17088"	.81707	67	15	82
12	"12-out17089"	.54385	155	130	285
12	"12-out17090"	.38202	102	165	267
12	"12-out17091"	.55752	252	200	452
12	"12-out17092"	.53846	140	120	260
12	"12-out17093"	.59523	50	34	84
12	"12-out17094"	.66304	61	31	92
12	"12-out17095"	.22072	49	173	222
12	"12-out17096"	.32857	92	188	280
12	"12-out17097"	.61797	55	34	89
12	"12-out17098"	.63392	71	41	112
12	"12-out17099"	.10628	22	185	207
12	"12-out17100"	.81300	100	23	123
12	"12-out17101"	.60560	281	183	464
12	"12-out17102"	.35972	159	283	442
12	"12-out17103"	.46938	69	78	147
12	"12-out17104"	.99537	215	1	216
12	"12-out17105"	.99618	261	1	262
12	"12-out17106"	.68032	166	78	244
12	"12-out17107"	.83048	583	119	702
12	"12-out17108"	.53548	249	216	465
12	"12-out17109"	.38069	142	231	373
12	"12-out17110"	.35817	149	267	416
12	"12-out17111"	.58545	161	114	275
12	"12-out17112"	.75925	574	182	756
12	"12-out17113"	.46913	38	43	81
12	"12-out17114"	.26315	15	42	57
12	"12-out17115"	.40185	260	387	647
12	"12-out17116"	.49423	257	263	520
12	"12-out17117"	.43859	150	192	342
12	"12-out17118"	.40288	307	455	762
12	"12-out17119"	.42385	167	227	394
12	"12-out17120"	.37027	284	483	767
12	"12-out17121"	.57677	154	113	267
12	"12-out17122"	.57734	265	194	459
12	"12-out17123"	.44552	229	285	514
12	"12-out17124"	.25130	192	572	764
12	"12-out17125"	.24870	48	145	193
12	"12-out17126"	.99242	131	1	132
12	"12-out17127"	.99563	228	1	229
12	"12-out17128"	.44978	103	126	229
12	"12-out17129"	.99565	229	1	230
12	"12-out17130"	.87945	321	44	365
12	"12-out17131"	.99465	186	1	187
12	"12-out17132"	.99393	164	1	165
12	"12-out17133"	.20359	34	133	167
12	"12-out17134"	.99145	116	1	117
12	"12-out17135"	.33729	142	279	421
12	"12-out17136"	.55154	107	87	194
12	"12-out17137"	.98016	346	7	353
12	"12-out17138"	.31343	231	506	737
12	"12-out17139"	.31853	1514	3239	4753
12	"12-out17140"	.46231	92	107	199
12	"12-out17141"	.20105	38	151	189
12	"12-out17142"	.89924	357	40	397
12	"12-out17143"	.24514	101	311	412
12	"12-out17144"	.60101	119	79	198
12	"12-out17145"	.72672	359	135	494
12	"12-out17146"	.99209	251	2	253
12	"12-out17147"	.90769	236	24	260
12	"12-out17148"	.29597	272	647	919
12	"12-out17149"	.22695	229	780	1009
12	"12-out17150"	.51372	468	443	911
12	"12-out17151"	.17751	30	139	169
12	"12-out17152"	.52197	95	87	182
12	"12-out17153"	.39344	72	111	183
12	"12-out17154"	.25707	318	919	1237
12	"12-out17155"	.53846	91	78	169
12	"12-out17156"	.40000	192	288	480
12	"12-out17157"	.44927	93	114	207
12	"12-out17158"	.99315	145	1	146
12	"12-out17159"	.40789	155	225	380
12	"12-out17160"	.37037	80	136	216
12	"12-out17161"	.30512	137	312	449
12	"12-out17162"	.41379	240	340	580
12	"12-out17163"	.98850	86	1	87
12	"12-out17164"	.45973	411	483	894
12	"12-out17165"	.49278	444	457	901
12	"12-out17166"	.51339	460	436	896
12	"12-out17167"	.26988	543	1469	2012
12	"12-out17168"	.26156	537	1516	2053
12	"12-out17169"	.53872	160	137	297
12	"12-out17170"	.80508	95	23	118
12	"12-out17171"	.43157	82	108	190
12	"12-out17172"	.74226	72	25	97
12	"12-out17173"	.99328	148	1	149
12	"12-out17174"	.38943	472	740	1212
12	"12-out17175"	.86430	828	130	958
12	"12-out17176"	.28884	303	746	1049
12	"12-out17177"	.44991	503	615	1118
12	"12-out17178"	.37537	375	624	999
12	"12-out17179"	.32692	340	700	1040
12	"12-out17180"	.31741	113	243	356
12	"12-out17181"	.69485	904	397	1301
12	"12-out17182"	.35970	441	785	1226
12	"12-out17183"	.10526	22	187	209
12	"12-out17184"	.60119	101	67	168
12	"12-out17185"	.50064	391	390	781
12	"12-out17186"	.37534	274	456	730
12	"12-out17187"	.29475	219	524	743
12	"12-out17188"	.20574	129	498	627
12	"12-out17189"	.95065	289	15	304
12	"12-out17190"	.87919	262	36	298
12	"12-out17191"	.57580	357	263	620
12	"12-out17192"	.99764	423	1	424
12	"12-out17193"	.99764	423	1	424
12	"12-out17194"	.99763	421	1	422
12	"12-out17195"	.99764	423	1	424
12	"12-out17196"	.99764	423	1	424
12	"12-out17197"	.99764	423	1	424
12	"12-out17198"	.57769	896	655	1551
12	"12-out17199"	.69315	1073	475	1548
12	"12-out17200"	.23157	44	146	190
12	"12-out17201"	.99056	105	1	106
12	"12-out17202"	.66139	293	150	443
12	"12-out17203"	.33230	216	434	650
12	"12-out17204"	.33513	62	123	185
12	"12-out17205"	.59936	190	127	317
12	"12-out17206"	.42893	169	225	394
12	"12-out17207"	.24409	93	288	381
12	"12-out17208"	.95833	368	16	384
12	"12-out17209"	.61454	169	106	275
12	"12-out17210"	.56721	308	235	543
12	"12-out17211"	.49612	256	260	516
12	"12-out17212"	.50662	612	596	1208
12	"12-out17213"	.57807	174	127	301
12	"12-out17214"	.41899	225	312	537
12	"12-out17215"	.64033	924	519	1443
12	"12-out17216"	.38958	217	340	557
12	"12-out17217"	.32804	248	508	756
12	"12-out17218"	.54237	64	54	118
12	"12-out17219"	.69545	153	67	220
12	"12-out17220"	.86386	349	55	404
12	"12-out17221"	.34693	68	128	196
12	"12-out17222"	.28895	191	470	661
12	"12-out17223"	.42292	321	438	759
12	"12-out17224"	.36279	546	959	1505
12	"12-out17225"	.50403	749	737	1486
12	"12-out17226"	.31136	189	418	607
12	"12-out17227"	.47500	76	84	160
12	"12-out17228"	.35862	104	186	290
12	"12-out17229"	.40740	99	144	243
12	"12-out17230"	.99248	132	1	133
12	"12-out17231"	.73873	82	29	111
12	"12-out17232"	.36544	110	191	301
12	"12-out17233"	.50365	757	746	1503
12	"12-out17234"	.60000	75	50	125
12	"12-out17235"	.72448	213	81	294
12	"12-out17236"	.55405	205	165	370
12	"12-out17237"	.99512	204	1	205
12	"12-out17238"	.65127	282	151	433
12	"12-out17239"	.93457	100	7	107
12	"12-out17240"	.47282	174	194	368
12	"12-out17241"	.59183	58	40	98
12	"12-out17242"	.69248	304	135	439
12	"12-out17243"	.60638	57	37	94
12	"12-out17244"	.53211	58	51	109
12	"12-out17245"	.45045	50	61	111
12	"12-out17246"	.67226	80	39	119
12	"12-out17247"	.21646	142	514	656
12	"12-out17248"	.24561	140	430	570
12	"12-out17249"	.89473	170	20	190
12	"12-out17250"	.36000	144	256	400
12	"12-out17251"	.33701	122	240	362
12	"12-out17252"	.50170	147	146	293
12	"12-out17253"	.61783	97	60	157
12	"12-out17254"	.35987	113	201	314
12	"12-out17255"	.27554	151	397	548
12	"12-out17256"	.99621	263	1	264
12	"12-out17257"	.94845	92	5	97
12	"12-out17258"	.57203	135	101	236
12	"12-out17259"	.22668	175	597	772
12	"12-out17260"	.99703	673	2	675
12	"12-out17261"	.38009	168	274	442
12	"12-out17262"	.37721	149	246	395
12	"12-out17263"	.33333	40	80	120
12	"12-out17264"	.80476	507	123	630
12	"12-out17265"	.56146	169	132	301
12	"12-out17266"	.58357	199	142	341
12	"12-out17267"	.61916	1021	628	1649
12	"12-out17268"	.41159	142	203	345
12	"12-out17269"	.23228	118	390	508
12	"12-out17270"	.35585	158	286	444
12	"12-out17271"	.75428	132	43	175
12	"12-out17272"	.64367	112	62	174
12	"12-out17273"	.45773	417	494	911
12	"12-out17274"	.39215	340	527	867
12	"12-out17275"	.98701	76	1	77
12	"12-out17276"	.99519	207	1	208
12	"12-out17277"	.48387	105	112	217
12	"12-out17278"	.53815	134	115	249
12	"12-out17279"	.35102	86	159	245
12	"12-out17280"	.41863	355	493	848
12	"12-out17281"	.66246	420	214	634
12	"12-out17282"	.35218	218	401	619
12	"12-out17283"	.39130	117	182	299
12	"12-out17284"	.47727	63	69	132
12	"12-out17285"	.95433	627	30	657
12	"12-out17286"	.44011	294	374	668
12	"12-out17287"	.32601	104	215	319
12	"12-out17288"	.43312	136	178	314
12	"12-out17289"	.36593	217	376	593
12	"12-out17290"	.35802	348	624	972
12	"12-out17291"	.37307	97	163	260
12	"12-out17292"	.99539	216	1	217
12	"12-out17293"	.38636	323	513	836
12	"12-out17294"	.76963	147	44	191
12	"12-out17295"	.99549	221	1	222
12	"12-out17296"	.27916	67	173	240
12	"12-out17297"	.29767	64	151	215
12	"12-out17298"	.54545	72	60	132
12	"12-out17299"	.38970	106	166	272
12	"12-out17300"	.31527	128	278	406
12	"12-out17301"	.82773	1922	400	2322
12	"12-out17302"	.41342	234	332	566
12	"12-out17303"	.49378	318	326	644
12	"12-out17304"	.29306	245	591	836
12	"12-out17305"	.45012	361	441	802
12	"12-out17306"	.99526	210	1	211
12	"12-out17307"	.25906	150	429	579
12	"12-out17308"	.49315	72	74	146
12	"12-out17309"	.31388	113	247	360
12	"12-out17310"	.98537	741	11	752
12	"12-out17311"	.99132	343	3	346
12	"12-out17312"	.53144	262	231	493
12	"12-out17313"	.37260	544	916	1460
12	"12-out17314"	.36815	363	623	986
12	"12-out17315"	.90406	311	33	344
12	"12-out17316"	.42508	610	825	1435
12	"12-out17317"	.77681	268	77	345
12	"12-out17318"	.75092	202	67	269
12	"12-out17319"	.99595	246	1	247
12	"12-out17320"	.63040	788	462	1250
12	"12-out17321"	.61877	323	199	522
12	"12-out17322"	.39849	212	320	532
12	"12-out17323"	.41379	132	187	319
12	"12-out17324"	.99378	160	1	161
12	"12-out17325"	.33796	73	143	216
12	"12-out17326"	.91200	570	55	625
12	"12-out17327"	.35199	327	602	929
12	"12-out17328"	.99290	140	1	141
12	"12-out17329"	.42857	57	76	133
12	"12-out17330"	.37053	83	141	224
12	"12-out17331"	.33781	176	345	521
12	"12-out17332"	.39562	199	304	503
12	"12-out17333"	.44466	450	562	1012
12	"12-out17334"	.39177	181	281	462
12	"12-out17335"	.49769	539	544	1083
12	"12-out17336"	.99797	493	1	494
12	"12-out17337"	.84923	445	79	524
12	"12-out17338"	.28173	586	1494	2080
12	"12-out17339"	.99805	514	1	515
12	"12-out17340"	.42214	244	334	578
12	"12-out17341"	.37632	283	469	752
12	"12-out17342"	.31422	148	323	471
12	"12-out17343"	.54770	310	256	566
12	"12-out17344"	.41826	174	242	416
12	"12-out17345"	.96538	502	18	520
12	"12-out17346"	.59243	141	97	238
12	"12-out17347"	.63209	323	188	511
12	"12-out17348"	.49854	171	172	343
12	"12-out17349"	.53558	286	248	534
12	"12-out17350"	.66587	279	140	419
12	"12-out17351"	.36666	44	76	120
12	"12-out17352"	.55447	229	184	413
12	"12-out17353"	.60240	200	132	332
12	"12-out17354"	.83611	301	59	360
12	"12-out17355"	.44256	131	165	296
12	"12-out17356"	.39400	184	283	467
12	"12-out17357"	.99872	781	1	782
12	"12-out17358"	.88942	185	23	208
12	"12-out17359"	.99792	481	1	482
12	"12-out17360"	.31622	567	1226	1793
12	"12-out17361"	.98936	93	1	94
12	"12-out17362"	.34682	180	339	519
12	"12-out17363"	.48924	91	95	186
12	"12-out17364"	.99115	112	1	113
12	"12-out17365"	.35324	136	249	385
12	"12-out17366"	.34722	100	188	288
12	"12-out17367"	.27046	76	205	281
12	"12-out17368"	.99502	200	1	201
12	"12-out17369"	.38341	245	394	639
12	"12-out17370"	.68493	200	92	292
12	"12-out17371"	.40397	61	90	151
12	"12-out17372"	.87974	278	38	316
12	"12-out17373"	.95512	149	7	156
12	"12-out17374"	.90683	146	15	161
12	"12-out17375"	.41978	1065	1472	2537
12	"12-out17376"	.71304	82	33	115
12	"12-out17377"	.84126	212	40	252
12	"12-out17378"	.42870	469	625	1094
12	"12-out17379"	.43535	1357	1760	3117
12	"12-out17380"	.72075	191	74	265
12	"12-out17381"	.93043	428	32	460
12	"12-out17382"	.96666	261	9	270
12	"12-out17383"	.50971	656	631	1287
12	"12-out17384"	.37448	182	304	486
12	"12-out17385"	.96644	144	5	149
12	"12-out17386"	.99264	270	2	272
12	"12-out17387"	.39673	1314	1998	3312
12	"12-out17388"	.77990	326	92	418
12	"12-out17389"	.39230	153	237	390
12	"12-out17390"	.54918	67	55	122
12	"12-out17391"	.42857	126	168	294
12	"12-out17392"	.55120	183	149	332
12	"12-out17393"	.75260	289	95	384
12	"12-out17394"	.48687	204	215	419
12	"12-out17395"	.99152	117	1	118
12	"12-out17396"	.42784	169	226	395
12	"12-out17397"	.60989	111	71	182
12	"12-out17398"	.43032	491	650	1141
12	"12-out17399"	.99206	125	1	126
12	"12-out17400"	.31673	159	343	502
12	"12-out17401"	.49416	254	260	514
12	"12-out17402"	.37664	200	331	531
12	"12-out17403"	.34081	167	323	490
12	"12-out17404"	.44000	231	294	525
12	"12-out17405"	.99614	517	2	519
12	"12-out17406"	.98807	497	6	503
12	"12-out17407"	.41687	326	456	782
12	"12-out17408"	.92537	124	10	134
12	"12-out17409"	.67241	117	57	174
12	"12-out17410"	.90497	200	21	221
12	"12-out17411"	.99290	140	1	141
12	"12-out17412"	.48880	131	137	268
12	"12-out17413"	.75308	183	60	243
12	"12-out17414"	.26623	41	113	154
12	"12-out17415"	.98947	94	1	95
12	"12-out17416"	.99107	111	1	112
12	"12-out17417"	.40148	108	161	269
12	"12-out17418"	.21800	46	165	211
12	"12-out17419"	.75812	210	67	277
12	"12-out17420"	.36341	451	790	1241
12	"12-out17421"	.38333	92	148	240
12	"12-out17422"	.67857	266	126	392
12	"12-out17423"	.34666	78	147	225
12	"12-out17424"	.57272	63	47	110
12	"12-out17425"	.30194	279	645	924
12	"12-out17426"	.24776	111	337	448
12	"12-out17427"	.28392	136	343	479
12	"12-out17428"	.38095	152	247	399
12	"12-out17429"	.34844	246	460	706
12	"12-out17430"	.44311	74	93	167
12	"12-out17431"	.43023	37	49	86
12	"12-out17432"	.52913	563	501	1064
12	"12-out17433"	.27659	26	68	94
12	"12-out17434"	.47822	615	671	1286
12	"12-out17435"	.54430	43	36	79
12	"12-out17436"	.60714	51	33	84
12	"12-out17437"	.30603	142	322	464
12	"12-out17438"	.99740	384	1	385
12	"12-out17439"	.98863	87	1	88
12	"12-out17440"	.39810	379	573	952
12	"12-out17441"	.38775	323	510	833
12	"12-out17442"	.43157	123	162	285
12	"12-out17443"	.30089	402	934	1336
12	"12-out17444"	.23675	295	951	1246
12	"12-out17445"	.26054	105	298	403
12	"12-out17446"	.36555	121	210	331
12	"12-out17447"	.99683	315	1	316
12	"12-out17448"	.35446	123	224	347
12	"12-out17449"	.98989	98	1	99
12	"12-out17450"	.40608	694	1015	1709
12	"12-out17451"	.44027	446	567	1013
12	"12-out17452"	.42651	296	398	694
12	"12-out17453"	.29789	482	1136	1618
12	"12-out17454"	.29475	545	1304	1849
12	"12-out17455"	.44361	775	972	1747
12	"12-out17456"	.49831	593	597	1190
12	"12-out17457"	.58732	343	241	584
12	"12-out17458"	.44428	319	399	718
12	"12-out17459"	.35829	177	317	494
12	"12-out17460"	.31188	1561	3444	5005
12	"12-out17461"	.84250	337	63	400
12	"12-out17462"	.91543	433	40	473
12	"12-out17463"	.40801	173	251	424
12	"12-out17464"	.92592	400	32	432
12	"12-out17465"	.54444	245	205	450
12	"12-out17466"	.99069	426	4	430
12	"12-out17467"	.92198	520	44	564
12	"12-out17468"	.93085	525	39	564
12	"12-out17469"	.70084	827	353	1180
12	"12-out17470"	.63796	326	185	511
12	"12-out17471"	.54929	351	288	639
12	"12-out17472"	.64461	341	188	529
12	"12-out17473"	.61956	399	245	644
12	"12-out17474"	.98343	475	8	483
12	"12-out17475"	.36701	385	664	1049
12	"12-out17476"	.61796	461	285	746
12	"12-out17477"	.37660	264	437	701
12	"12-out17478"	.54970	188	154	342
12	"12-out17479"	.54700	128	106	234
12	"12-out17480"	.44623	166	206	372
12	"12-out17481"	.26732	108	296	404
12	"12-out17482"	.34210	65	125	190
12	"12-out17483"	.40983	150	216	366
12	"12-out17484"	.45273	273	330	603
12	"12-out17485"	.53469	131	114	245
12	"12-out17486"	.99735	377	1	378
12	"12-out17487"	.99735	377	1	378
12	"12-out17488"	.55737	136	108	244
12	"12-out17489"	.33196	81	163	244
12	"12-out17490"	.32405	128	267	395
12	"12-out17491"	.66582	263	132	395
12	"12-out17492"	.36434	47	82	129
12	"12-out17493"	.36061	141	250	391
12	"12-out17494"	.99936	1567	1	1568
12	"12-out17495"	.92771	154	12	166
12	"12-out17496"	.34905	37	69	106
12	"12-out17497"	.42890	181	241	422
12	"12-out17498"	.63951	424	239	663
12	"12-out17499"	.42213	103	141	244
12	"12-out17500"	.47846	200	218	418
12	"12-out17501"	.22284	80	279	359
12	"12-out17502"	.98039	50	1	51
12	"12-out17503"	.35872	146	261	407
12	"12-out17504"	.19034	67	285	352
12	"12-out17505"	.38403	101	162	263
12	"12-out17506"	.34000	119	231	350
12	"12-out17507"	.99844	643	1	644
12	"12-out17508"	.67254	343	167	510
12	"12-out17509"	.28571	132	330	462
12	"12-out17510"	.27900	291	752	1043
12	"12-out17511"	.39575	205	313	518
12	"12-out17512"	.46465	447	515	962
12	"12-out17513"	.59482	69	47	116
12	"12-out17514"	.32915	289	589	878
12	"12-out17515"	.46153	126	147	273
12	"12-out17516"	.33630	113	223	336
12	"12-out17517"	.78272	281	78	359
12	"12-out17518"	.31279	66	145	211
12	"12-out17519"	.36544	349	606	955
12	"12-out17520"	.45560	431	515	946
12	"12-out17521"	.35139	240	443	683
12	"12-out17522"	.33397	173	345	518
12	"12-out17523"	.39436	168	258	426
12	"12-out17524"	.25420	136	399	535
12	"12-out17525"	.55128	43	35	78
12	"12-out17526"	.80263	61	15	76
12	"12-out17527"	.97355	405	11	416
12	"12-out17528"	.47487	463	512	975
12	"12-out17529"	.44236	426	537	963
12	"12-out17530"	.31822	344	737	1081
12	"12-out17531"	.91907	954	84	1038
12	"12-out17532"	.47348	491	546	1037
12	"12-out17533"	.99024	203	2	205
12	"12-out17534"	.94634	194	11	205
12	"12-out17535"	.49287	242	249	491
12	"12-out17536"	.33272	182	365	547
12	"12-out17537"	.33743	137	269	406
12	"12-out17538"	.47305	158	176	334
12	"12-out17539"	.92733	268	21	289
12	"12-out17540"	.99633	815	3	818
12	"12-out17541"	.34964	243	452	695
12	"12-out17542"	.46341	95	110	205
12	"12-out17543"	.75609	124	40	164
12	"12-out17544"	.45454	70	84	154
12	"12-out17545"	.76351	113	35	148
12	"12-out17546"	.32716	336	691	1027
12	"12-out17547"	.99800	500	1	501
12	"12-out17548"	.36271	428	752	1180
12	"12-out17549"	.58629	693	489	1182
12	"12-out17550"	.31925	529	1128	1657
12	"12-out17551"	.35315	576	1055	1631
12	"12-out17552"	.41918	236	327	563
12	"12-out17553"	.40455	320	471	791
12	"12-out17554"	.34228	204	392	596
12	"12-out17555"	.21846	71	254	325
12	"12-out17556"	.47040	453	510	963
12	"12-out17557"	.23850	166	530	696
12	"12-out17558"	.27988	192	494	686
12	"12-out17559"	.44202	549	693	1242
12	"12-out17560"	.52391	701	637	1338
12	"12-out17561"	.89567	352	41	393
12	"12-out17562"	.41020	201	289	490
12	"12-out17563"	.41176	35	50	85
12	"12-out17564"	.38144	37	60	97
12	"12-out17565"	.60465	52	34	86
12	"12-out17566"	.40668	146	213	359
12	"12-out17567"	.29261	218	527	745
12	"12-out17568"	.33644	144	284	428
12	"12-out17569"	.62521	357	214	571
12	"12-out17570"	.42953	128	170	298
12	"12-out17571"	.37297	207	348	555
12	"12-out17572"	.54827	159	131	290
12	"12-out17573"	.99145	116	1	117
12	"12-out17574"	.86086	198	32	230
12	"12-out17575"	.26582	147	406	553
12	"12-out17576"	.45481	156	187	343
12	"12-out17577"	.48668	329	347	676
12	"12-out17578"	.99145	116	1	117
12	"12-out17579"	.99173	120	1	121
12	"12-out17580"	.99166	119	1	120
12	"12-out17581"	.35606	94	170	264
12	"12-out17582"	.39761	167	253	420
12	"12-out17583"	.41217	176	251	427
12	"12-out17584"	.99145	116	1	117
12	"12-out17585"	.21317	123	454	577
12	"12-out17586"	.95325	571	28	599
12	"12-out17587"	.72552	378	143	521
12	"12-out17588"	.37811	197	324	521
12	"12-out17589"	.90661	466	48	514
12	"12-out17590"	.40032	500	749	1249
12	"12-out17591"	.38650	189	300	489
12	"12-out17592"	.32344	109	228	337
12	"12-out17593"	.28354	131	331	462
12	"12-out17594"	.99500	597	3	600
12	"12-out17595"	.63313	321	186	507
12	"12-out17596"	.35934	221	394	615
12	"12-out17597"	.38031	313	510	823
12	"12-out17598"	.36431	243	424	667
12	"12-out17599"	.57941	259	188	447
12	"12-out17600"	.28340	140	354	494
12	"12-out17601"	.47741	148	162	310
12	"12-out17602"	.24870	287	867	1154
12	"12-out17603"	.34263	135	259	394
12	"12-out17604"	.72557	505	191	696
12	"12-out17605"	.45320	339	409	748
12	"12-out17606"	.36980	436	743	1179
12	"12-out17607"	.38888	455	715	1170
12	"12-out17608"	.61095	212	135	347
12	"12-out17609"	.35973	804	1431	2235
12	"12-out17610"	.58270	465	333	798
12	"12-out17611"	.35046	375	695	1070
12	"12-out17612"	.48202	496	533	1029
12	"12-out17613"	.33461	174	346	520
12	"12-out17614"	.39916	479	721	1200
12	"12-out17615"	.99621	263	1	264
12	"12-out17616"	.67763	309	147	456
12	"12-out17617"	.94148	531	33	564
12	"12-out17618"	.71319	373	150	523
12	"12-out17619"	.89423	372	44	416
12	"12-out17620"	.44840	943	1160	2103
12	"12-out17621"	.65740	355	185	540
12	"12-out17622"	.64878	375	203	578
12	"12-out17623"	.99573	467	2	469
12	"12-out17624"	.24015	61	193	254
12	"12-out17625"	.52768	162	145	307
12	"12-out17626"	.47807	218	238	456
12	"12-out17627"	.32284	277	581	858
12	"12-out17628"	.39376	202	311	513
12	"12-out17629"	.44800	224	276	500
12	"12-out17630"	.33822	599	1172	1771
12	"12-out17631"	.80039	405	101	506
12	"12-out17632"	.33076	559	1131	1690
12	"12-out17633"	.32451	135	281	416
12	"12-out17634"	.56144	265	207	472
12	"12-out17635"	.99521	208	1	209
12	"12-out17636"	.41823	133	185	318
12	"12-out17637"	.44211	485	612	1097
12	"12-out17638"	.31796	331	710	1041
12	"12-out17639"	.99512	204	1	205
12	"12-out17640"	.99504	201	1	202
12	"12-out17641"	.47431	277	307	584
12	"12-out17642"	.50652	233	227	460
12	"12-out17643"	.39541	138	211	349
12	"12-out17644"	.33481	151	300	451
12	"12-out17645"	.34337	171	327	498
12	"12-out17646"	.65631	317	166	483
12	"12-out17647"	.99224	128	1	129
12	"12-out17648"	.32478	38	79	117
12	"12-out17649"	.37304	811	1363	2174
12	"12-out17650"	.23584	50	162	212
12	"12-out17651"	.66666	96	48	144
12	"12-out17652"	.33000	66	134	200
12	"12-out17653"	.34137	467	901	1368
12	"12-out17654"	.46268	124	144	268
12	"12-out17655"	.53424	78	68	146
12	"12-out17656"	.39412	188	289	477
12	"12-out17657"	.99663	296	1	297
12	"12-out17658"	.78097	271	76	347
12	"12-out17659"	.99820	555	1	556
12	"12-out17660"	.47286	427	476	903
12	"12-out17661"	.75947	641	203	844
12	"12-out17662"	.36120	108	191	299
12	"12-out17663"	.35570	106	192	298
12	"12-out17664"	.44344	345	433	778
12	"12-out17665"	.47300	219	244	463
12	"12-out17666"	.42021	79	109	188
12	"12-out17667"	.46601	48	55	103
12	"12-out17668"	.40241	233	346	579
12	"12-out17669"	.41494	422	595	1017
12	"12-out17670"	.31680	313	675	988
12	"12-out17671"	.50603	503	491	994
12	"12-out17672"	.34683	274	516	790
12	"12-out17673"	.37901	307	503	810
12	"12-out17674"	.80452	996	242	1238
12	"12-out17675"	.47852	78	85	163
12	"12-out17676"	.42049	476	656	1132
12	"12-out17677"	.62378	514	310	824
12	"12-out17678"	.44318	117	147	264
12	"12-out17679"	.60828	382	246	628
12	"12-out17680"	.28947	55	135	190
12	"12-out17681"	.41505	579	816	1395
12	"12-out17682"	.36847	395	677	1072
12	"12-out17683"	.51646	298	279	577
12	"12-out17684"	.31282	610	1340	1950
12	"12-out17685"	.54608	705	586	1291
12	"12-out17686"	.99872	786	1	787
12	"12-out17687"	.88870	1605	201	1806
12	"12-out17688"	.43549	557	722	1279
12	"12-out17689"	.65782	471	245	716
12	"12-out17690"	.61752	289	179	468
12	"12-out17691"	.46767	217	247	464
12	"12-out17692"	.43155	186	245	431
12	"12-out17693"	.52006	324	299	623
12	"12-out17694"	.99684	632	2	634
12	"12-out17695"	.63169	283	165	448
12	"12-out17696"	.76489	488	150	638
12	"12-out17697"	.68965	380	171	551
12	"12-out17698"	.55961	291	229	520
12	"12-out17699"	.58691	314	221	535
12	"12-out17700"	.43988	150	191	341
12	"12-out17701"	.69267	435	193	628
12	"12-out17702"	.58801	314	220	534
12	"12-out17703"	.38815	118	186	304
12	"12-out17704"	.29258	146	353	499
12	"12-out17705"	.29392	92	221	313
12	"12-out17706"	.34926	95	177	272
12	"12-out17707"	.43856	232	297	529
12	"12-out17708"	.71206	183	74	257
12	"12-out17709"	.33486	146	290	436
12	"12-out17710"	.99307	287	2	289
12	"12-out17711"	.34174	298	574	872
12	"12-out17712"	.21356	85	313	398
12	"12-out17713"	.22195	93	326	419
12	"12-out17714"	.46478	396	456	852
12	"12-out17715"	.34753	367	689	1056
12	"12-out17716"	.38398	513	823	1336
12	"12-out17717"	.31735	490	1054	1544
12	"12-out17718"	.75064	1171	389	1560
12	"12-out17719"	.44552	732	911	1643
12	"12-out17720"	.68728	200	91	291
12	"12-out17721"	.96928	284	9	293
12	"12-out17722"	.27697	385	1005	1390
12	"12-out17723"	.30404	173	396	569
12	"12-out17724"	.82213	416	90	506
12	"12-out17725"	.47380	208	231	439
12	"12-out17726"	.85695	635	106	741
12	"12-out17727"	.32191	94	198	292
12	"12-out17728"	.37087	135	229	364
12	"12-out17729"	.46850	357	405	762
12	"12-out17730"	.99159	118	1	119
12	"12-out17731"	.51384	297	281	578
12	"12-out17732"	.34934	349	650	999
12	"12-out17733"	.99152	117	1	118
12	"12-out17734"	.99159	118	1	119
12	"12-out17735"	.18649	58	253	311
12	"12-out17736"	.40860	152	220	372
12	"12-out17737"	.20491	75	291	366
12	"12-out17738"	.44845	87	107	194
12	"12-out17739"	.27532	106	279	385
12	"12-out17740"	.80434	333	81	414
12	"12-out17741"	.83229	134	27	161
12	"12-out17742"	.53363	119	104	223
12	"12-out17743"	.99818	549	1	550
12	"12-out17744"	.47779	312	341	653
12	"12-out17745"	.65384	102	54	156
12	"12-out17746"	.43593	541	700	1241
12	"12-out17747"	.99567	230	1	231
12	"12-out17748"	.23200	29	96	125
12	"12-out17749"	.66260	163	83	246
12	"12-out17750"	.63694	500	285	785
12	"12-out17751"	.45945	68	80	148
12	"12-out17752"	.99399	331	2	333
12	"12-out17753"	.42222	133	182	315
12	"12-out17754"	.99346	152	1	153
12	"12-out17755"	.63195	352	205	557
12	"12-out17756"	.24479	47	145	192
12	"12-out17757"	.39285	110	170	280
12	"12-out17758"	.76056	108	34	142
12	"12-out17759"	.33333	83	166	249
12	"12-out17760"	.25925	35	100	135
12	"12-out17761"	.63524	155	89	244
12	"12-out17762"	.44884	136	167	303
12	"12-out17763"	.39866	419	632	1051
12	"12-out17764"	.30639	364	824	1188
12	"12-out17765"	.41624	328	460	788
12	"12-out17766"	.42035	475	655	1130
12	"12-out17767"	.37022	194	330	524
12	"12-out17768"	.46895	219	248	467
12	"12-out17769"	.46322	233	270	503
12	"12-out17770"	.38262	163	263	426
12	"12-out17771"	.41458	199	281	480
12	"12-out17772"	.29313	141	340	481
12	"12-out17773"	.48066	87	94	181
12	"12-out17774"	.33386	208	415	623
12	"12-out17775"	.34304	153	293	446
12	"12-out17776"	.96103	148	6	154
12	"12-out17777"	.47250	232	259	491
12	"12-out17778"	.35239	1972	3624	5596
12	"12-out17779"	.41250	33	47	80
12	"12-out17780"	.99393	164	1	165
12	"12-out17781"	.26519	48	133	181
12	"12-out17782"	.22349	78	271	349
12	"12-out17783"	.49453	633	647	1280
12	"12-out17784"	.83505	81	16	97
12	"12-out17785"	.65000	91	49	140
12	"12-out17786"	.99512	204	1	205
12	"12-out17787"	.56984	257	194	451
12	"12-out17788"	.99572	233	1	234
12	"12-out17789"	.83576	229	45	274
12	"12-out17790"	.92737	332	26	358
12	"12-out17791"	.31891	59	126	185
12	"12-out17792"	.30294	113	260	373
12	"12-out17793"	.97473	2122	55	2177
12	"12-out17794"	.99731	372	1	373
12	"12-out17795"	.62895	278	164	442
12	"12-out17796"	.86133	323	52	375
12	"12-out17797"	.23348	152	499	651
12	"12-out17798"	.47500	285	315	600
12	"12-out17799"	.27434	231	611	842
12	"12-out17800"	.31280	381	837	1218
12	"12-out17801"	.46968	1193	1347	2540
12	"12-out17802"	.31980	331	704	1035
12	"12-out17803"	.74677	867	294	1161
12	"12-out17804"	.62987	97	57	154
12	"12-out17805"	.32465	374	778	1152
12	"12-out17806"	.38740	406	642	1048
12	"12-out17807"	.62318	86	52	138
12	"12-out17808"	.99600	249	1	250
12	"12-out17809"	.48648	468	494	962
12	"12-out17810"	.48166	197	212	409
12	"12-out17811"	.62113	241	147	388
12	"12-out17812"	.99145	116	1	117
12	"12-out17813"	.99152	117	1	118
12	"12-out17814"	.58762	114	80	194
12	"12-out17815"	.99333	149	1	150
12	"12-out17816"	.65454	72	38	110
12	"12-out17817"	.99145	116	1	117
12	"12-out17818"	.99285	139	1	140
12	"12-out17819"	.27272	45	120	165
12	"12-out17820"	.36580	338	586	924
12	"12-out17821"	.81434	193	44	237
12	"12-out17822"	.37099	243	412	655
12	"12-out17823"	.48146	1091	1175	2266
12	"12-out17824"	.89816	882	100	982
12	"12-out17825"	.42233	87	119	206
12	"12-out17826"	.45436	463	556	1019
12	"12-out17827"	.22689	27	92	119
12	"12-out17828"	.73275	85	31	116
12	"12-out17829"	.78854	179	48	227
12	"12-out17830"	.47136	107	120	227
12	"12-out17831"	.73177	532	195	727
12	"12-out17832"	.87737	508	71	579
12	"12-out17833"	.28804	53	131	184
12	"12-out17834"	.36116	186	329	515
12	"12-out17835"	.30719	478	1078	1556
12	"12-out17836"	.44522	252	314	566
12	"12-out17837"	.61832	81	50	131
12	"12-out17838"	.52517	73	66	139
12	"12-out17839"	.91875	147	13	160
12	"12-out17840"	.31306	206	452	658
12	"12-out17841"	.80581	776	187	963
12	"12-out17842"	.36702	374	645	1019
12	"12-out17843"	.42356	399	543	942
12	"12-out17844"	.26760	285	780	1065
12	"12-out17845"	.38741	831	1314	2145
12	"12-out17846"	.44986	323	395	718
12	"12-out17847"	.97073	199	6	205
12	"12-out17848"	.80936	484	114	598
12	"12-out17849"	.35193	164	302	466
12	"12-out17850"	.19626	21	86	107
12	"12-out17851"	.58490	93	66	159
12	"12-out17852"	.40418	116	171	287
12	"12-out17853"	.29802	287	676	963
12	"12-out17854"	.62903	936	552	1488
12	"12-out17855"	.39428	621	954	1575
12	"12-out17856"	.59756	49	33	82
12	"12-out17857"	.99859	711	1	712
12	"12-out17858"	.34560	216	409	625
12	"12-out17859"	.38169	221	358	579
12	"12-out17860"	.25057	325	972	1297
12	"12-out17861"	.25976	359	1023	1382
12	"12-out17862"	.41481	56	79	135
12	"12-out17863"	.52112	111	102	213
12	"12-out17864"	.37541	452	752	1204
12	"12-out17865"	.31095	681	1509	2190
12	"12-out17866"	.78803	461	124	585
12	"12-out17867"	.47347	473	526	999
12	"12-out17868"	.83425	151	30	181
12	"12-out17869"	.29317	73	176	249
12	"12-out17870"	.24671	75	229	304
12	"12-out17871"	.44444	156	195	351
12	"12-out17872"	.37375	826	1384	2210
12	"12-out17873"	.99765	426	1	427
12	"12-out17874"	.54564	257	214	471
12	"12-out17875"	.45027	566	691	1257
12	"12-out17876"	.72055	361	140	501
12	"12-out17877"	.89017	462	57	519
12	"12-out17878"	.45238	323	391	714
12	"12-out17879"	.37073	456	774	1230
12	"12-out17880"	.46296	225	261	486
12	"12-out17881"	.26420	172	479	651
12	"12-out17882"	.20192	42	166	208
12	"12-out17883"	.26375	417	1164	1581
12	"12-out17884"	.41282	161	229	390
12	"12-out17885"	.34411	117	223	340
12	"12-out17886"	.35163	397	732	1129
12	"12-out17887"	.52645	408	367	775
12	"12-out17888"	.99309	719	5	724
12	"12-out17889"	.81903	525	116	641
12	"12-out17890"	.73684	308	110	418
12	"12-out17891"	.35668	168	303	471
12	"12-out17892"	.99159	118	1	119
12	"12-out17893"	.99145	116	1	117
12	"12-out17894"	.99145	116	1	117
12	"12-out17895"	.41860	126	175	301
12	"12-out17896"	.99145	116	1	117
12	"12-out17897"	.52727	174	156	330
12	"12-out17898"	.41695	241	337	578
12	"12-out17899"	.35483	55	100	155
12	"12-out17900"	.47983	119	129	248
12	"12-out17901"	.70254	248	105	353
12	"12-out17902"	.84000	105	20	125
12	"12-out17903"	.91729	122	11	133
12	"12-out17904"	.70698	415	172	587
12	"12-out17905"	.74896	361	121	482
12	"12-out17906"	.57352	156	116	272
12	"12-out17907"	.38850	669	1053	1722
12	"12-out17908"	.45762	324	384	708
12	"12-out17909"	.35750	143	257	400
12	"12-out17910"	.70903	212	87	299
12	"12-out17911"	.41680	253	354	607
12	"12-out17912"	.55873	176	139	315
12	"12-out17913"	.29385	67	161	228
12	"12-out17914"	.99470	188	1	189
12	"12-out17915"	.93650	177	12	189
12	"12-out17916"	.99470	188	1	189
12	"12-out17917"	.38502	72	115	187
12	"12-out17918"	.59932	356	238	594
12	"12-out17919"	.98500	197	3	200
12	"12-out17920"	.99489	195	1	196
12	"12-out17921"	.99441	178	1	179
12	"12-out17922"	.66455	315	159	474
12	"12-out17923"	.18055	26	118	144
12	"12-out17924"	.40294	328	486	814
12	"12-out17925"	.19092	261	1106	1367
12	"12-out17926"	.98387	122	2	124
12	"12-out17927"	.32214	403	848	1251
12	"12-out17928"	1.00000	384	0	384
12	"12-out17929"	.42138	67	92	159
12	"12-out17930"	1.00000	106	0	106
12	"12-out17931"	.89671	191	22	213
12	"12-out17932"	.91957	343	30	373
12	"12-out17933"	.34108	308	595	903
12	"12-out17934"	.32291	62	130	192
12	"12-out17935"	.32185	430	906	1336
12	"12-out17936"	.80485	961	233	1194
12	"12-out17937"	.43980	179	228	407
12	"12-out17938"	.99371	474	3	477
12	"12-out17939"	.42545	351	474	825
12	"12-out17940"	.50980	78	75	153
12	"12-out17941"	.41666	75	105	180
12	"12-out17942"	.36481	197	343	540
12	"12-out17943"	.22458	95	328	423
12	"12-out17944"	.29124	173	421	594
12	"12-out17945"	.76041	292	92	384
12	"12-out17946"	.51012	126	121	247
12	"12-out17947"	.49113	194	201	395
12	"12-out17948"	.99305	143	1	144
12	"12-out17949"	.45892	257	303	560
12	"12-out17950"	.32000	64	136	200
12	"12-out17951"	.47234	316	353	669
12	"12-out17952"	.57565	175	129	304
12	"12-out17953"	.99074	107	1	108
12	"12-out17954"	.32716	230	473	703
12	"12-out17955"	.37113	72	122	194
12	"12-out17956"	.36199	80	141	221
12	"12-out17957"	.30088	68	158	226
12	"12-out17958"	.99145	116	1	117
12	"12-out17959"	.99145	116	1	117
12	"12-out17960"	.42628	133	179	312
12	"12-out17961"	.99861	723	1	724
12	"12-out17962"	.45375	157	189	346
12	"12-out17963"	.76734	188	57	245
12	"12-out17964"	.67973	104	49	153
12	"12-out17965"	.38335	608	978	1586
12	"12-out17966"	.25939	69	197	266
12	"12-out17967"	.36774	228	392	620
12	"12-out17968"	.47200	59	66	125
12	"12-out17969"	1.00000	326	0	326
12	"12-out17970"	.91044	305	30	335
12	"12-out17971"	.34177	54	104	158
12	"12-out17972"	.99390	163	1	164
12	"12-out17973"	.99056	105	1	106
12	"12-out17974"	.99470	376	2	378
12	"12-out17975"	.20133	121	480	601
12	"12-out17976"	.33809	142	278	420
12	"12-out17977"	.75599	694	224	918
12	"12-out17978"	.37721	192	317	509
12	"12-out17979"	.33333	153	306	459
12	"12-out17980"	.48484	48	51	99
12	"12-out17981"	.32638	47	97	144
12	"12-out17982"	.38278	209	337	546
12	"12-out17983"	.45226	289	350	639
12	"12-out17984"	.35204	138	254	392
12	"12-out17985"	.60518	210	137	347
12	"12-out17986"	.44186	323	408	731
12	"12-out17987"	.56333	338	262	600
12	"12-out17988"	.38160	332	538	870
12	"12-out17989"	.99701	334	1	335
12	"12-out17990"	.28684	109	271	380
12	"12-out17991"	.41316	502	713	1215
12	"12-out17992"	.65587	324	170	494
12	"12-out17993"	.37393	132	221	353
12	"12-out17994"	.69230	234	104	338
12	"12-out17995"	.70792	286	118	404
12	"12-out17996"	.37837	126	207	333
12	"12-out17997"	.70464	501	210	711
12	"12-out17998"	.48623	212	224	436
12	"12-out17999"	.51568	263	247	510
12	"12-out18000"	.23093	218	726	944
12	"12-out18001"	.53318	466	408	874
12	"12-out18002"	.35782	112	201	313
12	"12-out18003"	.74576	308	105	413
12	"12-out18004"	.76630	282	86	368
12	"12-out18005"	.14285	10	60	70
12	"12-out18006"	.95945	568	24	592
12	"12-out18007"	.78125	500	140	640
12	"12-out18008"	.33333	151	302	453
12	"12-out18009"	.38805	26	41	67
12	"12-out18010"	.19517	89	367	456
12	"12-out18011"	.24218	124	388	512
12	"12-out18012"	.73515	1238	446	1684
12	"12-out18013"	.47604	159	175	334
12	"12-out18014"	.52261	104	95	199
12	"12-out18015"	.30978	57	127	184
12	"12-out18016"	.35195	63	116	179
12	"12-out18017"	.45631	94	112	206
12	"12-out18018"	.28248	50	127	177
12	"12-out18019"	.72925	167	62	229
12	"12-out18020"	.35886	164	293	457
12	"12-out18021"	.76331	129	40	169
12	"12-out18022"	.84688	177	32	209
12	"12-out18023"	.38461	180	288	468
12	"12-out18024"	.99808	520	1	521
12	"12-out18025"	.45646	173	206	379
12	"12-out18026"	.14380	65	387	452
12	"12-out18027"	.99820	555	1	556
12	"12-out18028"	.22782	131	444	575
12	"12-out18029"	.70046	304	130	434
12	"12-out18030"	.23388	127	416	543
12	"12-out18031"	.34328	115	220	335
12	"12-out18032"	.86976	1142	171	1313
12	"12-out18033"	.44413	159	199	358
12	"12-out18034"	.30116	206	478	684
12	"12-out18035"	.50625	81	79	160
12	"12-out18036"	.26446	64	178	242
12	"12-out18037"	.44354	110	138	248
12	"12-out18038"	.53714	1005	866	1871
12	"12-out18039"	.99705	338	1	339
12	"12-out18040"	.33980	210	408	618
12	"12-out18041"	.67187	387	189	576
12	"12-out18042"	.56848	689	523	1212
12	"12-out18043"	.50760	267	259	526
12	"12-out18044"	.55043	382	312	694
12	"12-out18045"	.99849	665	1	666
12	"12-out18046"	.23507	63	205	268
12	"12-out18047"	.35546	166	301	467
12	"12-out18048"	.52298	182	166	348
12	"12-out18049"	.17333	13	62	75
12	"12-out18050"	.29899	119	279	398
12	"12-out18051"	.28787	95	235	330
12	"12-out18052"	.47149	488	547	1035
12	"12-out18053"	.35603	115	208	323
12	"12-out18054"	.37547	199	331	530
12	"12-out18055"	.38324	151	243	394
12	"12-out18056"	.26190	22	62	84
12	"12-out18057"	.48664	164	173	337
12	"12-out18058"	.99082	108	1	109
12	"12-out18059"	.99850	667	1	668
12	"12-out18060"	.34748	524	984	1508
12	"12-out18061"	.45475	196	235	431
12	"12-out18062"	.29545	91	217	308
12	"12-out18063"	.95000	152	8	160
12	"12-out18064"	.42335	174	237	411
12	"12-out18065"	.50673	301	293	594
12	"12-out18066"	.28725	133	330	463
12	"12-out18067"	.27760	88	229	317
12	"12-out18068"	.33202	169	340	509
12	"12-out18069"	.99497	198	1	199
12	"12-out18070"	.43378	95	124	219
12	"12-out18071"	.42682	140	188	328
12	"12-out18072"	.61111	99	63	162
12	"12-out18073"	.06451	10	145	155
12	"12-out18074"	.41968	81	112	193
12	"12-out18075"	.27683	49	128	177
12	"12-out18076"	.49122	280	290	570
12	"12-out18077"	.39483	107	164	271
12	"12-out18078"	.57866	320	233	553
12	"12-out18079"	.48204	255	274	529
12	"12-out18080"	.35687	96	173	269
12	"12-out18081"	.40131	61	91	152
12	"12-out18082"	.45518	259	310	569
12	"12-out18083"	.30508	54	123	177
12	"12-out18084"	.24431	43	133	176
12	"12-out18085"	.31412	169	369	538
12	"12-out18086"	.49122	84	87	171
12	"12-out18087"	.48529	132	140	272
12	"12-out18088"	.87477	489	70	559
12	"12-out18089"	.99728	368	1	369
12	"12-out18090"	.22635	67	229	296
12	"12-out18091"	.80750	495	118	613
12	"12-out18092"	.36206	231	407	638
12	"12-out18093"	.27948	109	281	390
12	"12-out18094"	.68089	335	157	492
12	"12-out18095"	.99561	227	1	228
12	"12-out18096"	.99242	131	1	132
12	"12-out18097"	.95767	181	8	189
12	"12-out18098"	.99470	188	1	189
12	"12-out18099"	.99470	188	1	189
12	"12-out18100"	.35714	145	261	406
12	"12-out18101"	.54819	91	75	166
12	"12-out18102"	.99500	199	1	200
12	"12-out18103"	.37694	170	281	451
12	"12-out18104"	.45394	138	166	304
12	"12-out18105"	.56213	380	296	676
12	"12-out18106"	.48717	95	100	195
12	"12-out18107"	.76666	138	42	180
12	"12-out18108"	.42535	151	204	355
12	"12-out18109"	.97023	326	10	336
12	"12-out18110"	.57013	126	95	221
12	"12-out18111"	.44827	130	160	290
12	"12-out18112"	.73170	180	66	246
12	"12-out18113"	.25423	150	440	590
12	"12-out18114"	.39433	362	556	918
12	"12-out18115"	.95073	193	10	203
12	"12-out18116"	.38095	232	377	609
12	"12-out18117"	.93333	210	15	225
12	"12-out18118"	.41954	438	606	1044
12	"12-out18119"	.40615	699	1022	1721
12	"12-out18120"	.44843	200	246	446
12	"12-out18121"	.50234	429	425	854
12	"12-out18122"	.50920	83	80	163
12	"12-out18123"	.99305	143	1	144
12	"12-out18124"	.13934	51	315	366
12	"12-out18125"	.35579	132	239	371
12	"12-out18126"	.40996	214	308	522
12	"12-out18127"	.34296	261	500	761
12	"12-out18128"	.57432	170	126	296
12	"12-out18129"	.65536	116	61	177
12	"12-out18130"	.77179	301	89	390
12	"12-out18131"	.21252	190	704	894
12	"12-out18132"	.70000	84	36	120
12	"12-out18133"	.75145	1684	557	2241
12	"12-out18134"	.47826	66	72	138
12	"12-out18135"	.26730	112	307	419
12	"12-out18136"	.52127	245	225	470
12	"12-out18137"	.99803	507	1	508
12	"12-out18138"	.59441	362	247	609
12	"12-out18139"	.41031	334	480	814
12	"12-out18140"	.59259	48	33	81
12	"12-out18141"	.24262	74	231	305
12	"12-out18142"	.47186	218	244	462
12	"12-out18143"	.23629	125	404	529
12	"12-out18144"	.32482	191	397	588
12	"12-out18145"	.24807	226	685	911
12	"12-out18146"	.76532	724	222	946
12	"12-out18147"	.31460	280	610	890
12	"12-out18148"	.30107	280	650	930
12	"12-out18149"	.33174	139	280	419
12	"12-out18150"	.37016	134	228	362
12	"12-out18151"	.26290	163	457	620
12	"12-out18152"	.51488	173	163	336
12	"12-out18153"	.60383	189	124	313
12	"12-out18154"	.99152	117	1	118
12	"12-out18155"	.29870	161	378	539
12	"12-out18156"	.39130	135	210	345
12	"12-out18157"	.99824	568	1	569
12	"12-out18158"	.77142	216	64	280
12	"12-out18159"	.38947	259	406	665
12	"12-out18160"	.99539	216	1	217
12	"12-out18161"	.35329	59	108	167
12	"12-out18162"	.91322	221	21	242
12	"12-out18163"	.50221	227	225	452
12	"12-out18164"	.52468	287	260	547
12	"12-out18165"	.41509	22	31	53
12	"12-out18166"	1.00000	106	0	106
12	"12-out18167"	.44955	459	562	1021
12	"12-out18168"	.43153	104	137	241
12	"12-out18169"	.28982	131	321	452
12	"12-out18170"	.35365	58	106	164
12	"12-out18171"	.35251	147	270	417
12	"12-out18172"	.46694	113	129	242
12	"12-out18173"	.37967	254	415	669
12	"12-out18174"	.59450	173	118	291
12	"12-out18175"	.37410	208	348	556
12	"12-out18176"	.34577	213	403	616
12	"12-out18177"	.36775	203	349	552
12	"12-out18178"	.30303	160	368	528
12	"12-out18179"	.33490	71	141	212
12	"12-out18180"	.46280	168	195	363
12	"12-out18181"	.83564	483	95	578
12	"12-out18182"	.35703	241	434	675
12	"12-out18183"	.34545	114	216	330
12	"12-out18184"	.31679	83	179	262
12	"12-out18185"	.24436	130	402	532
12	"12-out18186"	.25166	227	675	902
12	"12-out18187"	.28921	118	290	408
12	"12-out18188"	.15789	159	848	1007
12	"12-out18189"	.22753	200	679	879
12	"12-out18190"	.28481	227	570	797
12	"12-out18191"	.33440	209	416	625
12	"12-out18192"	.40364	354	523	877
12	"12-out18193"	.97826	360	8	368
12	"12-out18194"	.22959	211	708	919
12	"12-out18195"	.41409	376	532	908
12	"12-out18196"	.40481	387	569	956
12	"12-out18197"	.51612	112	105	217
12	"12-out18198"	.35816	351	629	980
12	"12-out18199"	.88807	603	76	679
12	"12-out18200"	.40096	1083	1618	2701
12	"12-out18201"	.72383	249	95	344
12	"12-out18202"	.46041	221	259	480
12	"12-out18203"	.39583	133	203	336
12	"12-out18204"	.41190	699	998	1697
12	"12-out18205"	.47470	713	789	1502
12	"12-out18206"	.16287	43	221	264
12	"12-out18207"	.30504	266	606	872
12	"12-out18208"	.33706	211	415	626
12	"12-out18209"	.25717	233	673	906
12	"12-out18210"	.51686	521	487	1008
12	"12-out18211"	.42567	63	85	148
12	"12-out18212"	.99658	292	1	293
12	"12-out18213"	.23708	101	325	426
12	"12-out18214"	.83414	171	34	205
12	"12-out18215"	.53696	138	119	257
12	"12-out18216"	.39516	196	300	496
12	"12-out18217"	.44881	228	280	508
12	"12-out18218"	.71694	347	137	484
12	"12-out18219"	.99581	238	1	239
12	"12-out18220"	.34913	81	151	232
12	"12-out18221"	.35530	124	225	349
12	"12-out18222"	.63503	174	100	274
12	"12-out18223"	.36734	234	403	637
12	"12-out18224"	.95945	213	9	222
12	"12-out18225"	.41287	109	155	264
12	"12-out18226"	.96330	210	8	218
12	"12-out18227"	.99473	944	5	949
12	"12-out18228"	.35714	215	387	602
12	"12-out18229"	.39972	289	434	723
12	"12-out18230"	.25490	39	114	153
12	"12-out18231"	.40259	155	230	385
12	"12-out18232"	.43610	215	278	493
12	"12-out18233"	.99694	326	1	327
12	"12-out18234"	.40666	122	178	300
12	"12-out18235"	.35185	152	280	432
12	"12-out18236"	.57416	120	89	209
12	"12-out18237"	.67878	224	106	330
12	"12-out18238"	.30055	217	505	722
12	"12-out18239"	.61585	101	63	164
12	"12-out18240"	.22844	106	358	464
12	"12-out18241"	.34328	207	396	603
12	"12-out18242"	.33720	203	399	602
12	"12-out18243"	.36144	210	371	581
12	"12-out18244"	.42097	269	370	639
12	"12-out18245"	.45372	201	242	443
12	"12-out18246"	.48327	289	309	598
12	"12-out18247"	.48507	65	69	134
12	"12-out18248"	.85932	281	46	327
12	"12-out18249"	.53020	79	70	149
12	"12-out18250"	.37368	71	119	190
12	"12-out18251"	.12299	23	164	187
12	"12-out18252"	.30303	120	276	396
12	"12-out18253"	.41148	86	123	209
12	"12-out18254"	.99881	840	1	841
12	"12-out18255"	.51121	228	218	446
12	"12-out18256"	.92631	264	21	285
12	"12-out18257"	.48307	585	626	1211
12	"12-out18258"	.33445	299	595	894
12	"12-out18259"	.50564	179	175	354
12	"12-out18260"	.98711	996	13	1009
12	"12-out18261"	.40138	232	346	578
12	"12-out18262"	.36347	201	352	553
12	"12-out18263"	.47256	155	173	328
12	"12-out18264"	.99065	106	1	107
12	"12-out18265"	.40905	515	744	1259
12	"12-out18266"	.54347	225	189	414
12	"12-out18267"	.27302	753	2005	2758
12	"12-out18268"	.25645	685	1986	2671
12	"12-out18269"	.12500	48	336	384
12	"12-out18270"	.36296	49	86	135
12	"12-out18271"	.76678	628	191	819
12	"12-out18272"	.46472	191	220	411
12	"12-out18273"	.67634	163	78	241
12	"12-out18274"	.38185	181	293	474
12	"12-out18275"	.31275	76	167	243
12	"12-out18276"	.41726	58	81	139
12	"12-out18277"	.94388	942	56	998
12	"12-out18278"	.39189	29	45	74
12	"12-out18279"	.99876	809	1	810
12	"12-out18280"	.48805	286	300	586
12	"12-out18281"	.99099	110	1	111
12	"12-out18282"	.45000	135	165	300
12	"12-out18283"	.53594	82	71	153
12	"12-out18284"	.99447	180	1	181
12	"12-out18285"	.96314	392	15	407
12	"12-out18286"	.37711	603	996	1599
12	"12-out18287"	.45741	725	860	1585
12	"12-out18288"	.44700	97	120	217
12	"12-out18289"	.30286	275	633	908
12	"12-out18290"	.32842	290	593	883
12	"12-out18291"	.39123	232	361	593
12	"12-out18292"	.32328	386	808	1194
12	"12-out18293"	.99590	243	1	244
12	"12-out18294"	.49390	243	249	492
12	"12-out18295"	.32042	91	193	284
12	"12-out18296"	.59821	67	45	112
12	"12-out18297"	.34825	70	131	201
12	"12-out18298"	.60833	146	94	240
12	"12-out18299"	.52608	353	318	671
12	"12-out18300"	.31494	822	1788	2610
12	"12-out18301"	.22353	359	1247	1606
12	"12-out18302"	.26399	415	1157	1572
12	"12-out18303"	.99915	1180	1	1181
12	"12-out18304"	.41419	572	809	1381
12	"12-out18305"	.40811	342	496	838
12	"12-out18306"	.51707	106	99	205
12	"12-out18307"	.45485	267	320	587
12	"12-out18308"	.49759	207	209	416
12	"12-out18309"	.43146	469	618	1087
12	"12-out18310"	.38847	209	329	538
12	"12-out18311"	.55263	168	136	304
12	"12-out18312"	.80429	337	82	419
12	"12-out18313"	.40418	251	370	621
12	"12-out18314"	.21989	42	149	191
12	"12-out18315"	.93916	633	41	674
12	"12-out18316"	.69736	477	207	684
12	"12-out18317"	.48753	176	185	361
12	"12-out18318"	.76854	259	78	337
12	"12-out18319"	.85459	288	49	337
12	"12-out18320"	.32048	133	282	415
12	"12-out18321"	.29807	124	292	416
12	"12-out18322"	.29857	126	296	422
12	"12-out18323"	.61927	257	158	415
12	"12-out18324"	.27293	122	325	447
12	"12-out18325"	.33855	173	338	511
12	"12-out18326"	.41288	173	246	419
12	"12-out18327"	.37027	137	233	370
12	"12-out18328"	.34285	132	253	385
12	"12-out18329"	.43487	207	269	476
12	"12-out18330"	.41132	109	156	265
12	"12-out18331"	.28879	67	165	232
12	"12-out18332"	.26635	114	314	428
12	"12-out18333"	.29355	123	296	419
12	"12-out18334"	.32158	73	154	227
12	"12-out18335"	.40740	110	160	270
12	"12-out18336"	.38258	145	234	379
12	"12-out18337"	.34358	134	256	390
12	"12-out18338"	.52340	123	112	235
12	"12-out18339"	.77060	215	64	279
12	"12-out18340"	.43971	186	237	423
12	"12-out18341"	.71428	95	38	133
12	"12-out18342"	.32248	109	229	338
12	"12-out18343"	.18614	86	376	462
12	"12-out18344"	.67857	57	27	84
12	"12-out18345"	.63076	205	120	325
12	"12-out18346"	.44866	118	145	263
12	"12-out18347"	.55263	147	119	266
12	"12-out18348"	.41198	110	157	267
12	"12-out18349"	.22023	37	131	168
12	"12-out18350"	.39958	193	290	483
12	"12-out18351"	.20777	139	530	669
12	"12-out18352"	.99324	147	1	148
12	"12-out18353"	.96169	477	19	496
12	"12-out18354"	.43346	215	281	496
12	"12-out18355"	.97356	221	6	227
12	"12-out18356"	.99551	222	1	223
12	"12-out18357"	.62049	430	263	693
12	"12-out18358"	.64516	60	33	93
12	"12-out18359"	.58101	355	256	611
12	"12-out18360"	.54347	100	84	184
12	"12-out18361"	.31660	82	177	259
12	"12-out18362"	.23505	59	192	251
12	"12-out18363"	.33662	409	806	1215
12	"12-out18364"	.35084	334	618	952
12	"12-out18365"	.42044	362	499	861
12	"12-out18366"	.30168	305	706	1011
12	"12-out18367"	.99824	569	1	570
12	"12-out18368"	.10052	19	170	189
12	"12-out18369"	.29752	72	170	242
12	"12-out18370"	.35781	229	411	640
12	"12-out18371"	.49183	241	249	490
12	"12-out18372"	.35735	238	428	666
12	"12-out18373"	.30460	152	347	499
12	"12-out18374"	.27598	154	404	558
12	"12-out18375"	.54828	176	145	321
12	"12-out18376"	.37793	161	265	426
12	"12-out18377"	.31919	158	337	495
12	"12-out18378"	.38608	222	353	575
12	"12-out18379"	.19839	99	400	499
12	"12-out18380"	.35905	121	216	337
12	"12-out18381"	.39359	209	322	531
12	"12-out18382"	.99839	621	1	622
12	"12-out18383"	.40800	530	769	1299
12	"12-out18384"	.61958	386	237	623
12	"12-out18385"	.22000	55	195	250
12	"12-out18386"	.36778	121	208	329
12	"12-out18387"	.25519	270	788	1058
12	"12-out18388"	.99889	908	1	909
12	"12-out18389"	.99825	573	1	574
12	"12-out18390"	.53680	350	302	652
12	"12-out18391"	.47539	396	437	833
12	"12-out18392"	.29976	125	292	417
12	"12-out18393"	.99090	109	1	110
12	"12-out18394"	.98319	117	2	119
12	"12-out18395"	1.00000	353	0	353
12	"12-out18396"	1.00000	340	0	340
12	"12-out18397"	1.00000	377	0	377
12	"12-out18398"	1.00000	453	0	453
12	"12-out18399"	1.00000	106	0	106
12	"12-out18400"	.32976	154	313	467
12	"12-out18401"	.42492	133	180	313
12	"12-out18402"	.39956	185	278	463
12	"12-out18403"	.39783	220	333	553
12	"12-out18404"	.21052	60	225	285
12	"12-out18405"	.90666	136	14	150
12	"12-out18406"	.98901	90	1	91
12	"12-out18407"	.38202	136	220	356
12	"12-out18408"	.51437	161	152	313
12	"12-out18409"	.17341	90	429	519
12	"12-out18410"	.29277	154	372	526
12	"12-out18411"	.39843	51	77	128
12	"12-out18412"	.21367	125	460	585
12	"12-out18413"	.41050	172	247	419
12	"12-out18414"	.46067	82	96	178
12	"12-out18415"	.98717	77	1	78
12	"12-out18416"	.35616	52	94	146
12	"12-out18417"	.33183	442	890	1332
12	"12-out18418"	.56111	101	79	180
12	"12-out18419"	.37055	73	124	197
12	"12-out18420"	.72772	147	55	202
12	"12-out18421"	.23926	39	124	163
12	"12-out18422"	.48798	264	277	541
12	"12-out18423"	.87341	483	70	553
12	"12-out18424"	.49246	196	202	398
12	"12-out18425"	.40000	62	93	155
12	"12-out18426"	.35449	67	122	189
12	"12-out18427"	.39268	247	382	629
12	"12-out18428"	.90946	221	22	243
12	"12-out18429"	.44464	245	306	551
12	"12-out18430"	.29411	45	108	153
12	"12-out18431"	.86624	136	21	157
12	"12-out18432"	.30054	220	512	732
12	"12-out18433"	.93162	218	16	234
12	"12-out18434"	.47777	129	141	270
12	"12-out18435"	.34406	171	326	497
12	"12-out18436"	.99541	217	1	218
12	"12-out18437"	.41248	370	527	897
12	"12-out18438"	.36842	56	96	152
12	"12-out18439"	.49433	131	134	265
12	"12-out18440"	.43092	262	346	608
12	"12-out18441"	.33154	185	373	558
12	"12-out18442"	.35090	213	394	607
12	"12-out18443"	.29734	157	371	528
12	"12-out18444"	.26476	139	386	525
12	"12-out18445"	.52592	284	256	540
12	"12-out18446"	.28289	544	1379	1923
12	"12-out18447"	.23502	51	166	217
12	"12-out18448"	.38144	74	120	194
12	"12-out18449"	.37147	724	1225	1949
12	"12-out18450"	.95206	993	50	1043
12	"12-out18451"	.43750	189	243	432
12	"12-out18452"	.40217	74	110	184
12	"12-out18453"	.97297	216	6	222
12	"12-out18454"	.97297	216	6	222
12	"12-out18455"	.99590	243	1	244
12	"12-out18456"	.60476	127	83	210
12	"12-out18457"	.43681	515	664	1179
12	"12-out18458"	.59124	567	392	959
12	"12-out18459"	.99583	239	1	240
12	"12-out18460"	.99473	944	5	949
12	"12-out18461"	.37942	236	386	622
12	"12-out18462"	.29166	210	510	720
12	"12-out18463"	.99806	515	1	516
12	"12-out18464"	.48927	935	976	1911
12	"12-out18465"	.37444	170	284	454
12	"12-out18466"	.99664	595	2	597
12	"12-out18467"	.90024	370	41	411
12	"12-out18468"	.60629	154	100	254
12	"12-out18469"	.52300	216	197	413
12	"12-out18470"	.37242	181	305	486
12	"12-out18471"	.37723	782	1291	2073
12	"12-out18472"	.34828	233	436	669
12	"12-out18473"	.40147	218	325	543
12	"12-out18474"	.43852	214	274	488
12	"12-out18475"	.36604	138	239	377
12	"12-out18476"	.43685	339	437	776
12	"12-out18477"	.40319	783	1159	1942
12	"12-out18478"	.46139	508	593	1101
12	"12-out18479"	.35281	163	299	462
12	"12-out18480"	.42424	56	76	132
12	"12-out18481"	.24409	93	288	381
12	"12-out18482"	.99578	708	3	711
12	"12-out18483"	.69047	58	26	84
12	"12-out18484"	.58666	132	93	225
12	"12-out18485"	.96330	210	8	218
12	"12-out18486"	.44308	218	274	492
12	"12-out18487"	.38676	415	658	1073
12	"12-out18488"	.47368	99	110	209
12	"12-out18489"	.49846	162	163	325
12	"12-out18490"	.34117	87	168	255
12	"12-out18491"	.28256	141	358	499
12	"12-out18492"	.28159	205	523	728
12	"12-out18493"	.27107	328	882	1210
12	"12-out18494"	.41784	206	287	493
12	"12-out18495"	.29105	296	721	1017
12	"12-out18496"	.29203	66	160	226
12	"12-out18497"	.47603	298	328	626
12	"12-out18498"	.39327	234	361	595
12	"12-out18499"	.30927	60	134	194
12	"12-out18500"	.96923	504	16	520
12	"12-out18501"	.26419	121	337	458
12	"12-out18502"	.32061	168	356	524
12	"12-out18503"	.30538	51	116	167
12	"12-out18504"	.40480	219	322	541
12	"12-out18505"	.27407	148	392	540
12	"12-out18506"	.35943	202	360	562
12	"12-out18507"	.28810	138	341	479
12	"12-out18508"	.97520	354	9	363
12	"12-out18509"	.30268	79	182	261
12	"12-out18510"	.37865	337	553	890
12	"12-out18511"	.31753	134	288	422
12	"12-out18512"	.38572	773	1231	2004
12	"12-out18513"	.48458	220	234	454
12	"12-out18514"	.32346	153	320	473
12	"12-out18515"	.31250	95	209	304
12	"12-out18516"	.59618	437	296	733
12	"12-out18517"	.98969	96	1	97
12	"12-out18518"	.99056	105	1	106
12	"12-out18519"	.35143	233	430	663
12	"12-out18520"	.25974	60	171	231
12	"12-out18521"	.24355	85	264	349
12	"12-out18522"	.33146	354	714	1068
12	"12-out18523"	.46400	116	134	250
12	"12-out18524"	.84295	365	68	433
12	"12-out18525"	.29166	105	255	360
12	"12-out18526"	.28669	125	311	436
12	"12-out18527"	.29333	110	265	375
12	"12-out18528"	.30143	126	292	418
12	"12-out18529"	.89145	386	47	433
12	"12-out18530"	.38187	472	764	1236
12	"12-out18531"	.31413	60	131	191
12	"12-out18532"	.25238	53	157	210
12	"12-out18533"	.49109	193	200	393
12	"12-out18534"	.35097	126	233	359
12	"12-out18535"	.73684	84	30	114
12	"12-out18536"	.53667	417	360	777
12	"12-out18537"	.38878	201	316	517
12	"12-out18538"	.86802	171	26	197
12	"12-out18539"	.45398	74	89	163
12	"12-out18540"	.31547	106	230	336
12	"12-out18541"	.16666	22	110	132
12	"12-out18542"	.25142	176	524	700
12	"12-out18543"	.29058	179	437	616
12	"12-out18544"	.99264	135	1	136
12	"12-out18545"	.99718	354	1	355
12	"12-out18546"	.29069	50	122	172
12	"12-out18547"	.29678	157	372	529
12	"12-out18548"	.94339	100	6	106
12	"12-out18549"	.98412	124	2	126
12	"12-out18550"	.80726	289	69	358
12	"12-out18551"	.99421	344	2	346
12	"12-out18552"	.99408	336	2	338
12	"12-out18553"	.99447	360	2	362
12	"12-out18554"	.39662	188	286	474
12	"12-out18555"	.97560	40	1	41
12	"12-out18556"	.95833	23	1	24
12	"12-out18557"	.96296	26	1	27
12	"12-out18558"	.28050	177	454	631
12	"12-out18559"	.52294	376	343	719
12	"12-out18560"	.25445	100	293	393
12	"12-out18561"	.99425	346	2	348
12	"12-out18562"	.27915	79	204	283
12	"12-out18563"	.33261	308	618	926
12	"12-out18564"	.38461	100	160	260
12	"12-out18565"	.33783	100	196	296
12	"12-out18566"	.54268	178	150	328
12	"12-out18567"	.35431	197	359	556
12	"12-out18568"	.46135	191	223	414
12	"12-out18569"	.30303	30	69	99
12	"12-out18570"	.47633	312	343	655
12	"12-out18571"	.17362	208	990	1198
12	"12-out18572"	.99719	355	1	356
12	"12-out18573"	.78947	45	12	57
12	"12-out18574"	.35164	64	118	182
12	"12-out18575"	.72549	37	14	51
12	"12-out18576"	.99647	1132	4	1136
12	"12-out18577"	.47985	131	142	273
12	"12-out18578"	.47484	151	167	318
12	"12-out18579"	.63507	268	154	422
12	"12-out18580"	.48666	146	154	300
12	"12-out18581"	.99145	116	1	117
12	"12-out18582"	.99145	116	1	117
12	"12-out18583"	.99145	116	1	117
12	"12-out18584"	.38450	268	429	697
12	"12-out18585"	.56284	206	160	366
12	"12-out18586"	.47798	304	332	636
12	"12-out18587"	.98029	398	8	406
12	"12-out18588"	.31205	132	291	423
12	"12-out18589"	.99555	224	1	225
12	"12-out18590"	.99541	217	1	218
12	"12-out18591"	.29656	207	491	698
12	"12-out18592"	1.00000	330	0	330
12	"12-out18593"	1.00000	327	0	327
12	"12-out18594"	1.00000	106	0	106
12	"12-out18595"	.45116	425	517	942
12	"12-out18596"	.87548	225	32	257
12	"12-out18597"	.31081	115	255	370
12	"12-out18598"	.38914	86	135	221
12	"12-out18599"	.99585	240	1	241
12	"12-out18600"	.97297	216	6	222
12	"12-out18601"	.99418	171	1	172
12	"12-out18602"	.48758	216	227	443
12	"12-out18603"	.38794	341	538	879
12	"12-out18604"	.29308	216	521	737
12	"12-out18605"	.50769	66	64	130
12	"12-out18606"	.46923	61	69	130
12	"12-out18607"	.47656	61	67	128
12	"12-out18608"	.46511	60	69	129
12	"12-out18609"	.39230	51	79	130
12	"12-out18610"	.99130	114	1	115
12	"12-out18611"	.28763	107	265	372
12	"12-out18612"	.96875	124	4	128
12	"12-out18613"	.76190	96	30	126
12	"12-out18614"	.76190	96	30	126
12	"12-out18615"	.78571	99	27	126
12	"12-out18616"	.76190	96	30	126
12	"12-out18617"	.76190	96	30	126
12	"12-out18618"	.78571	99	27	126
12	"12-out18619"	.76984	97	29	126
12	"12-out18620"	.30147	41	95	136
12	"12-out18621"	.52205	71	65	136
12	"12-out18622"	.37500	51	85	136
12	"12-out18623"	.77931	226	64	290
12	"12-out18624"	.41295	491	698	1189
12	"12-out18625"	.32972	122	248	370
12	"12-out18626"	.77715	279	80	359
12	"12-out18627"	.35597	131	237	368
12	"12-out18628"	.41219	169	241	410
12	"12-out18629"	.99295	141	1	142
12	"12-out18630"	.98591	140	2	142
12	"12-out18631"	.99539	216	1	217
12	"12-out18632"	.40898	182	263	445
12	"12-out18633"	.46020	133	156	289
12	"12-out18634"	.34100	415	802	1217
12	"12-out18635"	.19142	67	283	350
12	"12-out18636"	.39366	87	134	221
12	"12-out18637"	.84501	398	73	471
12	"12-out18638"	.37142	156	264	420
12	"12-out18639"	.26698	169	464	633
12	"12-out18640"	.99541	217	1	218
12	"12-out18641"	.99264	135	1	136
12	"12-out18642"	.48320	187	200	387
12	"12-out18643"	.42914	215	286	501
12	"12-out18644"	.32576	201	416	617
12	"12-out18645"	.40041	191	286	477
12	"12-out18646"	.32456	358	745	1103
12	"12-out18647"	.42500	102	138	240
12	"12-out18648"	.99606	253	1	254
12	"12-out18649"	.89545	394	46	440
12	"12-out18650"	.42194	300	411	711
12	"12-out18651"	.23255	50	165	215
12	"12-out18652"	.32394	69	144	213
12	"12-out18653"	.29223	64	155	219
12	"12-out18654"	.27450	70	185	255
12	"12-out18655"	.98969	96	1	97
12	"12-out18656"	.31887	125	267	392
12	"12-out18657"	.31297	41	90	131
12	"12-out18658"	.41538	54	76	130
12	"12-out18659"	.36923	48	82	130
12	"12-out18660"	.47656	61	67	128
12	"12-out18661"	.30769	40	90	130
12	"12-out18662"	.39160	56	87	143
12	"12-out18663"	.48031	61	66	127
12	"12-out18664"	.97927	189	4	193
12	"12-out18665"	.97560	160	4	164
12	"12-out18666"	.80158	101	25	126
12	"12-out18667"	.78571	99	27	126
12	"12-out18668"	.77777	98	28	126
12	"12-out18669"	.76190	96	30	126
12	"12-out18670"	.66712	483	241	724
12	"12-out18671"	.93228	2657	193	2850
12	"12-out18672"	.96428	27	1	28
12	"12-out18673"	.99763	422	1	423
12	"12-out18674"	.99399	331	2	333
12	"12-out18675"	.99750	400	1	401
12	"12-out18676"	.28693	101	251	352
12	"12-out18677"	.99152	117	1	118
12	"12-out18678"	.53674	168	145	313
12	"12-out18679"	.99145	116	1	117
12	"12-out18680"	.40046	173	259	432
12	"12-out18681"	.53846	147	126	273
12	"12-out18682"	.99130	114	1	115
12	"12-out18683"	.35672	61	110	171
12	"12-out18684"	.99578	236	1	237
12	"12-out18685"	.49789	118	119	237
12	"12-out18686"	.08196	10	112	122
12	"12-out18687"	.94915	448	24	472
12	"12-out18688"	.37958	145	237	382
12	"12-out18689"	.50105	237	236	473
12	"12-out18690"	.34745	41	77	118
12	"12-out18691"	.37388	126	211	337
12	"12-out18692"	.54626	183	152	335
12	"12-out18693"	.40192	209	311	520
12	"12-out18694"	.83734	278	54	332
12	"12-out18695"	.83955	225	43	268
12	"12-out18696"	.13455	44	283	327
12	"12-out18697"	.61565	173	108	281
12	"12-out18698"	.51779	902	840	1742
12	"12-out18699"	.44982	130	159	289
12	"12-out18700"	.54065	133	113	246
12	"12-out18701"	.11857	30	223	253
12	"12-out18702"	.38780	159	251	410
12	"12-out18703"	.48201	134	144	278
12	"12-out18704"	.32417	295	615	910
12	"12-out18705"	.35653	251	453	704
12	"12-out18706"	.47766	139	152	291
12	"12-out18707"	.50289	174	172	346
12	"12-out18708"	.38366	310	498	808
12	"12-out18709"	.56467	227	175	402
12	"12-out18710"	.25408	202	593	795
12	"12-out18711"	.47969	378	410	788
12	"12-out18712"	.25896	195	558	753
12	"12-out18713"	.38962	293	459	752
12	"12-out18714"	.44179	167	211	378
12	"12-out18715"	.57224	400	299	699
12	"12-out18716"	.36880	253	433	686
12	"12-out18717"	.45477	714	856	1570
12	"12-out18718"	.43047	774	1024	1798
12	"12-out18719"	.31703	415	894	1309
12	"12-out18720"	.30232	793	1830	2623
12	"12-out18721"	.38313	159	256	415
12	"12-out18722"	.44017	103	131	234
12	"12-out18723"	.28615	93	232	325
12	"12-out18724"	.44660	138	171	309
12	"12-out18725"	.19760	66	268	334
12	"12-out18726"	.49901	253	254	507
12	"12-out18727"	.17827	64	295	359
12	"12-out18728"	.15598	56	303	359
12	"12-out18729"	.99152	117	1	118
12	"12-out18730"	.99186	122	1	123
12	"12-out18731"	.99200	124	1	125
12	"12-out18732"	.45848	127	150	277
12	"12-out18733"	.37131	189	320	509
12	"12-out18734"	.45484	136	163	299
12	"12-out18735"	.33250	134	269	403
12	"12-out18736"	.34297	83	159	242
12	"12-out18737"	.24029	99	313	412
12	"12-out18738"	.99145	116	1	117
12	"12-out18739"	.33333	99	198	297
12	"12-out18740"	.57142	276	207	483
12	"12-out18741"	.99236	130	1	131
12	"12-out18742"	.43400	217	283	500
12	"12-out18743"	.38313	318	512	830
12	"12-out18744"	.97222	35	1	36
12	"12-out18745"	.23664	93	300	393
12	"12-out18746"	.99565	229	1	230
12	"12-out18747"	.34751	49	92	141
12	"12-out18748"	.99305	143	1	144
12	"12-out18749"	.25722	89	257	346
12	"12-out18750"	.48207	121	130	251
12	"12-out18751"	.29822	436	1026	1462
12	"12-out18752"	.85227	75	13	88
12	"12-out18753"	.46989	320	361	681
12	"12-out18754"	.43177	231	304	535
12	"12-out18755"	.33576	92	182	274
12	"12-out18756"	.59454	1242	847	2089
12	"12-out18757"	.99470	188	1	189
12	"12-out18758"	.42276	104	142	246
12	"12-out18759"	.50000	123	123	246
12	"12-out18760"	.49240	227	234	461
12	"12-out18761"	.36820	352	604	956
12	"12-out18762"	.21995	97	344	441
12	"12-out18763"	.22195	91	319	410
12	"12-out18764"	.28288	157	398	555
12	"12-out18765"	.47368	36	40	76
12	"12-out18766"	.95833	23	1	24
12	"12-out18767"	.95833	23	1	24
12	"12-out18768"	.71238	374	151	525
12	"12-out18769"	.20238	34	134	168
12	"12-out18770"	.22801	70	237	307
12	"12-out18771"	.72586	609	230	839
12	"12-out18772"	.35975	59	105	164
12	"12-out18773"	.99705	338	1	339
12	"12-out18774"	.46082	100	117	217
12	"12-out18775"	.87777	237	33	270
12	"12-out18776"	.64772	228	124	352
12	"12-out18777"	.31343	105	230	335
12	"12-out18778"	.60063	188	125	313
12	"12-out18779"	.27906	132	341	473
12	"12-out18780"	.99145	116	1	117
12	"12-out18781"	.48725	325	342	667
12	"12-out18782"	.99130	114	1	115
12	"12-out18783"	.55513	146	117	263
12	"12-out18784"	.39529	1729	2645	4374
12	"12-out18785"	.26369	154	430	584
12	"12-out18786"	.99145	116	1	117
12	"12-out18787"	.26522	196	543	739
12	"12-out18788"	.75313	360	118	478
12	"12-out18789"	.45000	117	143	260
12	"12-out18790"	.36024	415	737	1152
12	"12-out18791"	.50430	410	403	813
12	"12-out18792"	.48464	363	386	749
12	"12-out18793"	.69551	450	197	647
12	"12-out18794"	.47750	191	209	400
12	"12-out18795"	.99152	117	1	118
12	"12-out18796"	.29195	127	308	435
12	"12-out18797"	.99152	117	1	118
12	"12-out18798"	.94376	4833	288	5121
12	"12-out18799"	.99145	116	1	117
12	"12-out18800"	.99137	115	1	116
12	"12-out18801"	.30989	141	314	455
12	"12-out18802"	.99159	118	1	119
12	"12-out18803"	.31479	249	542	791
12	"12-out18804"	.99145	116	1	117
12	"12-out18805"	.36718	47	81	128
12	"12-out18806"	.53237	148	130	278
12	"12-out18807"	.49375	79	81	160
12	"12-out18808"	.38130	363	589	952
12	"12-out18809"	.35697	156	281	437
12	"12-out18810"	.63225	98	57	155
12	"12-out18811"	.45703	234	278	512
12	"12-out18812"	.41007	171	246	417
12	"12-out18813"	.74311	243	84	327
12	"12-out18814"	.99519	207	1	208
12	"12-out18815"	.99519	207	1	208
12	"12-out18816"	.99519	207	1	208
12	"12-out18817"	.96219	509	20	529
12	"12-out18818"	.34572	186	352	538
12	"12-out18819"	.37126	199	337	536
12	"12-out18820"	.47428	83	92	175
12	"12-out18821"	.69101	246	110	356
12	"12-out18822"	.23024	67	224	291
12	"12-out18823"	.42283	337	460	797
12	"12-out18824"	.40087	368	550	918
12	"12-out18825"	.41877	116	161	277
12	"12-out18826"	.59000	118	82	200
12	"12-out18827"	.24742	24	73	97
12	"12-out18828"	.31549	224	486	710
12	"12-out18829"	.29351	86	207	293
12	"12-out18830"	.43292	426	558	984
12	"12-out18831"	.42392	365	496	861
12	"12-out18832"	.86583	768	119	887
12	"12-out18833"	.38090	379	616	995
12	"12-out18834"	.88048	361	49	410
12	"12-out18835"	.46629	166	190	356
12	"12-out18836"	.37500	141	235	376
12	"12-out18837"	.96899	125	4	129
12	"12-out18838"	.42696	38	51	89
12	"12-out18839"	.55326	161	130	291
12	"12-out18840"	.62589	174	104	278
12	"12-out18841"	.34965	200	372	572
12	"12-out18842"	.63600	318	182	500
12	"12-out18843"	.49606	189	192	381
12	"12-out18844"	.39136	281	437	718
12	"12-out18845"	.91142	319	31	350
12	"12-out18846"	.44161	329	416	745
12	"12-out18847"	.23544	178	578	756
12	"12-out18848"	.36731	263	453	716
12	"12-out18849"	.34810	220	412	632
12	"12-out18850"	.58909	281	196	477
12	"12-out18851"	.34798	95	178	273
12	"12-out18852"	.42633	136	183	319
12	"12-out18853"	.23480	85	277	362
12	"12-out18854"	.99519	207	1	208
12	"12-out18855"	.27147	79	212	291
12	"12-out18856"	.53488	184	160	344
12	"12-out18857"	.35862	156	279	435
12	"12-out18858"	.44763	218	269	487
12	"12-out18859"	.70338	332	140	472
12	"12-out18860"	.26836	95	259	354
12	"12-out18861"	.38157	116	188	304
12	"12-out18862"	.52258	324	296	620
12	"12-out18863"	.27040	222	599	821
12	"12-out18864"	.23365	168	551	719
12	"12-out18865"	.52738	443	397	840
12	"12-out18866"	.38057	435	708	1143
12	"12-out18867"	.35820	192	344	536
12	"12-out18868"	.67248	347	169	516
12	"12-out18869"	.98113	52	1	53
12	"12-out18870"	.43884	61	78	139
12	"12-out18871"	.96428	27	1	28
12	"12-out18872"	.64971	230	124	354
12	"12-out18873"	.40545	223	327	550
12	"12-out18874"	.42200	303	415	718
12	"12-out18875"	.28621	245	611	856
12	"12-out18876"	.98692	302	4	306
12	"12-out18877"	.34562	75	142	217
12	"12-out18878"	.56363	465	360	825
12	"12-out18879"	.56164	41	32	73
12	"12-out18880"	.98559	342	5	347
12	"12-out18881"	.95073	386	20	406
12	"12-out18882"	.99145	116	1	117
12	"12-out18883"	.99145	116	1	117
12	"12-out18884"	.23823	81	259	340
12	"12-out18885"	.99145	116	1	117
12	"12-out18886"	.63745	160	91	251
12	"12-out18887"	.90441	246	26	272
12	"12-out18888"	.99115	112	1	113
12	"12-out18889"	.14529	17	100	117
12	"12-out18890"	.37190	90	152	242
12	"12-out18891"	.42270	350	478	828
12	"12-out18892"	.61003	158	101	259
12	"12-out18893"	.99145	116	1	117
12	"12-out18894"	.54426	664	556	1220
12	"12-out18895"	.84246	492	92	584
12	"12-out18896"	.41059	248	356	604
12	"12-out18897"	.45861	205	242	447
12	"12-out18898"	.41237	80	114	194
12	"12-out18899"	.99509	203	1	204
12	"12-out18900"	.35843	476	852	1328
12	"12-out18901"	.65677	155	81	236
12	"12-out18902"	.30316	546	1255	1801
12	"12-out18903"	.23611	68	220	288
12	"12-out18904"	.39906	170	256	426
12	"12-out18905"	.40384	210	310	520
12	"12-out18906"	.36491	104	181	285
12	"12-out18907"	.36026	107	190	297
12	"12-out18908"	.99820	557	1	558
12	"12-out18909"	.27123	265	712	977
12	"12-out18910"	.39384	128	197	325
12	"12-out18911"	.53253	221	194	415
12	"12-out18912"	.95833	23	1	24
12	"12-out18913"	.38446	386	618	1004
12	"12-out18914"	.27030	193	521	714
12	"12-out18915"	.31067	32	71	103
12	"12-out18916"	.39200	49	76	125
12	"12-out18917"	.99159	118	1	119
12	"12-out18918"	.99159	118	1	119
12	"12-out18919"	.99137	115	1	116
12	"12-out18920"	.99145	116	1	117
12	"12-out18921"	.33573	140	277	417
12	"12-out18922"	.23976	82	260	342
12	"12-out18923"	.58465	259	184	443
12	"12-out18924"	.34106	294	568	862
12	"12-out18925"	.38645	194	308	502
12	"12-out18926"	.99145	116	1	117
12	"12-out18927"	.99145	116	1	117
12	"12-out18928"	.49371	393	403	796
12	"12-out18929"	.47674	123	135	258
12	"12-out18930"	.27272	75	200	275
12	"12-out18931"	.34317	93	178	271
12	"12-out18932"	.38750	93	147	240
12	"12-out18933"	.56319	762	591	1353
12	"12-out18934"	.99468	187	1	188
12	"12-out18935"	.38721	206	326	532
12	"12-out18936"	.25827	78	224	302
12	"12-out18937"	.88805	119	15	134
12	"12-out18938"	.27358	58	154	212
12	"12-out18939"	.74642	209	71	280
12	"12-out18940"	.99145	116	1	117
12	"12-out18941"	.32806	353	723	1076
12	"12-out18942"	.99145	116	1	117
12	"12-out18943"	.36431	98	171	269
12	"12-out18944"	.99145	116	1	117
12	"12-out18945"	.43656	234	302	536
12	"12-out18946"	.77187	247	73	320
12	"12-out18947"	.22127	52	183	235
12	"12-out18948"	.80769	105	25	130
12	"12-out18949"	.30010	298	695	993
12	"12-out18950"	.65473	567	299	866
12	"12-out18951"	.88876	815	102	917
12	"12-out18952"	.33069	209	423	632
12	"12-out18953"	.53086	86	76	162
12	"12-out18954"	.59219	167	115	282
12	"12-out18955"	.38380	109	175	284
12	"12-out18956"	.33934	207	403	610
12	"12-out18957"	.21608	43	156	199
12	"12-out18958"	.31636	174	376	550
12	"12-out18959"	.55672	211	168	379
12	"12-out18960"	.34070	154	298	452
12	"12-out18961"	.77722	314	90	404
12	"12-out18962"	.46124	119	139	258
12	"12-out18963"	.99305	143	1	144
12	"12-out18964"	.49140	286	296	582
12	"12-out18965"	.35563	622	1127	1749
12	"12-out18966"	.90109	82	9	91
12	"12-out18967"	.67307	70	34	104
12	"12-out18968"	.61538	48	30	78
12	"12-out18969"	.98093	463	9	472
12	"12-out18970"	.46666	35	40	75
12	"12-out18971"	.39906	255	384	639
12	"12-out18972"	.96396	321	12	333
12	"12-out18973"	.95708	513	23	536
12	"12-out18974"	.33884	164	320	484
12	"12-out18975"	.38768	107	169	276
12	"12-out18976"	.99513	409	2	411
12	"12-out18977"	.92338	229	19	248
12	"12-out18978"	.90909	140	14	154
12	"12-out18979"	.47551	233	257	490
12	"12-out18980"	.42738	206	276	482
12	"12-out18981"	.29326	61	147	208
12	"12-out18982"	.51207	106	101	207
12	"12-out18983"	.90769	177	18	195
12	"12-out18984"	.48557	101	107	208
12	"12-out18985"	.52666	316	284	600
12	"12-out18986"	.76190	128	40	168
12	"12-out18987"	.99115	112	1	113
12	"12-out18988"	.97640	331	8	339
12	"12-out18989"	.43040	538	712	1250
12	"12-out18990"	1.00000	107	0	107
12	"12-out18991"	.89252	191	23	214
12	"12-out18992"	.41479	1088	1535	2623
12	"12-out18993"	.45859	144	170	314
12	"12-out18994"	.44654	142	176	318
12	"12-out18995"	.99324	147	1	148
12	"12-out18996"	.42419	277	376	653
12	"12-out18997"	.71755	94	37	131
12	"12-out18998"	.54446	300	251	551
12	"12-out18999"	.99555	224	1	225
12	"12-out19000"	.38240	200	323	523
12	"12-out19001"	.56250	126	98	224
12	"12-out19002"	.25379	401	1179	1580
12	"12-out19003"	.68909	297	134	431
12	"12-out19004"	.51341	287	272	559
12	"12-out19005"	.47969	248	269	517
12	"12-out19006"	.99236	130	1	131
12	"12-out19007"	.50000	61	61	122
12	"12-out19008"	.26153	34	96	130
12	"12-out19009"	.51804	531	494	1025
12	"12-out19010"	.41525	196	276	472
12	"12-out19011"	.99200	124	1	125
12	"12-out19012"	.99242	131	1	132
12	"12-out19013"	.99248	132	1	133
12	"12-out19014"	.99470	188	1	189
12	"12-out19015"	.99470	188	1	189
12	"12-out19016"	.99470	188	1	189
12	"12-out19017"	.99468	187	1	188
12	"12-out19018"	.99470	188	1	189
12	"12-out19019"	.41304	209	297	506
12	"12-out19020"	.84848	112	20	132
12	"12-out19021"	.48108	89	96	185
12	"12-out19022"	.48387	90	96	186
12	"12-out19023"	.34096	149	288	437
12	"12-out19024"	.35018	194	360	554
12	"12-out19025"	.41724	179	250	429
12	"12-out19026"	.74517	579	198	777
12	"12-out19027"	.33015	104	211	315
12	"12-out19028"	.99784	462	1	463
12	"12-out19029"	.37328	109	183	292
12	"12-out19030"	.24242	184	575	759
12	"12-out19031"	.99000	99	1	100
12	"12-out19032"	.50891	314	303	617
12	"12-out19033"	.99836	610	1	611
12	"12-out19034"	.37606	264	438	702
12	"12-out19035"	.97695	212	5	217
12	"12-out19036"	.20689	24	92	116
12	"12-out19037"	.39694	208	316	524
12	"12-out19038"	1.00000	428	0	428
12	"12-out19039"	1.00000	106	0	106
12	"12-out19040"	.33931	208	405	613
12	"12-out19041"	.98936	93	1	94
12	"12-out19042"	.87257	315	46	361
12	"12-out19043"	.99019	404	4	408
12	"12-out19044"	.27392	146	387	533
12	"12-out19045"	.99145	116	1	117
12	"12-out19046"	.41390	262	371	633
12	"12-out19047"	.86829	178	27	205
12	"12-out19048"	.35714	65	117	182
12	"12-out19049"	.28666	43	107	150
12	"12-out19050"	.65294	111	59	170
12	"12-out19051"	.24744	460	1399	1859
12	"12-out19052"	.98529	67	1	68
12	"12-out19053"	.22621	107	366	473
12	"12-out19054"	.92647	63	5	68
12	"12-out19055"	.26327	119	333	452
12	"12-out19056"	.36344	169	296	465
12	"12-out19057"	.99421	172	1	173
12	"12-out19058"	.28326	198	501	699
12	"12-out19059"	.37468	293	489	782
12	"12-out19060"	.34024	246	477	723
12	"12-out19061"	.31800	159	341	500
12	"12-out19062"	.24203	38	119	157
12	"12-out19063"	.36529	240	417	657
12	"12-out19064"	.58898	139	97	236
12	"12-out19065"	.58374	352	251	603
12	"12-out19066"	.37483	277	462	739
12	"12-out19067"	.70250	980	415	1395
12	"12-out19068"	.32916	158	322	480
12	"12-out19069"	.91666	484	44	528
12	"12-out19070"	.95095	349	18	367
12	"12-out19071"	.33391	193	385	578
12	"12-out19072"	.77205	105	31	136
12	"12-out19073"	.28132	119	304	423
12	"12-out19074"	.25882	88	252	340
12	"12-out19075"	.56521	39	30	69
12	"12-out19076"	.69863	51	22	73
12	"12-out19077"	.37694	170	281	451
12	"12-out19078"	1.00000	17	0	17
12	"12-out19079"	.67828	253	120	373
12	"12-out19080"	.42245	316	432	748
12	"12-out19081"	.28622	241	601	842
12	"12-out19082"	.63511	369	212	581
12	"12-out19083"	.47126	369	414	783
12	"12-out19084"	.48240	713	765	1478
12	"12-out19085"	.99137	115	1	116
12	"12-out19086"	.99145	116	1	117
12	"12-out19087"	.37626	745	1235	1980
12	"12-out19088"	.91244	198	19	217
12	"12-out19089"	.35356	134	245	379
12	"12-out19090"	.43073	171	226	397
12	"12-out19091"	.52269	334	305	639
12	"12-out19092"	.58823	350	245	595
12	"12-out19093"	.37606	44	73	117
12	"12-out19094"	.98578	624	9	633
12	"12-out19095"	.50400	126	124	250
12	"12-out19096"	.26255	115	323	438
12	"12-out19097"	.35920	236	421	657
12	"12-out19098"	.43468	203	264	467
12	"12-out19099"	.18328	125	557	682
12	"12-out19100"	.99824	568	1	569
12	"12-out19101"	.42077	162	223	385
12	"12-out19102"	.73936	139	49	188
12	"12-out19103"	.99137	115	1	116
12	"12-out19104"	.30513	202	460	662
12	"12-out19105"	.85120	389	68	457
12	"12-out19106"	.92476	295	24	319
12	"12-out19107"	.74857	262	88	350
12	"12-out19108"	.32447	232	483	715
12	"12-out19109"	.36060	238	422	660
12	"12-out19110"	.45659	142	169	311
12	"12-out19111"	.99612	257	1	258
12	"12-out19112"	.89224	414	50	464
12	"12-out19113"	.28343	854	2159	3013
12	"12-out19114"	.30895	321	718	1039
12	"12-out19115"	.32024	685	1454	2139
12	"12-out19116"	.60045	786	523	1309
12	"12-out19117"	.99834	1807	3	1810
12	"12-out19118"	.90060	444	49	493
12	"12-out19119"	.26045	162	460	622
12	"12-out19120"	.38734	153	242	395
12	"12-out19121"	.98648	73	1	74
12	"12-out19122"	.99766	428	1	429
12	"12-out19123"	.99849	665	1	666
12	"12-out19124"	.45161	210	255	465
12	"12-out19125"	.41935	325	450	775
12	"12-out19126"	.59539	465	316	781
12	"12-out19127"	.41541	194	273	467
12	"12-out19128"	.39955	179	269	448
12	"12-out19129"	.99895	960	1	961
12	"12-out19130"	.20758	104	397	501
12	"12-out19131"	.99849	665	1	666
12	"12-out19132"	.25373	68	200	268
12	"12-out19133"	.29571	131	312	443
12	"12-out19134"	.57466	254	188	442
12	"12-out19135"	.45595	383	457	840
12	"12-out19136"	.80340	519	127	646
12	"12-out19137"	.47937	244	265	509
12	"12-out19138"	.35425	333	607	940
12	"12-out19139"	.14705	10	58	68
12	"12-out19140"	.91452	107	10	117
12	"12-out19141"	.20938	116	438	554
12	"12-out19142"	.90084	536	59	595
12	"12-out19143"	.26136	115	325	440
12	"12-out19144"	.29272	185	447	632
12	"12-out19145"	.20253	96	378	474
12	"12-out19146"	.32394	23	48	71
12	"12-out19147"	.99768	431	1	432
12	"12-out19148"	.99808	521	1	522
12	"12-out19149"	.99818	549	1	550
12	"12-out19150"	.33986	104	202	306
12	"12-out19151"	.48491	225	239	464
12	"12-out19152"	.54876	332	273	605
12	"12-out19153"	.99806	517	1	518
12	"12-out19154"	.99145	116	1	117
12	"12-out19155"	.48927	228	238	466
12	"12-out19156"	.76221	234	73	307
12	"12-out19157"	.48424	169	180	349
12	"12-out19158"	.45107	295	359	654
12	"12-out19159"	.39316	46	71	117
12	"12-out19160"	.97872	46	1	47
12	"12-out19161"	.99889	906	1	907
12	"12-out19162"	.92857	143	11	154
12	"12-out19163"	.33996	376	730	1106
12	"12-out19164"	.70212	264	112	376
12	"12-out19165"	.29677	230	545	775
12	"12-out19166"	.27755	68	177	245
12	"12-out19167"	.30769	44	99	143
12	"12-out19168"	.41666	185	259	444
12	"12-out19169"	.80543	385	93	478
12	"12-out19170"	.97354	184	5	189
12	"12-out19171"	.50437	173	170	343
12	"12-out19172"	.35331	165	302	467
12	"12-out19173"	.71659	177	70	247
12	"12-out19174"	.36842	154	264	418
12	"12-out19175"	.23868	116	370	486
12	"12-out19176"	.43016	231	306	537
12	"12-out19177"	.98750	79	1	80
12	"12-out19178"	.99280	138	1	139
12	"12-out19179"	.40051	157	235	392
12	"12-out19180"	.32969	151	307	458
12	"12-out19181"	.42666	32	43	75
12	"12-out19182"	.97969	579	12	591
12	"12-out19183"	.48434	232	247	479
12	"12-out19184"	.97962	625	13	638
12	"12-out19185"	.94871	111	6	117
12	"12-out19186"	.66666	242	121	363
12	"12-out19187"	.25406	125	367	492
12	"12-out19188"	.47233	239	267	506
12	"12-out19189"	.36784	334	574	908
12	"12-out19190"	.56466	179	138	317
12	"12-out19191"	.99719	355	1	356
12	"12-out19192"	.33505	130	258	388
12	"12-out19193"	.56509	586	451	1037
12	"12-out19194"	.99762	5047	12	5059
12	"12-out19195"	.26351	234	654	888
12	"12-out19196"	.75476	317	103	420
12	"12-out19197"	.54657	399	331	730
12	"12-out19198"	.46040	250	293	543
12	"12-out19199"	.18493	27	119	146
12	"12-out19200"	.37878	325	533	858
12	"12-out19201"	.24523	90	277	367
12	"12-out19202"	.98633	722	10	732
12	"12-out19203"	.40909	135	195	330
12	"12-out19204"	.54115	263	223	486
12	"12-out19205"	.42696	190	255	445
12	"12-out19206"	.34146	210	405	615
12	"12-out19207"	.99295	141	1	142
12	"12-out19208"	.99743	389	1	390
12	"12-out19209"	.48430	324	345	669
12	"12-out19210"	.88601	342	44	386
12	"12-out19211"	.26255	319	896	1215
12	"12-out19212"	.10526	34	289	323
12	"12-out19213"	.23607	89	288	377
12	"12-out19214"	.15873	10	53	63
12	"12-out19215"	.33717	117	230	347
12	"12-out19216"	.28873	1627	4008	5635
12	"12-out19217"	.58269	303	217	520
12	"12-out19218"	.67091	263	129	392
12	"12-out19219"	.98924	92	1	93
12	"12-out19220"	.40559	116	170	286
12	"12-out19221"	.31598	249	539	788
12	"12-out19222"	.53913	124	106	230
12	"12-out19223"	.97186	760	22	782
12	"12-out19224"	.68232	494	230	724
12	"12-out19225"	.49600	124	126	250
12	"12-out19226"	.49460	275	281	556
12	"12-out19227"	.56590	571	438	1009
12	"12-out19228"	.27380	115	305	420
12	"12-out19229"	.43785	155	199	354
12	"12-out19230"	.87356	304	44	348
12	"12-out19231"	.43137	176	232	408
12	"12-out19232"	.35268	164	301	465
12	"12-out19233"	.95833	23	1	24
12	"12-out19234"	.80000	72	18	90
12	"12-out19235"	.46428	338	390	728
12	"12-out19236"	.37271	224	377	601
12	"12-out19237"	.30236	179	413	592
12	"12-out19238"	.28746	94	233	327
12	"12-out19239"	.36156	111	196	307
12	"12-out19240"	.99784	462	1	463
12	"12-out19241"	.73758	208	74	282
12	"12-out19242"	.61692	277	172	449
12	"12-out19243"	.57798	126	92	218
12	"12-out19244"	.43076	168	222	390
12	"12-out19245"	.88271	143	19	162
12	"12-out19246"	.28658	47	117	164
12	"12-out19247"	.86486	64	10	74
12	"12-out19248"	.49787	117	118	235
12	"12-out19249"	.26123	93	263	356
12	"12-out19250"	.47353	170	189	359
12	"12-out19251"	.42022	187	258	445
12	"12-out19252"	.84701	454	82	536
12	"12-out19253"	.45121	222	270	492
12	"12-out19254"	.19607	10	41	51
12	"12-out19255"	.54615	142	118	260
12	"12-out19256"	.41200	103	147	250
12	"12-out19257"	.99145	116	1	117
12	"12-out19258"	.32608	180	372	552
12	"12-out19259"	.99159	118	1	119
12	"12-out19260"	.40370	109	161	270
12	"12-out19261"	.61585	202	126	328
12	"12-out19262"	.99145	116	1	117
12	"12-out19263"	.48581	137	145	282
12	"12-out19264"	.99130	114	1	115
12	"12-out19265"	.35392	212	387	599
12	"12-out19266"	.53080	224	198	422
12	"12-out19267"	.48113	306	330	636
12	"12-out19268"	.50769	165	160	325
12	"12-out19269"	.23034	126	421	547
12	"12-out19270"	.99275	137	1	138
12	"12-out19271"	.39432	125	192	317
12	"12-out19272"	.28543	145	363	508
12	"12-out19273"	.56156	187	146	333
12	"12-out19274"	.85633	304	51	355
12	"12-out19275"	.31960	163	347	510
12	"12-out19276"	.15972	46	242	288
12	"12-out19277"	.65395	223	118	341
12	"12-out19278"	.45571	247	295	542
12	"12-out19279"	.41944	151	209	360
12	"12-out19280"	.90109	82	9	91
12	"12-out19281"	.33333	225	450	675
12	"12-out19282"	.41690	286	400	686
12	"12-out19283"	.99125	340	3	343
12	"12-out19284"	.40570	185	271	456
12	"12-out19285"	.54814	74	61	135
12	"12-out19286"	.48770	238	250	488
12	"12-out19287"	.49299	176	181	357
12	"12-out19288"	.95833	23	1	24
12	"12-out19289"	.95833	23	1	24
12	"12-out19290"	.95833	23	1	24
12	"12-out19291"	.85858	85	14	99
12	"12-out19292"	.98302	579	10	589
12	"12-out19293"	.87800	547	76	623
12	"12-out19294"	.50000	69	69	138
12	"12-out19295"	.86266	201	32	233
12	"12-out19296"	.72189	244	94	338
12	"12-out19297"	.99145	116	1	117
12	"12-out19298"	.99152	117	1	118
12	"12-out19299"	.41071	92	132	224
12	"12-out19300"	.27874	160	414	574
12	"12-out19301"	.22522	50	172	222
12	"12-out19302"	.44665	247	306	553
12	"12-out19303"	.75297	253	83	336
12	"12-out19304"	.99145	116	1	117
12	"12-out19305"	.47126	164	184	348
12	"12-out19306"	.53937	774	661	1435
12	"12-out19307"	.94312	199	12	211
12	"12-out19308"	.29824	119	280	399
12	"12-out19309"	.41525	343	483	826
12	"12-out19310"	.99295	141	1	142
12	"12-out19311"	.24545	81	249	330
12	"12-out19312"	.99801	503	1	504
12	"12-out19313"	.24444	33	102	135
12	"12-out19314"	.54074	146	124	270
12	"12-out19315"	.66326	65	33	98
12	"12-out19316"	.46779	138	157	295
12	"12-out19317"	.45675	169	201	370
12	"12-out19318"	.47740	169	185	354
12	"12-out19319"	.37810	152	250	402
12	"12-out19320"	.95833	23	1	24
12	"12-out19321"	.91666	22	2	24
12	"12-out19322"	.36986	108	184	292
12	"12-out19323"	.99658	292	1	293
12	"12-out19324"	.99658	292	1	293
12	"12-out19325"	.35759	113	203	316
12	"12-out19326"	.50780	781	757	1538
12	"12-out19327"	.30025	348	811	1159
12	"12-out19328"	.40867	226	327	553
12	"12-out19329"	.21751	77	277	354
12	"12-out19330"	.54142	379	321	700
12	"12-out19331"	.99913	1157	1	1158
12	"12-out19332"	.67826	78	37	115
12	"12-out19333"	.56556	427	328	755
12	"12-out19334"	.35416	34	62	96
12	"12-out19335"	.19083	25	106	131
12	"12-out19336"	.44131	188	238	426
12	"12-out19337"	.29929	85	199	284
12	"12-out19338"	.99159	118	1	119
12	"12-out19339"	.99159	118	1	119
12	"12-out19340"	.47687	165	181	346
12	"12-out19341"	.98275	57	1	58
12	"12-out19342"	.99145	116	1	117
12	"12-out19343"	.99152	117	1	118
12	"12-out19344"	.29490	110	263	373
12	"12-out19345"	.33552	102	202	304
12	"12-out19346"	.94000	94	6	100
12	"12-out19347"	.36565	132	229	361
12	"12-out19348"	.73333	66	24	90
12	"12-out19349"	.32315	180	377	557
12	"12-out19350"	.38821	290	457	747
12	"12-out19351"	.29649	110	261	371
12	"12-out19352"	.89086	351	43	394
12	"12-out19353"	.94508	327	19	346
12	"12-out19354"	.64248	124	69	193
12	"12-out19355"	.38190	76	123	199
12	"12-out19356"	.99551	222	1	223
12	"12-out19357"	.53405	149	130	279
12	"12-out19358"	.99700	333	1	334
12	"12-out19359"	.39014	190	297	487
12	"12-out19360"	.77948	304	86	390
12	"12-out19361"	.81903	525	116	641
12	"12-out19362"	.59906	384	257	641
12	"12-out19363"	.88157	67	9	76
12	"12-out19364"	.44801	237	292	529
12	"12-out19365"	.24850	83	251	334
12	"12-out19366"	.99399	331	2	333
12	"12-out19367"	.99658	292	1	293
12	"12-out19368"	.99658	292	1	293
12	"12-out19369"	.68374	307	142	449
12	"12-out19370"	.55780	193	153	346
12	"12-out19371"	.45182	211	256	467
12	"12-out19372"	.77251	489	144	633
12	"12-out19373"	.99721	358	1	359
12	"12-out19374"	.24607	47	144	191
12	"12-out19375"	.58549	113	80	193
12	"12-out19376"	.42372	300	408	708
12	"12-out19377"	.99760	417	1	418
12	"12-out19378"	.34971	121	225	346
12	"12-out19379"	.94152	322	20	342
12	"12-out19380"	.92610	376	30	406
12	"12-out19381"	.37919	226	370	596
12	"12-out19382"	.95833	23	1	24
12	"12-out19383"	.81250	65	15	80
12	"12-out19384"	.30215	84	194	278
12	"12-out19385"	.36428	102	178	280
12	"12-out19386"	.99152	117	1	118
12	"12-out19387"	.99145	116	1	117
12	"12-out19388"	.41960	107	148	255
12	"12-out19389"	.47984	250	271	521
12	"12-out19390"	.30010	277	646	923
12	"12-out19391"	.28979	71	174	245
12	"12-out19392"	.37887	391	641	1032
12	"12-out19393"	.35181	641	1181	1822
12	"12-out19394"	.28534	333	834	1167
12	"12-out19395"	.34668	277	522	799
12	"12-out19396"	.28446	227	571	798
12	"12-out19397"	.42059	437	602	1039
12	"12-out19398"	.41862	553	768	1321
12	"12-out19399"	.36065	66	117	183
12	"12-out19400"	.39878	394	594	988
12	"12-out19401"	.34549	322	610	932
12	"12-out19402"	.35687	192	346	538
12	"12-out19403"	.38461	85	136	221
12	"12-out19404"	.46838	200	227	427
12	"12-out19405"	.54707	215	178	393
12	"12-out19406"	.36513	199	346	545
12	"12-out19407"	.27906	132	341	473
12	"12-out19408"	.36316	986	1729	2715
12	"12-out19409"	.48625	2388	2523	4911
12	"12-out19410"	.36265	2008	3529	5537
12	"12-out19411"	.93231	427	31	458
12	"12-out19412"	.34898	431	804	1235
12	"12-out19413"	.31845	214	458	672
12	"12-out19414"	.31886	235	502	737
12	"12-out19415"	.32727	126	259	385
12	"12-out19416"	.90395	480	51	531
12	"12-out19417"	.99375	159	1	160
12	"12-out19418"	.40875	56	81	137
12	"12-out19419"	.91358	74	7	81
12	"12-out19420"	.83333	70	14	84
12	"12-out19421"	.92063	58	5	63
12	"12-out19422"	.98581	278	4	282
12	"12-out19423"	.93725	239	16	255
12	"12-out19424"	.96832	214	7	221
12	"12-out19425"	.98974	193	2	195
12	"12-out19426"	.99004	199	2	201
12	"12-out19427"	.99504	201	1	202
12	"12-out19428"	.99358	155	1	156
12	"12-out19429"	.98039	250	5	255
12	"12-out19430"	.98305	174	3	177
12	"12-out19431"	.80208	77	19	96
12	"12-out19432"	.92857	104	8	112
12	"12-out19433"	.99418	171	1	172
12	"12-out19434"	.97959	96	2	98
12	"12-out19435"	.98979	97	1	98
12	"12-out19436"	.98529	134	2	136
12	"12-out19437"	.90256	176	19	195
12	"12-out19438"	.96987	161	5	166
12	"12-out19439"	.98895	179	2	181
12	"12-out19440"	.99024	203	2	205
12	"12-out19441"	.99047	208	2	210
12	"12-out19442"	.98918	183	2	185
12	"12-out19443"	.99047	208	2	210
12	"12-out19444"	.92086	256	22	278
12	"12-out19445"	.99578	236	1	237
12	"12-out19446"	.96124	124	5	129
12	"12-out19447"	.99393	164	1	165
12	"12-out19448"	.99465	186	1	187
12	"12-out19449"	.99408	168	1	169
12	"12-out19450"	.95774	68	3	71
12	"12-out19451"	.87096	54	8	62
12	"12-out19452"	.96116	99	4	103
12	"12-out19453"	.83600	209	41	250
12	"12-out19454"	.98850	172	2	174
12	"12-out19455"	.98742	157	2	159
12	"12-out19456"	.98701	152	2	154
12	"12-out19457"	.96875	155	5	160
12	"12-out19458"	.98816	167	2	169
12	"12-out19459"	.99371	158	1	159
12	"12-out19460"	.30021	142	331	473
12	"12-out19461"	.52621	542	488	1030
12	"12-out19462"	.57031	73	55	128
12	"12-out19463"	.97076	166	5	171
12	"12-out19464"	.73406	334	121	455
12	"12-out19465"	.94877	426	23	449
12	"12-out19466"	.91885	419	37	456
12	"12-out19467"	.90060	444	49	493
12	"12-out19468"	.26739	196	537	733
12	"12-out19469"	.98591	910	13	923
12	"12-out19470"	.39157	372	578	950
12	"12-out19471"	.29875	144	338	482
12	"12-out19472"	.29362	313	753	1066
12	"12-out19473"	.58048	238	172	410
12	"12-out19474"	.94554	382	22	404
12	"12-out19475"	.54411	74	62	136
12	"12-out19476"	.98113	52	1	53
12	"12-out19477"	.99236	130	1	131
12	"12-out19478"	.99901	1012	1	1013
12	"12-out19479"	.85897	67	11	78
12	"12-out19480"	.94273	214	13	227
12	"12-out19481"	.29715	334	790	1124
12	"12-out19482"	.99477	381	2	383
12	"12-out19483"	.32563	155	321	476
12	"12-out19484"	.60754	322	208	530
12	"12-out19485"	.67735	317	151	468
12	"12-out19486"	.99880	836	1	837
12	"12-out19487"	.53767	264	227	491
12	"12-out19488"	.32566	524	1085	1609
12	"12-out19489"	.43043	758	1003	1761
12	"12-out19490"	.28164	336	857	1193
12	"12-out19491"	.41079	647	928	1575
12	"12-out19492"	.60952	256	164	420
12	"12-out19493"	.86750	275	42	317
12	"12-out19494"	.90735	666	68	734
12	"12-out19495"	.32831	371	759	1130
12	"12-out19496"	.58778	154	108	262
12	"12-out19497"	.97058	396	12	408
12	"12-out19498"	.49784	347	350	697
12	"12-out19499"	.35414	363	662	1025
12	"12-out19500"	.48318	632	676	1308
12	"12-out19501"	.28690	138	343	481
12	"12-out19502"	.94915	112	6	118
12	"12-out19503"	.93220	110	8	118
12	"12-out19504"	.51655	78	73	151
12	"12-out19505"	.31279	269	591	860
12	"12-out19506"	.55595	154	123	277
12	"12-out19507"	.26724	62	170	232
12	"12-out19508"	.54266	248	209	457
12	"12-out19509"	.30659	237	536	773
12	"12-out19510"	.25988	46	131	177
12	"12-out19511"	.33873	251	490	741
12	"12-out19512"	.36073	1062	1882	2944
12	"12-out19513"	.32028	270	573	843
12	"12-out19514"	.32795	244	500	744
12	"12-out19515"	.39212	229	355	584
12	"12-out19516"	.29207	59	143	202
12	"12-out19517"	.36482	336	585	921
12	"12-out19518"	.54716	377	312	689
12	"12-out19519"	.35616	52	94	146
12	"12-out19520"	.37931	33	54	87
12	"12-out19521"	.62500	205	123	328
12	"12-out19522"	.34948	101	188	289
12	"12-out19523"	.98936	93	1	94
12	"12-out19524"	.75057	1303	433	1736
12	"12-out19525"	.44518	536	668	1204
12	"12-out19526"	.75586	161	52	213
12	"12-out19527"	.45018	732	894	1626
12	"12-out19528"	.11578	22	168	190
12	"12-out19529"	.43718	87	112	199
12	"12-out19530"	.38974	76	119	195
12	"12-out19531"	.74371	148	51	199
12	"12-out19532"	.85267	191	33	224
12	"12-out19533"	.23316	45	148	193
12	"12-out19534"	.35858	71	127	198
12	"12-out19535"	.41649	202	283	485
12	"12-out19536"	.27522	90	237	327
12	"12-out19537"	.44171	72	91	163
12	"12-out19538"	.60000	105	70	175
12	"12-out19539"	.30252	36	83	119
12	"12-out19540"	.55185	298	242	540
12	"12-out19541"	.43757	750	964	1714
12	"12-out19542"	.47639	434	477	911
12	"12-out19543"	.78659	575	156	731
12	"12-out19544"	.79456	263	68	331
12	"12-out19545"	.50600	253	247	500
12	"12-out19546"	.47590	237	261	498
12	"12-out19547"	.29365	111	267	378
12	"12-out19548"	.33649	142	280	422
12	"12-out19549"	.30423	115	263	378
12	"12-out19550"	.27419	85	225	310
12	"12-out19551"	.99696	328	1	329
12	"12-out19552"	.22326	119	414	533
12	"12-out19553"	.43286	245	321	566
12	"12-out19554"	.40781	407	591	998
12	"12-out19555"	.87102	905	134	1039
12	"12-out19556"	.51005	203	195	398
12	"12-out19557"	.30519	94	214	308
12	"12-out19558"	.48888	88	92	180
12	"12-out19559"	.99047	104	1	105
12	"12-out19560"	.99694	326	1	327
12	"12-out19561"	.33566	48	95	143
12	"12-out19562"	.28957	150	368	518
12	"12-out19563"	.39209	129	200	329
12	"12-out19564"	.99603	251	1	252
12	"12-out19565"	.35443	112	204	316
12	"12-out19566"	.20159	101	400	501
12	"12-out19567"	.30566	81	184	265
12	"12-out19568"	.24869	143	432	575
12	"12-out19569"	.32608	180	372	552
12	"12-out19570"	.35256	165	303	468
12	"12-out19571"	.31336	68	149	217
12	"12-out19572"	.45930	79	93	172
12	"12-out19573"	.51337	403	382	785
12	"12-out19574"	.73443	177	64	241
12	"12-out19575"	.41509	132	186	318
12	"12-out19576"	.35917	139	248	387
12	"12-out19577"	.36917	103	176	279
12	"12-out19578"	.27402	134	355	489
12	"12-out19579"	.23809	125	400	525
12	"12-out19580"	.38602	718	1142	1860
12	"12-out19581"	.74449	169	58	227
12	"12-out19582"	.49421	769	787	1556
12	"12-out19583"	.24271	175	546	721
12	"12-out19584"	.95064	443	23	466
12	"12-out19585"	.96107	395	16	411
12	"12-out19586"	.25035	176	527	703
12	"12-out19587"	.60516	164	107	271
12	"12-out19588"	.31491	57	124	181
12	"12-out19589"	.30754	159	358	517
12	"12-out19590"	.49019	950	988	1938
12	"12-out19591"	.56281	224	174	398
12	"12-out19592"	.30131	138	320	458
12	"12-out19593"	.99173	120	1	121
12	"12-out19594"	.99230	129	1	130
12	"12-out19595"	.30957	139	310	449
12	"12-out19596"	.65495	205	108	313
12	"12-out19597"	.89140	197	24	221
12	"12-out19598"	.63959	126	71	197
12	"12-out19599"	.56994	110	83	193
12	"12-out19600"	.52040	51	47	98
12	"12-out19601"	.99770	434	1	435
12	"12-out19602"	.27761	465	1210	1675
12	"12-out19603"	.22804	374	1266	1640
12	"12-out19604"	.52901	310	276	586
12	"12-out19605"	.90688	224	23	247
12	"12-out19606"	.84189	213	40	253
12	"12-out19607"	.42350	609	829	1438
12	"12-out19608"	.28519	156	391	547
12	"12-out19609"	.79338	96	25	121
12	"12-out19610"	.63414	130	75	205
12	"12-out19611"	.72767	163	61	224
12	"12-out19612"	.31818	91	195	286
12	"12-out19613"	.43262	366	480	846
12	"12-out19614"	.36450	534	931	1465
12	"12-out19615"	.33647	143	282	425
12	"12-out19616"	.25141	89	265	354
12	"12-out19617"	.40061	131	196	327
12	"12-out19618"	.31470	107	233	340
12	"12-out19619"	.99390	163	1	164
12	"12-out19620"	.99692	324	1	325
12	"12-out19621"	.99528	211	1	212
12	"12-out19622"	.54442	288	241	529
12	"12-out19623"	.46749	151	172	323
12	"12-out19624"	.54120	243	206	449
12	"12-out19625"	.46946	123	139	262
12	"12-out19626"	.33413	279	556	835
12	"12-out19627"	.48365	1968	2101	4069
12	"12-out19628"	.48571	68	72	140
12	"12-out19629"	.98795	82	1	83
12	"12-out19630"	.98148	53	1	54
12	"12-out19631"	.99324	147	1	148
12	"12-out19632"	.56250	90	70	160
12	"12-out19633"	.37597	338	561	899
12	"12-out19634"	.41616	139	195	334
12	"12-out19635"	.95469	295	14	309
12	"12-out19636"	.32457	284	591	875
12	"12-out19637"	.61669	436	271	707
12	"12-out19638"	.45295	337	407	744
12	"12-out19639"	.43725	223	287	510
12	"12-out19640"	.61956	57	35	92
12	"12-out19641"	.19279	91	381	472
12	"12-out19642"	.47222	170	190	360
12	"12-out19643"	.25442	259	759	1018
12	"12-out19644"	.45181	497	603	1100
12	"12-out19645"	.28850	384	947	1331
12	"12-out19646"	.98936	93	1	94
12	"12-out19647"	.51685	92	86	178
12	"12-out19648"	.48806	511	536	1047
12	"12-out19649"	.78431	120	33	153
12	"12-out19650"	.38434	108	173	281
12	"12-out19651"	.56983	102	77	179
12	"12-out19652"	.28961	53	130	183
12	"12-out19653"	.52173	84	77	161
12	"12-out19654"	.36571	64	111	175
12	"12-out19655"	.99173	120	1	121
12	"12-out19656"	.43374	635	829	1464
12	"12-out19657"	.40080	596	891	1487
12	"12-out19658"	.76849	1278	385	1663
12	"12-out19659"	.42061	702	967	1669
12	"12-out19660"	.36039	617	1095	1712
12	"12-out19661"	.38872	655	1030	1685
12	"12-out19662"	.99942	1743	1	1744
12	"12-out19663"	.99942	1743	1	1744
12	"12-out19664"	.34289	514	985	1499
12	"12-out19665"	.25486	262	766	1028
12	"12-out19666"	.23454	239	780	1019
12	"12-out19667"	.29695	672	1591	2263
12	"12-out19668"	.44646	417	517	934
12	"12-out19669"	.61024	429	274	703
12	"12-out19670"	.36886	218	373	591
12	"12-out19671"	.42690	292	392	684
12	"12-out19672"	.52951	296	263	559
12	"12-out19673"	.28301	30	76	106
12	"12-out19674"	.78378	58	16	74
12	"12-out19675"	.68800	86	39	125
12	"12-out19676"	.38961	90	141	231
12	"12-out19677"	.41764	284	396	680
12	"12-out19678"	.45902	829	977	1806
12	"12-out19679"	.54321	685	576	1261
12	"12-out19680"	.40681	561	818	1379
12	"12-out19681"	.39545	331	506	837
12	"12-out19682"	.32713	633	1302	1935
12	"12-out19683"	.38956	1030	1614	2644
12	"12-out19684"	.28377	313	790	1103
12	"12-out19685"	.33578	319	631	950
12	"12-out19686"	.36621	401	694	1095
12	"12-out19687"	.39602	478	729	1207
12	"12-out19688"	.30315	144	331	475
12	"12-out19689"	.99720	1072	3	1075
12	"12-out19690"	.37837	56	92	148
12	"12-out19691"	.45132	153	186	339
12	"12-out19692"	.58543	209	148	357
12	"12-out19693"	.92555	373	30	403
12	"12-out19694"	.90697	312	32	344
12	"12-out19695"	.35651	1092	1971	3063
12	"12-out19696"	.42181	232	318	550
12	"12-out19697"	.38772	278	439	717
12	"12-out19698"	.32420	296	617	913
12	"12-out19699"	.24023	123	389	512
12	"12-out19700"	.21150	125	466	591
12	"12-out19701"	.28173	162	413	575
12	"12-out19702"	.92168	153	13	166
12	"12-out19703"	.52849	102	91	193
12	"12-out19704"	.54819	91	75	166
12	"12-out19705"	.40778	566	822	1388
12	"12-out19706"	.30249	255	588	843
12	"12-out19707"	.27455	123	325	448
12	"12-out19708"	.99782	459	1	460
12	"12-out19709"	.28789	226	559	785
12	"12-out19710"	.23338	165	542	707
12	"12-out19711"	.19282	129	540	669
12	"12-out19712"	.70270	156	66	222
12	"12-out19713"	.73267	74	27	101
12	"12-out19714"	.30512	137	312	449
12	"12-out19715"	.46600	610	699	1309
12	"12-out19716"	.58064	162	117	279
12	"12-out19717"	.28369	341	861	1202
12	"12-out19718"	.41688	321	449	770
12	"12-out19719"	.29368	158	380	538
12	"12-out19720"	.99145	116	1	117
12	"12-out19721"	.43200	54	71	125
12	"12-out19722"	.88524	108	14	122
12	"12-out19723"	.60493	196	128	324
12	"12-out19724"	.17814	75	346	421
12	"12-out19725"	.47935	209	227	436
12	"12-out19726"	.23090	133	443	576
12	"12-out19727"	.70640	717	298	1015
12	"12-out19728"	.30173	452	1046	1498
12	"12-out19729"	.34122	173	334	507
12	"12-out19730"	.42286	529	722	1251
12	"12-out19731"	.44252	358	451	809
12	"12-out19732"	.56250	81	63	144
12	"12-out19733"	.28750	46	114	160
12	"12-out19734"	.80575	112	27	139
12	"12-out19735"	.54103	178	151	329
12	"12-out19736"	.46792	445	506	951
12	"12-out19737"	.45677	354	421	775
12	"12-out19738"	.23703	128	412	540
12	"12-out19739"	.44754	337	416	753
12	"12-out19740"	.41071	69	99	168
12	"12-out19741"	.46153	84	98	182
12	"12-out19742"	.48561	135	143	278
12	"12-out19743"	.51310	372	353	725
12	"12-out19744"	.98291	1266	22	1288
12	"12-out19745"	.33171	341	687	1028
12	"12-out19746"	.98291	1266	22	1288
12	"12-out19747"	.44801	586	722	1308
12	"12-out19748"	.32465	424	882	1306
12	"12-out19749"	.47526	1105	1220	2325
12	"12-out19750"	.50955	80	77	157
12	"12-out19751"	.36237	495	871	1366
12	"12-out19752"	.37653	552	914	1466
12	"12-out19753"	.87248	260	38	298
12	"12-out19754"	.98214	55	1	56
12	"12-out19755"	.57352	117	87	204
12	"12-out19756"	.29432	166	398	564
12	"12-out19757"	.64779	103	56	159
12	"12-out19758"	.43489	344	447	791
12	"12-out19759"	.48272	922	988	1910
12	"12-out19760"	.40545	491	720	1211
12	"12-out19761"	.61837	1541	951	2492
12	"12-out19762"	.28279	263	667	930
12	"12-out19763"	.37515	598	996	1594
12	"12-out19764"	.99779	453	1	454
12	"12-out19765"	.38675	473	750	1223
12	"12-out19766"	.29493	361	863	1224
12	"12-out19767"	.33298	322	645	967
12	"12-out19768"	.34542	238	451	689
12	"12-out19769"	.36441	297	518	815
12	"12-out19770"	.98750	79	1	80
12	"12-out19771"	.60281	214	141	355
12	"12-out19772"	.87811	317	44	361
12	"12-out19773"	.37216	115	194	309
12	"12-out19774"	.44638	562	697	1259
12	"12-out19775"	.31013	254	565	819
12	"12-out19776"	.37138	244	413	657
12	"12-out19777"	.38005	282	460	742
12	"12-out19778"	.22077	34	120	154
12	"12-out19779"	.69421	84	37	121
12	"12-out19780"	.44395	202	253	455
12	"12-out19781"	.58928	66	46	112
12	"12-out19782"	.23605	55	178	233
12	"12-out19783"	.70588	60	25	85
12	"12-out19784"	.48500	97	103	200
12	"12-out19785"	.70491	129	54	183
12	"12-out19786"	.36868	73	125	198
12	"12-out19787"	.50000	101	101	202
12	"12-out19788"	.48453	94	100	194
12	"12-out19789"	.98203	328	6	334
12	"12-out19790"	.28137	213	544	757
12	"12-out19791"	.28044	76	195	271
12	"12-out19792"	.38920	483	758	1241
12	"12-out19793"	.41233	508	724	1232
12	"12-out19794"	.35503	349	634	983
12	"12-out19795"	.71034	103	42	145
12	"12-out19796"	.38023	127	207	334
12	"12-out19797"	.44891	145	178	323
12	"12-out19798"	.30122	197	457	654
12	"12-out19799"	.98805	331	4	335
12	"12-out19800"	.31944	391	833	1224
12	"12-out19801"	.53904	214	183	397
12	"12-out19802"	.47368	171	190	361
12	"12-out19803"	.24074	91	287	378
12	"12-out19804"	.29447	96	230	326
12	"12-out19805"	.25537	95	277	372
12	"12-out19806"	.51428	90	85	175
12	"12-out19807"	.26972	106	287	393
12	"12-out19808"	.38372	132	212	344
12	"12-out19809"	.24083	92	290	382
12	"12-out19810"	.61315	233	147	380
12	"12-out19811"	.41239	153	218	371
12	"12-out19812"	.85557	391	66	457
12	"12-out19813"	.55555	50	40	90
12	"12-out19814"	.29082	130	317	447
12	"12-out19815"	.74782	258	87	345
12	"12-out19816"	.43816	496	636	1132
12	"12-out19817"	.30834	366	821	1187
12	"12-out19818"	.63887	1686	953	2639
12	"12-out19819"	.99871	779	1	780
12	"12-out19820"	.45121	222	270	492
12	"12-out19821"	.41885	271	376	647
12	"12-out19822"	.78455	193	53	246
12	"12-out19823"	.52755	134	120	254
12	"12-out19824"	.35654	169	305	474
12	"12-out19825"	.34805	134	251	385
12	"12-out19826"	.39177	581	902	1483
12	"12-out19827"	.61417	78	49	127
12	"12-out19828"	.53782	1166	1002	2168
12	"12-out19829"	.29600	37	88	125
12	"12-out19830"	.38450	273	437	710
12	"12-out19831"	.40042	189	283	472
12	"12-out19832"	.40919	356	514	870
12	"12-out19833"	.31335	183	401	584
12	"12-out19834"	.50000	235	235	470
12	"12-out19835"	.46252	253	294	547
12	"12-out19836"	.49946	470	471	941
12	"12-out19837"	.72364	1270	485	1755
12	"12-out19838"	.52422	238	216	454
12	"12-out19839"	.33144	234	472	706
12	"12-out19840"	.99000	99	1	100
12	"12-out19841"	.44029	660	839	1499
12	"12-out19842"	.28751	410	1016	1426
12	"12-out19843"	.37317	128	215	343
12	"12-out19844"	.69359	1820	804	2624
12	"12-out19845"	.41146	244	349	593
12	"12-out19846"	.64497	109	60	169
12	"12-out19847"	.55913	156	123	279
12	"12-out19848"	.47784	248	271	519
12	"12-out19849"	.30598	179	406	585
12	"12-out19850"	.24550	164	504	668
12	"12-out19851"	.84666	127	23	150
12	"12-out19852"	.88000	66	9	75
12	"12-out19853"	.93750	75	5	80
12	"12-out19854"	.99056	105	1	106
12	"12-out19855"	.66666	46	23	69
12	"12-out19856"	.96800	121	4	125
12	"12-out19857"	.81081	90	21	111
12	"12-out19858"	.69166	83	37	120
12	"12-out19859"	.99099	110	1	111
12	"12-out19860"	.34888	157	293	450
12	"12-out19861"	.38045	253	412	665
12	"12-out19862"	.63373	263	152	415
12	"12-out19863"	.36189	245	432	677
12	"12-out19864"	.99717	353	1	354
12	"12-out19865"	.98994	394	4	398
12	"12-out19866"	.67699	153	73	226
12	"12-out19867"	.37554	86	143	229
12	"12-out19868"	.28932	103	253	356
12	"12-out19869"	.45308	169	204	373
12	"12-out19870"	.95555	301	14	315
12	"12-out19871"	.75625	121	39	160
12	"12-out19872"	.34969	57	106	163
12	"12-out19873"	.80733	264	63	327
12	"12-out19874"	.16577	31	156	187
12	"12-out19875"	.99543	218	1	219
12	"12-out19876"	.75630	180	58	238
12	"12-out19877"	.34668	199	375	574
12	"12-out19878"	.32094	380	804	1184
12	"12-out19879"	.47641	101	111	212
12	"12-out19880"	.50375	201	198	399
12	"12-out19881"	.23122	157	522	679
12	"12-out19882"	.20754	22	84	106
12	"12-out19883"	.40745	295	429	724
12	"12-out19884"	.22628	167	571	738
12	"12-out19885"	.42227	182	249	431
12	"12-out19886"	.98958	95	1	96
12	"12-out19887"	.31441	421	918	1339
12	"12-out19888"	.36585	525	910	1435
12	"12-out19889"	.22134	251	883	1134
12	"12-out19890"	.41036	483	694	1177
12	"12-out19891"	.52842	251	224	475
12	"12-out19892"	.17857	215	989	1204
12	"12-out19893"	.42118	497	683	1180
12	"12-out19894"	.50815	623	603	1226
12	"12-out19895"	.36204	433	763	1196
12	"12-out19896"	.28640	356	887	1243
12	"12-out19897"	.92114	257	22	279
12	"12-out19898"	.66901	95	47	142
12	"12-out19899"	.40650	350	511	861
12	"12-out19900"	.35789	34	61	95
12	"12-out19901"	.35111	158	292	450
12	"12-out19902"	.41323	481	683	1164
12	"12-out19903"	.57801	163	119	282
12	"12-out19904"	.22371	83	288	371
12	"12-out19905"	.36865	247	423	670
12	"12-out19906"	.36328	376	659	1035
12	"12-out19907"	.20274	59	232	291
12	"12-out19908"	.44541	102	127	229
12	"12-out19909"	.85333	192	33	225
12	"12-out19910"	.50404	498	490	988
12	"12-out19911"	.92233	95	8	103
12	"12-out19912"	.46842	356	404	760
12	"12-out19913"	.28819	232	573	805
12	"12-out19914"	.44769	107	132	239
12	"12-out19915"	.30701	70	158	228
12	"12-out19916"	.31441	72	157	229
12	"12-out19917"	.99065	212	2	214
12	"12-out19918"	.28063	71	182	253
12	"12-out19919"	.99557	225	1	226
12	"12-out19920"	.34710	168	316	484
12	"12-out19921"	.23492	113	368	481
12	"12-out19922"	.54137	157	133	290
12	"12-out19923"	.50746	102	99	201
12	"12-out19924"	.50000	179	179	358
12	"12-out19925"	.41121	176	252	428
12	"12-out19926"	.36059	194	344	538
12	"12-out19927"	.28366	297	750	1047
12	"12-out19928"	.98529	67	1	68
12	"12-out19929"	.44827	104	128	232
12	"12-out19930"	.48095	644	695	1339
12	"12-out19931"	.43063	149	197	346
12	"12-out19932"	.45278	187	226	413
12	"12-out19933"	.40128	187	279	466
12	"12-out19934"	.99319	146	1	147
12	"12-out19935"	.39676	98	149	247
12	"12-out19936"	.96514	360	13	373
12	"12-out19937"	.31500	527	1146	1673
12	"12-out19938"	.47305	79	88	167
12	"12-out19939"	.37096	115	195	310
12	"12-out19940"	.99047	104	1	105
12	"12-out19941"	.11111	9	72	81
12	"12-out19942"	.14457	12	71	83
12	"12-out19943"	.54746	767	634	1401
12	"12-out19944"	.44444	508	635	1143
12	"12-out19945"	.36859	223	382	605
12	"12-out19946"	.35694	257	463	720
12	"12-out19947"	.48936	506	528	1034
12	"12-out19948"	.34594	192	363	555
12	"12-out19949"	.19528	58	239	297
12	"12-out19950"	.84684	470	85	555
12	"12-out19951"	.30471	724	1652	2376
12	"12-out19952"	.37565	216	359	575
12	"12-out19953"	.38779	216	341	557
12	"12-out19954"	.93684	267	18	285
12	"12-out19955"	.49657	145	147	292
12	"12-out19956"	.33779	101	198	299
12	"12-out19957"	.52926	217	193	410
12	"12-out19958"	.62500	155	93	248
12	"12-out19959"	.49425	43	44	87
12	"12-out19960"	.47560	78	86	164
12	"12-out19961"	.32121	106	224	330
12	"12-out19962"	.47882	147	160	307
12	"12-out19963"	.43548	162	210	372
12	"12-out19964"	.34500	69	131	200
12	"12-out19965"	.53309	749	656	1405
12	"12-out19966"	.35288	367	673	1040
12	"12-out19967"	.28557	293	733	1026
12	"12-out19968"	.41536	427	601	1028
12	"12-out19969"	.16618	230	1154	1384
12	"12-out19970"	.33222	300	603	903
12	"12-out19971"	.28058	211	541	752
12	"12-out19972"	.50239	839	831	1670
12	"12-out19973"	.42189	713	977	1690
12	"12-out19974"	.43879	742	949	1691
12	"12-out19975"	.33405	614	1224	1838
12	"12-out19976"	.51919	906	839	1745
12	"12-out19977"	.34785	583	1093	1676
12	"12-out19978"	.24394	775	2402	3177
12	"12-out19979"	.36405	952	1663	2615
12	"12-out19980"	.99603	251	1	252
12	"12-out19981"	.21770	91	327	418
12	"12-out19982"	.47467	253	280	533
12	"12-out19983"	.48498	210	223	433
12	"12-out19984"	.80454	177	43	220
12	"12-out19985"	.99393	164	1	165
12	"12-out19986"	.36564	215	373	588
12	"12-out19987"	.49152	145	150	295
12	"12-out19988"	.52331	101	92	193
12	"12-out19989"	.32818	170	348	518
12	"12-out19990"	.18867	60	258	318
12	"12-out19991"	.82993	244	50	294
12	"12-out19992"	.76165	147	46	193
12	"12-out19993"	.56913	177	134	311
12	"12-out19994"	.41176	84	120	204
12	"12-out19995"	.33168	67	135	202
12	"12-out19996"	.37931	88	144	232
12	"12-out19997"	.34389	217	414	631
12	"12-out19998"	.29230	133	322	455
12	"12-out19999"	.51436	179	169	348
12	"12-out20000"	.43764	386	496	882
12	"12-out20001"	.35233	136	250	386
12	"12-out20002"	.15801	67	357	424
12	"12-out20003"	.38148	169	274	443
12	"12-out20004"	.40909	144	208	352
12	"12-out20005"	.45652	189	225	414
12	"12-out20006"	.47016	260	293	553
12	"12-out20007"	.55844	43	34	77
12	"12-out20008"	.50797	191	185	376
12	"12-out20009"	.86956	60	9	69
12	"12-out20010"	.38739	418	661	1079
12	"12-out20011"	.99473	189	1	190
12	"12-out20012"	.44769	107	132	239
12	"12-out20013"	.66336	67	34	101
12	"12-out20014"	.48275	98	105	203
12	"12-out20015"	.81481	88	20	108
12	"12-out20016"	.39370	50	77	127
12	"12-out20017"	.56561	1043	801	1844
12	"12-out20018"	.70317	244	103	347
12	"12-out20019"	.98153	1276	24	1300
12	"12-out20020"	.40352	481	711	1192
12	"12-out20021"	.49712	691	699	1390
12	"12-out20022"	.93672	607	41	648
12	"12-out20023"	.40733	211	307	518
12	"12-out20024"	.36234	179	315	494
12	"12-out20025"	.87857	123	17	140
12	"12-out20026"	.31606	61	132	193
12	"12-out20027"	.37054	770	1308	2078
12	"12-out20028"	.46153	78	91	169
12	"12-out20029"	.99206	125	1	126
12	"12-out20030"	.99180	121	1	122
12	"12-out20031"	.29439	247	592	839
12	"12-out20032"	.60281	557	367	924
12	"12-out20033"	.28301	30	76	106
12	"12-out20034"	.50332	303	299	602
12	"12-out20035"	.24404	430	1332	1762
12	"12-out20036"	.72765	692	259	951
12	"12-out20037"	.54830	227	187	414
12	"12-out20038"	.99212	126	1	127
12	"12-out20039"	.67845	422	200	622
12	"12-out20040"	.56326	138	107	245
12	"12-out20041"	.58778	77	54	131
12	"12-out20042"	.27108	45	121	166
12	"12-out20043"	.35730	159	286	445
12	"12-out20044"	.99397	165	1	166
12	"12-out20045"	.99628	268	1	269
12	"12-out20046"	.91549	65	6	71
12	"12-out20047"	.99684	316	1	317
12	"12-out20048"	.23448	34	111	145
12	"12-out20049"	.29032	162	396	558
12	"12-out20050"	.35677	208	375	583
12	"12-out20051"	.45286	245	296	541
12	"12-out20052"	.98924	92	1	93
12	"12-out20053"	.63109	751	439	1190
12	"12-out20054"	.41807	148	206	354
12	"12-out20055"	.40827	385	558	943
12	"12-out20056"	.99854	686	1	687
12	"12-out20057"	.44376	363	455	818
12	"12-out20058"	.28150	210	536	746
12	"12-out20059"	.23820	207	662	869
12	"12-out20060"	.34210	78	150	228
12	"12-out20061"	.40983	100	144	244
12	"12-out20062"	.18390	48	213	261
12	"12-out20063"	.41232	87	124	211
12	"12-out20064"	.40434	93	137	230
12	"12-out20065"	.40000	88	132	220
12	"12-out20066"	.95909	211	9	220
12	"12-out20067"	.26222	59	166	225
12	"12-out20068"	.21556	36	131	167
12	"12-out20069"	.85477	206	35	241
12	"12-out20070"	.45762	108	128	236
12	"12-out20071"	.66761	470	234	704
12	"12-out20072"	.48275	308	330	638
12	"12-out20073"	.68556	133	61	194
12	"12-out20074"	.38253	127	205	332
12	"12-out20075"	.54959	205	168	373
12	"12-out20076"	.31866	478	1022	1500
12	"12-out20077"	.92766	513	40	553
12	"12-out20078"	.47551	301	332	633
12	"12-out20079"	.32743	74	152	226
12	"12-out20080"	.99703	336	1	337
12	"12-out20081"	.52066	63	58	121
12	"12-out20082"	.27781	397	1032	1429
12	"12-out20083"	.21659	261	944	1205
12	"12-out20084"	.30259	338	779	1117
12	"12-out20085"	.92111	1553	133	1686
12	"12-out20086"	.42744	380	509	889
12	"12-out20087"	.39803	568	859	1427
12	"12-out20088"	.28910	353	868	1221
12	"12-out20089"	.50266	660	653	1313
12	"12-out20090"	.40470	361	531	892
12	"12-out20091"	.27560	113	297	410
12	"12-out20092"	.60220	218	144	362
12	"12-out20093"	.28086	182	466	648
12	"12-out20094"	.31972	47	100	147
12	"12-out20095"	.43079	221	292	513
12	"12-out20096"	.30033	179	417	596
12	"12-out20097"	.53820	324	278	602
12	"12-out20098"	.34075	612	1184	1796
12	"12-out20099"	.99695	327	1	328
12	"12-out20100"	.31531	105	228	333
12	"12-out20101"	.99705	338	1	339
12	"12-out20102"	.98776	323	4	327
12	"12-out20103"	.44367	449	563	1012
12	"12-out20104"	.39095	337	525	862
12	"12-out20105"	.59438	233	159	392
12	"12-out20106"	.24897	244	736	980
12	"12-out20107"	.29945	221	517	738
12	"12-out20108"	.40579	336	492	828
12	"12-out20109"	.43146	362	477	839
12	"12-out20110"	.45454	350	420	770
12	"12-out20111"	.41339	253	359	612
12	"12-out20112"	.45012	722	882	1604
12	"12-out20113"	.41683	624	873	1497
12	"12-out20114"	.41334	725	1029	1754
12	"12-out20115"	.95486	550	26	576
12	"12-out20116"	.38353	438	704	1142
12	"12-out20117"	.46261	594	690	1284
12	"12-out20118"	.23826	66	211	277
12	"12-out20119"	.32103	87	184	271
12	"12-out20120"	.39393	377	580	957
12	"12-out20121"	.99193	123	1	124
12	"12-out20122"	.40074	107	160	267
12	"12-out20123"	.48000	48	52	100
12	"12-out20124"	.66666	268	134	402
12	"12-out20125"	.29301	109	263	372
12	"12-out20126"	.42187	162	222	384
12	"12-out20127"	.48129	193	208	401
12	"12-out20128"	.44080	175	222	397
12	"12-out20129"	.33664	305	601	906
12	"12-out20130"	.36306	346	607	953
12	"12-out20131"	.23373	97	318	415
12	"12-out20132"	.41878	214	297	511
12	"12-out20133"	.30882	63	141	204
12	"12-out20134"	.27459	240	634	874
12	"12-out20135"	.91618	798	73	871
12	"12-out20136"	.40191	168	250	418
12	"12-out20137"	.27061	105	283	388
12	"12-out20138"	.41337	136	193	329
12	"12-out20139"	.99456	183	1	184
12	"12-out20140"	.84736	161	29	190
12	"12-out20141"	.46736	179	204	383
12	"12-out20142"	.38418	68	109	177
12	"12-out20143"	.51428	108	102	210
12	"12-out20144"	.31929	235	501	736
12	"12-out20145"	.33293	280	561	841
12	"12-out20146"	.32268	101	212	313
12	"12-out20147"	.46612	172	197	369
12	"12-out20148"	.61904	104	64	168
12	"12-out20149"	.98876	88	1	89
12	"12-out20150"	.39810	84	127	211
12	"12-out20151"	.20183	66	261	327
12	"12-out20152"	.97674	42	1	43
12	"12-out20153"	.99082	108	1	109
12	"12-out20154"	.99082	108	1	109
12	"12-out20155"	.97435	38	1	39
12	"12-out20156"	.97674	42	1	43
12	"12-out20157"	.93364	197	14	211
12	"12-out20158"	.32307	84	176	260
12	"12-out20159"	.84971	441	78	519
12	"12-out20160"	.34430	251	478	729
12	"12-out20161"	.45036	245	299	544
12	"12-out20162"	.46177	151	176	327
12	"12-out20163"	.33560	148	293	441
12	"12-out20164"	.96529	445	16	461
12	"12-out20165"	.53667	417	360	777
12	"12-out20166"	.28333	136	344	480
12	"12-out20167"	.59854	164	110	274
12	"12-out20168"	.79310	207	54	261
12	"12-out20169"	.88082	170	23	193
12	"12-out20170"	.34076	214	414	628
12	"12-out20171"	.60000	63	42	105
12	"12-out20172"	.33090	273	552	825
12	"12-out20173"	.53184	167	147	314
12	"12-out20174"	.48815	103	108	211
12	"12-out20175"	.44622	502	623	1125
12	"12-out20176"	.59574	252	171	423
12	"12-out20177"	.52173	216	198	414
12	"12-out20178"	.56304	192	149	341
12	"12-out20179"	.27427	113	299	412
12	"12-out20180"	.46781	109	124	233
12	"12-out20181"	.41004	98	141	239
12	"12-out20182"	.48279	1473	1578	3051
12	"12-out20183"	.98367	241	4	245
12	"12-out20184"	.36679	95	164	259
12	"12-out20185"	.34888	157	293	450
12	"12-out20186"	.99767	430	1	431
12	"12-out20187"	.52431	248	225	473
12	"12-out20188"	.80180	89	22	111
12	"12-out20189"	.95238	60	3	63
12	"12-out20190"	.90277	65	7	72
12	"12-out20191"	.92452	98	8	106
12	"12-out20192"	.58227	46	33	79
12	"12-out20193"	.89843	115	13	128
12	"12-out20194"	.82677	315	66	381
12	"12-out20195"	.37942	225	368	593
12	"12-out20196"	.23697	423	1362	1785
12	"12-out20197"	.31917	263	561	824
12	"12-out20198"	.99797	493	1	494
12	"12-out20199"	.99305	143	1	144
12	"12-out20200"	.46650	195	223	418
12	"12-out20201"	.47633	1097	1206	2303
12	"12-out20202"	.22222	22	77	99
12	"12-out20203"	.47683	247	271	518
12	"12-out20204"	.45454	50	60	110
12	"12-out20205"	.33879	62	121	183
12	"12-out20206"	.37000	37	63	100
12	"12-out20207"	.36526	183	318	501
12	"12-out20208"	.99715	350	1	351
12	"12-out20209"	.11055	22	177	199
12	"12-out20210"	.34326	265	507	772
12	"12-out20211"	.44949	178	218	396
12	"12-out20212"	.70992	93	38	131
12	"12-out20213"	.99698	331	1	332
12	"12-out20214"	.41736	250	349	599
12	"12-out20215"	.37922	157	257	414
12	"12-out20216"	.41866	175	243	418
12	"12-out20217"	.46554	527	605	1132
12	"12-out20218"	.30588	312	708	1020
12	"12-out20219"	.37317	384	645	1029
12	"12-out20220"	.44088	537	681	1218
12	"12-out20221"	.75907	230	73	303
12	"12-out20222"	.39215	140	217	357
12	"12-out20223"	.32295	394	826	1220
12	"12-out20224"	.27586	80	210	290
12	"12-out20225"	.29411	365	876	1241
12	"12-out20226"	.31556	290	629	919
12	"12-out20227"	.73000	73	27	100
12	"12-out20228"	.33333	86	172	258
12	"12-out20229"	.44949	534	654	1188
12	"12-out20230"	.86765	1049	160	1209
12	"12-out20231"	.99500	199	1	200
12	"12-out20232"	.40979	368	530	898
12	"12-out20233"	.70967	66	27	93
12	"12-out20234"	.22516	34	117	151
12	"12-out20235"	.48430	108	115	223
12	"12-out20236"	.52564	123	111	234
12	"12-out20237"	.50781	65	63	128
12	"12-out20238"	.99074	107	1	108
12	"12-out20239"	.46000	69	81	150
12	"12-out20240"	.38758	181	286	467
12	"12-out20241"	.53030	70	62	132
12	"12-out20242"	.99319	146	1	147
12	"12-out20243"	.99539	216	1	217
12	"12-out20244"	.41441	138	195	333
12	"12-out20245"	.51639	63	59	122
12	"12-out20246"	.48275	70	75	145
12	"12-out20247"	.43636	120	155	275
12	"12-out20248"	.30081	37	86	123
12	"12-out20249"	.18220	43	193	236
12	"12-out20250"	.50158	158	157	315
12	"12-out20251"	.47260	138	154	292
12	"12-out20252"	.66086	76	39	115
12	"12-out20253"	.56410	44	34	78
12	"12-out20254"	.38510	729	1164	1893
12	"12-out20255"	.91699	464	42	506
12	"12-out20256"	.99853	682	1	683
12	"12-out20257"	.34645	704	1328	2032
12	"12-out20258"	.28562	483	1208	1691
12	"12-out20259"	.34662	365	688	1053
12	"12-out20260"	.45810	492	582	1074
12	"12-out20261"	.99775	445	1	446
12	"12-out20262"	.99775	445	1	446
12	"12-out20263"	.99264	135	1	136
12	"12-out20264"	.99750	399	1	400
12	"12-out20265"	.39258	508	786	1294
12	"12-out20266"	.45320	1385	1671	3056
12	"12-out20267"	.25538	83	242	325
12	"12-out20268"	.47701	83	91	174
12	"12-out20269"	.36125	69	122	191
12	"12-out20270"	.40909	27	39	66
12	"12-out20271"	.61184	93	59	152
12	"12-out20272"	.57943	186	135	321
12	"12-out20273"	.40237	237	352	589
12	"12-out20274"	.61244	128	81	209
12	"12-out20275"	.40890	101	146	247
12	"12-out20276"	.33041	302	612	914
12	"12-out20277"	.38617	95	151	246
12	"12-out20278"	.98473	258	4	262
12	"12-out20279"	.74596	185	63	248
12	"12-out20280"	.96078	49	2	51
12	"12-out20281"	.99378	160	1	161
12	"12-out20282"	.38294	211	340	551
12	"12-out20283"	.97101	67	2	69
12	"12-out20284"	.97379	669	18	687
12	"12-out20285"	.93518	101	7	108
12	"12-out20286"	.38323	64	103	167
12	"12-out20287"	.24610	221	677	898
12	"12-out20288"	.53488	115	100	215
12	"12-out20289"	.41545	86	121	207
12	"12-out20290"	.30163	92	213	305
12	"12-out20291"	.30803	69	155	224
12	"12-out20292"	.35267	79	145	224
12	"12-out20293"	.40182	88	131	219
12	"12-out20294"	.88181	194	26	220
12	"12-out20295"	.27739	81	211	292
12	"12-out20296"	.91363	201	19	220
12	"12-out20297"	.49282	103	106	209
12	"12-out20298"	.31651	69	149	218
12	"12-out20299"	.69194	146	65	211
12	"12-out20300"	.64976	141	76	217
12	"12-out20301"	.54098	330	280	610
12	"12-out20302"	.29024	119	291	410
12	"12-out20303"	.37762	395	651	1046
12	"12-out20304"	.39007	275	430	705
12	"12-out20305"	.79158	395	104	499
12	"12-out20306"	.74916	224	75	299
12	"12-out20307"	.38023	381	621	1002
12	"12-out20308"	.73972	324	114	438
12	"12-out20309"	.58842	183	128	311
12	"12-out20310"	.31299	359	788	1147
12	"12-out20311"	.37121	98	166	264
12	"12-out20312"	.31538	82	178	260
12	"12-out20313"	.31764	54	116	170
12	"12-out20314"	.85786	169	28	197
12	"12-out20315"	.99767	430	1	431
12	"12-out20316"	.55135	102	83	185
12	"12-out20317"	.35904	135	241	376
12	"12-out20318"	.33838	134	262	396
12	"12-out20319"	.99622	264	1	265
12	"12-out20320"	.99371	158	1	159
12	"12-out20321"	.99507	202	1	203
12	"12-out20322"	.81818	315	70	385
12	"12-out20323"	.31343	63	138	201
12	"12-out20324"	.30455	127	290	417
12	"12-out20325"	.28669	125	311	436
12	"12-out20326"	.26588	113	312	425
12	"12-out20327"	.66386	553	280	833
12	"12-out20328"	.73702	213	76	289
12	"12-out20329"	.51727	494	461	955
12	"12-out20330"	.99300	142	1	143
12	"12-out20331"	.48986	145	151	296
12	"12-out20332"	.99746	394	1	395
12	"12-out20333"	.99717	705	2	707
12	"12-out20334"	.99746	394	1	395
12	"12-out20335"	.37545	104	173	277
12	"12-out20336"	.44521	512	638	1150
12	"12-out20337"	.44897	44	54	98
12	"12-out20338"	.31202	288	635	923
12	"12-out20339"	.54545	342	285	627
12	"12-out20340"	.74269	508	176	684
12	"12-out20341"	.34103	192	371	563
12	"12-out20342"	.45098	138	168	306
12	"12-out20343"	.40404	40	59	99
12	"12-out20344"	.41768	274	382	656
12	"12-out20345"	.58585	58	41	99
12	"12-out20346"	.69520	203	89	292
12	"12-out20347"	.31951	131	279	410
12	"12-out20348"	.43155	227	299	526
12	"12-out20349"	.36901	131	224	355
12	"12-out20350"	.76044	273	86	359
12	"12-out20351"	.54888	393	323	716
12	"12-out20352"	.98684	75	1	76
12	"12-out20353"	.85783	1231	204	1435
12	"12-out20354"	.66814	453	225	678
12	"12-out20355"	.61868	245	151	396
12	"12-out20356"	.68253	86	40	126
12	"12-out20357"	.99200	124	1	125
12	"12-out20358"	.44354	880	1104	1984
12	"12-out20359"	.47422	276	306	582
12	"12-out20360"	.32697	257	529	786
12	"12-out20361"	.99521	208	1	209
12	"12-out20362"	.31125	47	104	151
12	"12-out20363"	.45785	201	238	439
12	"12-out20364"	.68224	146	68	214
12	"12-out20365"	.40839	292	423	715
12	"12-out20366"	.99572	233	1	234
12	"12-out20367"	.99502	200	1	201
12	"12-out20368"	.89959	448	50	498
12	"12-out20369"	.99746	394	1	395
12	"12-out20370"	.96644	432	15	447
12	"12-out20371"	.99640	277	1	278
12	"12-out20372"	.76377	194	60	254
12	"12-out20373"	.98913	91	1	92
12	"12-out20374"	.99905	1062	1	1063
12	"12-out20375"	.49586	120	122	242
12	"12-out20376"	.68510	161	74	235
12	"12-out20377"	.99735	377	1	378
12	"12-out20378"	.60390	340	223	563
12	"12-out20379"	.99009	100	1	101
12	"12-out20380"	.74204	210	73	283
12	"12-out20381"	.37915	433	709	1142
12	"12-out20382"	.50746	170	165	335
12	"12-out20383"	.76595	72	22	94
12	"12-out20384"	.98913	91	1	92
12	"12-out20385"	.52785	199	178	377
12	"12-out20386"	.56354	470	364	834
12	"12-out20387"	.51744	178	166	344
12	"12-out20388"	.48189	173	186	359
12	"12-out20389"	.40780	115	167	282
12	"12-out20390"	.59595	177	120	297
12	"12-out20391"	.42511	193	261	454
12	"12-out20392"	.48348	366	391	757
12	"12-out20393"	.52293	171	156	327
12	"12-out20394"	.43916	148	189	337
12	"12-out20395"	.40597	136	199	335
12	"12-out20396"	.93787	468	31	499
12	"12-out20397"	.43343	140	183	323
12	"12-out20398"	.98823	84	1	85
12	"12-out20399"	.82862	411	85	496
12	"12-out20400"	.99815	540	1	541
12	"12-out20401"	.33592	346	684	1030
12	"12-out20402"	.45977	40	47	87
12	"12-out20403"	.36153	47	83	130
12	"12-out20404"	.58007	163	118	281
12	"12-out20405"	.46391	225	260	485
12	"12-out20406"	.99151	935	8	943
12	"12-out20407"	.51644	424	397	821
12	"12-out20408"	.59722	172	116	288
12	"12-out20409"	.58757	104	73	177
12	"12-out20410"	.44186	76	96	172
12	"12-out20411"	.91620	492	45	537
12	"12-out20412"	.36916	182	311	493
